bill_id,roll_call_id,date,chamber,description,yea,nay,nv,absent,total
678596,384363,2015-01-14,House,"House Third Reading: Roll Call # 3",109,0,0,0,109
678908,384318,2015-01-14,House,"House Third Reading: Roll Call # 2",109,0,0,0,109
681491,393795,2015-02-11,House,"Reported With Recommendation Without Amendment",11,0,0,0,11
681771,477727,2015-10-14,House,"Reported With Recommendation With Substitute  H-2",8,0,0,0,8
681771,480695,2015-10-28,House,"House Third Reading: Given Immediate Effect Roll Call # 392",105,0,0,0,105
681771,548144,2016-05-24,Senate,"Reported Favorably Without Amendment",5,0,0,0,5
681771,562390,2016-09-08,Senate,"Senate Third Reading: Given Immediate Effect Roll Call # 502",37,0,0,0,37
681850,397499,2015-02-18,House,"Reported With Recommendation With Substitute  H-1",8,0,0,0,8
682027,413326,2015-03-18,House,"Reported With Recommendation With Substitute  H-1",17,0,0,0,17
682027,420850,2015-03-26,House,"House Third Reading: Given Immediate Effect Roll Call # 51",106,4,0,0,110
682027,445781,2015-05-12,Senate,"Reported Favorably Without Amendment",4,0,0,0,4
682027,448500,2015-05-19,Senate,"Senate Third Reading: Given Immediate Effect Roll Call # 194",35,1,0,2,38
682075,539802,2016-04-28,House,"Reported With Recommendation Without Amendment",10,6,0,0,16
682177,412572,2015-03-17,House,"Reported With Recommendation Without Amendment",5,3,0,0,8
682177,416976,2015-03-25,House,"House Third Reading: Given Immediate Effect Roll Call # 45",70,40,0,0,110
682227,394146,2015-02-11,House,"Reported With Recommendation Without Amendment",11,0,0,0,11
685270,436116,2015-04-21,Senate,"Reported Favorably With Substitute  S-1",4,0,0,0,4
685294,385459,2015-01-21,Senate,"Reported Favorably With Substitute  S-1",5,0,0,0,5
685294,389745,2015-02-03,Senate,"Senate Third Reading: Passed Roll Call # 7",37,0,0,1,38
685294,408872,2015-03-10,House,"Reported With Recommendation With Substitute  H-1",9,1,0,0,10
685294,434392,2015-04-16,House,"House Third Reading: Given Immediate Effect Roll Call # 62",82,28,0,0,110
685294,438633,2015-04-23,Senate,"Senate Third Reading: Roll Call # 108",37,0,0,1,38
685310,422261,2015-03-26,Senate,"Reported Favorably With Substitute  S-2",7,0,0,0,7
685352,394598,2015-02-11,Senate,"Reported Favorably Without Amendment",4,0,0,0,4
685352,398404,2015-02-19,Senate,"Senate Third Reading: Passed Roll Call # 18",38,0,0,0,38
685352,413444,2015-03-18,House,"Reported With Recommendation Without Amendment",27,0,0,0,27
685352,421928,2015-03-26,House,"House Third Reading: Given Immediate Effect Roll Call # 49",109,1,0,0,110
685367,543150,2016-05-05,Senate,"Reported Favorably With Substitute  S-1",3,1,0,0,4
685380,447108,2015-05-14,Senate,"Reported Favorably With Substitute  S-1",3,0,0,0,3
685380,447109,2015-05-14,Senate,"Senate Third Reading: Passed Roll Call # 171",22,15,0,1,38
685396,394515,2015-02-11,Senate,"Reported Favorably Without Amendment",4,0,0,0,4
685396,398624,2015-02-19,Senate,"Senate Third Reading: Passed Roll Call # 17",38,0,0,0,38
685396,413377,2015-03-18,House,"Reported With Recommendation Without Amendment",27,0,0,0,27
685396,418720,2015-03-26,House,"House Third Reading: Given Immediate Effect Roll Call # 48",108,2,0,0,110
685409,513305,2016-03-03,Senate,"Reported Favorably With Recommendation For Referral To Committee On Natural Resources",4,0,0,0,4
685438,481129,2015-11-10,Senate,"Reported Favorably Without Amendment",4,0,0,0,4
685438,481130,2015-11-10,Senate,"Senate Third Reading: Passed Roll Call # 529",23,13,0,2,38
685438,482004,2015-12-08,House,"Reported With Recommendation With Substitute  H-2",5,2,0,0,7
685438,482083,2015-12-09,House,"House Third Reading: Given Immediate Effect Roll Call # 466",54,51,0,0,105
685438,482648,2015-12-16,Senate,"Senate Third Reading: Roll Call # 647",24,13,0,1,38
685438,482649,2015-12-16,House,"House Third Reading: Roll Call # 505",54,52,0,0,106
685456,404020,2015-03-03,Senate,"Reported Favorably With Recommendation For Referral To Committee On Finance",4,0,0,0,4
685456,449681,2015-05-21,Senate,"Reported Favorably With Substitute  S-1",5,2,0,0,7
685456,482493,2015-12-15,Senate,"Senate Third Reading: Passed Roll Call # 601",36,2,0,0,38
685497,446827,2015-05-14,Senate,"Reported Favorably Without Amendment",3,0,0,0,3
685497,446828,2015-05-14,Senate,"Senate Third Reading: Passed Roll Call # 170",22,15,0,1,38
685511,446892,2015-05-14,Senate,"Reported Favorably With Substitute  S-1",3,0,0,0,3
685511,446893,2015-05-14,Senate,"Senate Third Reading: Passed Roll Call # 173",22,15,0,1,38
685524,513327,2016-03-03,Senate,"Reported Favorably With Recommendation For Referral To Committee On Natural Resources",4,0,0,0,4
685541,418717,2015-03-26,Senate,"Reported Favorably With Substitute  S-2",7,0,0,0,7
685590,397582,2015-02-18,Senate,"Reported Favorably With Substitute  S-1",4,0,0,0,4
685590,422181,2015-03-26,Senate,"Senate Third Reading: Passed Roll Call # 71",37,0,0,1,38
685590,440236,2015-04-28,House,"Reported With Recommendation With Substitute  H-1",16,0,0,0,16
685590,451915,2015-05-26,House,"House Third Reading: Given Immediate Effect Roll Call # 195",110,0,0,0,110
685590,453557,2015-05-27,Senate,"Senate Third Reading: Roll Call # 243",37,0,0,1,38
687763,459394,2015-06-11,Senate,"Reported Favorably With Substitute  S-1",4,0,0,0,4
687763,461461,2015-06-17,Senate,"Senate Third Reading: Passed Roll Call # 299",38,0,0,0,38
687763,477590,2015-10-07,House,"Reported With Recommendation With Substitute H-2",24,1,0,0,25
687763,480293,2015-10-20,House,"House Third Reading: Given Immediate Effect Roll Call # 368",103,2,0,0,105
687763,480345,2015-10-21,Senate,"Senate Third Reading: Roll Call # 448",37,0,0,1,38
688013,406477,2015-03-05,Senate,"Reported Favorably With Substitute  S-1",7,0,0,0,7
688013,414011,2015-03-19,Senate,"Senate Third Reading: Passed Roll Call # 56",37,0,0,1,38
688108,459365,2015-06-11,Senate,"Reported Favorably Without Amendment",4,0,0,0,4
688108,461394,2015-06-17,Senate,"Senate Third Reading: Passed Roll Call # 298",38,0,0,0,38
688270,437274,2015-04-22,House,"Reported With Recommendation With Substitute  H-2",11,0,0,0,11
688270,460841,2015-06-17,House,"House Third Reading: Given Immediate Effect Roll Call # 258",93,17,0,0,110
688270,480726,2015-10-28,Senate,"Reported Favorably Without Amendment",3,0,0,0,3
688270,480907,2015-11-05,Senate,"Senate Third Reading: Given Immediate Effect Roll Call # 498",37,1,0,0,38
688428,408812,2015-03-10,House,"Reported With Recommendation With Substitute  H-2",7,0,0,0,7
688428,413241,2015-03-18,House,"House Third Reading: Given Immediate Effect Roll Call # 38",85,24,0,0,109
688428,438853,2015-04-23,Senate,"Reported Favorably Without Amendment",3,1,0,0,4
688428,445801,2015-05-12,Senate,"Senate Third Reading: Given Immediate Effect Roll Call # 161",26,11,1,0,38
688901,443465,2015-05-05,House,"Reported With Recommendation With Substitute  H-1",15,0,0,0,15
688901,456041,2015-06-02,House,"House Third Reading: Given Immediate Effect Roll Call # 209",108,0,0,0,108
688901,550172,2016-05-31,Senate,"Reported Favorably With Substitute  S-1",5,0,0,0,5
688901,564027,2016-10-20,Senate,"Senate Third Reading: Given Immediate Effect Roll Call # 568",36,0,0,1,37
688901,564818,2016-11-09,House,"House Third Reading: Roll Call # 502",105,0,0,0,105
689055,413159,2015-03-18,House,"Reported With Recommendation Without Amendment",5,3,0,0,8
689055,418755,2015-03-26,House,"House Third Reading: Given Immediate Effect Roll Call # 50",74,36,0,0,110
689055,446757,2015-05-14,Senate,"Reported Favorably With Substitute  S-2",4,0,0,0,4
689055,451785,2015-05-26,Senate,"Senate Third Reading: Given Immediate Effect Roll Call # 222",26,12,0,0,38
689055,456086,2015-06-02,House,"House Third Reading: Roll Call # 207",74,34,0,0,108
691087,564059,2016-10-20,Senate,"Reported Favorably With Substitute  S-1",4,0,0,0,4
691087,564060,2016-10-20,Senate,"Senate Third Reading: Passed Roll Call # 592",36,0,0,1,37
691087,565476,2016-11-30,House,"Reported With Recommendation With Substitute  H-1",13,0,0,0,13
691087,566262,2016-12-13,House,"House Third Reading: Passed Roll Call # 666",106,2,0,0,108
691087,566263,2016-12-13,Senate,"Senate Third Reading: Roll Call # 755",37,0,0,1,38
691184,397457,2015-02-18,House,"Reported With Recommendation Without Amendment",13,0,0,0,13
691184,404157,2015-03-03,House,"House Third Reading: Given Immediate Effect Roll Call # 24",110,0,0,0,110
691184,410676,2015-03-12,Senate,"Reported Favorably Without Amendment",7,0,0,0,7
691184,416990,2015-03-25,Senate,"Senate Third Reading: Given Immediate Effect Roll Call # 62",37,0,0,1,38
691240,387976,2015-01-29,Senate,"Reported Favorably With Substitute S-1",5,0,0,0,5
691715,563064,2016-09-21,Senate,"Reported Favorably With Substitute S-1",7,0,0,0,7
691715,564066,2016-10-20,Senate,"Senate Third Reading: Passed Roll Call # 564",35,2,0,0,37
691715,566052,2016-12-07,House,"Reported With Recommendation Without Amendment",26,0,0,0,26
691715,566643,2016-12-14,House,"House Third Reading: Given Immediate Effect Roll Call # 706",104,4,0,0,108
691824,448441,2015-05-19,House,"Reported With Recommendation With Substitute  H-3",11,7,0,0,18
691824,448956,2015-05-20,House,"House Third Reading: Given Immediate Effect Roll Call # 173",57,52,0,0,109
691824,459349,2015-06-11,Senate,"Reported Favorably With Substitute S-1",4,0,0,0,4
691824,459350,2015-06-11,Senate,"Senate Third Reading: Given Immediate Effect Roll Call # 293",22,16,0,0,38
691824,460202,2015-06-16,House,"House Third Reading: Roll Call # 249",59,51,0,0,110
691824,461316,2015-06-17,Senate,"Senate Third Reading: Roll Call # 296",23,15,0,0,38
691824,461317,2015-06-17,Senate,"Senate Third Reading: Roll Call # 297",22,16,0,0,38
691879,387718,2015-01-29,Senate,"Reported Favorably Without Amendment",5,0,0,0,5
691990,409727,2015-03-11,House,"Reported With Recommendation With Substitute  H-3",14,1,0,0,15
691990,416369,2015-03-24,House,"House Third Reading: Given Immediate Effect Roll Call # 41",106,3,0,0,109
691990,438847,2015-04-23,Senate,"Reported Favorably With Substitute  S-1",9,0,0,0,9
691990,445875,2015-05-12,Senate,"Senate Third Reading: Given Immediate Effect Roll Call # 162",37,0,1,0,38
691990,448442,2015-05-19,House,"House Third Reading: Roll Call # 151",105,3,0,0,108
698192,387817,2015-01-29,Senate,"Reported Favorably Without Amendment",4,1,0,0,5
700184,563880,2016-10-18,Senate,"Reported Favorably With Substitute  S-2",4,1,0,0,5
700184,564096,2016-10-20,Senate,"Senate Third Reading: Passed Roll Call # 576",26,10,0,1,37
700245,393114,2015-02-10,Senate,"Reported Favorably Without Amendment",4,0,0,0,4
700245,396549,2015-02-17,Senate,"Senate Third Reading: Passed Roll Call # 14",38,0,0,0,38
700245,408716,2015-03-10,House,"Reported With Recommendation Without Amendment",16,0,0,0,16
700245,414053,2015-03-19,House,"House Third Reading: Given Immediate Effect Roll Call # 40",105,2,0,0,107
700245,416955,2015-03-25,Senate,"Senate Third Reading: House Amendment(s) Concurred In Roll Call # 61",37,0,0,1,38
700275,406125,2015-03-05,Senate,"Reported Favorably With Substitute  S-1",3,1,0,0,4
700332,458875,2015-06-10,Senate,"Reported Favorably With Substitute  S-2",3,0,0,0,3
700332,480884,2015-11-04,Senate,"Senate Third Reading: Passed Roll Call # 485",38,0,0,0,38
700332,564862,2016-11-10,House,"Reported With Recommendation With Substitute  H-2",12,2,0,0,14
700332,566008,2016-12-07,House,"House Third Reading: Given Immediate Effect Roll Call # 564",84,22,0,0,106
700332,566009,2016-12-08,Senate,"Senate Third Reading: Roll Call # 700",36,1,0,1,38
700332,566010,2016-12-08,Senate,"Senate Third Reading: Roll Call # 701",37,0,0,1,38
700361,563887,2016-10-18,Senate,"Reported Favorably With Substitute  S-1",5,0,0,0,5
700361,564065,2016-10-20,Senate,"Senate Third Reading: Passed Roll Call # 577",26,10,0,1,37
700391,387724,2015-01-29,Senate,"Reported Favorably With Substitute  S-1",5,0,0,0,5
700391,389743,2015-02-03,Senate,"Senate Third Reading: Passed Roll Call # 5",28,9,0,1,38
700391,397607,2015-02-18,House,"Reported With Recommendation With Substitute  H-1",7,3,0,0,10
700391,401736,2015-02-25,House,"House Third Reading: Given Immediate Effect Roll Call # 16",76,34,0,0,110
700391,402420,2015-02-26,Senate,"Senate Third Reading: Roll Call # 35",28,9,0,1,38
700451,406672,2015-03-05,Senate,"Reported Favorably With Substitute  S-1",3,1,0,0,4
700480,387893,2015-01-29,Senate,"Reported Favorably Without Amendment",5,0,0,0,5
700480,389744,2015-02-03,Senate,"Senate Third Reading: Passed Roll Call # 6",28,9,0,1,38
700480,397452,2015-02-18,House,"Reported With Recommendation Without Amendment",7,3,0,0,10
700480,401677,2015-02-25,House,"House Third Reading: Given Immediate Effect Roll Call # 17",81,29,0,0,110
700528,414131,2015-03-19,House,"Reported With Recommendation Without Amendment",7,0,0,0,7
700528,418714,2015-03-26,House,"House Third Reading: Given Immediate Effect Roll Call # 53",110,0,0,0,110
700528,448439,2015-05-19,Senate,"Reported Favorably Without Amendment",5,0,0,0,5
700528,452193,2015-05-26,Senate,"Senate Third Reading: Given Immediate Effect Roll Call # 224",38,0,0,0,38
700538,390623,2015-02-04,House,"Reported With Recommendation Without Amendment",27,1,0,0,28
700538,390871,2015-02-05,House,"House Third Reading: Given Immediate Effect Roll Call # 4",103,7,0,0,110
700538,402528,2015-02-26,Senate,"Reported Favorably Without Amendment",16,0,0,0,16
700538,406684,2015-03-05,Senate,"Senate Third Reading: Given Immediate Effect Roll Call # 39",31,5,0,2,38
700595,441712,2015-04-29,House,"Reported With Recommendation With Substitute  H-2",14,0,0,0,14
700595,445754,2015-05-12,House,"House Third Reading: Given Immediate Effect Roll Call # 142",106,4,0,0,110
700616,404846,2015-03-04,House,"Reported With Recommendation Without Amendment",10,0,0,0,10
700616,412477,2015-03-17,House,"House Third Reading: Given Immediate Effect Roll Call # 34",104,4,0,0,108
700616,441176,2015-04-29,Senate,"Reported Favorably With Substitute  S-1",5,0,0,0,5
700616,445858,2015-05-12,Senate,"Senate Third Reading: Given Immediate Effect Roll Call # 163",37,0,1,0,38
700616,449297,2015-05-20,Senate,"Senate Third Reading: Passed Roll Call # 213",37,0,0,1,38
700616,449711,2015-05-21,House,"House Third Reading: Roll Call # 185",105,4,0,0,109
700629,432682,2015-04-15,House,"Reported With Recommendation Without Amendment",13,0,0,0,13
700636,404081,2015-03-03,House,"Reported With Recommendation With Substitute  H-1",7,0,0,0,7
700636,410606,2015-03-12,House,"House Third Reading: Given Immediate Effect Roll Call # 29",98,12,0,0,110
700636,438580,2015-04-23,Senate,"Reported Favorably Without Amendment",4,0,0,0,4
700636,444463,2015-05-07,Senate,"Senate Third Reading: Given Immediate Effect Roll Call # 158",38,0,0,0,38
700692,535136,2016-04-19,House,"Reported With Recommendation For Referral To Committee On Government Operations",20,1,0,0,21
700702,401600,2015-02-25,House,"Reported With Recommendation With Substitute  H-2",13,0,0,0,13
700715,397770,2015-02-18,House,"Reported With Recommendation Without Amendment",11,0,0,0,11
700715,401599,2015-02-25,House,"House Third Reading: Given Immediate Effect Roll Call # 12",110,0,0,0,110
700715,444737,2015-05-07,Senate,"Reported Favorably Without Amendment",4,0,0,0,4
700715,446265,2015-05-13,Senate,"Senate Third Reading: Given Immediate Effect Roll Call # 164",37,0,0,1,38
700721,444503,2015-05-07,House,"Reported With Recommendation With Substitute  H-2",6,0,0,0,6
700721,449039,2015-05-20,House,"House Third Reading: Given Immediate Effect Roll Call # 184",101,9,0,0,110
700721,461541,2015-06-17,Senate,"Reported Favorably With Substitute  S-1",5,0,0,0,5
700721,476823,2015-09-17,Senate,"Senate Third Reading: Given Immediate Effect Roll Call # 358",34,2,1,1,38
700721,476937,2015-09-22,House,"House Third Reading: Roll Call # 305",86,18,0,0,104
700735,440704,2015-04-28,House,"Reported With Recommendation With Substitute  H-1",10,0,0,0,10
700735,444504,2015-05-07,House,"House Third Reading: Given Immediate Effect Roll Call # 132",110,0,0,0,110
700735,452120,2015-05-26,Senate,"Senate Third Reading: Given Immediate Effect Roll Call # 217",38,0,0,0,38
700746,394610,2015-02-12,House,"Reported With Recommendation With Substitute  H-2",9,0,0,0,9
700746,406220,2015-03-05,House,"House Third Reading: Given Immediate Effect Roll Call # 25",108,2,0,0,110
700746,477643,2015-10-08,Senate,"Reported Favorably With Substitute  S-5",5,0,0,0,5
700746,481580,2015-12-01,Senate,"Senate Third Reading: Given Immediate Effect Roll Call # 532",35,0,0,3,38
700746,481721,2015-12-03,House,"House Third Reading: Roll Call # 442",102,2,0,0,104
700746,481967,2015-12-08,Senate,"Senate Third Reading: Roll Call # 551",37,0,0,1,38
700756,393833,2015-02-11,House,"Reported With Recommendation With Substitute  H-1",8,0,0,0,8
700756,396666,2015-02-17,House,"House Third Reading: Given Immediate Effect Roll Call # 5",109,1,0,0,110
700935,441651,2015-04-29,House,"Reported With Recommendation Without Amendment",8,0,0,0,8
700940,408804,2015-03-10,Senate,"Reported Favorably With Substitute  S-1",6,3,0,0,9
701554,413997,2015-03-19,Senate,"Reported Favorably Without Amendment",4,0,0,0,4
701554,418790,2015-03-26,Senate,"Senate Third Reading: Passed Roll Call # 74",33,3,1,1,38
701554,488671,2016-01-27,House,"Reported With Recommendation With Substitute  H-1",27,2,0,0,29
701554,499287,2016-02-16,House,"House Third Reading: Given Immediate Effect Roll Call # 40",97,6,0,0,103
701554,501158,2016-02-17,Senate,"Senate Third Reading: Roll Call # 57",32,4,0,2,38
701612,444577,2015-05-07,House,"Reported With Recommendation With Substitute  H-2",24,3,0,0,27
701612,444578,2015-05-07,House,"House Third Reading: Passed Roll Call # 124",86,24,0,0,110
701612,447019,2015-05-14,Senate,"Senate Third Reading: Passed Roll Call # 183",28,9,0,1,38
701612,448525,2015-05-19,House,"House Third Reading: Roll Call # 152",0,108,0,0,108
701671,394822,2015-02-12,Senate,"Reported Favorably With Substitute  S-1",5,0,0,0,5
701671,398406,2015-02-19,Senate,"Senate Third Reading: Passed Roll Call # 19",37,1,0,0,38
701671,408748,2015-03-10,House,"Reported With Recommendation With Substitute H-1",7,4,0,0,11
701671,408829,2015-03-10,House,"Reported With Recommendation With Substitute  H-1",7,4,0,0,11
701671,416950,2015-03-25,House,"House Third Reading: Given Immediate Effect Roll Call # 44",73,37,0,0,110
701671,422309,2015-03-26,Senate,"Senate Third Reading: Roll Call # 67",35,2,0,1,38
701671,422310,2015-03-26,Senate,"Senate Third Reading: Roll Call # 68",36,1,0,1,38
701694,444491,2015-05-07,House,"Reported With Recommendation With Substitute  H-2",25,1,0,0,26
701694,444492,2015-05-07,House,"House Third Reading: Passed Roll Call # 123",103,7,0,0,110
701694,447106,2015-05-14,Senate,"Senate Third Reading: Passed Roll Call # 184",28,9,0,1,38
701694,448642,2015-05-19,House,"House Third Reading: Roll Call # 153",0,108,0,0,108
701729,444478,2015-05-07,House,"Reported With Recommendation With Substitute  H-2",22,2,0,0,24
701729,444479,2015-05-07,House,"House Third Reading: Passed Roll Call # 117",103,7,0,0,110
701729,446896,2015-05-14,Senate,"Senate Third Reading: Passed Roll Call # 190",27,10,0,1,38
701729,448593,2015-05-19,House,"House Third Reading: Roll Call # 159",0,109,0,0,109
701741,444567,2015-05-07,House,"Reported With Recommendation With Substitute  H-2",24,1,0,0,25
701741,444568,2015-05-07,House,"House Third Reading: Passed Roll Call # 119",104,6,0,0,110
701741,447111,2015-05-14,Senate,"Senate Third Reading: Passed Roll Call # 185",28,9,0,1,38
701741,448468,2015-05-19,House,"House Third Reading: Roll Call # 154",0,108,0,0,108
701768,460752,2015-06-17,House,"Reported With Recommendation With Substitute  H-1",27,0,0,0,27
701768,481737,2015-12-03,House,"House Third Reading: Given Immediate Effect Roll Call # 443",103,1,0,0,104
701768,482240,2015-12-10,Senate,"Reported Favorably Without Amendment",16,0,0,0,16
701768,482505,2015-12-15,Senate,"Senate Third Reading: Given Immediate Effect Roll Call # 598",38,0,0,0,38
701792,393378,2015-02-10,Senate,"Reported Favorably Without Amendment",4,1,0,0,5
701792,394675,2015-02-12,Senate,"Senate Third Reading: Passed Roll Call # 10",38,0,0,0,38
701792,396555,2015-02-17,House,"Reported With Recommendation Without Amendment",6,0,0,0,6
701792,397466,2015-02-18,House,"House Third Reading: Given Immediate Effect Roll Call # 8",72,38,0,0,110
701792,398400,2015-02-19,Senate,"Senate Third Reading: House Amendment(s) Concurred In Roll Call # 15",37,1,0,0,38
701815,390778,2015-02-05,Senate,"Reported Favorably With Substitute  S-1",5,0,0,0,5
701815,396585,2015-02-17,Senate,"Senate Third Reading: Passed Roll Call # 12",38,0,0,0,38
701815,405194,2015-03-04,House,"Reported With Recommendation With Substitute  H-1",8,0,0,0,8
701815,416924,2015-03-25,House,"House Third Reading: Given Immediate Effect Roll Call # 42",110,0,0,0,110
701815,418708,2015-03-26,Senate,"Senate Third Reading: Roll Call # 69",37,0,0,1,38
701824,394664,2015-02-12,Senate,"Reported Favorably With Substitute  S-1",4,1,0,0,5
701850,438546,2015-04-23,House,"Reported With Recommendation With Substitute  H-1",17,12,0,0,29
701850,441231,2015-04-29,House,"House Third Reading: Given Immediate Effect Roll Call # 92",60,50,0,0,110
701850,446779,2015-05-14,Senate,"Senate Third Reading: Passed Roll Call # 191",27,10,0,1,38
701850,448469,2015-05-19,House,"House Third Reading: Roll Call # 160",0,109,0,0,109
701850,456858,2015-06-03,House,"House Third Reading: Conference Report Adopted Roll Call # 213",99,10,0,0,109
701850,456859,2015-06-03,Senate,"Senate Third Reading: Senate Adopted Conference Report With Immediate Effect Roll Call # 262",24,14,0,0,38
701863,444471,2015-05-07,House,"Reported With Recommendation With Substitute  H-2",22,2,0,0,24
701863,444472,2015-05-07,House,"House Third Reading: Passed Roll Call # 118",102,8,0,0,110
701863,446957,2015-05-14,Senate,"Senate Third Reading: Passed Roll Call # 186",27,10,0,1,38
701863,448475,2015-05-19,House,"House Third Reading: Roll Call # 155",0,108,0,0,108
701875,390782,2015-02-05,Senate,"Reported Favorably With Substitute  S-1",5,0,0,0,5
701875,396696,2015-02-17,Senate,"Senate Third Reading: Passed Roll Call # 13",38,0,0,0,38
701875,405177,2015-03-04,House,"Reported With Recommendation Without Amendment",8,0,0,0,8
701875,417364,2015-03-25,House,"House Third Reading: Given Immediate Effect Roll Call # 43",110,0,0,0,110
701875,421968,2015-03-26,Senate,"Senate Third Reading: Roll Call # 70",37,0,0,1,38
701897,393107,2015-02-10,Senate,"Reported Favorably Without Amendment",4,1,0,0,5
701897,394668,2015-02-12,Senate,"Senate Third Reading: Passed Roll Call # 11",38,0,0,0,38
701897,396930,2015-02-17,House,"Reported With Recommendation Without Amendment",6,0,0,0,6
701897,397934,2015-02-18,House,"House Third Reading: Given Immediate Effect Roll Call # 9",74,36,0,0,110
701897,398466,2015-02-19,Senate,"Senate Third Reading: House Amendment(s) Concurred In Roll Call # 16",37,1,0,0,38
701944,394591,2015-02-12,House,"Reported With Recommendation With Substitute  H-1",19,10,0,0,29
701944,397887,2015-02-18,House,"House Third Reading: Given Immediate Effect Roll Call # 7",66,44,0,0,110
701944,402364,2015-02-26,Senate,"Reported Favorably Without Amendment",4,0,0,0,4
701944,402365,2015-02-26,Senate,"Senate Third Reading: Given Immediate Effect Roll Call # 29",26,11,0,1,38
701957,481966,2015-12-08,Senate,"Reported Favorably With Substitute  S-1",5,0,0,0,5
701957,482524,2015-12-15,Senate,"Senate Third Reading: Passed Roll Call # 606",38,0,0,0,38
701957,499301,2016-02-16,House,"Reported With Recommendation Without Amendment",15,0,0,0,15
701957,510889,2016-03-01,House,"House Third Reading: Given Immediate Effect Roll Call # 76",105,0,0,0,105
701978,404259,2015-03-03,Senate,"Reported Favorably With Substitute  S-1",5,0,0,0,5
701978,409679,2015-03-11,Senate,"Senate Third Reading: Passed Roll Call # 42",38,0,0,0,38
701978,442391,2015-04-30,House,"Reported With Recommendation Without Amendment",9,0,0,0,9
701978,445838,2015-05-12,House,"House Third Reading: Given Immediate Effect Roll Call # 143",110,0,0,0,110
701987,394755,2015-02-12,Senate,"Reported Favorably With Substitute  S-1",4,1,0,0,5
702002,444480,2015-05-07,House,"Reported With Recommendation With Substitute  H-2",26,0,0,0,26
702002,444481,2015-05-07,House,"House Third Reading: Passed Roll Call # 122",103,7,0,0,110
702002,446808,2015-05-14,Senate,"Senate Third Reading: Passed Roll Call # 189",27,10,0,1,38
702002,448514,2015-05-19,House,"House Third Reading: Roll Call # 158",0,109,0,0,109
702096,416942,2015-03-25,House,"Reported With Recommendation With Substitute  H-1",27,0,0,0,27
702096,446830,2015-05-14,House,"House Third Reading: Given Immediate Effect Roll Call # 146",107,1,0,0,108
702096,459410,2015-06-11,Senate,"Reported Favorably With Substitute S--1",4,0,0,0,4
702096,459411,2015-06-11,Senate,"Senate Third Reading: Given Immediate Effect Roll Call # 287",38,0,0,0,38
702096,459412,2015-06-11,House,"House Third Reading: Roll Call # 247",109,0,0,0,109
702096,459951,2015-06-11,Senate,"Reported Favorably With Substitute S-1",4,0,0,0,4
702391,438560,2015-04-23,House,"Reported With Recommendation With Substitute  H-1",18,11,0,0,29
702391,440473,2015-04-28,House,"House Third Reading: Given Immediate Effect Roll Call # 83",59,51,0,0,110
702391,477455,2015-10-01,Senate,"Reported Favorably With Substitute  S-1",9,0,0,0,9
702391,477456,2015-10-01,Senate,"Senate Third Reading: Given Immediate Effect Roll Call # 394",30,5,0,3,38
702391,477707,2015-10-14,House,"House Third Reading: Roll Call # 354",105,0,0,0,105
702391,478808,2015-10-15,Senate,"Senate Third Reading: Roll Call # 434",37,0,0,1,38
702591,394589,2015-02-12,House,"Reported With Recommendation With Substitute  H-1",18,11,0,0,29
702591,397476,2015-02-18,House,"House Third Reading: Given Immediate Effect Roll Call # 6",62,48,0,0,110
702591,402520,2015-02-26,Senate,"Reported Favorably Without Amendment",4,0,0,0,4
702591,402521,2015-02-26,Senate,"Senate Third Reading: Given Immediate Effect Roll Call # 26",23,14,0,1,38
702687,444465,2015-05-07,House,"Reported With Recommendation With Substitute  H-2",22,2,0,0,24
702687,444466,2015-05-07,House,"House Third Reading: Passed Roll Call # 120",102,8,0,0,110
702687,447100,2015-05-14,Senate,"Senate Third Reading: Passed Roll Call # 187",27,10,0,1,38
702687,448460,2015-05-19,House,"House Third Reading: Roll Call # 156",0,108,0,0,108
703182,444572,2015-05-07,House,"Reported With Recommendation With Substitute  H-2",25,1,0,0,26
703182,444573,2015-05-07,House,"House Third Reading: Passed Roll Call # 121",104,6,0,0,110
703182,446807,2015-05-14,Senate,"Senate Third Reading: Passed Roll Call # 188",27,10,0,1,38
703182,448619,2015-05-19,House,"House Third Reading: Roll Call # 157",0,109,0,0,109
704274,393306,2015-02-10,House,"Reported With Recommendation With Substitute H-1",19,0,0,0,19
704274,399051,2015-02-19,House,"House Third Reading: Given Immediate Effect Roll Call # 10",109,1,0,0,110
704274,410661,2015-03-12,Senate,"Reported Favorably Without Amendment",5,0,0,0,5
704274,418738,2015-03-26,Senate,"Senate Third Reading: Given Immediate Effect Roll Call # 72",37,0,0,1,38
704274,418739,2015-03-26,House,"House Third Reading: Roll Call # 56",110,0,0,0,110
704280,441192,2015-04-29,Senate,"Reported Favorably With Substitute  S-2",5,0,0,0,5
704280,456878,2015-06-03,Senate,"Senate Third Reading: Passed Roll Call # 255",38,0,0,0,38
704280,460978,2015-06-17,House,"Reported With Recommendation Without Amendment",10,0,0,0,10
704280,476779,2015-09-16,House,"House Third Reading: Given Immediate Effect Roll Call # 300",101,2,0,0,103
704302,394607,2015-02-12,Senate,"Reported Favorably With Substitute  S-1",5,0,0,0,5
704302,408735,2015-03-10,Senate,"Senate Third Reading: Passed By 3/4 Vote Roll Call # 41",34,3,0,1,38
704302,436529,2015-04-21,House,"Reported With Recommendation With Substitute  H-1",8,3,0,0,11
704302,566716,2016-12-14,House,"House Third Reading: Passed By 3/4 Vote Roll Call # 679",88,17,0,0,105
704302,566717,2016-12-14,Senate,"Senate Third Reading: Roll Call # 804",33,4,0,1,38
704313,431790,2015-04-14,Senate,"Reported Favorably With Substitute  S-1",5,0,0,0,5
704313,436492,2015-04-21,Senate,"Senate Third Reading: Passed Roll Call # 106",38,0,0,0,38
704313,460285,2015-06-16,House,"Reported With Recommendation Without Amendment",17,2,0,0,19
704313,476933,2015-09-22,House,"House Third Reading: Given Immediate Effect Roll Call # 309",69,35,0,0,104
704338,456742,2015-06-03,House,"Reported With Recommendation With Substitute  H-2",13,0,0,0,13
704350,405237,2015-03-04,House,"Reported With Recommendation Without Amendment",8,3,0,0,11
704350,409793,2015-03-11,House,"House Third Reading: Given Immediate Effect Roll Call # 26",58,51,0,0,109
704350,459417,2015-06-11,Senate,"Reported Favorably With Substitute  S-1",3,2,0,0,5
704350,461462,2015-06-18,Senate,"Senate Third Reading: Given Immediate Effect Roll Call # 304",24,13,0,1,38
704350,461463,2015-06-18,House,"House Third Reading: Roll Call # 272",63,46,0,0,109
704410,397471,2015-02-18,Senate,"Reported Favorably Without Amendment",5,0,0,0,5
704410,401656,2015-02-25,Senate,"Senate Third Reading: Passed Roll Call # 23",37,0,0,1,38
704433,431630,2015-04-14,Senate,"Reported Favorably With Substitute  S-2",5,0,0,0,5
704433,436159,2015-04-21,Senate,"Senate Third Reading: Passed Roll Call # 103",38,0,0,0,38
704433,458380,2015-06-09,House,"Reported With Recommendation With Substitute  H-1",15,2,0,0,17
704433,476946,2015-09-22,House,"House Third Reading: Given Immediate Effect Roll Call # 306",67,37,0,0,104
704433,477363,2015-09-29,House,"House Third Reading: Passed Roll Call # 324",69,37,0,0,106
704433,477407,2015-09-30,Senate,"Senate Third Reading: Roll Call # 382",37,0,0,1,38
704460,431616,2015-04-14,Senate,"Reported Favorably With Substitute  S-1",5,0,0,0,5
704460,436175,2015-04-21,Senate,"Senate Third Reading: Passed Roll Call # 105",38,0,0,0,38
704460,460411,2015-06-16,House,"Reported With Recommendation Without Amendment",17,2,0,0,19
704460,476954,2015-09-22,House,"House Third Reading: Given Immediate Effect Roll Call # 308",69,35,0,0,104
704472,397478,2015-02-18,Senate,"Reported Favorably Without Amendment",5,0,0,0,5
704472,401635,2015-02-25,Senate,"Senate Third Reading: Passed Roll Call # 21",35,1,1,1,38
704472,401636,2015-02-25,Senate,"Senate Third Reading: Passed Roll Call # 24",36,1,0,1,38
704472,458851,2015-06-10,House,"Reported With Recommendation With Substitute  H-1",26,1,0,0,27
704472,461298,2015-06-18,House,"House Third Reading: Given Immediate Effect Roll Call # 267",104,5,0,0,109
704472,464751,2015-07-01,Senate,"Senate Third Reading: Roll Call # 341",37,1,0,0,38
704483,397753,2015-02-18,Senate,"Reported Favorably Without Amendment",5,0,0,0,5
704483,401592,2015-02-25,Senate,"Senate Third Reading: Passed Roll Call # 22",37,0,0,1,38
704511,396606,2015-02-17,House,"Reported With Recommendation Without Amendment",16,0,0,0,16
704523,393135,2015-02-10,House,"Reported With Recommendation With Amendment(s)",19,0,0,0,19
704523,399052,2015-02-19,House,"House Third Reading: Given Immediate Effect Roll Call # 11",109,1,0,0,110
704523,410593,2015-03-12,Senate,"Reported Favorably Without Amendment",5,0,0,0,5
704523,422185,2015-03-26,Senate,"Senate Third Reading: Given Immediate Effect Roll Call # 73",37,0,0,1,38
704583,431697,2015-04-14,Senate,"Reported Favorably With Substitute  S-1",5,0,0,0,5
704583,436462,2015-04-21,Senate,"Senate Third Reading: Passed Roll Call # 104",38,0,0,0,38
704583,460258,2015-06-16,House,"Reported With Recommendation With Substitute  H-1",17,2,0,0,19
704583,460942,2015-06-16,House,"Reported With Recommendation With Substitute H-1",17,2,0,0,19
704583,476953,2015-09-22,House,"House Third Reading: Given Immediate Effect Roll Call # 307",69,35,0,0,104
704583,477360,2015-09-29,Senate,"Senate Third Reading: Roll Call # 375",35,0,0,3,38
704593,442343,2015-04-30,Senate,"Reported Favorably With Substitute  S-3",9,0,0,0,9
705285,404378,2015-03-03,Senate,"Reported Favorably Without Amendment",5,0,0,0,5
709737,396758,2015-02-17,House,"Reported With Recommendation Without Amendment",16,0,0,0,16
709804,413175,2015-03-18,House,"Reported With Recommendation Without Amendment",14,0,0,0,14
709804,421926,2015-03-26,House,"House Third Reading: Given Immediate Effect Roll Call # 52",110,0,0,0,110
709804,477740,2015-10-15,Senate,"Reported Favorably With Substitute  S-1",8,0,0,0,8
709804,480694,2015-10-28,Senate,"Senate Third Reading: Given Immediate Effect Roll Call # 467",37,0,0,1,38
709804,480832,2015-11-03,House,"House Third Reading: Roll Call # 404",106,1,0,0,107
709900,540016,2016-04-28,House,"Reported With Recommendation Without Amendment",14,0,0,0,14
709900,550240,2016-05-31,House,"House Third Reading: Given Immediate Effect Roll Call # 337",82,27,0,0,109
709900,566048,2016-12-08,Senate,"Reported Favorably With Substitute  S-1",4,0,0,0,4
709900,566385,2016-12-14,Senate,"Senate Third Reading: Passed Roll Call # 816",36,1,0,1,38
709900,566722,2016-12-15,House,"House Third Reading: Roll Call # 753",105,2,0,0,107
710106,404123,2015-03-03,House,"Reported With Recommendation With Substitute  H-1",7,0,0,0,7
710106,410419,2015-03-12,House,"House Third Reading: Given Immediate Effect Roll Call # 30",85,25,0,0,110
710106,438877,2015-04-23,Senate,"Reported Favorably With Substitute  S-1",5,0,0,0,5
710106,444507,2015-05-07,Senate,"Senate Third Reading: Given Immediate Effect Roll Call # 160",38,0,0,0,38
710106,445860,2015-05-12,House,"House Third Reading: Roll Call # 138",84,26,0,0,110
711330,460235,2015-06-16,House,"Reported With Recommendation With Substitute  H-4",7,1,0,0,8
711330,477442,2015-10-01,House,"House Third Reading: Given Immediate Effect Roll Call # 329",67,39,0,0,106
711375,460232,2015-06-16,House,"Reported With Recommendation With Substitute  H-1",8,0,0,0,8
711375,477446,2015-10-01,House,"House Third Reading: Given Immediate Effect Roll Call # 331",101,5,0,0,106
712712,397454,2015-02-18,House,"Reported With Recommendation Without Amendment",8,3,0,0,11
712712,402539,2015-02-26,House,"House Third Reading: Given Immediate Effect Roll Call # 21",87,22,0,0,109
712712,410510,2015-03-12,Senate,"Reported Favorably With Substitute  S-1",5,0,0,0,5
712712,441291,2015-04-29,Senate,"Senate Third Reading: Given Immediate Effect Roll Call # 114",37,0,0,1,38
712712,442325,2015-04-30,House,"House Third Reading: Roll Call # 107",89,21,0,0,110
712738,397521,2015-02-18,House,"Reported With Recommendation Without Amendment",8,3,0,0,11
712738,402368,2015-02-26,House,"House Third Reading: Given Immediate Effect Roll Call # 23",89,20,0,0,109
712738,410432,2015-03-12,Senate,"Reported Favorably With Substitute  S-1",5,0,0,0,5
712738,440359,2015-03-12,Senate,"Reported Favorably With Substitute S-1",5,0,0,0,5
712738,441503,2015-04-29,Senate,"Senate Third Reading: Given Immediate Effect Roll Call # 116",37,0,0,1,38
712738,442362,2015-04-30,House,"House Third Reading: Roll Call # 109",89,21,0,0,110
712752,408753,2015-03-10,Senate,"Reported Favorably With Substitute  S-1",4,0,0,0,4
712752,413624,2015-03-18,Senate,"Senate Third Reading: Passed Roll Call # 54",26,11,0,1,38
712781,410682,2015-03-12,Senate,"Reported Favorably Without Amendment",7,0,0,0,7
712800,397786,2015-02-18,House,"Reported With Recommendation With Substitute  H-1",11,0,0,0,11
712800,401879,2015-02-25,House,"House Third Reading: Given Immediate Effect Roll Call # 15",108,2,0,0,110
712800,438932,2015-04-23,Senate,"Reported Favorably Without Amendment",5,0,0,0,5
712800,441197,2015-04-29,Senate,"Senate Third Reading: Given Immediate Effect Roll Call # 120",37,0,0,1,38
712800,442322,2015-04-30,House,"House Third Reading: Roll Call # 110",108,2,0,0,110
712810,397899,2015-02-18,House,"Reported With Recommendation Without Amendment",10,1,0,0,11
712810,401612,2015-02-25,House,"House Third Reading: Given Immediate Effect Roll Call # 14",95,15,0,0,110
712810,438686,2015-04-23,Senate,"Reported Favorably Without Amendment",5,0,0,0,5
712810,441136,2015-04-29,Senate,"Senate Third Reading: Given Immediate Effect Roll Call # 119",37,0,0,1,38
712829,397453,2015-02-18,House,"Reported With Recommendation Without Amendment",8,3,0,0,11
712829,402311,2015-02-26,House,"House Third Reading: Given Immediate Effect Roll Call # 20",85,24,0,0,109
712829,410462,2015-03-12,Senate,"Reported Favorably Without Amendment",5,0,0,0,5
712829,441504,2015-04-29,Senate,"Senate Third Reading: Given Immediate Effect Roll Call # 113",37,0,0,1,38
712857,397475,2015-02-18,House,"Reported With Recommendation Without Amendment",8,3,0,0,11
712857,402379,2015-02-26,House,"House Third Reading: Given Immediate Effect Roll Call # 19",87,22,0,0,109
712857,410596,2015-03-12,Senate,"Reported Favorably Without Amendment",4,0,0,0,4
712857,441692,2015-04-29,Senate,"Senate Third Reading: Given Immediate Effect Roll Call # 112",37,0,0,1,38
712871,410437,2015-03-12,Senate,"Reported Favorably Without Amendment",7,0,0,0,7
712940,397455,2015-02-18,House,"Reported With Recommendation With Substitute  H-1",7,4,0,0,11
712940,402347,2015-02-26,House,"House Third Reading: Given Immediate Effect Roll Call # 22",88,21,0,0,109
712940,410569,2015-03-12,Senate,"Reported Favorably With Substitute  S-1",5,0,0,0,5
712940,441141,2015-04-29,Senate,"Senate Third Reading: Given Immediate Effect Roll Call # 115",37,0,0,1,38
712940,442272,2015-04-30,House,"House Third Reading: Roll Call # 108",90,20,0,0,110
712988,397462,2015-02-18,House,"Reported With Recommendation Without Amendment",8,3,0,0,11
712988,402358,2015-02-26,House,"House Third Reading: Given Immediate Effect Roll Call # 18",80,29,0,0,109
712988,410487,2015-03-12,Senate,"Reported Favorably Without Amendment",4,0,0,0,4
712988,441830,2015-04-29,Senate,"Senate Third Reading: Given Immediate Effect Roll Call # 111",30,7,0,1,38
713001,398445,2015-02-19,Senate,"Reported Favorably With Substitute  S-1",7,0,0,0,7
713001,402552,2015-02-26,Senate,"Senate Third Reading: Passed Roll Call # 34",33,4,0,1,38
713001,416920,2015-03-25,House,"Reported With Recommendation Without Amendment",11,2,0,0,13
713018,397590,2015-02-18,House,"Reported With Recommendation Without Amendment",9,2,0,0,11
713018,401601,2015-02-25,House,"House Third Reading: Given Immediate Effect Roll Call # 13",89,21,0,0,110
713018,477661,2015-10-08,Senate,"Reported Favorably With Substitute  S-4",4,0,0,0,4
713018,481112,2015-11-10,Senate,"Senate Third Reading: Given Immediate Effect Roll Call # 514",28,8,0,2,38
713018,481113,2015-11-10,House,"House Third Reading: Roll Call # 432",82,23,0,0,105
713031,565602,2016-11-29,House,"Reported With Recommendation Without Amendment",13,1,0,0,14
713031,565666,2016-12-06,House,"House Third Reading: Given Immediate Effect Roll Call # 551",69,37,0,0,106
713031,565703,2016-12-06,House,"House Third Reading: Passed Roll Call # 551",69,37,0,0,106
713031,566190,2016-12-13,Senate,"Reported Favorably Without Amendment",4,1,0,0,5
713031,566404,2016-12-14,Senate,"Senate Third Reading: Passed Roll Call # 817",28,9,0,1,38
717112,402310,2015-02-26,Senate,"Reported Favorably With Substitute  S-1",4,0,0,0,4
717112,477603,2015-10-07,Senate,"Senate Third Reading: Passed Roll Call # 407",38,0,0,0,38
717112,540109,2016-04-28,House,"Reported With Recommendation Without Amendment",9,1,0,0,10
717112,562361,2016-09-07,House,"House Third Reading: Given Immediate Effect Roll Call # 443",105,1,0,0,106
717112,562382,2016-09-08,Senate,"Senate Third Reading: Roll Call # 514",36,0,0,1,37
717224,410524,2015-03-12,Senate,"Reported Favorably Without Amendment",4,1,0,0,5
717224,417361,2015-03-25,Senate,"Senate Third Reading: Passed Roll Call # 66",29,8,0,1,38
717224,436572,2015-04-21,House,"Reported With Recommendation Without Amendment",8,3,0,0,11
717224,441552,2015-04-29,House,"House Third Reading: Given Immediate Effect Roll Call # 106",79,31,0,0,110
717340,402354,2015-02-26,Senate,"Reported Favorably With Substitute  S-1",4,0,0,0,4
717340,477611,2015-10-07,Senate,"Senate Third Reading: Passed Roll Call # 409",38,0,0,0,38
717340,540099,2016-04-28,House,"Reported With Recommendation Without Amendment",11,0,0,0,11
717340,562366,2016-09-07,House,"House Third Reading: Given Immediate Effect Roll Call # 445",106,0,0,0,106
717395,402547,2015-02-26,Senate,"Reported Favorably With Substitute  S-2",4,0,0,0,4
717395,477589,2015-10-07,Senate,"Senate Third Reading: Passed Roll Call # 410",38,0,0,0,38
717395,539772,2016-04-28,House,"Reported With Recommendation With Substitute  H-2",10,0,0,0,10
717395,562360,2016-09-07,House,"House Third Reading: Given Immediate Effect Roll Call # 442",106,0,0,0,106
717395,562383,2016-09-08,Senate,"Senate Third Reading: Roll Call # 513",36,0,1,0,37
717451,402549,2015-02-26,Senate,"Reported Favorably With Substitute  S-1",4,0,0,0,4
717451,477605,2015-10-07,Senate,"Senate Third Reading: Passed Roll Call # 408",38,0,0,0,38
717451,540076,2016-04-28,House,"Reported With Recommendation Without Amendment",11,0,0,0,11
717451,562359,2016-09-07,House,"House Third Reading: Given Immediate Effect Roll Call # 444",106,0,0,0,106
717566,466622,2015-07-16,Senate,"Reported Favorably Without Amendment",3,0,0,0,3
717566,484996,2016-01-14,Senate,"Senate Third Reading: Passed Roll Call # 1",34,2,0,2,38
717626,402430,2015-02-26,Senate,"Reported Favorably With Substitute  S-1",4,0,0,0,4
717626,477598,2015-10-07,Senate,"Senate Third Reading: Passed Roll Call # 406",38,0,0,0,38
717626,540060,2016-04-28,House,"Reported With Recommendation Without Amendment",10,0,0,0,10
717626,562275,2016-09-07,House,"House Third Reading: Given Immediate Effect Roll Call # 441",106,0,0,0,106
717682,398493,2015-02-19,Senate,"Reported Favorably Without Amendment",7,0,0,0,7
717682,405409,2015-03-04,Senate,"Senate Third Reading: Passed Roll Call # 36",36,0,0,2,38
717682,405410,2015-03-04,Senate,"Senate Third Reading: Passed Roll Call # 37",38,0,0,0,38
717682,444540,2015-05-07,House,"Reported With Recommendation Without Amendment",9,0,0,0,9
717682,449101,2015-05-20,House,"House Third Reading: Given Immediate Effect Roll Call # 182",109,1,0,0,110
717738,564052,2016-10-20,Senate,"Reported Favorably With Substitute S-1",4,0,0,0,4
717738,564053,2016-10-20,Senate,"Senate Third Reading: Passed Roll Call # 591",36,0,0,1,37
717794,466301,2015-07-15,Senate,"Reported Favorably With Substitute  S-1",4,0,0,0,4
717794,476828,2015-09-17,Senate,"Senate Third Reading: Passed Roll Call # 371",37,0,0,1,38
717914,404101,2015-03-03,House,"Reported With Recommendation With Substitute  H-1",7,0,0,0,7
717914,410422,2015-03-12,House,"House Third Reading: Given Immediate Effect Roll Call # 31",99,11,0,0,110
717914,438872,2015-04-23,Senate,"Reported Favorably Without Amendment",4,0,0,0,4
717914,444461,2015-05-07,Senate,"Senate Third Reading: Given Immediate Effect Roll Call # 159",37,1,0,0,38
717971,404044,2015-03-03,House,"Reported With Recommendation Without Amendment",12,5,0,0,17
717971,409651,2015-03-11,House,"House Third Reading: Given Immediate Effect Roll Call # 27",62,47,0,0,109
717971,444732,2015-05-07,Senate,"Reported Favorably Without Amendment",6,3,0,0,9
717971,446438,2015-05-13,Senate,"Senate Third Reading: Given Immediate Effect Roll Call # 168",27,10,0,1,38
718027,477381,2015-09-29,House,"Reported With Recommendation For Referral To Committee On Criminal Justice",11,0,0,0,11
718085,404326,2015-03-03,House,"Reported With Recommendation With Amendment(s)",12,5,0,0,17
718085,409942,2015-03-11,House,"House Third Reading: Given Immediate Effect Roll Call # 28",62,47,0,0,109
718085,444700,2015-05-07,Senate,"Reported Favorably Without Amendment",6,3,0,0,9
718085,446240,2015-05-13,Senate,"Senate Third Reading: Given Immediate Effect Roll Call # 169",27,10,0,1,38
718141,477321,2015-09-29,House,"Reported With Recommendation For Referral To Committee On Criminal Justice",11,0,0,0,11
718201,441121,2015-04-29,House,"Reported With Recommendation With Substitute  H-1",8,2,0,0,10
718201,445888,2015-05-12,House,"House Third Reading: Given Immediate Effect Roll Call # 141",73,37,0,0,110
718201,461315,2015-06-17,Senate,"Reported Favorably Without Amendment",5,0,0,0,5
718201,477088,2015-09-24,Senate,"Senate Third Reading: Given Immediate Effect Roll Call # 374",35,2,0,1,38
718371,433228,2015-04-15,House,"Reported With Recommendation Without Amendment",12,0,0,0,12
718371,437389,2015-04-22,House,"House Third Reading: Given Immediate Effect Roll Call # 73",108,1,0,0,109
718371,461283,2015-06-17,Senate,"Reported Favorably Without Amendment",6,0,0,0,6
718371,481151,2015-11-10,Senate,"Senate Third Reading: Passed Roll Call # 515",36,0,0,2,38
718371,481152,2015-11-10,Senate,"Senate Third Reading: Given Immediate Effect Roll Call # 517",36,0,0,2,38
718371,481596,2015-12-01,House,"House Third Reading: Roll Call # 433",103,3,0,0,106
718482,417446,2015-03-25,House,"Reported With Recommendation With Substitute H-1",11,0,0,0,11
718482,433127,2015-03-25,House,"Reported With Recommendation With Substitute  H-1",11,0,0,0,11
718482,436129,2015-04-21,House,"House Third Reading: Given Immediate Effect Roll Call # 72",108,1,0,0,109
718482,449355,2015-05-20,Senate,"Reported Favorably Without Amendment",5,0,0,0,5
718482,477439,2015-10-01,Senate,"Senate Third Reading: Given Immediate Effect Roll Call # 388",34,1,0,3,38
718541,416941,2015-03-25,House,"Reported With Recommendation Without Amendment",11,4,0,0,15
718541,436122,2015-04-21,House,"House Third Reading: Given Immediate Effect Roll Call # 70",64,46,0,0,110
718541,436123,2015-04-21,House,"House Third Reading: Passed Roll Call # 71",63,46,0,0,109
718541,445811,2015-05-12,Senate,"Reported Favorably Without Amendment",4,0,0,0,4
718541,451777,2015-05-26,Senate,"Senate Third Reading: Given Immediate Effect Roll Call # 219",27,11,0,0,38
718541,459351,2015-06-11,House,"House Third Reading: Roll Call # 244",64,44,0,0,108
718824,477318,2015-09-29,House,"Reported With Recommendation For Referral To Committee On Criminal Justice",11,0,0,0,11
719585,431915,2015-04-14,Senate,"Reported Favorably Without Amendment",5,0,0,0,5
719585,434326,2015-04-16,Senate,"Senate Third Reading: Passed Roll Call # 84",38,0,0,0,38
719585,440390,2015-04-28,House,"Reported With Recommendation Without Amendment",16,0,0,0,16
719585,444590,2015-05-07,House,"House Third Reading: Given Immediate Effect Roll Call # 130",110,0,0,0,110
719655,486534,2016-01-21,Senate,"Reported Favorably With Substitute  S-1",5,0,0,0,5
719687,565507,2016-12-01,Senate,"Reported Favorably With Substitute  S-4",9,8,0,0,17
719755,464459,2015-06-30,Senate,"Reported Favorably With Substitute  S-1",3,2,0,0,5
719822,438618,2015-04-23,House,"Reported With Recommendation With Substitute  H-2",5,1,0,0,6
719822,451968,2015-05-26,House,"House Third Reading: Given Immediate Effect Roll Call # 196",91,19,0,0,110
719822,477283,2015-09-29,Senate,"Reported Favorably With Substitute  S-1",5,0,0,0,5
719822,480410,2015-10-22,Senate,"Senate Third Reading: Given Immediate Effect Roll Call # 462",30,7,0,1,38
719856,480677,2015-10-27,House,"Reported With Recommendation With Substitute H-3",6,0,0,0,6
719856,480786,2015-10-27,House,"Reported With Recommendation With Substitute  H-3",6,0,0,0,6
719856,486132,2016-01-20,House,"House Third Reading: Given Immediate Effect Roll Call # 7",88,18,0,0,106
719856,513578,2016-03-03,Senate,"Reported Favorably Without Amendment",5,0,0,0,5
719856,539040,2016-04-27,Senate,"Senate Third Reading: Given Immediate Effect Roll Call # 198",36,0,0,1,37
719889,456683,2015-06-03,House,"Reported With Recommendation With Substitute  H-1",14,1,0,0,15
719889,461023,2015-06-17,House,"House Third Reading: Given Immediate Effect Roll Call # 266",108,2,0,0,110
719889,565434,2016-12-01,Senate,"Reported Favorably With Substitute  S-1",5,0,0,0,5
719889,565975,2016-12-08,Senate,"Senate Third Reading: Given Immediate Effect Roll Call # 718",37,0,0,1,38
719889,566225,2016-12-13,House,"House Third Reading: Roll Call # 624",106,2,0,0,108
719958,406256,2015-03-05,Senate,"Reported Favorably With Substitute  S-1",5,2,0,0,7
719958,414082,2015-03-19,Senate,"Senate Third Reading: Passed Roll Call # 57",36,1,0,1,38
719958,441169,2015-04-29,House,"Reported With Recommendation Without Amendment",13,0,0,0,13
719958,453898,2015-05-27,House,"House Third Reading: Passed Roll Call # 200",109,0,0,0,109
719958,456689,2015-06-03,Senate,"Senate Third Reading: Roll Call # 256",38,0,0,0,38
720024,409613,2015-03-11,House,"Reported With Recommendation With Substitute  H-2",8,2,0,0,10
722152,416277,2015-03-24,House,"Reported With Recommendation With Substitute  H-3",17,2,0,0,19
722152,432756,2015-04-15,House,"House Third Reading: Given Immediate Effect Roll Call # 58",108,2,0,0,110
722152,477365,2015-09-29,Senate,"Reported Favorably With Substitute  S-1",7,0,0,0,7
722152,480736,2015-10-29,Senate,"Senate Third Reading: Given Immediate Effect Roll Call # 471",36,0,0,2,38
722152,480888,2015-11-04,House,"House Third Reading: Roll Call # 414",102,5,0,0,107
722191,404765,2015-03-04,House,"Reported With Recommendation Without Amendment",5,3,0,0,8
722191,413550,2015-03-18,House,"House Third Reading: Given Immediate Effect Roll Call # 37",65,44,0,0,109
722191,440459,2015-04-28,Senate,"Reported Favorably Without Amendment",4,1,0,0,5
722191,458831,2015-06-10,Senate,"Senate Third Reading: Given Immediate Effect Roll Call # 283",26,12,0,0,38
722230,404753,2015-03-04,House,"Reported With Recommendation Without Amendment",5,3,0,0,8
722230,413190,2015-03-18,House,"House Third Reading: Given Immediate Effect Roll Call # 35",65,44,0,0,109
722230,440294,2015-04-28,Senate,"Reported Favorably Without Amendment",4,1,0,0,5
722230,458858,2015-06-10,Senate,"Senate Third Reading: Given Immediate Effect Roll Call # 281",26,12,0,0,38
722230,458859,2015-06-10,House,"House Third Reading: Roll Call # 243",65,44,0,0,109
722347,416256,2015-03-24,House,"Reported With Recommendation With Substitute  H-2",17,2,0,0,19
722347,432754,2015-04-15,House,"House Third Reading: Given Immediate Effect Roll Call # 57",107,3,0,0,110
722347,477356,2015-09-29,Senate,"Reported Favorably With Substitute  S-1",7,0,0,0,7
722347,480739,2015-10-29,Senate,"Senate Third Reading: Given Immediate Effect Roll Call # 470",36,0,0,2,38
722347,480898,2015-11-04,House,"House Third Reading: Roll Call # 413",101,6,0,0,107
722425,441251,2015-04-29,Senate,"Reported Favorably With Substitute  S-3",4,1,0,0,5
722425,449022,2015-05-20,Senate,"Senate Third Reading: Passed Roll Call # 212",22,15,0,1,38
722425,477460,2015-10-01,House,"Reported With Recommendation With Substitute  H-8",14,2,0,0,16
722425,477751,2015-10-15,House,"House Third Reading: Given Immediate Effect Roll Call # 356",97,8,0,0,105
722425,480271,2015-10-20,Senate,"Senate Third Reading: Roll Call # 441",35,2,0,1,38
722501,404739,2015-03-04,House,"Reported With Recommendation Without Amendment",5,3,0,0,8
722501,413149,2015-03-18,House,"House Third Reading: Given Immediate Effect Roll Call # 36",65,44,0,0,109
722501,440239,2015-04-28,Senate,"Reported Favorably Without Amendment",4,1,0,0,5
722501,458837,2015-06-10,Senate,"Senate Third Reading: Given Immediate Effect Roll Call # 282",26,12,0,0,38
722544,460384,2015-06-16,Senate,"Reported Favorably With Substitute  S-1",4,0,0,0,4
722544,482065,2015-12-09,Senate,"Senate Third Reading: Passed Roll Call # 566",33,5,0,0,38
722544,546819,2016-05-18,House,"Reported With Recommendation With Substitute  H-3",26,1,0,0,27
722544,552366,2016-06-09,House,"House Third Reading: Given Immediate Effect Roll Call # 424",107,1,0,0,108
722544,552367,2016-06-09,Senate,"Senate Third Reading: Roll Call # 473",32,5,0,0,37
722661,414163,2015-03-19,House,"Reported With Recommendation With Substitute  H-1",17,0,0,0,17
722661,420307,2015-03-26,House,"House Third Reading: Given Immediate Effect Roll Call # 54",108,2,0,0,110
722661,461518,2015-06-18,Senate,"Reported Favorably Without Amendment",5,1,0,0,6
722661,477406,2015-09-30,Senate,"Senate Third Reading: Given Immediate Effect Roll Call # 384",37,0,0,1,38
722777,401646,2015-02-25,Senate,"Reported Favorably Without Amendment",4,0,0,0,4
722777,406260,2015-03-05,Senate,"Senate Third Reading: Passed Roll Call # 38",36,0,0,2,38
722777,456738,2015-06-03,House,"Reported With Recommendation Without Amendment",8,0,0,0,8
722777,460318,2015-06-16,House,"House Third Reading: Given Immediate Effect Roll Call # 251",109,1,0,0,110
722816,406475,2015-03-05,Senate,"Reported Favorably With Substitute  S-1",7,0,0,0,7
722816,414004,2015-03-19,Senate,"Senate Third Reading: Passed Roll Call # 59",37,0,0,1,38
722816,565518,2016-11-30,House,"Reported With Recommendation Without Amendment",12,0,0,0,12
722816,566264,2016-12-13,House,"House Third Reading: Passed Roll Call # 658",94,14,0,0,108
726936,404074,2015-03-03,Senate,"Reported Favorably With Substitute  S-1",4,0,0,0,4
726936,410436,2015-03-12,Senate,"Senate Third Reading: Passed Roll Call # 44",37,0,0,1,38
726936,443436,2015-05-05,House,"Reported With Recommendation With Substitute  H-1",18,0,0,0,18
726936,460305,2015-06-16,House,"House Third Reading: Given Immediate Effect Roll Call # 255",110,0,0,0,110
726936,461218,2015-06-18,Senate,"Senate Third Reading: Roll Call # 302",37,0,0,1,38
726947,440539,2015-04-28,Senate,"Reported Favorably With Substitute  S-1",14,2,0,0,16
726947,444486,2015-05-07,Senate,"Senate Third Reading: Passed Roll Call # 154",27,11,0,0,38
726947,446333,2015-05-13,House,"Reported With Recommendation With Substitute  H-1",25,1,0,0,26
726947,448594,2015-05-19,House,"House Third Reading: Passed Roll Call # 166",99,9,0,0,108
726947,449213,2015-05-20,Senate,"Senate Third Reading: Roll Call # 199",0,35,0,3,38
726966,440680,2015-04-28,Senate,"Reported Favorably With Substitute  S-1",15,1,0,0,16
726974,440210,2015-04-28,Senate,"Reported Favorably With Substitute  S-1",12,5,0,0,17
726988,404169,2015-03-03,Senate,"Reported Favorably Without Amendment",4,0,0,0,4
726988,410442,2015-03-12,Senate,"Senate Third Reading: Passed Roll Call # 43",37,0,0,1,38
726988,443554,2015-05-05,House,"Reported With Recommendation Without Amendment",18,0,0,0,18
726988,460216,2015-06-16,House,"House Third Reading: Given Immediate Effect Roll Call # 254",110,0,0,0,110
726998,436302,2015-04-21,Senate,"Reported Favorably With Substitute  S-1",15,1,0,0,16
726998,444734,2015-05-07,Senate,"Senate Third Reading: Passed Roll Call # 151",27,11,0,0,38
726998,446244,2015-05-13,House,"Reported With Recommendation With Substitute  H-1",26,2,0,0,28
726998,448497,2015-05-19,House,"House Third Reading: Passed Roll Call # 169",99,9,0,0,108
726998,449064,2015-05-20,Senate,"Senate Third Reading: Roll Call # 202",0,36,0,2,38
727008,436560,2015-04-21,Senate,"Reported Favorably With Substitute  S-1",17,0,0,0,17
727015,436433,2015-04-21,Senate,"Reported Favorably With Substitute  S-1",13,0,0,0,13
727015,444528,2015-05-07,Senate,"Senate Third Reading: Passed Roll Call # 152",27,11,0,0,38
727015,446393,2015-05-13,House,"Reported With Recommendation With Substitute  H-1",26,2,0,0,28
727015,448435,2015-05-19,House,"House Third Reading: Passed Roll Call # 170",99,9,0,0,108
727015,449359,2015-05-20,Senate,"Senate Third Reading: Roll Call # 203",0,36,0,2,38
727025,440615,2015-04-28,Senate,"Reported Favorably With Substitute  S-1",12,5,0,0,17
727025,444508,2015-05-07,Senate,"Senate Third Reading: Passed Roll Call # 155",27,11,0,0,38
727025,446369,2015-05-13,House,"Reported With Recommendation With Substitute H-1",25,1,0,0,26
727025,448695,2015-05-19,House,"House Third Reading: Passed Roll Call # 167",100,8,0,0,108
727025,449304,2015-05-20,Senate,"Senate Third Reading: Roll Call # 200",0,35,0,3,38
727033,440570,2015-04-28,Senate,"Reported Favorably With Substitute  S-1",15,2,0,0,17
727041,440575,2015-04-28,Senate,"Reported Favorably With Substitute  S-1",13,4,0,0,17
727041,444485,2015-05-07,Senate,"Senate Third Reading: Passed Roll Call # 156",27,11,0,0,38
727041,446329,2015-05-13,House,"Reported With Recommendation With Substitute  H-1",26,1,0,0,27
727041,448607,2015-05-19,House,"House Third Reading: Passed Roll Call # 168",98,10,0,0,108
727041,449242,2015-05-20,Senate,"Senate Third Reading: Roll Call # 201",0,36,0,2,38
727049,458399,2015-06-09,Senate,"Reported Favorably Without Amendment",3,0,0,0,3
727049,481164,2015-11-10,Senate,"Senate Third Reading: Passed Roll Call # 502",25,11,1,1,38
727049,482103,2015-12-09,House,"Reported With Recommendation Without Amendment",5,3,0,0,8
727059,402303,2015-02-26,Senate,"Reported Favorably Without Amendment",4,0,0,0,4
727059,402304,2015-02-26,Senate,"Senate Third Reading: Passed Roll Call # 31",27,10,0,1,38
727059,404776,2015-03-04,House,"Reported With Recommendation Without Amendment",16,12,0,0,28
727059,410571,2015-03-12,House,"House Third Reading: Given Immediate Effect Roll Call # 33",58,52,0,0,110
727066,436211,2015-04-21,Senate,"Reported Favorably With Substitute  S-1",13,4,0,0,17
727066,444735,2015-05-07,Senate,"Senate Third Reading: Passed Roll Call # 149",27,11,0,0,38
727066,446455,2015-05-13,House,"Reported With Recommendation With Substitute  H-1",25,1,0,0,26
727066,448647,2015-05-19,House,"House Third Reading: Passed Roll Call # 163",99,10,0,0,109
727066,449287,2015-05-20,Senate,"Senate Third Reading: Roll Call # 196",1,35,0,2,38
727080,402392,2015-02-26,Senate,"Reported Favorably Without Amendment",4,0,0,0,4
727080,402393,2015-02-26,Senate,"Senate Third Reading: Passed Roll Call # 30",26,11,0,1,38
727080,405176,2015-03-04,House,"Reported With Recommendation Without Amendment",17,12,0,0,29
727080,410441,2015-03-12,House,"House Third Reading: Given Immediate Effect Roll Call # 32",62,48,0,0,110
727090,491953,2016-02-04,Senate,"Senate Third Reading: Passed Roll Call # 29",37,0,0,1,38
727090,501217,2016-02-17,House,"Reported With Recommendation With Substitute  H-1",29,0,0,0,29
727090,502042,2016-02-18,House,"House Third Reading: Given Immediate Effect Roll Call # 48",106,0,0,0,106
727090,505562,2016-02-23,Senate,"Senate Third Reading: Roll Call # 71",37,0,0,1,38
727099,443451,2015-05-05,Senate,"Senate Third Reading: Passed Roll Call # 147",23,15,0,0,38
727099,446367,2015-05-13,House,"Reported With Recommendation With Substitute  H-1",25,2,0,0,27
727099,448524,2015-05-19,House,"House Third Reading: Passed Roll Call # 172",100,8,0,0,108
727099,449123,2015-05-20,Senate,"Senate Third Reading: Roll Call # 205",0,36,0,2,38
727099,456972,2015-06-03,Senate,"Senate Third Reading: Senate Adopted Conference Report With Immediate Effect Roll Call # 251",22,16,0,0,38
727099,456973,2015-06-03,House,"House Third Reading: Conference Report Adopted Roll Call # 214",70,39,0,0,109
727106,436405,2015-04-21,Senate,"Reported Favorably With Substitute  S-1",17,0,0,0,17
727106,444521,2015-05-07,Senate,"Senate Third Reading: Passed Roll Call # 150",27,11,0,0,38
727106,446401,2015-05-13,House,"Reported With Recommendation With Substitute  H-1",25,1,0,0,26
727106,448437,2015-05-19,House,"House Third Reading: Passed Roll Call # 165",98,10,0,0,108
727106,449362,2015-05-20,Senate,"Senate Third Reading: Roll Call # 198",0,35,0,3,38
727122,440567,2015-04-28,Senate,"Reported Favorably With Substitute  S-1",17,0,0,0,17
727122,444506,2015-05-07,Senate,"Senate Third Reading: Passed Roll Call # 157",27,11,0,0,38
727122,446384,2015-05-13,House,"Reported With Recommendation With Substitute  H-1",23,3,0,0,26
727122,448445,2015-05-19,House,"House Third Reading: Passed Roll Call # 171",96,12,0,0,108
727122,449415,2015-05-20,Senate,"Senate Third Reading: Roll Call # 204",0,36,0,2,38
727131,440617,2015-04-28,Senate,"Reported Favorably With Substitute  S-1",16,1,0,0,17
727159,440224,2015-04-28,Senate,"Reported Favorably With Substitute  S-1",17,0,0,0,17
727165,443420,2015-05-05,Senate,"Senate Third Reading: Passed Roll Call # 127",25,13,0,0,38
727165,443421,2015-05-05,Senate,"Senate Third Reading: Passed Roll Call # 148",24,14,0,0,38
727165,476791,2015-09-16,House,"Reported With Recommendation With Substitute  H-1",23,0,0,0,23
727165,476840,2015-09-17,House,"House Third Reading: Given Immediate Effect Roll Call # 304",99,2,0,0,101
727165,477358,2015-09-29,Senate,"Senate Third Reading: Roll Call # 376",31,4,0,3,38
727165,477359,2015-09-29,House,"House Third Reading: Roll Call # 323",104,2,0,0,106
727174,440460,2015-04-28,Senate,"Reported Favorably With Substitute  S-1",16,0,0,0,16
727174,444745,2015-05-07,Senate,"Senate Third Reading: Passed Roll Call # 153",27,11,0,0,38
727174,446226,2015-05-13,House,"Reported With Recommendation With Substitute  H-1",25,1,0,0,26
727174,448515,2015-05-19,House,"House Third Reading: Passed Roll Call # 164",98,10,0,0,108
727174,449094,2015-05-20,Senate,"Senate Third Reading: Roll Call # 197",0,35,1,2,38
727184,436261,2015-04-21,Senate,"Reported Favorably With Substitute  S-1",16,0,0,0,16
727192,404065,2015-03-03,Senate,"Reported Favorably Without Amendment",4,0,0,0,4
727192,410438,2015-03-12,Senate,"Senate Third Reading: Passed Roll Call # 45",37,0,0,1,38
727192,443541,2015-05-05,House,"Reported With Recommendation With Substitute  H-1",18,0,0,0,18
727192,460452,2015-06-16,House,"House Third Reading: Given Immediate Effect Roll Call # 256",110,0,0,0,110
727192,461322,2015-06-18,Senate,"Senate Third Reading: Roll Call # 303",37,0,0,1,38
727200,436437,2015-04-21,Senate,"Reported Favorably With Substitute  S-1",9,6,0,0,15
727269,443439,2015-05-05,House,"Reported With Recommendation Without Amendment",9,1,0,0,10
727269,449270,2015-05-20,House,"House Third Reading: Given Immediate Effect Roll Call # 180",70,40,0,0,110
727269,480350,2015-10-21,Senate,"Reported Favorably With Substitute  S-1",4,1,0,0,5
727269,482244,2015-12-10,Senate,"Senate Third Reading: Given Immediate Effect Roll Call # 573",26,10,1,1,38
727269,482457,2015-12-15,House,"House Third Reading: Roll Call # 476",73,33,0,0,106
727306,476955,2015-09-22,House,"Reported With Recommendation With Substitute  H-1",10,1,0,0,11
727306,477585,2015-10-07,House,"House Third Reading: Given Immediate Effect Roll Call # 343",96,10,0,0,106
727306,562280,2016-09-08,Senate,"Senate Third Reading: Given Immediate Effect Roll Call # 500",28,9,0,0,37
727306,562519,2016-09-14,House,"House Third Reading: Senate Amendment(s) Concurred In By 3/4 Vote Roll Call # 451",93,12,0,0,105
727323,443575,2015-05-05,House,"Reported With Recommendation Without Amendment",9,1,0,0,10
727323,449184,2015-05-20,House,"House Third Reading: Given Immediate Effect Roll Call # 181",70,40,0,0,110
727323,480349,2015-10-21,Senate,"Reported Favorably With Substitute  S-1",4,1,0,0,5
727323,482251,2015-12-10,Senate,"Senate Third Reading: Given Immediate Effect Roll Call # 574",25,13,0,0,38
727323,482503,2015-12-15,House,"House Third Reading: Roll Call # 477",73,33,0,0,106
727430,476934,2015-09-22,House,"Reported With Recommendation With Substitute  H-4",8,2,0,0,10
727430,477587,2015-10-07,House,"House Third Reading: Given Immediate Effect Roll Call # 342",95,11,0,0,106
727430,562284,2016-09-08,Senate,"Senate Third Reading: Given Immediate Effect Roll Call # 496",25,12,0,0,37
727430,562520,2016-09-14,House,"House Third Reading: Roll Call # 450",83,22,0,0,105
727448,443584,2015-05-05,House,"Reported With Recommendation With Substitute  H-1",18,0,0,0,18
727448,446972,2015-05-14,House,"House Third Reading: Given Immediate Effect Roll Call # 148",108,0,0,0,108
727448,460407,2015-06-16,Senate,"Reported Favorably Without Amendment",4,0,0,0,4
727448,461530,2015-06-18,Senate,"Senate Third Reading: Given Immediate Effect Roll Call # 305",37,0,0,1,38
727518,443577,2015-05-05,House,"Reported With Recommendation With Substitute  H-2",18,0,0,0,18
727518,446804,2015-05-14,House,"House Third Reading: Given Immediate Effect Roll Call # 150",108,0,0,0,108
727518,460498,2015-06-16,Senate,"Reported Favorably With Substitute  S-1",5,0,0,0,5
727518,461202,2015-06-18,Senate,"Senate Third Reading: Given Immediate Effect Roll Call # 307",37,0,0,1,38
727518,461203,2015-06-18,House,"House Third Reading: Roll Call # 271",109,0,0,0,109
727534,443475,2015-05-05,House,"Reported With Recommendation Without Amendment",18,0,0,0,18
727534,447063,2015-05-14,House,"House Third Reading: Given Immediate Effect Roll Call # 149",108,0,0,0,108
727534,460227,2015-06-16,Senate,"Reported Favorably Without Amendment",4,0,0,0,4
727534,461273,2015-06-18,Senate,"Senate Third Reading: Given Immediate Effect Roll Call # 306",37,0,0,1,38
727552,564859,2016-11-10,House,"Reported With Recommendation With Substitute  H-6",18,2,0,0,20
728093,437344,2015-04-22,House,"Reported With Recommendation With Substitute  H-2",14,1,0,0,15
728093,442251,2015-04-30,House,"House Third Reading: Given Immediate Effect Roll Call # 111",100,10,0,0,110
728150,409672,2015-03-11,Senate,"Reported Favorably With Substitute  S-1",5,0,0,0,5
728150,414003,2015-03-19,Senate,"Senate Third Reading: Passed Roll Call # 60",36,1,0,1,38
728150,438742,2015-04-23,House,"Reported With Recommendation With Substitute  H-1",17,0,0,0,17
728150,446370,2015-05-13,House,"House Third Reading: Given Immediate Effect Roll Call # 145",66,43,0,0,109
728150,448693,2015-05-19,Senate,"Senate Third Reading: Roll Call # 192",33,3,0,2,38
728245,445746,2015-05-12,Senate,"Reported Favorably With Substitute  S-1",4,0,0,0,4
728245,448459,2015-05-19,Senate,"Senate Third Reading: Passed Roll Call # 193",35,1,0,2,38
728245,460774,2015-06-17,House,"Reported With Recommendation Without Amendment",16,1,0,0,17
728245,477059,2015-09-24,House,"House Third Reading: Given Immediate Effect Roll Call # 312",89,16,0,0,105
728378,562281,2016-09-08,Senate,"Senate Third Reading: Given Immediate Effect Roll Call # 498",26,11,0,0,37
728378,565569,2016-11-29,House,"Reported With Recommendation Without Amendment",7,2,0,0,9
728378,566487,2016-12-14,House,"House Third Reading: Given Immediate Effect Roll Call # 685",106,0,0,0,106
729642,404366,2015-03-03,House,"Reported With Recommendation With Substitute H-1",9,3,0,0,12
729747,406478,2015-03-05,Senate,"Reported Favorably Without Amendment",5,0,0,0,5
729747,477724,2015-10-14,Senate,"Senate Third Reading: Passed Roll Call # 424",37,0,0,1,38
729747,480643,2015-10-27,House,"Reported With Recommendation Without Amendment",7,0,0,0,7
729747,481980,2015-12-08,House,"House Third Reading: Given Immediate Effect Roll Call # 453",106,0,0,0,106
729779,444468,2015-05-07,Senate,"Reported Favorably With Substitute  S-2",9,0,0,0,9
729779,446854,2015-05-14,Senate,"Senate Third Reading: Passed Roll Call # 180",37,0,0,1,38
729779,477713,2015-10-14,House,"Reported With Recommendation Without Amendment",15,0,0,0,15
729779,480371,2015-10-21,House,"House Third Reading: Given Immediate Effect Roll Call # 372",97,9,0,0,106
729779,480457,2015-10-22,Senate,"Senate Third Reading: House Amendment(s) Concurred In Roll Call # 454",37,0,0,1,38
729848,461201,2015-06-18,Senate,"Reported Favorably With Substitute  S-2",8,0,0,0,8
729848,476824,2015-09-17,Senate,"Senate Third Reading: Passed Roll Call # 359",37,0,0,1,38
729848,502173,2016-02-18,House,"Reported With Recommendation Without Amendment",15,0,0,0,15
729848,511011,2016-03-01,House,"House Third Reading: Given Immediate Effect Roll Call # 79",105,0,0,0,105
729879,414052,2015-03-19,House,"Reported With Recommendation Without Amendment",17,0,0,0,17
729879,418702,2015-03-26,House,"House Third Reading: Given Immediate Effect Roll Call # 55",105,5,0,0,110
729879,552378,2016-06-09,Senate,"Senate Third Reading: Given Immediate Effect Roll Call # 438",24,12,1,0,37
734068,402835,2015-02-25,Senate,"Reported Favorably Without Amendment",4,0,0,0,4
734344,477750,2015-10-15,Senate,"Reported Favorably Without Amendment",7,0,0,0,7
734437,444739,2015-05-07,Senate,"Reported Favorably Without Amendment",9,0,0,0,9
734437,446801,2015-05-14,Senate,"Senate Third Reading: Passed Roll Call # 181",37,0,0,1,38
734437,477726,2015-10-14,House,"Reported With Recommendation Without Amendment",15,0,0,0,15
734532,438839,2015-04-23,Senate,"Reported Favorably With Substitute  S-1",3,0,0,0,3
734532,477629,2015-10-08,Senate,"Senate Third Reading: Passed Roll Call # 412",30,5,1,2,38
734664,445872,2015-05-12,House,"Reported With Recommendation With Substitute  H-1",13,4,0,0,17
734664,456746,2015-06-03,House,"House Third Reading: Given Immediate Effect Roll Call # 217",79,30,0,0,109
734664,460571,2015-06-16,Senate,"Reported Favorably Without Amendment",7,0,0,0,7
734664,461353,2015-06-18,Senate,"Senate Third Reading: Given Immediate Effect Roll Call # 311",33,4,0,1,38
734898,546397,2016-05-17,House,"Reported With Recommendation With Substitute  H-2",18,1,0,0,19
734898,551222,2016-06-02,House,"House Third Reading: Given Immediate Effect Roll Call # 381",103,5,0,0,108
734898,565412,2016-11-30,Senate,"Reported Favorably Without Amendment",9,0,0,0,9
734898,566317,2016-12-14,Senate,"Senate Third Reading: Given Immediate Effect Roll Call # 812",37,0,0,1,38
735618,406471,2015-03-05,Senate,"Reported Favorably Without Amendment",9,0,0,0,9
735618,413211,2015-03-18,Senate,"Senate Third Reading: Passed Roll Call # 48",37,0,0,1,38
735618,492060,2016-02-04,House,"Reported With Recommendation With Substitute  H-3",14,0,0,0,14
735646,406469,2015-03-05,Senate,"Reported Favorably Without Amendment",9,0,0,0,9
735646,413170,2015-03-18,Senate,"Senate Third Reading: Passed Roll Call # 49",37,0,0,1,38
735672,410006,2015-03-11,House,"Reported With Recommendation Without Amendment",22,0,0,0,22
735697,406242,2015-03-05,Senate,"Reported Favorably With Substitute  S-1",9,0,0,0,9
735697,413577,2015-03-18,Senate,"Senate Third Reading: Passed Roll Call # 47",37,0,0,1,38
735697,491721,2016-02-04,House,"Reported With Recommendation With Substitute  H-2",14,0,0,0,14
735748,406485,2015-03-05,Senate,"Reported Favorably Without Amendment",8,1,0,0,9
735748,413154,2015-03-18,Senate,"Senate Third Reading: Passed Roll Call # 50",29,8,0,1,38
735748,492018,2016-02-04,House,"Reported With Recommendation With Substitute  H-2",14,0,0,0,14
735798,412795,2015-03-17,House,"Reported With Recommendation Without Amendment",6,4,0,0,10
735798,436508,2015-04-21,House,"House Third Reading: Given Immediate Effect Roll Call # 69",79,31,0,0,110
735826,406503,2015-03-05,Senate,"Reported Favorably With Substitute  S-1",7,0,0,0,7
735826,413431,2015-03-18,Senate,"Senate Third Reading: Passed Roll Call # 46",36,1,0,1,38
735826,422183,2015-03-26,House,"Reported With Recommendation Without Amendment",4,0,0,0,4
735826,432622,2015-04-15,House,"House Third Reading: Given Immediate Effect Roll Call # 61",107,3,0,0,110
735877,417332,2015-03-25,House,"Reported With Recommendation Without Amendment",14,0,0,0,14
735877,432860,2015-04-15,House,"House Third Reading: Given Immediate Effect Roll Call # 60",110,0,0,0,110
735877,449940,2015-05-21,Senate,"Reported Favorably Without Amendment",8,0,0,0,8
735877,459015,2015-06-10,Senate,"Senate Third Reading: Given Immediate Effect Roll Call # 267",38,0,0,0,38
735877,459494,2015-06-11,House,"House Third Reading: Roll Call # 245",108,0,0,0,108
735955,437446,2015-04-22,House,"Reported With Recommendation Without Amendment",8,0,0,0,8
735955,443453,2015-05-05,House,"House Third Reading: Given Immediate Effect Roll Call # 113",110,0,0,0,110
735955,476449,2015-09-10,Senate,"Reported Favorably With Substitute  S-2",4,0,0,0,4
735955,477654,2015-10-08,Senate,"Senate Third Reading: Given Immediate Effect Roll Call # 413",36,0,0,2,38
735955,480693,2015-10-28,House,"House Third Reading: Roll Call # 389",105,0,0,0,105
735955,480746,2015-10-29,Senate,"Senate Third Reading: Roll Call # 469",36,0,0,2,38
736890,434167,2015-04-16,House,"Reported With Recommendation With Substitute H-2",9,0,0,0,9
736890,443479,2015-05-05,Senate,"Reported Favorably Without Amendment",5,0,0,0,5
737744,443593,2015-05-05,Senate,"Reported Favorably With Substitute  S-1",4,0,0,0,4
737744,447085,2015-05-14,Senate,"Senate Third Reading: Passed Roll Call # 178",37,0,0,1,38
737744,458485,2015-06-09,House,"Reported With Recommendation Without Amendment",15,0,0,0,15
737744,461354,2015-06-18,House,"House Third Reading: Given Immediate Effect Roll Call # 268",96,13,0,0,109
737762,491735,2016-02-04,House,"Reported With Recommendation With Substitute  H-3",12,2,0,0,14
737779,446258,2015-05-13,House,"Reported With Recommendation Without Amendment",15,0,0,0,15
737779,452011,2015-05-26,House,"House Third Reading: Given Immediate Effect Roll Call # 198",109,1,0,0,110
737779,477464,2015-10-01,Senate,"Reported Favorably Without Amendment",9,0,0,0,9
737779,477739,2015-10-15,Senate,"Senate Third Reading: Given Immediate Effect Roll Call # 435",37,0,0,1,38
737860,443449,2015-05-05,Senate,"Reported Favorably Without Amendment",4,0,0,0,4
737860,447060,2015-05-14,Senate,"Senate Third Reading: Passed Roll Call # 179",37,0,0,1,38
737860,458534,2015-06-09,House,"Reported With Recommendation Without Amendment",15,0,0,0,15
737860,461458,2015-06-18,House,"House Third Reading: Given Immediate Effect Roll Call # 269",100,9,0,0,109
737881,460361,2015-06-16,House,"Reported With Recommendation Without Amendment",8,0,0,0,8
737881,473909,2015-08-19,House,"House Third Reading: Given Immediate Effect Roll Call # 290",105,0,0,0,105
737881,477338,2015-09-29,Senate,"Reported Favorably Without Amendment",4,0,0,0,4
737881,486631,2015-12-02,Senate,"Senate Third Reading: Given Immediate Effect Roll Call # 537",37,0,0,1,38
737914,442327,2015-04-30,House,"Reported With Recommendation With Substitute  H-1",16,0,0,0,16
737914,447037,2015-05-14,House,"House Third Reading: Given Immediate Effect Roll Call # 147",108,0,0,0,108
737914,565976,2016-12-08,Senate,"Reported Favorably With Substitute  S-1",4,0,0,0,4
737914,565977,2016-12-08,Senate,"Senate Third Reading: Given Immediate Effect Roll Call # 727",37,0,0,1,38
737914,566253,2016-12-13,House,"House Third Reading: Roll Call # 630",100,8,0,0,108
737932,491968,2016-02-04,House,"Reported With Recommendation With Substitute  H-3",12,2,0,0,14
737998,460243,2015-06-16,House,"Reported With Recommendation Without Amendment",8,0,0,0,8
737998,473929,2015-08-19,House,"House Third Reading: Given Immediate Effect Roll Call # 289",105,0,0,0,105
737998,477331,2015-09-29,Senate,"Reported Favorably Without Amendment",4,0,0,0,4
737998,486570,2015-12-02,Senate,"Senate Third Reading: Given Immediate Effect Roll Call # 536",37,0,0,1,38
738033,460267,2015-06-16,House,"Reported With Recommendation With Substitute  H-1",8,0,0,0,8
738033,473912,2015-08-19,House,"House Third Reading: Given Immediate Effect Roll Call # 288",105,0,0,0,105
738033,477301,2015-09-29,Senate,"Reported Favorably Without Amendment",4,0,0,0,4
738033,486613,2015-12-02,Senate,"Senate Third Reading: Given Immediate Effect Roll Call # 535",37,0,0,1,38
738065,491722,2016-02-04,House,"Reported With Recommendation With Substitute  H-2",14,0,0,0,14
738083,565486,2016-11-30,House,"Reported With Recommendation Without Amendment",10,1,0,0,11
738083,566100,2016-12-08,House,"House Third Reading: Passed Roll Call # 602",106,1,0,0,107
742831,417202,2015-03-25,Senate,"Reported Favorably With Substitute  S-1",5,0,0,0,5
742831,433977,2015-04-16,Senate,"Senate Third Reading: Passed Roll Call # 78",38,0,0,0,38
742831,476453,2015-09-10,House,"Reported With Recommendation For Referral To Committee On Workforce And Talent Development",13,1,0,0,14
742883,418729,2015-03-26,Senate,"Reported Favorably With Substitute  S-1",7,0,0,0,7
742883,482258,2015-12-10,Senate,"Senate Third Reading: Passed Roll Call # 572",37,0,0,1,38
742883,494912,2016-02-10,House,"Reported With Recommendation With Substitute  H-1",13,0,0,0,13
742883,524612,2016-03-24,House,"House Third Reading: Given Immediate Effect Roll Call # 139",107,1,0,0,108
742883,524613,2016-03-24,Senate,"Senate Third Reading: Roll Call # 151",35,0,1,2,38
742883,524614,2016-03-24,Senate,"Senate Third Reading: Roll Call # 156",36,0,0,2,38
742994,410484,2015-03-12,Senate,"Reported Favorably Without Amendment",14,0,0,0,14
742994,416995,2015-03-25,Senate,"Senate Third Reading: Passed Roll Call # 64",29,8,0,1,38
742994,458958,2015-06-10,House,"Reported With Recommendation With Substitute  H-2",27,0,0,0,27
743047,417286,2015-03-25,Senate,"Reported Favorably With Substitute  S-1",5,0,0,0,5
743047,433981,2015-04-16,Senate,"Senate Third Reading: Passed Roll Call # 77",38,0,0,0,38
743047,457341,2015-06-04,House,"Reported With Recommendation For Referral To Committee On Workforce And Talent Development",12,3,0,0,15
743270,417799,2015-03-25,Senate,"Reported Favorably Without Amendment",7,3,0,0,10
743436,409989,2015-03-11,House,"Reported With Recommendation Without Amendment",9,0,0,0,9
743436,414020,2015-03-18,House,"House Third Reading: Given Immediate Effect Roll Call # 39",108,1,0,0,109
744050,480732,2015-10-29,Senate,"Reported Favorably With Substitute  S-1",8,0,0,0,8
744050,480910,2015-11-05,Senate,"Senate Third Reading: Passed Roll Call # 500",38,0,0,0,38
744050,481738,2015-12-03,House,"Reported With Recommendation With Substitute  H-1",16,0,0,0,16
744050,482217,2015-12-10,House,"House Third Reading: Given Immediate Effect Roll Call # 473",106,0,0,0,106
744050,482485,2015-12-15,Senate,"Senate Third Reading: Roll Call # 587",38,0,0,0,38
744124,480748,2015-10-29,Senate,"Reported Favorably With Substitute  S-1",8,0,0,0,8
744124,480909,2015-11-05,Senate,"Senate Third Reading: Passed Roll Call # 499",38,0,0,0,38
744124,481811,2015-12-03,House,"Reported With Recommendation With Substitute  H-2",16,0,0,0,16
744124,482196,2015-12-10,House,"House Third Reading: Given Immediate Effect Roll Call # 472",106,0,0,0,106
744124,482473,2015-12-15,Senate,"Senate Third Reading: Roll Call # 586",38,0,0,0,38
744246,477644,2015-10-08,Senate,"Reported Favorably With Substitute  S-1",3,1,0,0,4
744246,480409,2015-10-22,Senate,"Senate Third Reading: Passed Roll Call # 459",34,3,0,1,38
744324,477630,2015-10-08,Senate,"Reported Favorably With Substitute  S-1",4,1,0,0,5
744324,480394,2015-10-22,Senate,"Senate Third Reading: Passed Roll Call # 460",34,3,0,1,38
744324,481585,2015-12-01,House,"Reported With Recommendation With Substitute  H-1",9,2,0,0,11
744324,501031,2016-02-17,House,"House Third Reading: Given Immediate Effect Roll Call # 41",80,26,0,0,106
744324,502616,2016-02-18,Senate,"Senate Third Reading: Roll Call # 63",35,2,0,1,38
744399,476377,2015-09-10,House,"Reported With Recommendation For Referral To Committee On Workforce And Talent Development",13,1,0,0,14
744416,457327,2015-06-04,House,"Reported With Recommendation For Referral To Committee On Workforce And Talent Development",12,3,0,0,15
744433,416930,2015-03-25,House,"Reported With Recommendation With Substitute  H-3",6,2,0,0,8
744433,434389,2015-04-16,House,"House Third Reading: Given Immediate Effect Roll Call # 65",93,17,0,0,110
744433,458750,2015-06-09,Senate,"Reported Favorably Without Amendment",3,0,0,0,3
744433,461370,2015-06-18,Senate,"Senate Third Reading: Given Immediate Effect Roll Call # 325",30,7,0,1,38
744451,480344,2015-10-21,House,"Reported With Recommendation Without Amendment",11,0,0,0,11
744451,482277,2015-12-10,House,"House Third Reading: Given Immediate Effect Roll Call # 475",104,2,0,0,106
744467,480724,2015-10-28,House,"Reported With Recommendation With Substitute  H-2",9,6,0,0,15
744467,563066,2016-09-22,House,"House Third Reading: Given Immediate Effect Roll Call # 492",69,38,0,0,107
744503,437249,2015-04-22,House,"Reported With Recommendation With Substitute  H-1",14,1,0,0,15
744503,442468,2015-04-30,House,"House Third Reading: Given Immediate Effect Roll Call # 112",99,11,0,0,110
744503,477738,2015-10-15,Senate,"Reported Favorably With Substitute  S-2",8,0,0,0,8
744503,480374,2015-10-21,Senate,"Senate Third Reading: Given Immediate Effect Roll Call # 453",38,0,0,0,38
744503,480375,2015-10-21,House,"House Third Reading: Roll Call # 382",95,11,0,0,106
744519,417331,2015-03-25,House,"Reported With Recommendation With Substitute  H-2",6,2,0,0,8
744519,434384,2015-04-16,House,"House Third Reading: Given Immediate Effect Roll Call # 66",93,17,0,0,110
744519,458812,2015-06-09,Senate,"Reported Favorably Without Amendment",3,0,0,0,3
744519,461496,2015-06-18,Senate,"Senate Third Reading: Given Immediate Effect Roll Call # 326",30,7,0,1,38
744549,417335,2015-03-25,House,"Reported With Recommendation With Substitute  H-2",6,2,0,0,8
744549,434342,2015-04-16,House,"House Third Reading: Given Immediate Effect Roll Call # 63",93,17,0,0,110
744549,458439,2015-06-09,Senate,"Reported Favorably Without Amendment",3,0,0,0,3
744549,461339,2015-06-18,Senate,"Senate Third Reading: Given Immediate Effect Roll Call # 323",30,7,0,1,38
744588,417215,2015-03-25,House,"Reported With Recommendation With Substitute  H-2",6,2,0,0,8
744588,434372,2015-04-16,House,"House Third Reading: Given Immediate Effect Roll Call # 64",93,17,0,0,110
744588,458848,2015-06-09,Senate,"Reported Favorably Without Amendment",3,0,0,0,3
744588,461267,2015-06-18,Senate,"Senate Third Reading: Given Immediate Effect Roll Call # 324",30,7,0,1,38
744672,416921,2015-03-25,House,"Reported With Recommendation With Substitute  H-2",6,2,0,0,8
744672,434405,2015-04-16,House,"House Third Reading: Given Immediate Effect Roll Call # 67",93,17,0,0,110
744672,458835,2015-06-09,Senate,"Reported Favorably Without Amendment",3,0,0,0,3
744672,461301,2015-06-18,Senate,"Senate Third Reading: Given Immediate Effect Roll Call # 327",31,6,0,1,38
744690,480704,2015-10-28,House,"Reported With Recommendation With Substitute  H-1",9,6,0,0,15
744690,563115,2016-09-22,House,"House Third Reading: Given Immediate Effect Roll Call # 493",66,40,0,0,106
744707,434046,2015-04-16,House,"Reported With Recommendation Without Amendment",9,0,0,0,9
745671,445755,2015-05-12,Senate,"Reported Favorably With Substitute  S-2",9,0,0,0,9
745671,482071,2015-12-09,Senate,"Senate Third Reading: Passed Roll Call # 565",34,4,0,0,38
745671,523895,2016-03-23,House,"Reported With Recommendation With Substitute  H-1",15,0,0,0,15
745728,440588,2015-04-28,House,"Reported With Recommendation Without Amendment",6,0,0,0,6
745728,460872,2015-06-17,House,"House Third Reading: Given Immediate Effect Roll Call # 257",89,21,0,0,110
745728,477343,2015-09-29,Senate,"Reported Favorably With Substitute  S-1",4,0,0,0,4
745728,482475,2015-12-15,Senate,"Senate Third Reading: Given Immediate Effect Roll Call # 602",38,0,0,0,38
745728,509744,2016-02-24,House,"House Third Reading: Roll Call # 59",83,19,0,0,102
745757,459546,2015-06-11,Senate,"Reported Favorably With Substitute  S-5",6,1,0,0,7
745770,481115,2015-11-10,House,"Reported With Recommendation With Substitute  H-3",21,3,0,0,24
745785,460710,2015-06-17,House,"Reported With Recommendation With Substitute  H-2",14,0,0,0,14
745799,524143,2016-03-23,House,"Reported With Recommendation With Substitute  H-3",15,0,0,0,15
745856,412456,2015-03-17,House,"Reported With Recommendation Without Amendment",9,2,0,0,11
745856,416938,2015-03-25,House,"House Third Reading: Given Immediate Effect Roll Call # 46",90,20,0,0,110
745903,459484,2015-06-11,Senate,"Reported Favorably With Substitute  S-5",6,1,0,0,7
745918,542052,2016-05-03,Senate,"Reported Favorably With Substitute  S-1",4,0,0,0,4
745918,550160,2016-05-31,Senate,"Senate Third Reading: Passed Roll Call # 342",34,3,0,0,37
746017,448661,2015-05-19,Senate,"Reported Favorably With Substitute  S-1",5,0,0,0,5
746017,451917,2015-05-26,Senate,"Senate Third Reading: Passed Roll Call # 223",35,1,2,0,38
746031,541512,2016-05-03,Senate,"Reported Favorably With Substitute  S-1",4,0,0,0,4
746031,550176,2016-05-31,Senate,"Senate Third Reading: Passed Roll Call # 340",31,5,1,0,37
746031,550177,2016-05-31,Senate,"Senate Third Reading: Passed Roll Call # 341",34,3,0,0,37
746102,481125,2015-11-10,House,"Reported With Recommendation With Substitute  H-9",18,7,0,0,25
748701,416963,2015-03-25,Senate,"Reported Favorably Without Amendment",9,0,0,0,9
748701,419205,2015-03-26,Senate,"Senate Third Reading: Passed Roll Call # 75",33,4,0,1,38
748701,476942,2015-09-22,House,"Reported With Recommendation With Substitute  H-1",21,0,0,0,21
748701,477466,2015-10-01,House,"House Third Reading: Given Immediate Effect Roll Call # 333",105,1,0,0,106
748701,480313,2015-10-20,Senate,"Senate Third Reading: Roll Call # 442",34,3,0,1,38
748892,414016,2015-03-19,Senate,"Reported Favorably Without Amendment",5,0,0,0,5
748892,431748,2015-04-14,Senate,"Senate Third Reading: Passed Roll Call # 76",36,1,0,1,38
751821,431777,2015-04-14,Senate,"Reported Favorably Without Amendment",5,0,0,0,5
751821,437495,2015-04-22,Senate,"Senate Third Reading: Passed Roll Call # 107",37,0,0,1,38
751821,445863,2015-05-12,House,"Reported With Recommendation Without Amendment",16,0,0,0,16
751821,452099,2015-05-26,House,"House Third Reading: Given Immediate Effect Roll Call # 197",107,3,0,0,110
751849,433163,2015-04-15,House,"Reported With Recommendation With Substitute  H-3",6,3,0,0,9
751849,438544,2015-04-23,House,"House Third Reading: Given Immediate Effect Roll Call # 77",60,49,0,0,109
751849,461209,2015-06-18,Senate,"Reported Favorably With Substitute  S-5",4,0,0,0,4
751849,461210,2015-06-18,Senate,"Senate Third Reading: Given Immediate Effect Roll Call # 332",25,12,0,1,38
751849,461211,2015-06-18,House,"House Third Reading: Roll Call # 284",63,45,0,0,108
751849,464563,2015-06-30,Senate,"Senate Third Reading: Roll Call # 338",26,9,0,3,38
751870,432627,2015-04-15,House,"Reported With Recommendation Without Amendment",6,3,0,0,9
751870,438607,2015-04-23,House,"House Third Reading: Given Immediate Effect Roll Call # 78",60,49,0,0,109
751870,461470,2015-06-18,Senate,"Reported Favorably With Substitute  S-1",4,0,0,0,4
751870,461471,2015-06-18,Senate,"Senate Third Reading: Given Immediate Effect Roll Call # 333",25,12,0,1,38
751870,461472,2015-06-18,House,"House Third Reading: Roll Call # 279",61,47,0,0,108
751893,432601,2015-04-15,House,"Reported With Recommendation With Substitute  H-1",6,3,0,0,9
751893,438852,2015-04-23,House,"House Third Reading: Given Immediate Effect Roll Call # 80",58,51,0,0,109
751893,461493,2015-06-18,Senate,"Reported Favorably With Substitute  S-1",4,0,0,0,4
751893,461494,2015-06-18,Senate,"Senate Third Reading: Given Immediate Effect Roll Call # 335",25,12,0,1,38
751893,461495,2015-06-18,House,"House Third Reading: Roll Call # 281",61,47,0,0,108
751959,477700,2015-10-13,House,"Reported With Recommendation With Substitute  H-2",6,0,0,0,6
751959,480699,2015-10-28,House,"House Third Reading: Given Immediate Effect Roll Call # 391",83,22,0,0,105
751959,502613,2016-02-18,Senate,"Reported Favorably Without Amendment",5,0,0,0,5
752004,441844,2015-04-29,House,"Reported With Recommendation With Substitute  H-1",12,0,0,0,12
752004,444527,2015-05-07,House,"House Third Reading: Given Immediate Effect Roll Call # 136",104,6,0,0,110
752026,416982,2015-03-25,House,"Reported With Recommendation With Substitute  H-1",7,0,0,0,7
752026,438775,2015-04-23,House,"House Third Reading: Given Immediate Effect Roll Call # 75",64,45,0,0,109
752026,458825,2015-06-10,Senate,"Reported Favorably Without Amendment",3,0,0,0,3
752026,464556,2015-06-30,Senate,"Senate Third Reading: Given Immediate Effect Roll Call # 339",25,10,0,3,38
752046,433215,2015-04-15,House,"Reported With Recommendation With Substitute  H-1",6,3,0,0,9
752046,438830,2015-04-23,House,"House Third Reading: Given Immediate Effect Roll Call # 82",60,49,0,0,109
752046,461385,2015-06-18,Senate,"Reported Favorably With Substitute  S-1",4,0,0,0,4
752046,461386,2015-06-18,Senate,"Senate Third Reading: Given Immediate Effect Roll Call # 337",25,12,0,1,38
752046,461387,2015-06-18,House,"House Third Reading: Roll Call # 283",61,47,0,0,108
752068,440534,2015-04-28,House,"Reported With Recommendation Without Amendment",16,0,0,0,16
752068,443623,2015-05-05,House,"House Third Reading: Given Immediate Effect Roll Call # 116",110,0,0,0,110
752068,464512,2015-06-30,Senate,"Reported Favorably Without Amendment",3,2,0,0,5
752068,464794,2015-07-01,Senate,"Senate Third Reading: Given Immediate Effect Roll Call # 343",38,0,0,0,38
752092,433016,2015-04-15,House,"Reported With Recommendation With Substitute  H-3",6,3,0,0,9
752092,438789,2015-04-23,House,"House Third Reading: Given Immediate Effect Roll Call # 79",60,49,0,0,109
752092,461512,2015-06-18,Senate,"Reported Favorably With Substitute  S-1",4,0,0,0,4
752092,461513,2015-06-18,Senate,"Senate Third Reading: Given Immediate Effect Roll Call # 334",25,12,0,1,38
752092,461514,2015-06-18,House,"House Third Reading: Roll Call # 280",61,47,0,0,108
752180,432616,2015-04-15,House,"Reported With Recommendation Without Amendment",6,3,0,0,9
752180,438836,2015-04-23,House,"House Third Reading: Given Immediate Effect Roll Call # 81",59,50,0,0,109
752180,461233,2015-06-18,Senate,"Reported Favorably With Substitute  S-1",4,0,0,0,4
752180,461234,2015-06-18,Senate,"Senate Third Reading: Given Immediate Effect Roll Call # 336",25,12,0,1,38
752180,461235,2015-06-18,House,"House Third Reading: Roll Call # 282",60,48,0,0,108
752200,435241,2015-04-16,Senate,"Reported Favorably With Substitute  S-1",5,0,0,0,5
752222,441713,2015-04-29,House,"Reported With Recommendation With Substitute  H-1",12,0,0,0,12
752222,444571,2015-05-07,House,"House Third Reading: Given Immediate Effect Roll Call # 135",105,5,0,0,110
752243,435273,2015-04-16,Senate,"Reported Favorably With Substitute  S-1",5,0,0,0,5
752265,416926,2015-03-25,House,"Reported With Recommendation Without Amendment",9,0,0,0,9
752265,438772,2015-04-23,House,"House Third Reading: Given Immediate Effect Roll Call # 76",105,4,0,0,109
752265,499084,2015-06-10,Senate,"Reported Favorably Without Amendment",3,0,0,0,3
752265,499085,2015-06-30,Senate,"Senate Third Reading: Given Immediate Effect Roll Call # 340",28,7,0,3,38
752287,520580,2016-03-16,House,"Reported With Recommendation With Substitute  H-2",6,2,0,0,8
752287,546901,2016-05-18,House,"House Third Reading: Given Immediate Effect Roll Call # 300",66,43,0,0,109
752308,440700,2015-04-28,House,"Reported With Recommendation Without Amendment",16,0,0,0,16
752308,443588,2015-05-05,House,"House Third Reading: Given Immediate Effect Roll Call # 115",110,0,0,0,110
752308,464575,2015-06-30,Senate,"Reported Favorably Without Amendment",3,2,0,0,5
752308,464723,2015-07-01,Senate,"Senate Third Reading: Given Immediate Effect Roll Call # 342",38,0,0,0,38
754474,481599,2015-12-01,Senate,"Reported Favorably With Substitute  S-3",7,0,0,0,7
754474,482270,2015-12-10,Senate,"Senate Third Reading: Passed Roll Call # 576",33,5,0,0,38
754512,477641,2015-10-08,Senate,"Reported Favorably With Substitute  S-1",5,0,0,0,5
754512,486073,2016-01-20,Senate,"Senate Third Reading: Passed Roll Call # 4",29,9,0,0,38
754512,523624,2016-03-22,House,"Reported With Recommendation With Substitute H-1",7,3,0,0,10
754512,524177,2016-03-22,House,"Reported With Recommendation With Substitute  H-1",7,3,0,0,10
754512,552390,2016-06-09,House,"House Third Reading: Given Immediate Effect Roll Call # 422",69,39,0,0,108
754512,552391,2016-06-09,Senate,"Senate Third Reading: Roll Call # 474",27,10,0,0,37
754621,438543,2015-04-23,Senate,"Reported Favorably Without Amendment",5,0,0,0,5
754779,456176,2015-06-02,House,"Reported With Recommendation With Substitute  H-1",10,6,0,0,16
755278,445748,2015-05-12,House,"Reported With Recommendation With Substitute  H-3",16,0,0,0,16
755278,494866,2016-02-10,House,"House Third Reading: Given Immediate Effect Roll Call # 33",84,22,0,0,106
755278,531492,2016-04-12,Senate,"Reported Favorably With Substitute  S-2",6,0,0,0,6
755278,546363,2016-05-17,Senate,"Senate Third Reading: Given Immediate Effect Roll Call # 291",33,4,0,0,37
755278,550068,2016-05-31,House,"House Third Reading: Roll Call # 334",86,23,0,0,109
755278,550510,2016-06-01,Senate,"Senate Third Reading: Roll Call # 358",33,3,0,1,37
758408,449263,2015-05-20,Senate,"Reported Favorably Without Amendment",4,1,0,0,5
758408,459348,2015-06-11,Senate,"Senate Third Reading: Passed Roll Call # 285",27,11,0,0,38
758408,481121,2015-11-10,House,"Reported With Recommendation With Substitute  H-1",11,0,0,0,11
758469,449202,2015-05-20,Senate,"Reported Favorably Without Amendment",5,0,0,0,5
758469,459463,2015-06-11,Senate,"Senate Third Reading: Passed Roll Call # 286",30,8,0,0,38
758469,481141,2015-11-10,House,"Reported With Recommendation Without Amendment",11,0,0,0,11
758479,443445,2015-05-05,Senate,"Reported Favorably Without Amendment",5,0,0,0,5
758510,449203,2015-05-20,Senate,"Senate Third Reading: Passed Roll Call # 214",37,0,0,1,38
758510,477534,2015-10-06,House,"Reported With Recommendation Without Amendment",19,0,0,0,19
758510,480883,2015-11-04,House,"House Third Reading: Given Immediate Effect Roll Call # 415",106,1,0,0,107
758510,496023,2015-05-07,Senate,"Reported Favorably Without Amendment",4,0,0,0,4
758859,480754,2015-10-29,House,"Reported With Recommendation Without Amendment",9,0,0,0,9
759202,443460,2015-05-05,Senate,"Reported Favorably Without Amendment",5,0,0,0,5
759222,422341,2015-03-26,Senate,"Reported Favorably With Substitute  S-1",8,0,0,0,8
759222,434015,2015-04-16,Senate,"Senate Third Reading: Passed Roll Call # 79",38,0,0,0,38
759222,444712,2015-05-07,House,"Reported With Recommendation Without Amendment",16,0,0,0,16
759222,448985,2015-05-20,House,"House Third Reading: Given Immediate Effect Roll Call # 183",110,0,0,0,110
759250,485858,2015-12-02,Senate,"Reported Favorably With Substitute  S-4",5,0,0,0,5
759250,485859,2015-12-15,Senate,"Senate Third Reading: Passed Roll Call # 603",38,0,0,0,38
759250,513492,2016-03-03,House,"Reported With Recommendation With Substitute  H-1",17,0,0,0,17
759250,521069,2016-03-16,House,"House Third Reading: Given Immediate Effect Roll Call # 105",108,1,0,0,109
759250,521291,2016-03-17,Senate,"Senate Third Reading: Roll Call # 115",37,0,0,1,38
759275,419277,2015-03-26,Senate,"Reported Favorably Without Amendment",17,0,0,0,17
759275,441170,2015-04-29,Senate,"Senate Third Reading: Passed Roll Call # 117",37,0,0,1,38
759275,562373,2016-09-08,House,"Reported With Recommendation With Substitute H-4",24,4,0,0,28
759275,562536,2016-09-08,House,"Reported With Recommendation With Substitute  H-4",24,4,0,0,28
759275,562537,2016-09-14,House,"House Third Reading: Given Immediate Effect Roll Call # 453",97,7,0,0,104
759275,563069,2016-09-21,Senate,"Senate Third Reading: Roll Call # 517",35,0,0,2,37
759275,563070,2016-09-21,House,"House Third Reading: Roll Call # 478",99,6,0,0,105
759299,433944,2015-04-16,Senate,"Reported Favorably Without Amendment",5,0,0,0,5
759299,440494,2015-04-28,Senate,"Senate Third Reading: Passed Roll Call # 110",38,0,0,0,38
759299,451887,2015-05-26,House,"Reported With Recommendation With Substitute  H-1",7,0,0,0,7
759299,458747,2015-06-09,House,"House Third Reading: Given Immediate Effect Roll Call # 230",89,20,0,0,109
759299,460229,2015-06-16,Senate,"Senate Third Reading: Roll Call # 294",38,0,0,0,38
759325,444715,2015-05-07,Senate,"Reported Favorably With Substitute  S-1",5,0,0,0,5
759325,489052,2016-01-28,Senate,"Senate Third Reading: Passed Roll Call # 10",37,1,0,0,38
759353,444579,2015-05-07,Senate,"Reported Favorably With Substitute  S-1",5,0,0,0,5
759353,489224,2016-01-28,Senate,"Senate Third Reading: Passed Roll Call # 11",37,1,0,0,38
759448,480317,2015-10-20,Senate,"Reported Favorably Without Amendment",9,0,0,0,9
759448,503381,2016-02-17,House,"Reported With Recommendation Without Amendment",23,0,0,0,23
759477,445953,2015-05-12,House,"Reported With Recommendation Without Amendment",8,0,0,0,8
759477,494308,2016-02-09,House,"House Third Reading: Given Immediate Effect Roll Call # 31",88,17,0,0,105
759477,502457,2016-02-18,Senate,"Reported Favorably With Substitute  S-1",5,0,0,0,5
759477,566388,2016-12-14,Senate,"Senate Third Reading: Passed Roll Call # 824",31,6,0,1,38
759477,566503,2016-12-15,House,"House Third Reading: Roll Call # 738",84,24,0,0,108
759511,434364,2015-04-16,House,"Reported With Recommendation With Substitute  H-1",17,0,0,0,17
759511,437279,2015-04-22,House,"House Third Reading: Given Immediate Effect Roll Call # 74",95,14,0,0,109
759511,461534,2015-06-18,Senate,"Reported Favorably Without Amendment",8,0,0,0,8
759511,477412,2015-09-30,Senate,"Senate Third Reading: Given Immediate Effect Roll Call # 385",37,0,0,1,38
759511,477452,2015-10-01,House,"House Third Reading: Senate Amendment(s) Concurred In Roll Call # 332",89,17,0,0,106
759545,445804,2015-05-12,House,"Reported With Recommendation With Substitute  H-1",9,0,0,0,9
759545,493825,2016-02-09,House,"House Third Reading: Given Immediate Effect Roll Call # 30",88,17,0,0,105
759545,502091,2016-02-18,Senate,"Reported Favorably With Substitute  S-1",5,0,0,0,5
759545,566389,2016-12-14,Senate,"Senate Third Reading: Passed Roll Call # 823",30,7,0,1,38
759545,566568,2016-12-15,House,"House Third Reading: Roll Call # 737",81,27,0,0,108
759617,431749,2015-04-14,Senate,"Reported Favorably Without Amendment",5,0,0,0,5
759654,480309,2015-10-20,Senate,"Reported Favorably Without Amendment",9,0,0,0,9
759654,503409,2016-02-17,House,"Reported With Recommendation Without Amendment",23,0,0,0,23
759687,435235,2015-04-16,Senate,"Reported Favorably Without Amendment",5,0,0,0,5
760163,416358,2015-03-24,House,"Reported With Recommendation With Substitute  H-1",17,2,0,0,19
760163,432938,2015-04-15,House,"House Third Reading: Given Immediate Effect Roll Call # 59",108,2,0,0,110
760163,477346,2015-09-29,Senate,"Reported Favorably Without Amendment",7,0,0,0,7
760163,480747,2015-10-29,Senate,"Senate Third Reading: Given Immediate Effect Roll Call # 472",36,0,0,2,38
760200,416915,2015-03-25,House,"Reported With Recommendation With Substitute  H-1",20,6,0,0,26
760200,441782,2015-04-29,House,"House Third Reading: Given Immediate Effect Roll Call # 85",96,14,0,0,110
760200,445904,2015-05-12,Senate,"Reported Favorably Without Amendment",11,0,0,0,11
760200,452293,2015-05-26,Senate,"Senate Third Reading: Given Immediate Effect Roll Call # 226",23,15,0,0,38
760233,417490,2015-03-25,House,"Reported With Recommendation With Substitute  H-1",20,6,0,0,26
760233,441171,2015-04-29,House,"House Third Reading: Given Immediate Effect Roll Call # 84",100,10,0,0,110
760233,445954,2015-05-12,Senate,"Reported Favorably Without Amendment",11,0,0,0,11
760233,451909,2015-05-26,Senate,"Senate Third Reading: Given Immediate Effect Roll Call # 225",25,13,0,0,38
760356,440209,2015-04-28,House,"Reported With Recommendation With Substitute  H-1",19,0,0,0,19
760356,444544,2015-05-07,House,"House Third Reading: Given Immediate Effect Roll Call # 128",109,1,0,0,110
760356,477733,2015-10-15,Senate,"Reported Favorably With Substitute S-2",5,0,0,0,5
760356,480725,2015-10-28,Senate,"Senate Third Reading: Given Immediate Effect Roll Call # 463",37,0,0,1,38
760356,480855,2015-11-04,House,"House Third Reading: Roll Call # 412",106,1,0,0,107
760718,440338,2015-04-28,Senate,"Reported Favorably Without Amendment",5,0,0,0,5
761388,424455,2015-03-26,Senate,"Reported Favorably Without Amendment",7,0,0,0,7
761454,424542,2015-03-26,Senate,"Reported Favorably Without Amendment",7,0,0,0,7
761710,477658,2015-10-08,Senate,"Reported Favorably With Substitute  S-1",6,0,0,0,6
761710,482098,2015-12-09,Senate,"Senate Third Reading: Passed Roll Call # 567",38,0,0,0,38
761710,565660,2016-12-06,House,"Reported With Recommendation With Substitute  H-4",8,0,0,0,8
761728,422053,2015-03-26,Senate,"Reported Favorably Without Amendment",7,0,0,0,7
761728,434370,2015-04-16,Senate,"Senate Third Reading: Passed Roll Call # 81",37,1,0,0,38
761728,477613,2015-10-07,House,"Reported With Recommendation Without Amendment",12,0,0,0,12
761728,485958,2016-01-20,House,"House Third Reading: Given Immediate Effect Roll Call # 9",101,5,0,0,106
761762,461483,2015-06-18,Senate,"Reported Favorably With Substitute  S-2",4,0,0,0,4
761762,477421,2015-09-30,Senate,"Senate Third Reading: Passed Roll Call # 386",36,1,0,1,38
761762,480299,2015-10-20,House,"Reported With Recommendation Without Amendment",9,1,0,0,10
761762,480750,2015-10-29,House,"House Third Reading: Given Immediate Effect Roll Call # 401",99,6,0,0,105
761817,446748,2015-05-14,Senate,"Reported Favorably Without Amendment",8,0,0,0,8
761817,449042,2015-05-20,Senate,"Senate Third Reading: Passed Roll Call # 215",37,0,0,1,38
761839,477400,2015-09-30,Senate,"Reported Favorably With Substitute  S-3",8,0,0,0,8
761839,477401,2015-09-30,Senate,"Senate Third Reading: Passed Roll Call # 387",37,0,0,1,38
761839,480308,2015-10-20,House,"Reported With Recommendation Without Amendment",9,1,0,0,10
761839,480753,2015-10-29,House,"House Third Reading: Given Immediate Effect Roll Call # 402",99,6,0,0,105
761851,421281,2015-03-26,Senate,"Reported Favorably Without Amendment",7,0,0,0,7
761851,434317,2015-04-16,Senate,"Senate Third Reading: Passed Roll Call # 83",37,1,0,0,38
761851,477591,2015-10-07,House,"Reported With Recommendation Without Amendment",12,0,0,0,12
761851,486255,2016-01-20,House,"House Third Reading: Given Immediate Effect Roll Call # 10",101,5,0,0,106
761883,458887,2015-06-10,House,"Reported With Recommendation With Substitute  H-1",27,0,0,0,27
761907,431836,2015-04-14,House,"Reported With Recommendation With Substitute  H-1",25,2,0,0,27
761907,441142,2015-04-29,House,"House Third Reading: Given Immediate Effect Roll Call # 88",88,22,0,0,110
761907,445937,2015-05-12,Senate,"Reported Favorably Without Amendment",11,0,0,0,11
761907,451872,2015-05-26,Senate,"Senate Third Reading: Given Immediate Effect Roll Call # 227",23,15,0,0,38
761940,431907,2015-04-14,House,"Reported With Recommendation With Substitute  H-1",27,0,0,0,27
761940,441116,2015-04-29,House,"House Third Reading: Given Immediate Effect Roll Call # 89",88,22,0,0,110
761940,445966,2015-05-12,Senate,"Reported Favorably Without Amendment",11,0,0,0,11
761940,451916,2015-05-26,Senate,"Senate Third Reading: Given Immediate Effect Roll Call # 230",22,16,0,0,38
761956,417173,2015-03-25,House,"Reported With Recommendation Without Amendment",6,2,0,0,8
761956,434339,2015-04-16,House,"House Third Reading: Given Immediate Effect Roll Call # 68",94,16,0,0,110
761956,458391,2015-06-09,Senate,"Reported Favorably Without Amendment",3,0,0,0,3
761956,461243,2015-06-18,Senate,"Senate Third Reading: Given Immediate Effect Roll Call # 328",30,7,0,1,38
761963,416934,2015-03-25,House,"Reported With Recommendation With Substitute  H-1",20,6,0,0,26
761963,441771,2015-04-29,House,"House Third Reading: Given Immediate Effect Roll Call # 86",92,18,0,0,110
761963,445951,2015-05-12,Senate,"Reported Favorably Without Amendment",11,0,0,0,11
761963,451967,2015-05-26,Senate,"Senate Third Reading: Given Immediate Effect Roll Call # 228",23,15,0,0,38
761981,480359,2015-10-21,House,"House Third Reading: Given Immediate Effect Roll Call # 376",62,44,0,0,106
761981,480834,2015-11-03,Senate,"Senate Third Reading: Passed Roll Call # 478",28,10,0,0,38
761981,480835,2015-11-03,House,"House Third Reading: Roll Call # 408",62,45,0,0,107
762079,417492,2015-03-25,House,"Reported With Recommendation With Substitute  H-1",20,6,0,0,26
762079,441144,2015-04-29,House,"House Third Reading: Given Immediate Effect Roll Call # 87",92,18,0,0,110
762079,445786,2015-05-12,Senate,"Reported Favorably Without Amendment",11,0,0,0,11
762079,452241,2015-05-26,Senate,"Senate Third Reading: Given Immediate Effect Roll Call # 229",23,15,0,0,38
762499,431796,2015-04-14,House,"Reported With Recommendation With Substitute  H-1",28,0,0,0,28
762499,441150,2015-04-29,House,"House Third Reading: Given Immediate Effect Roll Call # 91",98,12,0,0,110
762499,445762,2015-05-12,Senate,"Reported Favorably Without Amendment",11,0,0,0,11
762499,451939,2015-05-26,Senate,"Senate Third Reading: Given Immediate Effect Roll Call # 232",23,15,0,0,38
762574,437748,2015-04-22,House,"Reported With Recommendation With Substitute H-2",27,2,0,0,29
762574,445148,2015-04-22,House,"Reported With Recommendation With Substitute  H-2",27,2,0,0,29
762574,449713,2015-05-21,House,"House Third Reading: Given Immediate Effect Roll Call # 193",61,48,0,0,109
762574,456942,2015-06-03,Senate,"Reported Favorably Without Amendment",5,0,0,0,5
762574,461584,2015-06-18,Senate,"Senate Third Reading: Given Immediate Effect Roll Call # 331",24,13,0,1,38
762574,461585,2015-06-18,House,"House Third Reading: Roll Call # 278",74,34,0,0,108
762648,431987,2015-04-14,House,"Reported With Recommendation With Substitute  H-1",28,0,0,0,28
762648,441857,2015-04-29,House,"House Third Reading: Given Immediate Effect Roll Call # 93",98,12,0,0,110
762648,445976,2015-05-12,Senate,"Reported Favorably Without Amendment",11,0,0,0,11
762648,451885,2015-05-26,Senate,"Senate Third Reading: Given Immediate Effect Roll Call # 233",23,15,0,0,38
762694,440296,2015-04-28,House,"Reported With Recommendation With Substitute  H-1",16,0,0,0,16
762694,444482,2015-05-07,House,"House Third Reading: Given Immediate Effect Roll Call # 129",110,0,0,0,110
762694,466299,2015-07-15,Senate,"Reported Favorably Without Amendment",4,0,0,0,4
762694,477302,2015-09-29,Senate,"Senate Third Reading: Given Immediate Effect Roll Call # 377",35,0,0,3,38
762743,438867,2015-04-23,House,"Reported With Recommendation With Substitute  H-1",16,0,0,0,16
762743,443422,2015-05-05,House,"House Third Reading: Given Immediate Effect Roll Call # 114",110,0,0,0,110
762743,477712,2015-10-14,Senate,"Reported Favorably Without Amendment",5,0,0,0,5
762743,480906,2015-11-05,Senate,"Senate Third Reading: Given Immediate Effect Roll Call # 491",38,0,0,0,38
762764,480427,2015-10-22,House,"Reported With Recommendation For Referral To Committee On Appropriations",15,0,0,0,15
762764,500987,2016-02-17,House,"Reported With Recommendation With Substitute  H-3",29,0,0,0,29
762764,552315,2016-06-08,House,"House Third Reading: Given Immediate Effect Roll Call # 403",107,1,0,0,108
762764,562285,2016-09-08,Senate,"Reported Favorably Without Amendment",17,0,0,0,17
762764,564037,2016-10-20,Senate,"Senate Third Reading: Passed Roll Call # 569",36,0,0,1,37
762789,431813,2015-04-14,House,"Reported With Recommendation With Substitute  H-1",26,1,0,0,27
762789,441113,2015-04-29,House,"House Third Reading: Given Immediate Effect Roll Call # 94",99,11,0,0,110
762789,445831,2015-05-12,Senate,"Reported Favorably Without Amendment",11,0,0,0,11
762789,451780,2015-05-26,Senate,"Senate Third Reading: Given Immediate Effect Roll Call # 234",23,15,0,0,38
762900,431829,2015-04-14,House,"Reported With Recommendation With Substitute  H-1",28,0,0,0,28
762900,441831,2015-04-29,House,"House Third Reading: Given Immediate Effect Roll Call # 90",94,16,0,0,110
762900,445759,2015-05-12,Senate,"Reported Favorably Without Amendment",11,0,0,0,11
762900,452058,2015-05-26,Senate,"Senate Third Reading: Given Immediate Effect Roll Call # 231",23,15,0,0,38
763081,433967,2015-04-16,Senate,"Reported Favorably With Substitute S-2",5,0,0,0,5
763081,433968,2015-04-16,Senate,"Senate Third Reading: Passed Roll Call # 101",21,17,0,0,38
763081,438547,2015-04-23,House,"Reported With Recommendation With Substitute  H-3",9,6,0,0,15
763100,449291,2015-05-20,Senate,"Reported Favorably Without Amendment",5,0,0,0,5
763100,449292,2015-05-20,Senate,"Reported Favorably With Recommendation For Referral To Committee On Agriculture",5,0,0,0,5
763100,477096,2015-09-24,Senate,"Reported Favorably With Substitute  S-1",5,0,0,0,5
763100,477635,2015-10-08,Senate,"Senate Third Reading: Passed Roll Call # 415",25,11,0,2,38
763119,446787,2015-05-14,Senate,"Reported Favorably Without Amendment",9,0,0,0,9
763119,449032,2015-05-20,Senate,"Senate Third Reading: Passed Roll Call # 216",37,0,0,1,38
763119,476180,2015-09-09,House,"Reported With Recommendation Without Amendment",13,0,0,0,13
763119,477685,2015-10-13,House,"House Third Reading: Given Immediate Effect Roll Call # 350",102,3,0,0,105
763180,444493,2015-05-07,Senate,"Reported Favorably With Substitute  S-2",4,0,0,0,4
763180,446230,2015-05-13,Senate,"Senate Third Reading: Passed Roll Call # 166",37,0,0,1,38
763180,476948,2015-09-22,House,"Reported With Recommendation With Substitute  H-2",8,1,0,0,9
763180,480709,2015-10-28,House,"House Third Reading: Given Immediate Effect Roll Call # 394",78,27,0,0,105
763180,480752,2015-10-29,Senate,"Senate Third Reading: Roll Call # 468",35,1,0,2,38
763227,433961,2015-04-16,Senate,"Reported Favorably Without Amendment",5,0,0,0,5
763227,433962,2015-04-16,Senate,"Senate Third Reading: Passed Roll Call # 102",21,17,0,0,38
763227,438859,2015-04-23,House,"Reported With Recommendation Without Amendment",9,6,0,0,15
763236,444721,2015-05-07,Senate,"Reported Favorably With Substitute  S-1",4,0,0,0,4
763236,446257,2015-05-13,Senate,"Senate Third Reading: Passed Roll Call # 167",37,0,0,1,38
763236,476945,2015-09-22,House,"Reported With Recommendation Without Amendment",8,1,0,0,9
763236,480700,2015-10-28,House,"House Third Reading: Given Immediate Effect Roll Call # 395",77,28,0,0,105
763246,444702,2015-05-07,Senate,"Reported Favorably Without Amendment",4,0,0,0,4
763246,446408,2015-05-13,Senate,"Senate Third Reading: Passed Roll Call # 165",37,0,0,1,38
763246,476943,2015-09-22,House,"Reported With Recommendation Without Amendment",8,0,0,0,8
763246,480692,2015-10-28,House,"House Third Reading: Given Immediate Effect Roll Call # 393",76,29,0,0,105
763306,476221,2015-09-09,House,"Reported With Recommendation Without Amendment",13,0,0,0,13
763354,480887,2015-11-04,House,"Reported With Recommendation With Substitute  H-3",17,0,0,0,17
763354,481791,2015-12-03,House,"House Third Reading: Given Immediate Effect Roll Call # 445",95,9,0,0,104
763354,499368,2016-02-16,Senate,"Reported Favorably Without Amendment",5,0,0,0,5
763354,508621,2016-02-24,Senate,"Senate Third Reading: Given Immediate Effect Roll Call # 77",36,2,0,0,38
763404,432638,2015-04-15,House,"Reported With Recommendation With Substitute  H-1",28,0,0,0,28
763404,441127,2015-04-29,House,"House Third Reading: Given Immediate Effect Roll Call # 104",110,0,0,0,110
763404,445942,2015-05-12,Senate,"Reported Favorably Without Amendment",11,0,0,0,11
763404,451743,2015-05-26,Senate,"Senate Third Reading: Given Immediate Effect Roll Call # 236",38,0,0,0,38
763421,451981,2015-05-26,House,"Reported With Recommendation Without Amendment",6,0,0,0,6
763421,551187,2016-06-02,House,"House Third Reading: Roll Call # 361",107,1,0,0,108
763433,431760,2015-04-14,House,"Reported With Recommendation Without Amendment",17,2,0,0,19
763433,441189,2015-04-29,House,"House Third Reading: Given Immediate Effect Roll Call # 103",107,3,0,0,110
763433,445749,2015-05-12,Senate,"Reported Favorably Without Amendment",11,0,0,0,11
763433,451786,2015-05-26,Senate,"Senate Third Reading: Given Immediate Effect Roll Call # 235",24,14,0,0,38
763467,481114,2015-11-10,House,"Reported With Recommendation For Referral To Committee On Criminal Justice",11,0,0,0,11
768804,442321,2015-04-30,Senate,"Reported Favorably With Substitute  S-1",5,0,0,0,5
768804,446789,2015-05-14,Senate,"Senate Third Reading: Passed Roll Call # 175",37,0,0,1,38
768804,548031,2016-05-24,House,"Reported With Recommendation With Substitute  H-2",10,1,0,0,11
768804,552326,2016-06-09,House,"House Third Reading: Given Immediate Effect Roll Call # 425",105,4,0,0,109
768804,552327,2016-06-09,Senate,"Senate Third Reading: Roll Call # 475",37,0,0,0,37
768813,442405,2015-04-30,House,"Reported With Recommendation Without Amendment",9,0,0,0,9
768813,487626,2015-12-16,Senate,"Reported Favorably With Substitute S-1",4,0,0,0,4
768830,464398,2015-06-30,Senate,"Reported Favorably Without Amendment",4,1,0,0,5
768919,434279,2015-04-16,House,"Reported With Recommendation With Substitute  H-2",20,4,0,0,24
768919,441244,2015-04-29,House,"House Third Reading: Given Immediate Effect Roll Call # 102",108,2,0,0,110
768936,490445,2016-02-02,House,"Reported With Recommendation With Substitute  H-3",11,3,0,0,14
768936,550859,2016-06-01,House,"House Third Reading: Given Immediate Effect Roll Call # 342",60,49,0,0,109
768936,565257,2016-11-29,Senate,"Reported Favorably With Substitute  S-1",3,0,0,0,3
768936,565788,2016-12-07,Senate,"Senate Third Reading: Given Immediate Effect Roll Call # 693",27,10,0,1,38
768936,566196,2016-12-13,House,"House Third Reading: Roll Call # 627",61,47,0,0,108
768945,460476,2015-06-16,House,"Reported With Recommendation With Substitute  H-1",20,0,0,0,20
768945,476796,2015-09-16,House,"House Third Reading: Given Immediate Effect Roll Call # 297",103,0,0,0,103
768945,481613,2015-12-01,Senate,"Reported Favorably Without Amendment",10,0,0,0,10
768945,482269,2015-12-10,Senate,"Senate Third Reading: Given Immediate Effect Roll Call # 575",38,0,0,0,38
768954,446255,2015-05-13,House,"Reported With Recommendation Without Amendment",13,2,0,0,15
768954,452205,2015-05-26,House,"House Third Reading: Given Immediate Effect Roll Call # 199",103,7,0,0,110
768963,432966,2015-04-15,House,"Reported With Recommendation With Substitute  H-1",28,0,0,0,28
768963,441107,2015-04-29,House,"House Third Reading: Given Immediate Effect Roll Call # 97",106,4,0,0,110
768963,445777,2015-05-12,Senate,"Reported Favorably Without Amendment",11,0,0,0,11
768963,451888,2015-05-26,Senate,"Senate Third Reading: Given Immediate Effect Roll Call # 239",22,16,0,0,38
768972,433081,2015-04-15,House,"Reported With Recommendation With Substitute  H-2",28,0,0,0,28
768972,441103,2015-04-29,House,"House Third Reading: Given Immediate Effect Roll Call # 105",109,1,0,0,110
768972,445778,2015-05-12,Senate,"Reported Favorably Without Amendment",11,0,0,0,11
768972,456753,2015-06-03,Senate,"Senate Third Reading: Given Immediate Effect Roll Call # 263",38,0,0,0,38
768972,458381,2015-06-09,House,"House Third Reading: Senate Amendment(s) Concurred In Roll Call # 227",109,0,0,0,109
768982,433087,2015-04-15,House,"Reported With Recommendation With Substitute  H-1",28,1,0,0,29
768982,441632,2015-04-29,House,"House Third Reading: Given Immediate Effect Roll Call # 101",107,3,0,0,110
768982,445852,2015-05-12,Senate,"Reported Favorably With Substitute  S-1",11,0,0,0,11
768982,451997,2015-05-26,Senate,"Senate Third Reading: Given Immediate Effect Roll Call # 238",35,3,0,0,38
768982,537634,2016-04-21,House,"Reported With Recommendation With Substitute H-4",29,0,0,0,29
768982,537884,2016-04-21,House,"Reported With Recommendation With Substitute H-4 To Senate Substitute S-1",29,0,0,0,29
768982,552348,2016-06-09,House,"House Third Reading: Roll Call # 421",88,20,0,0,108
768982,552349,2016-06-09,Senate,"Senate Third Reading: Roll Call # 478",34,3,0,0,37
768989,441466,2015-04-29,House,"Reported With Recommendation With Substitute  H-1",15,0,0,0,15
768989,444502,2015-05-07,House,"House Third Reading: Given Immediate Effect Roll Call # 137",106,4,0,0,110
769007,433170,2015-04-15,House,"Reported With Recommendation With Substitute  H-1",29,0,0,0,29
769007,441130,2015-04-29,House,"House Third Reading: Given Immediate Effect Roll Call # 99",103,7,0,0,110
769007,445757,2015-05-12,Senate,"Reported Favorably Without Amendment",11,0,0,0,11
769007,452005,2015-05-26,Senate,"Senate Third Reading: Given Immediate Effect Roll Call # 241",24,14,0,0,38
769026,499356,2016-02-16,House,"Reported With Recommendation With Substitute  H-1",11,0,0,0,11
769026,510955,2016-03-01,House,"House Third Reading: Given Immediate Effect Roll Call # 77",105,0,0,0,105
769026,536834,2016-04-20,Senate,"Reported Favorably Without Amendment",5,0,0,0,5
769026,543318,2016-05-05,Senate,"Senate Third Reading: Given Immediate Effect Roll Call # 241",35,0,0,2,37
769034,434324,2015-04-16,House,"Reported With Recommendation With Substitute  H-1",18,6,0,0,24
769034,449715,2015-05-21,House,"House Third Reading: Given Immediate Effect Roll Call # 190",57,52,0,0,109
769034,456866,2015-06-03,Senate,"Reported Favorably Without Amendment",5,0,0,0,5
769034,456867,2015-06-03,Senate,"Senate Third Reading: Given Immediate Effect Roll Call # 259",21,17,0,0,38
769053,490426,2016-02-02,House,"Reported With Recommendation With Substitute  H-4",12,2,0,0,14
769053,501465,2016-02-17,House,"House Third Reading: Given Immediate Effect Roll Call # 47",67,39,0,0,106
769053,550621,2016-06-01,House,"House Third Reading: Passed Roll Call # 343",75,34,0,0,109
769053,565235,2016-11-29,Senate,"Reported Favorably With Substitute  S-1",5,0,0,0,5
769053,565821,2016-12-07,Senate,"Senate Third Reading: Given Immediate Effect Roll Call # 694",35,2,0,1,38
769053,566260,2016-12-13,House,"House Third Reading: Roll Call # 628",78,30,0,0,108
769070,490425,2016-02-02,House,"Reported With Recommendation With Substitute  H-2",12,1,0,0,13
769070,500853,2016-02-17,House,"House Third Reading: Given Immediate Effect Roll Call # 46",67,39,0,0,106
769070,550814,2016-06-01,House,"House Third Reading: Passed Roll Call # 344",83,26,0,0,109
769070,565234,2016-11-29,Senate,"Reported Favorably With Substitute  S-1",5,0,0,0,5
769070,565771,2016-12-07,Senate,"Senate Third Reading: Given Immediate Effect Roll Call # 695",34,3,0,1,38
769070,566195,2016-12-13,House,"House Third Reading: Roll Call # 629",91,17,0,0,108
769079,490458,2016-02-02,House,"Reported With Recommendation Without Amendment",14,1,0,0,15
769079,500371,2016-02-16,House,"House Third Reading: Given Immediate Effect Roll Call # 38",76,29,0,0,105
769079,523260,2016-03-22,Senate,"Reported Favorably Without Amendment",5,0,0,0,5
769079,524211,2016-03-23,Senate,"Senate Third Reading: Given Immediate Effect Roll Call # 138",27,9,0,2,38
769089,436190,2015-04-21,House,"Reported With Recommendation For Referral To Committee On Criminal Justice",11,0,0,0,11
769089,460231,2015-06-16,House,"Reported With Recommendation With Substitute  H-3",7,1,0,0,8
769098,490455,2016-02-02,House,"Reported With Recommendation With Substitute  H-3",11,2,0,0,13
769098,550654,2016-06-01,House,"House Third Reading: Given Immediate Effect Roll Call # 341",59,50,0,0,109
769098,565290,2016-11-29,Senate,"Reported Favorably With Substitute  S-1",3,0,0,0,3
769098,565830,2016-12-07,Senate,"Senate Third Reading: Given Immediate Effect Roll Call # 692",27,10,0,1,38
769098,566288,2016-12-13,House,"House Third Reading: Roll Call # 626",57,51,0,0,108
769107,432762,2015-04-15,House,"Reported With Recommendation Without Amendment",28,0,0,0,28
769107,441522,2015-04-29,House,"House Third Reading: Given Immediate Effect Roll Call # 96",109,1,0,0,110
769107,445767,2015-05-12,Senate,"Reported Favorably Without Amendment",11,0,0,0,11
769107,456958,2015-06-03,Senate,"Senate Third Reading: Given Immediate Effect Roll Call # 253",22,16,0,0,38
769107,458477,2015-06-09,House,"House Third Reading: Senate Amendment(s) Concurred In Roll Call # 228",108,1,0,0,109
769115,461276,2015-06-18,House,"Reported With Recommendation With Substitute  H-2",4,0,0,0,4
769134,490544,2016-02-02,House,"Reported With Recommendation With Substitute  H-4",11,1,0,0,12
769134,550537,2016-06-01,House,"House Third Reading: Given Immediate Effect Roll Call # 340",56,53,0,0,109
769134,565319,2016-11-29,Senate,"Reported Favorably With Substitute  S-2",3,0,0,0,3
769134,565824,2016-12-07,Senate,"Senate Third Reading: Given Immediate Effect Roll Call # 691",28,8,1,1,38
769134,566275,2016-12-13,House,"House Third Reading: Roll Call # 625",57,51,0,0,108
769143,433171,2015-04-15,House,"Reported With Recommendation With Substitute  H-1",29,0,0,0,29
769143,441157,2015-04-29,House,"House Third Reading: Given Immediate Effect Roll Call # 98",104,6,0,0,110
769143,445780,2015-05-12,Senate,"Reported Favorably Without Amendment",11,0,0,0,11
769143,451801,2015-05-26,Senate,"Senate Third Reading: Given Immediate Effect Roll Call # 240",24,14,0,0,38
769151,437235,2015-04-22,House,"Reported With Recommendation With Substitute  H-2",29,0,0,0,29
769151,453609,2015-05-27,House,"House Third Reading: Given Immediate Effect Roll Call # 206",94,15,0,0,109
769151,457387,2015-06-04,Senate,"Reported Favorably With Substitute  S-1",16,0,0,0,16
769151,458901,2015-06-10,Senate,"Senate Third Reading: Given Immediate Effect Roll Call # 272",32,6,0,0,38
769151,459356,2015-06-11,House,"House Third Reading: Roll Call # 246",96,12,0,0,108
769160,436149,2015-04-21,House,"Reported With Recommendation For Referral To Committee On Criminal Justice",10,0,0,0,10
769160,460482,2015-06-16,House,"Reported With Recommendation With Substitute H-3",7,1,0,0,8
769160,461916,2015-06-16,House,"Reported With Recommendation With Substitute  H-3",7,1,0,0,8
769185,433006,2015-04-15,House,"Reported With Recommendation With Substitute  H-1",27,0,0,0,27
769185,441661,2015-04-29,House,"House Third Reading: Given Immediate Effect Roll Call # 95",102,8,0,0,110
769185,445760,2015-05-12,Senate,"Reported Favorably Without Amendment",11,0,0,0,11
769185,452352,2015-05-26,Senate,"Senate Third Reading: Given Immediate Effect Roll Call # 237",24,14,0,0,38
769535,442347,2015-04-30,Senate,"Reported Favorably Without Amendment",5,0,0,0,5
769535,446762,2015-05-14,Senate,"Senate Third Reading: Passed Roll Call # 176",37,0,0,1,38
769535,565581,2016-11-29,House,"Reported With Recommendation Without Amendment",7,4,0,0,11
769535,566533,2016-12-14,House,"House Third Reading: Passed Roll Call # 686",64,42,0,0,106
769623,441153,2015-04-29,House,"Reported With Recommendation Without Amendment",8,0,0,0,8
769623,444470,2015-05-07,House,"House Third Reading: Given Immediate Effect Roll Call # 134",110,0,0,0,110
769623,460400,2015-06-16,Senate,"Reported Favorably Without Amendment",5,0,0,0,5
769623,461517,2015-06-18,Senate,"Senate Third Reading: Given Immediate Effect Roll Call # 308",37,0,0,1,38
769631,477427,2015-09-30,House,"Reported With Recommendation With Substitute  H-1",13,0,0,0,13
769631,477577,2015-10-07,House,"House Third Reading: Passed Roll Call # 340",106,0,0,0,106
769643,458461,2015-06-09,House,"Reported With Recommendation With Substitute  H-2",15,0,0,0,15
769643,460694,2015-06-17,House,"House Third Reading: Passed Roll Call # 260",110,0,0,0,110
769643,482549,2015-12-15,Senate,"Reported Favorably With Substitute  S-2",5,0,0,0,5
769643,484976,2016-01-14,Senate,"Senate Third Reading: Given Immediate Effect Roll Call # 3",37,0,0,1,38
769643,485950,2016-01-20,House,"House Third Reading: Roll Call # 6",106,0,0,0,106
769651,445837,2015-05-12,House,"Reported With Recommendation Without Amendment",16,0,0,0,16
769651,449687,2015-05-21,House,"House Third Reading: Given Immediate Effect Roll Call # 187",95,14,0,0,109
769651,490397,2016-02-02,Senate,"Reported Favorably Without Amendment",5,0,0,0,5
769651,493826,2016-02-09,Senate,"Senate Third Reading: Given Immediate Effect Roll Call # 34",37,0,0,1,38
769678,434253,2015-04-16,House,"Reported With Recommendation With Substitute  H-1",28,1,0,0,29
769678,449710,2015-05-21,House,"House Third Reading: Given Immediate Effect Roll Call # 191",106,3,0,0,109
769678,456719,2015-06-03,Senate,"Reported Favorably Without Amendment",5,0,0,0,5
769678,456720,2015-06-03,Senate,"Senate Third Reading: Given Immediate Effect Roll Call # 254",20,18,0,0,38
769684,458538,2015-06-09,House,"Reported With Recommendation With Substitute  H-2",15,0,0,0,15
769684,460847,2015-06-17,House,"House Third Reading: Passed Roll Call # 259",110,0,0,0,110
769684,482551,2015-12-15,Senate,"Reported Favorably With Substitute  S-2",5,0,0,0,5
769684,485002,2016-01-14,Senate,"Senate Third Reading: Given Immediate Effect Roll Call # 2",37,0,0,1,38
769684,485962,2016-01-20,House,"House Third Reading: Roll Call # 5",106,0,0,0,106
769706,477423,2015-09-30,House,"Reported With Recommendation Without Amendment",13,0,0,0,13
769706,477576,2015-10-07,House,"House Third Reading: Passed Roll Call # 341",106,0,0,0,106
769706,482499,2015-12-15,Senate,"Senate Third Reading: Given Immediate Effect Roll Call # 618",21,17,0,0,38
769718,434265,2015-04-16,House,"Reported With Recommendation Without Amendment",29,0,0,0,29
769718,441218,2015-04-29,House,"House Third Reading: Given Immediate Effect Roll Call # 100",107,3,0,0,110
769718,445750,2015-05-12,Senate,"Reported Favorably Without Amendment",11,0,0,0,11
769718,452167,2015-05-26,Senate,"Senate Third Reading: Given Immediate Effect Roll Call # 242",23,15,0,0,38
769725,445955,2015-05-12,House,"Reported With Recommendation Without Amendment",16,0,0,0,16
769725,456197,2015-06-02,House,"House Third Reading: Given Immediate Effect Roll Call # 208",90,18,0,0,108
769725,477551,2015-10-06,Senate,"Reported Favorably Without Amendment",4,0,0,0,4
769725,510979,2016-03-01,Senate,"Senate Third Reading: Given Immediate Effect Roll Call # 80",28,10,0,0,38
769741,437480,2015-04-22,House,"Reported With Recommendation With Substitute  H-1",27,1,0,0,28
769741,449761,2015-05-21,House,"House Third Reading: Given Immediate Effect Roll Call # 194",59,50,0,0,109
769741,456932,2015-06-03,Senate,"Reported Favorably Without Amendment",5,0,0,0,5
769741,456933,2015-06-03,Senate,"Senate Third Reading: Given Immediate Effect Roll Call # 252",22,16,0,0,38
769741,458488,2015-06-09,House,"House Third Reading: Roll Call # 229",62,47,0,0,109
771956,442368,2015-04-30,Senate,"Reported Favorably Without Amendment",5,0,0,0,5
771956,446744,2015-05-14,Senate,"Senate Third Reading: Passed Roll Call # 177",37,0,0,1,38
771956,460402,2015-06-16,House,"Reported With Recommendation Without Amendment",9,0,0,0,9
771956,476797,2015-09-16,House,"House Third Reading: Given Immediate Effect Roll Call # 301",67,36,0,0,103
771966,461501,2015-06-17,Senate,"Reported Favorably With Substitute  S-1",4,1,0,0,5
771966,481168,2015-11-10,Senate,"Senate Third Reading: Passed Roll Call # 507",20,17,0,1,38
771966,565973,2016-12-08,House,"Reported With Recommendation With Substitute  H-2",11,6,0,0,17
771979,441754,2015-04-29,House,"Reported With Recommendation With Substitute  H-1",13,0,0,0,13
771979,445753,2015-05-12,House,"House Third Reading: Given Immediate Effect Roll Call # 139",108,2,0,0,110
771979,477636,2015-10-08,Senate,"Reported Favorably Without Amendment",6,0,0,0,6
771979,480392,2015-10-22,Senate,"Senate Third Reading: Given Immediate Effect Roll Call # 457",37,0,0,1,38
772005,440540,2015-04-28,House,"Reported With Recommendation Without Amendment",8,0,0,0,8
772005,444488,2015-05-07,House,"House Third Reading: Passed Roll Call # 126",108,2,0,0,110
772005,444489,2015-05-07,House,"House Third Reading: Given Immediate Effect Roll Call # 127",105,5,0,0,110
772005,459482,2015-06-11,Senate,"Reported Favorably Without Amendment",4,0,0,0,4
772005,477060,2015-09-24,Senate,"Senate Third Reading: Given Immediate Effect Roll Call # 373",37,0,0,1,38
772005,477325,2015-09-29,House,"House Third Reading: Senate Amendment(s) Concurred In Roll Call # 325",85,21,0,0,106
772029,456726,2015-06-03,Senate,"Reported Favorably Without Amendment",5,0,0,0,5
772039,441132,2015-04-29,House,"Reported With Recommendation With Substitute  H-1",13,0,0,0,13
772039,445812,2015-05-12,House,"House Third Reading: Given Immediate Effect Roll Call # 140",109,1,0,0,110
772039,477638,2015-10-08,Senate,"Reported Favorably Without Amendment",6,0,0,0,6
772039,480396,2015-10-22,Senate,"Senate Third Reading: Given Immediate Effect Roll Call # 458",37,0,0,1,38
772054,440590,2015-04-28,House,"Reported With Recommendation Without Amendment",6,4,0,0,10
772054,444535,2015-05-07,House,"House Third Reading: Given Immediate Effect Roll Call # 125",57,53,0,0,110
772054,449942,2015-05-21,Senate,"Reported Favorably Without Amendment",3,2,0,0,5
772054,453640,2015-05-27,Senate,"Senate Third Reading: Given Immediate Effect Roll Call # 250",23,14,0,1,38
772118,461545,2015-06-17,Senate,"Reported Favorably With Substitute  S-1",4,1,0,0,5
772118,481110,2015-11-10,Senate,"Senate Third Reading: Passed Roll Call # 504",25,12,0,1,38
772118,485926,2016-01-20,House,"Reported With Recommendation For Referral To Committee On Commerce And Trade",24,4,0,0,28
772118,565964,2016-12-08,House,"Reported With Recommendation Without Amendment",12,6,0,0,18
772153,438708,2015-04-23,Senate,"Reported Favorably With Substitute  S-1",9,0,0,0,9
772153,442377,2015-04-30,Senate,"Senate Third Reading: Passed Roll Call # 121",38,0,0,0,38
772153,446452,2015-05-13,House,"Reported With Recommendation Without Amendment",15,0,0,0,15
772153,449688,2015-05-21,House,"House Third Reading: Given Immediate Effect Roll Call # 186",103,6,0,0,109
772165,440525,2015-04-28,House,"Reported With Recommendation Without Amendment",16,0,0,0,16
772165,444729,2015-05-07,House,"House Third Reading: Given Immediate Effect Roll Call # 131",110,0,0,0,110
772165,452271,2015-05-26,Senate,"Reported Favorably Without Amendment",3,0,0,0,3
772165,459011,2015-06-10,Senate,"Senate Third Reading: Given Immediate Effect Roll Call # 268",38,0,0,0,38
772203,458393,2015-06-09,Senate,"Reported Favorably Without Amendment",4,0,0,0,4
772203,476172,2015-09-09,Senate,"Senate Third Reading: Passed Roll Call # 352",38,0,0,0,38
772203,480297,2015-10-20,House,"Reported With Recommendation Without Amendment",16,0,0,0,16
772203,481155,2015-11-10,House,"House Third Reading: Given Immediate Effect Roll Call # 426",106,0,0,0,106
772203,481156,2015-11-10,Senate,"Senate Third Reading: Roll Call # 530",36,0,0,2,38
772240,437610,2015-04-22,House,"Reported With Recommendation With Substitute  H-2",25,3,0,0,28
772240,449765,2015-05-21,House,"House Third Reading: Given Immediate Effect Roll Call # 192",79,30,0,0,109
772240,456732,2015-06-03,Senate,"Reported Favorably Without Amendment",5,0,0,0,5
772240,456733,2015-06-03,Senate,"Senate Third Reading: Given Immediate Effect Roll Call # 258",21,17,0,0,38
773029,458382,2015-06-09,House,"Reported With Recommendation Without Amendment",8,0,0,0,8
773029,477743,2015-10-15,House,"House Third Reading: Given Immediate Effect Roll Call # 358",96,9,0,0,105
773029,491985,2016-02-04,Senate,"Reported Favorably With Substitute  S-1",5,0,0,0,5
773029,533335,2016-04-14,Senate,"Senate Third Reading: Given Immediate Effect Roll Call # 169",37,0,0,0,37
773029,535278,2016-04-19,House,"House Third Reading: Roll Call # 159",100,8,0,0,108
773034,440385,2015-04-28,House,"Reported With Recommendation Without Amendment",10,0,0,0,10
773034,444460,2015-05-07,House,"House Third Reading: Given Immediate Effect Roll Call # 133",110,0,0,0,110
773034,451753,2015-05-26,Senate,"Senate Third Reading: Given Immediate Effect Roll Call # 218",38,0,0,0,38
773048,481126,2015-11-10,House,"Reported With Recommendation With Substitute  H-1",17,0,0,0,17
773048,505289,2016-02-23,House,"House Third Reading: Given Immediate Effect Roll Call # 55",105,1,0,0,106
773048,539075,2016-04-27,Senate,"Reported Favorably Without Amendment",4,0,0,0,4
773048,546737,2016-05-18,Senate,"Senate Third Reading: Given Immediate Effect Roll Call # 307",34,3,0,0,37
773048,548515,2016-05-25,House,"House Third Reading: Roll Call # 318",109,0,0,0,109
773057,458383,2015-06-09,House,"Reported With Recommendation With Substitute  H-1",8,0,0,0,8
773057,477746,2015-10-15,House,"House Third Reading: Given Immediate Effect Roll Call # 357",104,1,0,0,105
773057,492080,2016-02-04,Senate,"Reported Favorably With Substitute  S-2",3,1,0,0,4
773057,533339,2016-04-14,Senate,"Senate Third Reading: Given Immediate Effect Roll Call # 167",37,0,0,0,37
773057,535944,2016-04-19,House,"House Third Reading: Roll Call # 158",107,1,0,0,108
773075,456788,2015-06-03,House,"Reported With Recommendation With Substitute  H-1",8,0,0,0,8
773075,459491,2015-06-11,House,"House Third Reading: Given Immediate Effect Roll Call # 248",108,1,0,0,109
773075,477645,2015-10-08,Senate,"Reported Favorably Without Amendment",6,0,0,0,6
773081,446490,2015-05-13,House,"Reported With Recommendation Without Amendment",9,0,0,0,9
773081,449706,2015-05-21,House,"House Third Reading: Given Immediate Effect Roll Call # 189",108,1,0,0,109
773081,459436,2015-06-11,Senate,"Reported Favorably Without Amendment",17,0,0,0,17
773081,461305,2015-06-17,Senate,"Senate Third Reading: Given Immediate Effect Roll Call # 301",38,0,0,0,38
773099,458431,2015-06-09,House,"Reported With Recommendation Without Amendment",5,0,0,0,5
773099,477745,2015-10-15,House,"House Third Reading: Given Immediate Effect Roll Call # 361",101,4,0,0,105
773099,492003,2016-02-04,Senate,"Reported Favorably With Substitute  S-1",5,0,0,0,5
773099,533520,2016-04-14,Senate,"Senate Third Reading: Given Immediate Effect Roll Call # 172",37,0,0,0,37
773099,535150,2016-04-19,House,"House Third Reading: Roll Call # 161",105,3,0,0,108
773118,458527,2015-06-09,House,"Reported With Recommendation Without Amendment",8,0,0,0,8
773118,480395,2015-10-22,House,"House Third Reading: Given Immediate Effect Roll Call # 383",76,28,0,0,104
773118,492036,2016-02-04,Senate,"Reported Favorably Without Amendment",3,1,0,0,4
773118,533321,2016-04-14,Senate,"Senate Third Reading: Given Immediate Effect Roll Call # 171",37,0,0,0,37
773118,535041,2016-04-19,House,"House Third Reading: Roll Call # 160",79,27,0,0,106
773124,458437,2015-06-09,House,"Reported With Recommendation With Substitute  H-2",5,0,0,0,5
773124,477736,2015-10-15,House,"House Third Reading: Given Immediate Effect Roll Call # 359",103,2,0,0,105
773124,491965,2016-02-04,Senate,"Reported Favorably Without Amendment",5,0,0,0,5
773124,533271,2016-04-14,Senate,"Senate Third Reading: Given Immediate Effect Roll Call # 170",37,0,0,0,37
773147,446485,2015-05-13,House,"Reported With Recommendation Without Amendment",9,0,0,0,9
773147,449682,2015-05-21,House,"House Third Reading: Given Immediate Effect Roll Call # 188",108,1,0,0,109
773147,459496,2015-06-11,Senate,"Reported Favorably Without Amendment",17,0,0,0,17
773147,461593,2015-06-17,Senate,"Senate Third Reading: Given Immediate Effect Roll Call # 300",38,0,0,0,38
773153,458369,2015-06-09,House,"Reported With Recommendation With Substitute H-1",8,0,0,0,8
773153,465521,2015-06-09,House,"Reported With Recommendation With Substitute  H-1",8,0,0,0,8
773153,477735,2015-10-15,House,"House Third Reading: Given Immediate Effect Roll Call # 360",104,1,0,0,105
773153,491999,2016-02-04,Senate,"Reported Favorably Without Amendment",5,0,0,0,5
773153,533338,2016-04-14,Senate,"Senate Third Reading: Given Immediate Effect Roll Call # 168",37,0,0,0,37
773376,464732,2015-07-01,Senate,"Reported Favorably With Substitute  S-2",5,0,0,0,5
773376,552306,2016-06-09,Senate,"Senate Third Reading: Passed Roll Call # 449",37,0,0,0,37
773376,566089,2016-12-08,House,"Reported With Recommendation With Substitute  H-1",8,0,0,0,8
773376,566498,2016-12-15,House,"House Third Reading: Passed Roll Call # 748",107,0,0,0,107
773376,566499,2016-12-15,Senate,"Senate Third Reading: Roll Call # 854",37,0,0,1,38
773437,458475,2015-06-09,Senate,"Reported Favorably With Substitute  S-3",5,3,0,0,8
773449,451788,2015-05-26,House,"Reported With Recommendation Without Amendment",11,0,0,0,11
773449,457435,2015-06-04,House,"House Third Reading: Given Immediate Effect Roll Call # 222",107,2,0,0,109
773449,474054,2015-08-20,Senate,"Reported Favorably Without Amendment",5,0,0,0,5
773449,477607,2015-10-07,Senate,"Senate Third Reading: Given Immediate Effect Roll Call # 401",38,0,0,0,38
773456,451742,2015-05-26,House,"Reported With Recommendation With Substitute  H-1",9,1,0,0,10
773456,457350,2015-06-04,House,"House Third Reading: Given Immediate Effect Roll Call # 220",103,6,0,0,109
773456,474049,2015-08-20,Senate,"Reported Favorably With Substitute  S-1",5,0,0,0,5
773456,477608,2015-10-07,Senate,"Senate Third Reading: Given Immediate Effect Roll Call # 403",38,0,0,0,38
773456,477626,2015-10-08,House,"House Third Reading: Roll Call # 347",100,6,0,0,106
773464,451804,2015-05-26,House,"Reported With Recommendation With Substitute  H-1",10,0,0,0,10
773464,457372,2015-06-04,House,"House Third Reading: Given Immediate Effect Roll Call # 223",107,2,0,0,109
773464,474055,2015-08-20,Senate,"Reported Favorably With Substitute  S-1",5,0,0,0,5
773464,477584,2015-10-07,Senate,"Senate Third Reading: Given Immediate Effect Roll Call # 402",38,0,0,0,38
773464,477657,2015-10-08,House,"House Third Reading: Roll Call # 346",106,0,0,0,106
773481,451927,2015-05-26,House,"Reported With Recommendation Without Amendment",11,0,0,0,11
773481,457400,2015-06-04,House,"House Third Reading: Given Immediate Effect Roll Call # 225",108,1,0,0,109
773481,474052,2015-08-20,Senate,"Reported Favorably Without Amendment",5,0,0,0,5
773481,477595,2015-10-07,Senate,"Senate Third Reading: Given Immediate Effect Roll Call # 405",38,0,0,0,38
773490,451711,2015-05-26,House,"Reported With Recommendation With Substitute  H-1",7,2,0,0,9
773490,457338,2015-06-04,House,"House Third Reading: Given Immediate Effect Roll Call # 219",104,5,0,0,109
773490,474053,2015-08-20,Senate,"Reported Favorably Without Amendment",5,0,0,0,5
773490,477606,2015-10-07,Senate,"Senate Third Reading: Given Immediate Effect Roll Call # 399",38,0,0,0,38
773499,451989,2015-05-26,House,"Reported With Recommendation Without Amendment",11,0,0,0,11
773499,457429,2015-06-04,House,"House Third Reading: Given Immediate Effect Roll Call # 224",107,2,0,0,109
773499,474050,2015-08-20,Senate,"Reported Favorably Without Amendment",5,0,0,0,5
773499,477586,2015-10-07,Senate,"Senate Third Reading: Given Immediate Effect Roll Call # 404",38,0,0,0,38
773507,460298,2015-06-16,House,"Reported With Recommendation Without Amendment",8,0,0,0,8
773507,473917,2015-08-19,House,"House Third Reading: Given Immediate Effect Roll Call # 291",104,1,0,0,105
773507,477351,2015-09-29,Senate,"Reported Favorably Without Amendment",4,0,0,0,4
773507,486599,2015-12-02,Senate,"Senate Third Reading: Given Immediate Effect Roll Call # 538",37,0,0,1,38
773514,451972,2015-05-26,House,"Reported With Recommendation With Substitute  H-2",10,1,0,0,11
773514,457432,2015-06-04,House,"House Third Reading: Given Immediate Effect Roll Call # 226",81,28,0,0,109
773521,451990,2015-05-26,House,"Reported With Recommendation Without Amendment",11,0,0,0,11
773521,457385,2015-06-04,House,"House Third Reading: Given Immediate Effect Roll Call # 221",107,2,0,0,109
773521,474051,2015-08-20,Senate,"Reported Favorably Without Amendment",5,0,0,0,5
773521,477588,2015-10-07,Senate,"Senate Third Reading: Given Immediate Effect Roll Call # 400",38,0,0,0,38
773743,482214,2015-12-10,Senate,"Reported Favorably Without Amendment",16,0,0,0,16
773743,494883,2016-02-10,Senate,"Senate Third Reading: Passed Roll Call # 39",37,0,0,1,38
773743,536444,2016-04-20,House,"Reported With Recommendation Without Amendment",9,0,0,0,9
773743,550591,2016-06-01,House,"House Third Reading: Passed Roll Call # 348",109,0,0,0,109
773794,477313,2015-09-29,Senate,"Reported Favorably With Substitute  S-1",4,0,0,0,4
773794,552354,2016-06-09,Senate,"Senate Third Reading: Passed Roll Call # 452",37,0,0,0,37
773794,562880,2016-09-20,House,"Reported With Recommendation Without Amendment",8,0,0,0,8
773794,565940,2016-12-07,House,"House Third Reading: Passed Roll Call # 563",104,2,0,0,106
773794,565941,2016-12-08,Senate,"Senate Third Reading: House Amendment(s) Concurred In Roll Call # 702",37,0,0,1,38
773887,476846,2015-09-17,Senate,"Reported Favorably Without Amendment",4,0,0,0,4
773958,449817,2015-05-21,House,"Reported With Recommendation For Referral To Committee On Appropriations",15,0,0,0,15
773958,460807,2015-06-17,House,"Reported With Recommendation Without Amendment",27,0,0,0,27
773958,461334,2015-06-18,House,"House Third Reading: Given Immediate Effect Roll Call # 270",108,1,0,0,109
773958,476818,2015-09-17,Senate,"Reported Favorably Without Amendment",16,0,0,0,16
773958,477631,2015-10-08,Senate,"Senate Third Reading: Given Immediate Effect Roll Call # 414",36,0,0,2,38
773986,476851,2015-09-17,Senate,"Reported Favorably Without Amendment",4,0,0,0,4
774673,446987,2015-05-14,Senate,"Reported Favorably With Substitute  S-1",3,0,0,0,3
774673,495595,2016-02-10,Senate,"Senate Third Reading: Passed Roll Call # 38",27,10,0,1,38
774699,460456,2015-06-16,Senate,"Reported Favorably With Substitute  S-1",5,0,0,0,5
774699,461452,2015-06-18,Senate,"Senate Third Reading: Passed Roll Call # 309",37,0,0,1,38
774699,476380,2015-09-10,House,"Reported With Recommendation With Substitute  H-1",8,0,0,0,8
774699,477583,2015-10-07,House,"House Third Reading: Given Immediate Effect Roll Call # 337",106,0,0,0,106
774699,477637,2015-10-08,Senate,"Senate Third Reading: Roll Call # 411",35,0,0,3,38
774733,460418,2015-06-16,Senate,"Reported Favorably With Substitute  S-1",5,0,0,0,5
774733,461450,2015-06-18,Senate,"Senate Third Reading: Passed Roll Call # 310",37,0,0,1,38
774733,476456,2015-09-10,House,"Reported With Recommendation Without Amendment",8,0,0,0,8
774733,477612,2015-10-07,House,"House Third Reading: Given Immediate Effect Roll Call # 338",106,0,0,0,106
774914,446903,2015-05-14,House,"Reported With Recommendation With Substitute  H-2",5,1,0,0,6
774914,456309,2015-06-02,House,"House Third Reading: Passed Roll Call # 211",69,39,0,0,108
774955,542046,2016-05-03,House,"Reported With Recommendation With Substitute  H-3",12,4,0,0,16
774982,459396,2015-06-11,House,"Reported With Recommendation With Substitute  H-1",9,0,0,0,9
774982,460453,2015-06-16,House,"House Third Reading: Given Immediate Effect Roll Call # 252",110,0,0,0,110
774982,477066,2015-09-24,Senate,"Reported Favorably With Substitute  S-1",4,0,0,0,4
774982,477543,2015-10-06,Senate,"Senate Third Reading: Given Immediate Effect Roll Call # 396",37,0,0,1,38
774982,477592,2015-10-07,House,"House Third Reading: Roll Call # 335",106,0,0,0,106
774992,566032,2016-12-08,House,"Reported With Recommendation With Substitute  H-2",6,3,0,0,9
774992,566033,2016-12-08,House,"House Third Reading: Passed Roll Call # 618",55,50,0,0,105
775010,447070,2015-05-14,House,"Reported With Recommendation With Substitute  H-3",5,1,0,0,6
775010,456170,2015-06-02,House,"House Third Reading: Given Immediate Effect Roll Call # 212",74,34,0,0,108
775016,459353,2015-06-11,House,"Reported With Recommendation With Substitute  H-1",9,0,0,0,9
775016,460446,2015-06-16,House,"House Third Reading: Given Immediate Effect Roll Call # 253",108,2,0,0,110
775016,477092,2015-09-24,Senate,"Reported Favorably With Substitute  S-1",4,0,0,0,4
775016,477540,2015-10-06,Senate,"Senate Third Reading: Given Immediate Effect Roll Call # 397",37,0,0,1,38
775016,477581,2015-10-07,House,"House Third Reading: Roll Call # 336",105,1,0,0,106
775140,445931,2015-05-12,Senate,"Reported Favorably Without Amendment",6,0,0,0,6
775140,447079,2015-05-14,Senate,"Senate Third Reading: Passed Roll Call # 182",37,0,0,1,38
775140,448516,2015-05-19,House,"Reported With Recommendation Without Amendment",10,0,0,0,10
775140,453602,2015-05-27,House,"House Third Reading: Given Immediate Effect Roll Call # 201",69,40,0,0,109
775140,456821,2015-06-03,Senate,"Senate Third Reading: House Amendment(s) Concurred In Roll Call # 257",38,0,0,0,38
775156,464783,2015-07-01,Senate,"Reported Favorably Without Amendment",4,1,0,0,5
775156,476827,2015-09-17,Senate,"Senate Third Reading: Passed Roll Call # 370",26,11,0,1,38
775202,449106,2015-05-20,Senate,"Reported Favorably With Substitute  S-1",4,1,0,0,5
775202,458432,2015-06-09,Senate,"Senate Third Reading: Passed Roll Call # 266",27,10,0,1,38
775207,477462,2015-10-01,Senate,"Reported Favorably Without Amendment",9,0,0,0,9
775207,477710,2015-10-14,Senate,"Senate Third Reading: Passed Roll Call # 422",37,0,0,1,38
775207,482051,2015-12-09,House,"Reported With Recommendation Without Amendment",10,0,0,0,10
775207,488083,2016-01-26,House,"House Third Reading: Given Immediate Effect Roll Call # 15",106,1,0,0,107
775207,489192,2016-01-28,Senate,"Senate Third Reading: House Amendment(s) Concurred In Roll Call # 15",38,0,0,0,38
775376,460210,2015-06-16,House,"Reported With Recommendation With Substitute  H-1",7,1,0,0,8
775376,477086,2015-09-24,House,"House Third Reading: Given Immediate Effect Roll Call # 311",102,3,0,0,105
775376,480438,2015-10-22,Senate,"Reported Favorably With Substitute  S-1",4,0,0,0,4
775376,486517,2016-01-21,Senate,"Senate Third Reading: Given Immediate Effect Roll Call # 7",32,3,0,3,38
775376,487808,2016-01-26,House,"House Third Reading: Roll Call # 13",101,6,0,0,107
775401,460253,2015-06-16,House,"Reported With Recommendation Without Amendment",8,0,0,0,8
775527,443454,2015-05-05,House,"Reported With Recommendation With Substitute H-1",6,4,0,0,10
775552,449911,2015-05-20,Senate,"Reported Favorably Without Amendment",5,0,0,0,5
775552,454000,2015-05-27,Senate,"Senate Third Reading: Passed Roll Call # 244",37,0,0,1,38
775552,477601,2015-10-07,House,"Reported With Recommendation With Substitute  H-1",11,0,0,0,11
775552,477749,2015-10-15,House,"House Third Reading: Given Immediate Effect Roll Call # 363",104,1,0,0,105
775552,480270,2015-10-20,Senate,"Senate Third Reading: Roll Call # 443",37,0,0,1,38
775567,464518,2015-06-30,Senate,"Reported Favorably Without Amendment",5,0,0,0,5
775567,476833,2015-09-17,Senate,"Senate Third Reading: Passed Roll Call # 361",37,0,0,1,38
775567,481145,2015-11-10,House,"Reported With Recommendation With Substitute  H-4",19,0,0,0,19
775805,487828,2016-01-26,House,"Reported With Recommendation With Substitute  H-1",19,0,0,0,19
775805,491170,2016-02-03,House,"House Third Reading: Given Immediate Effect Roll Call # 25",106,0,0,0,106
775805,521140,2016-03-17,Senate,"Reported Favorably Without Amendment",5,0,0,0,5
775805,524487,2016-03-24,Senate,"Senate Third Reading: Given Immediate Effect Roll Call # 144",36,0,0,2,38
776481,446394,2015-05-13,House,"Reported With Recommendation With Amendment(s)",7,0,0,0,7
776496,524547,2016-03-24,House,"Reported With Recommendation Without Amendment",16,0,0,0,16
776509,446860,2015-05-14,House,"Reported With Recommendation With Substitute  H-3",13,0,0,0,13
776509,449017,2015-05-20,House,"House Third Reading: Given Immediate Effect Roll Call # 175",109,1,0,0,110
776509,461507,2015-06-17,Senate,"Reported Favorably With Substitute  S-1",6,0,0,0,6
776509,461508,2015-06-18,Senate,"Senate Third Reading: Given Immediate Effect Roll Call # 313",37,0,0,1,38
776509,461509,2015-06-18,House,"House Third Reading: Roll Call # 274",108,1,0,0,109
776513,458401,2015-06-09,House,"Reported With Recommendation With Substitute  H-1",9,0,0,0,9
776519,446816,2015-05-14,House,"Reported With Recommendation Without Amendment",13,0,0,0,13
776519,449066,2015-05-20,House,"House Third Reading: Given Immediate Effect Roll Call # 178",109,1,0,0,110
776519,461473,2015-06-17,Senate,"Reported Favorably With Substitute  S-1",6,0,0,0,6
776519,461474,2015-06-18,Senate,"Senate Third Reading: Given Immediate Effect Roll Call # 316",37,0,0,1,38
776519,461475,2015-06-18,House,"House Third Reading: Roll Call # 277",108,1,0,0,109
776527,481707,2015-12-03,House,"Reported With Recommendation With Substitute  H-3",8,6,0,0,14
776527,484926,2016-01-13,House,"House Third Reading: Given Immediate Effect Roll Call # 3",78,29,0,0,107
776541,458429,2015-06-09,House,"Reported With Recommendation With Substitute  H-1",10,0,0,0,10
776541,513012,2015-06-09,House,"Reported With Recommendation With Substitute H-1",10,0,0,0,10
776550,482261,2015-12-10,House,"Reported With Recommendation For Referral To Committee On Natural Resources With Substitute H-8",4,2,0,0,6
776550,505202,2016-02-23,House,"Reported With Recommendation With Substitute  H-9",9,0,0,0,9
776550,522698,2016-02-23,House,"Reported With Recommendation With Substitute H-9",9,0,0,0,9
776550,524831,2016-03-23,House,"House Third Reading: Given Immediate Effect Roll Call # 129",105,3,0,0,108
776555,449124,2015-05-20,House,"Reported With Recommendation With Substitute  H-2",9,0,0,0,9
776555,454050,2015-05-27,House,"House Third Reading: Given Immediate Effect Roll Call # 203",108,1,0,0,109
776555,466425,2015-07-15,Senate,"Reported Favorably With Substitute  S-1",7,0,0,0,7
776555,477327,2015-09-29,Senate,"Senate Third Reading: Given Immediate Effect Roll Call # 379",35,0,0,3,38
776555,477450,2015-10-01,House,"House Third Reading: Roll Call # 327",106,0,0,0,106
776565,446818,2015-05-14,House,"Reported With Recommendation Without Amendment",13,0,0,0,13
776565,448957,2015-05-20,House,"House Third Reading: Given Immediate Effect Roll Call # 179",106,4,0,0,110
776565,461368,2015-06-17,Senate,"Reported Favorably Without Amendment",6,0,0,0,6
776565,461369,2015-06-18,Senate,"Senate Third Reading: Given Immediate Effect Roll Call # 317",37,0,0,1,38
776572,449119,2015-05-20,House,"Reported With Recommendation Without Amendment",9,0,0,0,9
776572,453866,2015-05-27,House,"House Third Reading: Given Immediate Effect Roll Call # 205",108,1,0,0,109
776572,466426,2015-07-15,Senate,"Reported Favorably With Substitute  S-1",7,0,0,0,7
776572,477303,2015-09-29,Senate,"Senate Third Reading: Given Immediate Effect Roll Call # 381",35,0,0,3,38
776572,477627,2015-10-08,House,"House Third Reading: Roll Call # 345",106,0,0,0,106
776576,446897,2015-05-14,House,"Reported With Recommendation Without Amendment",13,0,0,0,13
776576,449207,2015-05-20,House,"House Third Reading: Given Immediate Effect Roll Call # 177",109,1,0,0,110
776576,461263,2015-06-17,Senate,"Reported Favorably With Substitute  S-1",6,0,0,0,6
776576,461264,2015-06-18,Senate,"Senate Third Reading: Given Immediate Effect Roll Call # 315",37,0,0,1,38
776576,461265,2015-06-18,House,"House Third Reading: Roll Call # 276",108,1,0,0,109
776583,458438,2015-06-09,House,"Reported With Recommendation With Substitute  H-1",10,0,0,0,10
776595,516292,2016-03-08,Senate,"Reported Favorably Without Amendment",4,0,0,0,4
776595,519925,2016-03-15,Senate,"Senate Third Reading: Passed Roll Call # 106",26,12,0,0,38
776595,520974,2016-03-16,Senate,"Senate Third Reading: Passed Roll Call # 107",28,10,0,0,38
776600,446793,2015-05-14,House,"Reported With Recommendation With Substitute  H-2",13,0,0,0,13
776600,449081,2015-05-20,House,"House Third Reading: Given Immediate Effect Roll Call # 174",109,1,0,0,110
776600,461279,2015-06-17,Senate,"Reported Favorably With Substitute  S-2",6,0,0,0,6
776600,461280,2015-06-18,Senate,"Senate Third Reading: Given Immediate Effect Roll Call # 312",37,0,0,1,38
776600,461281,2015-06-18,House,"House Third Reading: Roll Call # 273",108,1,0,0,109
776622,480623,2015-10-27,House,"Reported With Recommendation With Substitute H-1",6,0,0,0,6
776622,480785,2015-10-27,House,"Reported With Recommendation With Substitute  H-1",6,0,0,0,6
776629,448982,2015-05-20,House,"Reported With Recommendation Without Amendment",9,0,0,0,9
776629,453669,2015-05-27,House,"House Third Reading: Given Immediate Effect Roll Call # 204",108,1,0,0,109
776629,466313,2015-07-15,Senate,"Reported Favorably With Substitute  S-1",7,0,0,0,7
776629,477309,2015-09-29,Senate,"Senate Third Reading: Given Immediate Effect Roll Call # 380",35,0,0,3,38
776629,477459,2015-10-01,House,"House Third Reading: Roll Call # 328",106,0,0,0,106
776635,448984,2015-05-20,House,"Reported With Recommendation Without Amendment",9,0,0,0,9
776635,453743,2015-05-27,House,"House Third Reading: Given Immediate Effect Roll Call # 202",107,2,0,0,109
776642,446922,2015-05-14,House,"Reported With Recommendation With Substitute  H-3",13,0,0,0,13
776642,449221,2015-05-20,House,"House Third Reading: Given Immediate Effect Roll Call # 176",109,1,0,0,110
776642,461564,2015-06-17,Senate,"Reported Favorably With Substitute  S-1",6,0,0,0,6
776642,461565,2015-06-18,Senate,"Senate Third Reading: Given Immediate Effect Roll Call # 314",37,0,0,1,38
776642,461566,2015-06-18,House,"House Third Reading: Roll Call # 275",108,1,0,0,109
777256,562808,2016-09-20,Senate,"Reported Favorably Without Amendment",3,1,0,0,4
777256,563067,2016-09-21,Senate,"Senate Third Reading: Passed Roll Call # 531",25,10,0,2,37
777256,565535,2016-12-01,House,"Reported With Recommendation Without Amendment",3,2,0,0,5
777256,566532,2016-12-14,House,"House Third Reading: Passed Roll Call # 687",56,50,0,0,106
777282,448509,2015-05-19,House,"Reported With Recommendation Without Amendment",15,0,0,0,15
777282,456064,2015-06-02,House,"House Third Reading: Given Immediate Effect Roll Call # 210",108,0,0,0,108
777282,477544,2015-10-06,Senate,"Reported Favorably Without Amendment",4,0,0,0,4
777282,480897,2015-11-04,Senate,"Senate Third Reading: Given Immediate Effect Roll Call # 486",38,0,0,0,38
777297,447746,2015-05-14,Senate,"Reported Favorably Without Amendment",3,0,0,0,3
777328,446301,2015-05-13,House,"Reported With Recommendation Without Amendment",26,1,0,0,27
777328,448554,2015-05-19,House,"House Third Reading: Given Immediate Effect Roll Call # 161",103,6,0,0,109
777328,456793,2015-06-03,Senate,"Reported Favorably Without Amendment",5,0,0,0,5
777328,456794,2015-06-03,Senate,"Senate Third Reading: Given Immediate Effect Roll Call # 260",21,17,0,0,38
777375,450404,2015-05-20,Senate,"Reported Favorably Without Amendment",4,1,0,0,5
777409,446291,2015-05-13,House,"Reported With Recommendation Without Amendment",28,0,0,0,28
777409,448529,2015-05-19,House,"House Third Reading: Given Immediate Effect Roll Call # 162",105,4,0,0,109
777409,456892,2015-06-03,Senate,"Reported Favorably Without Amendment",5,0,0,0,5
777409,456893,2015-06-03,Senate,"Senate Third Reading: Given Immediate Effect Roll Call # 261",21,17,0,0,38
777442,562461,2016-09-13,House,"Reported With Recommendation With Substitute H-4",11,0,0,0,11
777442,562501,2016-09-13,House,"Reported With Recommendation With Substitute  H-4",11,0,0,0,11
777456,460691,2015-06-17,House,"Reported With Recommendation With Substitute  H-1",10,0,0,0,10
777456,476784,2015-09-16,House,"House Third Reading: Given Immediate Effect Roll Call # 298",103,0,0,0,103
777456,482509,2015-12-15,Senate,"Reported Favorably Without Amendment",5,0,0,0,5
777456,482788,2015-12-16,Senate,"Senate Third Reading: Given Immediate Effect Roll Call # 634",38,0,0,0,38
778323,449932,2015-05-21,Senate,"Reported Favorably With Substitute  S-1",5,0,0,0,5
778323,457365,2015-06-04,Senate,"Senate Third Reading: Passed Roll Call # 265",35,0,0,3,38
778323,477696,2015-10-13,House,"Reported With Recommendation Without Amendment",11,0,0,0,11
778323,487827,2016-01-26,House,"House Third Reading: Given Immediate Effect Roll Call # 14",107,0,0,0,107
778336,448477,2015-05-19,Senate,"Reported Favorably Without Amendment",5,0,0,0,5
778336,448478,2015-05-19,Senate,"Senate Third Reading: Passed Roll Call # 195",34,2,0,2,38
778336,453731,2015-05-27,House,"Reported With Recommendation With Substitute  H-3",8,0,0,0,8
778336,456654,2015-06-03,House,"House Third Reading: Given Immediate Effect Roll Call # 218",95,14,0,0,109
778336,457035,2015-06-03,Senate,"Senate Third Reading: Roll Call # 264",37,1,0,0,38
778349,466315,2015-07-15,Senate,"Reported Favorably Without Amendment",4,0,0,0,4
778349,480343,2015-10-21,Senate,"Senate Third Reading: Passed Roll Call # 450",38,0,0,0,38
778362,456849,2015-06-03,Senate,"Reported Favorably Without Amendment",5,0,0,0,5
778362,458916,2015-06-10,Senate,"Senate Third Reading: Passed Roll Call # 269",38,0,0,0,38
778447,481994,2015-12-08,House,"Reported With Recommendation Without Amendment",15,0,0,0,15
778447,490381,2016-02-02,House,"House Third Reading: Given Immediate Effect Roll Call # 23",103,3,0,0,106
778455,482002,2015-12-08,House,"Reported With Recommendation With Substitute  H-2",15,0,0,0,15
778455,490736,2016-02-02,House,"House Third Reading: Given Immediate Effect Roll Call # 24",103,3,0,0,106
778478,523794,2016-03-23,House,"Reported With Recommendation With Substitute H-1",10,0,0,0,10
778478,524292,2016-03-23,House,"Reported With Recommendation With Substitute  H-1",10,0,0,0,10
778478,535078,2016-04-19,House,"House Third Reading: Given Immediate Effect Roll Call # 162",108,0,0,0,108
778478,546674,2016-05-18,Senate,"Reported Favorably Without Amendment",4,0,0,0,4
778478,550059,2016-05-31,Senate,"Senate Third Reading: Given Immediate Effect Roll Call # 346",37,0,0,0,37
778486,491062,2016-02-03,House,"Reported With Recommendation With Substitute  H-2",13,0,0,0,13
778486,532838,2016-04-13,House,"House Third Reading: Given Immediate Effect Roll Call # 151",109,0,0,0,109
778486,543336,2016-05-05,Senate,"Reported Favorably Without Amendment",7,0,0,0,7
778486,563079,2016-09-21,Senate,"Senate Third Reading: Given Immediate Effect Roll Call # 519",35,0,0,2,37
778486,565236,2016-11-29,House,"House Third Reading: Roll Call # 513",107,0,0,0,107
778498,481120,2015-11-10,House,"Reported With Recommendation With Substitute  H-3",19,4,0,0,23
778505,476771,2015-09-16,House,"Reported With Recommendation With Substitute  H-1",14,0,0,0,14
778505,477647,2015-10-08,House,"House Third Reading: Given Immediate Effect Roll Call # 348",102,4,0,0,106
778505,481709,2015-12-03,Senate,"Reported Favorably Without Amendment",9,0,0,0,9
778505,482517,2015-12-15,Senate,"Senate Third Reading: Given Immediate Effect Roll Call # 594",36,2,0,0,38
778516,477354,2015-09-29,House,"Reported With Recommendation With Substitute  H-1",15,0,0,0,15
778516,480274,2015-10-20,House,"House Third Reading: Given Immediate Effect Roll Call # 365",105,0,0,0,105
778516,522829,2016-03-22,Senate,"Reported Favorably Without Amendment",5,0,0,0,5
778516,524212,2016-03-23,Senate,"Senate Third Reading: Given Immediate Effect Roll Call # 139",36,0,0,2,38
778516,524629,2016-03-24,House,"House Third Reading: Roll Call # 135",108,0,0,0,108
778847,453672,2015-05-27,House,"Reported With Recommendation With Substitute  H-3",8,0,0,0,8
778873,449269,2015-05-20,House,"Reported With Recommendation Without Amendment",8,0,0,0,8
778873,456674,2015-06-03,House,"House Third Reading: Given Immediate Effect Roll Call # 215",109,0,0,0,109
778873,482050,2015-12-09,Senate,"Reported Favorably Without Amendment",5,0,0,0,5
778873,482680,2015-12-16,Senate,"Senate Third Reading: Given Immediate Effect Roll Call # 629",37,0,1,0,38
778877,448960,2015-05-20,House,"Reported With Recommendation Without Amendment",8,0,0,0,8
778877,456673,2015-06-03,House,"House Third Reading: Given Immediate Effect Roll Call # 216",109,0,0,0,109
778877,482096,2015-12-09,Senate,"Reported Favorably Without Amendment",5,0,0,0,5
778877,482811,2015-12-16,Senate,"Senate Third Reading: Given Immediate Effect Roll Call # 630",38,0,0,0,38
778896,457343,2015-06-04,House,"Reported With Recommendation Without Amendment",15,0,0,0,15
778896,460273,2015-06-16,House,"House Third Reading: Given Immediate Effect Roll Call # 250",110,0,0,0,110
778896,481583,2015-12-01,Senate,"Reported Favorably Without Amendment",4,0,0,0,4
778896,482073,2015-12-09,Senate,"Senate Third Reading: Given Immediate Effect Roll Call # 563",38,0,0,0,38
778909,520278,2016-03-15,House,"Reported With Recommendation With Substitute  H-1",9,1,0,0,10
778909,546315,2016-05-17,House,"House Third Reading: Given Immediate Effect Roll Call # 275",87,22,0,0,109
778909,563881,2016-10-18,Senate,"Reported Favorably Without Amendment",5,0,0,0,5
778909,564036,2016-10-20,Senate,"Senate Third Reading: Given Immediate Effect Roll Call # 573",36,0,0,1,37
778909,564828,2016-11-09,House,"House Third Reading: Senate Amendment(s) Concurred In Roll Call # 503",80,25,0,0,105
779294,457360,2015-06-04,House,"Reported With Recommendation With Substitute  H-1",5,2,0,0,7
779294,458909,2015-06-10,House,"House Third Reading: Given Immediate Effect Roll Call # 241",58,51,0,0,109
779294,464718,2015-07-01,Senate,"Reported Favorably With Substitute  S-1",4,1,0,0,5
779294,464719,2015-07-01,Senate,"Senate Third Reading: Given Immediate Effect Roll Call # 344",19,19,0,0,38
779294,473844,2015-08-18,House,"House Third Reading: Roll Call # 287",0,103,0,0,103
779299,477741,2015-10-15,Senate,"Reported Favorably Without Amendment",8,0,0,0,8
779299,481622,2015-12-01,Senate,"Senate Third Reading: Passed Roll Call # 533",36,0,0,2,38
779299,522979,2016-03-22,House,"Reported With Recommendation With Substitute H-1",18,0,0,0,18
779299,524282,2016-03-22,House,"Reported With Recommendation With Substitute  H-1",18,0,0,0,18
779299,537390,2016-04-21,House,"House Third Reading: Given Immediate Effect Roll Call # 168",83,24,0,0,107
779299,538719,2016-04-26,Senate,"Senate Third Reading: Roll Call # 190",35,0,1,1,37
779303,457339,2015-06-04,House,"Reported With Recommendation Without Amendment",5,2,0,0,7
779303,458828,2015-06-10,House,"House Third Reading: Given Immediate Effect Roll Call # 235",57,52,0,0,109
779303,466351,2015-07-15,Senate,"Reported Favorably With Substitute  S-1",3,2,0,0,5
779308,459413,2015-06-11,Senate,"Reported Favorably With Substitute  S-1",4,0,0,0,4
779308,513877,2016-03-03,Senate,"Senate Third Reading: Passed Roll Call # 87",36,2,0,0,38
779308,562455,2016-09-13,House,"Reported With Recommendation With Substitute H-2",8,0,0,0,8
779308,562500,2016-09-13,House,"Reported With Recommendation With Substitute  H-2",8,0,0,0,8
779308,565692,2016-12-06,House,"House Third Reading: Given Immediate Effect Roll Call # 553",106,0,0,0,106
779308,565857,2016-12-07,Senate,"Senate Third Reading: Roll Call # 683",36,1,0,1,38
779317,457347,2015-06-04,House,"Reported With Recommendation With Substitute  H-1",5,2,0,0,7
779317,458902,2015-06-10,House,"House Third Reading: Given Immediate Effect Roll Call # 232",64,45,0,0,109
779325,457357,2015-06-04,House,"Reported With Recommendation Without Amendment",5,2,0,0,7
779325,458894,2015-06-10,House,"House Third Reading: Given Immediate Effect Roll Call # 236",63,46,0,0,109
779325,464772,2015-07-01,Senate,"Reported Favorably With Substitute  S-1",4,1,0,0,5
779325,464773,2015-07-01,Senate,"Senate Third Reading: Given Immediate Effect Roll Call # 349",27,11,0,0,38
779325,480356,2015-10-21,House,"House Third Reading: Roll Call # 380",62,44,0,0,106
779337,476177,2015-09-09,House,"Reported With Recommendation Without Amendment",12,0,0,0,12
779337,476843,2015-09-17,House,"House Third Reading: Given Immediate Effect Roll Call # 302",66,35,0,0,101
779337,482177,2015-12-10,Senate,"Reported Favorably With Substitute  S-1",4,1,0,0,5
779337,482813,2015-12-16,Senate,"Senate Third Reading: Given Immediate Effect Roll Call # 632",25,13,0,0,38
779337,484911,2016-01-13,House,"House Third Reading: Roll Call # 1",64,43,0,0,107
779348,459386,2015-06-11,Senate,"Reported Favorably With Substitute  S-2",4,0,0,0,4
779348,513258,2016-03-03,Senate,"Senate Third Reading: Passed Roll Call # 86",36,2,0,0,38
779348,562470,2016-09-13,House,"Reported With Recommendation With Substitute  H-1",8,0,0,0,8
779348,565693,2016-12-06,House,"House Third Reading: Given Immediate Effect Roll Call # 550",105,1,0,0,106
779348,565776,2016-12-07,Senate,"Senate Third Reading: Roll Call # 682",36,1,0,1,38
779360,457369,2015-06-04,House,"Reported With Recommendation With Substitute  H-2",5,2,0,0,7
779360,459113,2015-06-10,House,"House Third Reading: Given Immediate Effect Roll Call # 238",59,50,0,0,109
779360,464774,2015-07-01,Senate,"Reported Favorably With Substitute  S-2",4,1,0,0,5
779360,464775,2015-07-01,Senate,"Senate Third Reading: Given Immediate Effect Roll Call # 348",21,17,0,0,38
779360,473831,2015-08-18,House,"House Third Reading: Roll Call # 285",0,103,0,0,103
779364,477549,2015-10-06,Senate,"Reported Favorably With Substitute  S-1",5,0,0,0,5
779364,477732,2015-10-15,Senate,"Senate Third Reading: Passed Roll Call # 437",37,0,0,1,38
779364,480728,2015-10-28,House,"Reported With Recommendation Without Amendment",8,0,0,0,8
779364,510346,2016-02-24,House,"House Third Reading: Given Immediate Effect Roll Call # 61",103,0,0,0,103
779364,510888,2016-03-01,Senate,"Senate Third Reading: Roll Call # 79",38,0,0,0,38
779371,476780,2015-09-16,House,"Reported With Recommendation With Substitute  H-3",12,0,0,0,12
779371,481763,2015-12-03,House,"House Third Reading: Given Immediate Effect Roll Call # 444",79,25,0,0,104
779371,565855,2016-12-07,Senate,"Reported Favorably With Substitute  S-5",10,0,0,0,10
779371,566390,2016-12-14,Senate,"Senate Third Reading: Given Immediate Effect Roll Call # 780",36,1,0,1,38
779371,566525,2016-12-15,House,"House Third Reading: Roll Call # 723",81,27,0,0,108
779377,457380,2015-06-04,House,"Reported With Recommendation With Substitute  H-1",5,2,0,0,7
779377,458922,2015-06-10,House,"House Third Reading: Given Immediate Effect Roll Call # 231",62,47,0,0,109
779382,457051,2015-06-03,Senate,"Reported Favorably Without Amendment",5,0,0,0,5
779382,458869,2015-06-10,Senate,"Senate Third Reading: Passed Roll Call # 270",38,0,0,0,38
779382,477537,2015-10-06,House,"Reported With Recommendation With Substitute  H-1",7,0,0,0,7
779382,480280,2015-10-20,House,"House Third Reading: Given Immediate Effect Roll Call # 367",104,1,0,0,105
779382,480370,2015-10-21,Senate,"Senate Third Reading: Roll Call # 449",37,0,0,1,38
779389,476845,2015-09-17,Senate,"Reported Favorably Without Amendment",3,1,0,0,4
779389,547303,2016-05-17,House,"Reported With Recommendation Without Amendment",8,1,0,0,9
779394,457440,2015-06-04,House,"Reported With Recommendation Without Amendment",5,2,0,0,7
779394,458846,2015-06-10,House,"House Third Reading: Given Immediate Effect Roll Call # 237",65,44,0,0,109
779394,464790,2015-07-01,Senate,"Reported Favorably With Substitute  S-1",4,1,0,0,5
779394,464791,2015-07-01,Senate,"Senate Third Reading: Given Immediate Effect Roll Call # 350",27,11,0,0,38
779394,480363,2015-10-21,House,"House Third Reading: Roll Call # 381",62,44,0,0,106
779405,457422,2015-06-04,House,"Reported With Recommendation With Substitute  H-1",5,2,0,0,7
779405,458832,2015-06-10,House,"House Third Reading: Passed Roll Call # 233",60,49,0,0,109
779412,457359,2015-06-04,House,"Reported With Recommendation With Substitute  H-1",5,2,0,0,7
779412,458840,2015-06-10,House,"House Third Reading: Given Immediate Effect Roll Call # 240",59,50,0,0,109
779412,464785,2015-07-01,Senate,"Reported Favorably With Substitute  S-1",4,1,0,0,5
779412,464786,2015-07-01,Senate,"Senate Third Reading: Given Immediate Effect Roll Call # 351",20,18,0,0,38
779412,480361,2015-10-21,House,"House Third Reading: Roll Call # 378",56,50,0,0,106
779412,480837,2015-11-03,Senate,"Senate Third Reading: Roll Call # 480",21,17,0,0,38
779412,480838,2015-11-03,House,"House Third Reading: Roll Call # 410",55,52,0,0,107
779419,457363,2015-06-04,House,"Reported With Recommendation With Substitute  H-3",7,0,0,0,7
779419,458979,2015-06-10,House,"House Third Reading: Given Immediate Effect Roll Call # 239",100,9,0,0,109
779419,464725,2015-07-01,Senate,"Reported Favorably With Substitute  S-1",4,1,0,0,5
779419,464726,2015-07-01,Senate,"Senate Third Reading: Given Immediate Effect Roll Call # 347",28,10,0,0,38
779419,473833,2015-08-18,House,"House Third Reading: Roll Call # 286",32,71,0,0,103
779443,476849,2015-09-17,Senate,"Reported Favorably Without Amendment",3,1,0,0,4
779446,457449,2015-06-04,House,"Reported With Recommendation With Substitute  H-1",5,2,0,0,7
779446,458874,2015-06-10,House,"House Third Reading: Given Immediate Effect Roll Call # 242",58,51,0,0,109
779446,464735,2015-07-01,Senate,"Reported Favorably With Substitute  S-1",4,1,0,0,5
779446,464736,2015-07-01,Senate,"Senate Third Reading: Given Immediate Effect Roll Call # 345",19,19,0,0,38
779446,480360,2015-10-21,House,"House Third Reading: Roll Call # 379",56,50,0,0,106
779446,480843,2015-11-03,Senate,"Senate Third Reading: Roll Call # 481",20,18,0,0,38
779446,480844,2015-11-03,House,"House Third Reading: Roll Call # 411",56,51,0,0,107
779450,457434,2015-06-04,House,"Reported With Recommendation With Substitute  H-1",5,2,0,0,7
779450,458839,2015-06-10,House,"House Third Reading: Passed Roll Call # 234",59,50,0,0,109
780172,477058,2015-09-24,Senate,"Reported Favorably With Substitute  S-1",4,0,0,0,4
780172,520687,2015-09-24,Senate,"Reported Favorably With Substitute S-1",4,0,0,0,4
780371,477556,2015-10-06,House,"Reported With Recommendation Without Amendment",19,0,0,0,19
780395,449012,2015-05-20,House,"Reported With Recommendation Without Amendment",16,0,0,0,16
780459,565426,2016-12-01,Senate,"Reported Favorably With Substitute  S-1",3,0,0,0,3
780459,565427,2016-12-01,Senate,"Senate Third Reading: Passed Roll Call # 674",36,0,0,2,38
780459,565500,2016-12-01,Senate,"Reported Favorably With Substitute  S-2",3,0,0,0,3
780499,461192,2015-06-18,Senate,"Reported Favorably Without Amendment",4,0,0,0,4
780499,477532,2015-10-06,Senate,"Senate Third Reading: Passed Roll Call # 395",37,0,0,1,38
780972,457721,2015-06-03,Senate,"Reported Favorably Without Amendment",5,0,0,0,5
780972,459645,2015-06-10,House,"Reported With Recommendation Without Amendment",24,0,0,0,24
781003,524521,2016-03-24,Senate,"Reported Favorably With Substitute S-2",6,1,0,0,7
781003,524522,2016-03-24,Senate,"Senate Third Reading: Passed Roll Call # 150",36,0,0,2,38
781003,543717,2016-05-04,House,"Reported With Recommendation Without Amendment",14,0,0,0,14
781003,545579,2016-05-12,House,"House Third Reading: Given Immediate Effect Roll Call # 273",103,5,0,0,108
781013,456852,2015-06-03,Senate,"Reported Favorably With Substitute  S-1",15,0,0,0,15
781013,461548,2015-06-18,Senate,"Senate Third Reading: Passed Roll Call # 330",32,5,0,1,38
781013,537546,2016-04-21,House,"Reported With Recommendation With Substitute  H-1",29,0,0,0,29
781013,545509,2016-05-12,House,"House Third Reading: Given Immediate Effect Roll Call # 268",100,8,0,0,108
781013,546277,2016-05-17,Senate,"Senate Third Reading: Roll Call # 263",36,1,0,0,37
781054,565573,2016-11-29,House,"Reported With Recommendation Without Amendment",12,7,0,0,19
781054,566043,2016-12-07,House,"House Third Reading: Given Immediate Effect Roll Call # 588",59,48,0,0,107
781072,487809,2016-01-26,House,"Reported With Recommendation For Referral To Committee On Oversight And Ethics",10,0,0,0,10
781072,505177,2016-02-23,House,"Reported With Recommendation With Substitute H-1",6,0,0,0,6
781072,522818,2016-03-22,House,"House Third Reading: Given Immediate Effect Roll Call # 127",100,7,0,0,107
781072,545319,2016-05-12,Senate,"Reported Favorably With Substitute  S-1",5,0,0,0,5
781072,566344,2016-12-14,Senate,"Senate Third Reading: Given Immediate Effect Roll Call # 778",29,8,0,1,38
781072,566621,2016-12-15,House,"House Third Reading: Roll Call # 719",101,7,0,0,108
781250,461602,2015-06-17,Senate,"Reported Favorably With Substitute  S-1",6,0,0,0,6
781250,476163,2015-09-09,Senate,"Senate Third Reading: Passed Roll Call # 353",38,0,0,0,38
781250,480358,2015-10-21,House,"Reported With Recommendation Without Amendment",13,0,0,0,13
781250,480735,2015-10-29,House,"House Third Reading: Given Immediate Effect Roll Call # 403",105,0,0,0,105
781272,456710,2015-06-03,Senate,"Reported Favorably Without Amendment",4,1,0,0,5
781272,458931,2015-06-10,Senate,"Senate Third Reading: Passed Roll Call # 271",36,2,0,0,38
781292,485550,2015-12-02,Senate,"Reported Favorably With Substitute  S-3",8,0,0,0,8
781292,485551,2015-12-10,Senate,"Senate Third Reading: Passed Roll Call # 578",38,0,0,0,38
781292,516145,2016-03-08,House,"Reported With Recommendation With Substitute  H-1",13,0,0,0,13
781292,524538,2016-03-24,House,"House Third Reading: Given Immediate Effect Roll Call # 136",70,38,0,0,108
781292,524539,2016-03-24,Senate,"Senate Third Reading: Roll Call # 152",27,9,0,2,38
781303,490450,2016-02-02,House,"Reported With Recommendation With Substitute  H-1",16,0,0,0,16
781303,500481,2016-02-16,House,"House Third Reading: Given Immediate Effect Roll Call # 39",88,17,0,0,105
781303,544584,2016-05-10,Senate,"Reported Favorably Without Amendment",5,0,0,0,5
781303,548024,2016-05-24,Senate,"Senate Third Reading: Given Immediate Effect Roll Call # 315",37,0,0,0,37
781307,476766,2015-09-16,House,"Reported With Recommendation With Substitute  H-1",13,1,0,0,14
781307,477350,2015-09-29,House,"House Third Reading: Given Immediate Effect Roll Call # 326",71,34,0,0,105
781307,524535,2016-03-24,Senate,"Reported Favorably Without Amendment",7,0,0,0,7
781307,539756,2016-04-28,Senate,"Senate Third Reading: Given Immediate Effect Roll Call # 207",33,3,0,1,37
781321,480691,2015-10-28,Senate,"Reported Favorably Without Amendment",3,0,0,0,3
781948,460357,2015-06-16,House,"Reported With Recommendation With Substitute  H-2",10,7,0,0,17
781948,460932,2015-06-17,House,"House Third Reading: Given Immediate Effect Roll Call # 263",73,37,0,0,110
781948,565449,2016-12-01,Senate,"Reported Favorably With Substitute  S-3",3,0,0,0,3
781948,565450,2016-12-01,Senate,"Senate Third Reading: Given Immediate Effect Roll Call # 669",33,3,0,2,38
781948,565970,2016-12-07,House,"House Third Reading: Roll Call # 556",91,15,0,0,106
781956,476802,2015-09-16,House,"Reported With Recommendation Without Amendment",11,1,0,0,12
781965,477376,2015-09-29,House,"Reported With Recommendation Without Amendment",16,0,0,0,16
781965,480653,2015-10-27,House,"House Third Reading: Given Immediate Effect Roll Call # 388",101,4,0,0,105
781965,550266,2016-05-31,Senate,"Reported Favorably Without Amendment",5,0,0,0,5
781986,460296,2015-06-16,House,"Reported With Recommendation With Substitute  H-1",10,7,0,0,17
781986,460796,2015-06-17,House,"House Third Reading: Given Immediate Effect Roll Call # 265",74,36,0,0,110
781986,565438,2016-12-01,Senate,"Reported Favorably With Substitute  S-4",3,0,0,0,3
781986,565439,2016-12-01,Senate,"Senate Third Reading: Given Immediate Effect Roll Call # 671",33,3,0,2,38
781986,565965,2016-12-07,House,"House Third Reading: Roll Call # 558",92,14,0,0,106
782025,488135,2016-01-26,House,"Reported With Recommendation Without Amendment",7,0,0,0,7
782025,502499,2016-02-18,House,"House Third Reading: Given Immediate Effect Roll Call # 49",87,19,0,0,106
782025,564049,2016-10-20,Senate,"Reported Favorably Without Amendment",4,0,0,0,4
782025,564050,2016-10-20,Senate,"Senate Third Reading: Given Immediate Effect Roll Call # 585",36,0,0,1,37
782045,460404,2015-06-16,House,"Reported With Recommendation With Substitute  H-1",10,7,0,0,17
782045,460975,2015-06-17,House,"House Third Reading: Given Immediate Effect Roll Call # 262",73,37,0,0,110
782054,460306,2015-06-16,House,"Reported With Recommendation With Substitute  H-1",10,7,0,0,17
782054,460805,2015-06-17,House,"House Third Reading: Given Immediate Effect Roll Call # 264",70,40,0,0,110
782054,565461,2016-12-01,Senate,"Reported Favorably With Substitute  S-2",3,0,0,0,3
782054,565462,2016-12-01,Senate,"Senate Third Reading: Given Immediate Effect Roll Call # 670",33,3,0,2,38
782054,565969,2016-12-07,House,"House Third Reading: Roll Call # 557",93,13,0,0,106
782073,476764,2015-09-16,House,"Reported With Recommendation Without Amendment",11,1,0,0,12
782082,480690,2015-10-28,House,"Reported With Recommendation With Substitute  H-1",10,2,0,0,12
782082,481682,2015-12-02,House,"House Third Reading: Given Immediate Effect Roll Call # 435",64,42,0,0,106
782091,460389,2015-06-16,House,"Reported With Recommendation With Substitute  H-3",10,6,0,0,16
782091,460732,2015-06-17,House,"House Third Reading: Given Immediate Effect Roll Call # 261",71,39,0,0,110
782091,565441,2016-12-01,Senate,"Reported Favorably With Substitute  S-4",3,0,0,0,3
782091,565442,2016-12-01,Senate,"Senate Third Reading: Given Immediate Effect Roll Call # 668",31,4,1,2,38
782091,566041,2016-12-07,House,"House Third Reading: Roll Call # 555",94,12,0,0,106
782100,565574,2016-11-29,House,"Reported With Recommendation Without Amendment",12,7,0,0,19
782100,565932,2016-12-07,House,"House Third Reading: Given Immediate Effect Roll Call # 589",57,50,0,0,107
782376,523824,2016-03-23,House,"Reported With Recommendation With Substitute  H-2",10,0,0,0,10
782376,535370,2016-04-19,House,"House Third Reading: Given Immediate Effect Roll Call # 163",108,0,0,0,108
782376,546671,2016-05-18,Senate,"Reported Favorably Without Amendment",4,0,0,0,4
782376,550799,2016-06-01,Senate,"Senate Third Reading: Given Immediate Effect Roll Call # 352",36,0,0,1,37
783568,476428,2015-09-10,House,"Reported With Recommendation Without Amendment",16,0,0,0,16
783568,477076,2015-09-24,House,"House Third Reading: Given Immediate Effect Roll Call # 313",104,1,0,0,105
783568,524465,2016-03-24,Senate,"Reported Favorably Without Amendment",8,0,0,0,8
783568,535902,2016-04-19,Senate,"Senate Third Reading: Given Immediate Effect Roll Call # 174",37,0,0,0,37
783572,473922,2015-08-19,House,"Reported With Recommendation With Substitute  H-1",7,0,0,0,7
783572,476790,2015-09-16,House,"House Third Reading: Given Immediate Effect Roll Call # 299",102,1,0,0,103
783572,481989,2015-12-08,Senate,"Reported Favorably With Substitute  S-1",5,0,0,0,5
783572,482460,2015-12-15,Senate,"Senate Third Reading: Given Immediate Effect Roll Call # 607",36,2,0,0,38
783572,482564,2015-12-16,House,"House Third Reading: Roll Call # 492",103,2,0,0,105
783579,476405,2015-09-10,House,"Reported With Recommendation Without Amendment",16,0,0,0,16
783579,477097,2015-09-24,House,"House Third Reading: Given Immediate Effect Roll Call # 315",104,1,0,0,105
783579,524619,2016-03-24,Senate,"Reported Favorably Without Amendment",8,0,0,0,8
783579,535359,2016-04-19,Senate,"Senate Third Reading: Given Immediate Effect Roll Call # 176",37,0,0,0,37
783582,476448,2015-09-10,House,"Reported With Recommendation Without Amendment",16,0,0,0,16
783582,477093,2015-09-24,House,"House Third Reading: Given Immediate Effect Roll Call # 319",104,1,0,0,105
783582,524670,2016-03-24,Senate,"Reported Favorably Without Amendment",8,0,0,0,8
783582,535419,2016-04-19,Senate,"Senate Third Reading: Given Immediate Effect Roll Call # 180",37,0,0,0,37
783586,476424,2015-09-10,House,"Reported With Recommendation Without Amendment",16,0,0,0,16
783586,477098,2015-09-24,House,"House Third Reading: Given Immediate Effect Roll Call # 321",104,1,0,0,105
783586,524721,2016-03-24,Senate,"Reported Favorably Without Amendment",8,0,0,0,8
783586,535394,2016-04-19,Senate,"Senate Third Reading: Given Immediate Effect Roll Call # 182",37,0,0,0,37
783590,476452,2015-09-10,House,"Reported With Recommendation Without Amendment",16,0,0,0,16
783590,477083,2015-09-24,House,"House Third Reading: Given Immediate Effect Roll Call # 316",104,1,0,0,105
783590,524436,2016-03-24,Senate,"Reported Favorably Without Amendment",8,0,0,0,8
783590,535212,2016-04-19,Senate,"Senate Third Reading: Given Immediate Effect Roll Call # 177",37,0,0,0,37
783605,476454,2015-09-10,House,"Reported With Recommendation Without Amendment",16,0,0,0,16
783605,477082,2015-09-24,House,"House Third Reading: Given Immediate Effect Roll Call # 320",104,1,0,0,105
783605,524468,2016-03-24,Senate,"Reported Favorably Without Amendment",8,0,0,0,8
783605,535097,2016-04-19,Senate,"Senate Third Reading: Given Immediate Effect Roll Call # 181",37,0,0,0,37
783610,477369,2015-09-29,House,"Reported With Recommendation With Substitute  H-2",21,0,0,0,21
783610,480316,2015-10-20,House,"House Third Reading: Given Immediate Effect Roll Call # 364",103,2,0,0,105
783610,563117,2016-09-21,Senate,"Reported Favorably With Substitute S-1",9,0,0,0,9
783610,563993,2016-10-19,Senate,"Senate Third Reading: Given Immediate Effect Roll Call # 547",37,0,0,0,37
783610,564838,2016-11-09,House,"House Third Reading: Roll Call # 500",103,2,0,0,105
783619,476406,2015-09-10,House,"Reported With Recommendation With Substitute  H-1",16,0,0,0,16
783619,477062,2015-09-24,House,"House Third Reading: Given Immediate Effect Roll Call # 318",104,1,0,0,105
783619,524477,2016-03-24,Senate,"Reported Favorably Without Amendment",8,0,0,0,8
783619,535341,2016-04-19,Senate,"Senate Third Reading: Given Immediate Effect Roll Call # 179",37,0,0,0,37
783622,477614,2015-10-07,House,"Reported With Recommendation With Substitute  H-2",13,0,0,0,13
783622,480273,2015-10-20,House,"House Third Reading: Given Immediate Effect Roll Call # 369",105,0,0,0,105
783622,537619,2016-04-21,Senate,"Reported Favorably With Substitute  S-1",5,0,0,0,5
783622,565756,2016-12-07,Senate,"Senate Third Reading: Given Immediate Effect Roll Call # 685",37,0,0,1,38
783622,566214,2016-12-13,House,"House Third Reading: Roll Call # 620",105,1,0,0,106
783634,476302,2015-09-10,House,"Reported With Recommendation Without Amendment",16,0,0,0,16
783634,477090,2015-09-24,House,"House Third Reading: Given Immediate Effect Roll Call # 317",104,1,0,0,105
783634,524428,2016-03-24,Senate,"Reported Favorably Without Amendment",8,0,0,0,8
783634,535124,2016-04-19,Senate,"Senate Third Reading: Given Immediate Effect Roll Call # 178",37,0,0,0,37
783642,476441,2015-09-10,House,"Reported With Recommendation Without Amendment",16,0,0,0,16
783642,477091,2015-09-24,House,"House Third Reading: Given Immediate Effect Roll Call # 314",104,1,0,0,105
783642,524430,2016-03-24,Senate,"Reported Favorably Without Amendment",8,0,0,0,8
783642,535187,2016-04-19,Senate,"Senate Third Reading: Given Immediate Effect Roll Call # 175",37,0,0,0,37
783811,457311,2015-06-04,Senate,"Reported Favorably With Substitute  S-2",15,0,0,0,15
783811,460245,2015-06-16,Senate,"Senate Third Reading: Passed Roll Call # 295",34,4,0,0,38
783811,473923,2015-08-19,House,"Reported With Recommendation With Substitute H-1",25,0,0,0,25
783811,476932,2015-09-22,House,"House Third Reading: Given Immediate Effect Roll Call # 310",94,10,0,0,104
783811,477409,2015-09-30,Senate,"Senate Third Reading: Roll Call # 383",33,4,0,1,38
783847,466308,2015-07-15,Senate,"Reported Favorably With Substitute  S-1",7,0,0,0,7
783847,477364,2015-09-29,Senate,"Senate Third Reading: Passed Roll Call # 378",35,0,0,3,38
783847,477615,2015-10-07,House,"Reported With Recommendation With Substitute  H-1",13,0,0,0,13
783847,477660,2015-10-08,House,"House Third Reading: Given Immediate Effect Roll Call # 349",106,0,0,0,106
783847,477722,2015-10-14,Senate,"Senate Third Reading: Roll Call # 421",37,0,0,1,38
783857,459666,2015-06-09,Senate,"Reported Favorably Without Amendment",5,3,0,0,8
783868,461199,2015-06-18,Senate,"Reported Favorably With Substitute  S-3",14,0,0,0,14
783868,476391,2015-09-10,Senate,"Senate Third Reading: Passed Roll Call # 357",31,7,0,0,38
783875,466385,2015-07-15,Senate,"Reported Favorably With Substitute  S-1",5,0,0,0,5
783875,477454,2015-10-01,Senate,"Senate Third Reading: Passed Roll Call # 389",35,0,0,3,38
783875,494017,2016-02-09,House,"Reported With Recommendation With Substitute  H-2",18,0,0,0,18
783875,520888,2016-03-16,House,"House Third Reading: Given Immediate Effect Roll Call # 106",109,0,0,0,109
783875,523907,2016-03-23,Senate,"Senate Third Reading: Roll Call # 140",36,0,0,2,38
783880,466423,2015-07-15,Senate,"Reported Favorably With Substitute  S-2",7,0,0,0,7
783880,476832,2015-09-17,Senate,"Senate Third Reading: Passed Roll Call # 365",37,0,0,1,38
783885,477437,2015-10-01,Senate,"Reported Favorably With Recommendation For Referral To Committee On Judiciary",7,0,0,0,7
783885,477628,2015-10-08,Senate,"Reported Favorably With Substitute  S-1",4,1,0,0,5
783885,480447,2015-10-22,Senate,"Senate Third Reading: Passed Roll Call # 461",34,3,0,1,38
783885,481611,2015-12-01,House,"Reported With Recommendation Without Amendment",9,1,0,0,10
783885,501136,2016-02-17,House,"House Third Reading: Given Immediate Effect Roll Call # 42",82,24,0,0,106
783885,502491,2016-02-18,Senate,"Senate Third Reading: House Amendment(s) Concurred In Roll Call # 64",35,2,0,1,38
783903,480434,2015-10-22,Senate,"Reported Favorably Without Amendment",4,1,0,0,5
783903,481597,2015-12-01,Senate,"Senate Third Reading: Passed Roll Call # 534",26,10,0,2,38
783903,539594,2016-04-26,House,"Reported With Recommendation With Substitute  H-2",7,2,0,0,9
783903,546527,2016-05-17,House,"House Third Reading: Given Immediate Effect Roll Call # 278",67,42,0,0,109
783903,546666,2016-05-18,Senate,"Senate Third Reading: Roll Call # 292",25,12,0,0,37
783908,466406,2015-07-15,Senate,"Reported Favorably With Substitute  S-1",6,0,0,0,6
783908,476844,2015-09-17,Senate,"Senate Third Reading: Passed Roll Call # 363",37,0,0,1,38
784052,542080,2016-05-03,Senate,"Reported Favorably With Substitute  S-1",5,0,0,0,5
784055,477404,2015-09-30,Senate,"Reported Favorably Without Amendment",9,0,0,0,9
784055,477711,2015-10-14,Senate,"Senate Third Reading: Passed Roll Call # 426",37,0,0,1,38
784055,511825,2016-03-01,House,"Reported With Recommendation Without Amendment",18,0,0,0,18
784055,520691,2016-03-16,House,"House Third Reading: Given Immediate Effect Roll Call # 112",102,7,0,0,109
784061,477428,2015-09-30,Senate,"Reported Favorably Without Amendment",9,0,0,0,9
784061,477706,2015-10-14,Senate,"Senate Third Reading: Passed Roll Call # 430",36,0,0,2,38
784061,510844,2016-03-01,House,"Reported With Recommendation Without Amendment",18,0,0,0,18
784061,521214,2016-03-17,House,"House Third Reading: Given Immediate Effect Roll Call # 116",101,8,0,0,109
784064,477652,2015-10-08,Senate,"Reported Favorably Without Amendment",7,0,0,0,7
784064,481140,2015-11-10,Senate,"Senate Third Reading: Passed Roll Call # 518",36,0,0,2,38
784069,477413,2015-09-30,Senate,"Reported Favorably Without Amendment",8,0,0,0,8
784069,477725,2015-10-14,Senate,"Senate Third Reading: Passed Roll Call # 425",37,0,0,1,38
784069,510877,2016-03-01,House,"Reported With Recommendation Without Amendment",18,0,0,0,18
784069,520644,2016-03-16,House,"House Third Reading: Given Immediate Effect Roll Call # 111",102,7,0,0,109
784073,464375,2015-06-30,Senate,"Reported Favorably With Substitute  S-1",5,0,0,0,5
784073,476838,2015-09-17,Senate,"Senate Third Reading: Passed Roll Call # 367",37,0,0,1,38
784073,480373,2015-10-21,House,"Reported With Recommendation Without Amendment",13,0,0,0,13
784073,480889,2015-11-04,House,"House Third Reading: Given Immediate Effect Roll Call # 416",82,25,0,0,107
784076,464415,2015-06-30,Senate,"Reported Favorably With Substitute  S-1",5,0,0,0,5
784076,476829,2015-09-17,Senate,"Senate Third Reading: Passed Roll Call # 369",37,0,0,1,38
784076,480354,2015-10-21,House,"Reported With Recommendation Without Amendment",13,0,0,0,13
784076,480881,2015-11-04,House,"House Third Reading: Given Immediate Effect Roll Call # 417",82,25,0,0,107
784080,477396,2015-09-30,Senate,"Reported Favorably Without Amendment",9,0,0,0,9
784080,477715,2015-10-14,Senate,"Senate Third Reading: Passed Roll Call # 431",36,0,0,2,38
784080,511031,2016-03-01,House,"Reported With Recommendation Without Amendment",18,0,0,0,18
784080,521293,2016-03-17,House,"House Third Reading: Given Immediate Effect Roll Call # 117",102,7,0,0,109
784088,477403,2015-09-30,Senate,"Reported Favorably Without Amendment",9,0,0,0,9
784088,477717,2015-10-14,Senate,"Senate Third Reading: Passed Roll Call # 432",36,0,0,2,38
784088,510871,2016-03-01,House,"Reported With Recommendation Without Amendment",19,0,0,0,19
784088,521264,2016-03-17,House,"House Third Reading: Given Immediate Effect Roll Call # 118",102,7,0,0,109
784094,477451,2015-10-01,Senate,"Reported Favorably Without Amendment",9,0,0,0,9
784094,477709,2015-10-14,Senate,"Senate Third Reading: Passed Roll Call # 423",37,0,0,1,38
784094,480929,2015-11-05,House,"Reported With Recommendation Without Amendment",14,0,0,0,14
784094,481166,2015-11-10,House,"House Third Reading: Given Immediate Effect Roll Call # 430",105,0,0,0,105
784103,477430,2015-09-30,Senate,"Reported Favorably Without Amendment",9,0,0,0,9
784103,477720,2015-10-14,Senate,"Senate Third Reading: Passed Roll Call # 427",37,0,0,1,38
784103,510861,2016-03-01,House,"Reported With Recommendation Without Amendment",18,0,0,0,18
784103,520950,2016-03-16,House,"House Third Reading: Given Immediate Effect Roll Call # 113",102,7,0,0,109
784109,477411,2015-09-30,Senate,"Reported Favorably Without Amendment",9,0,0,0,9
784109,477708,2015-10-14,Senate,"Senate Third Reading: Passed Roll Call # 428",37,0,0,1,38
784109,510858,2016-03-01,House,"Reported With Recommendation Without Amendment",18,0,0,0,18
784109,521250,2016-03-16,House,"House Third Reading: Given Immediate Effect Roll Call # 114",101,8,0,0,109
784114,480279,2015-10-20,House,"Reported With Recommendation Without Amendment",11,0,0,0,11
784114,480738,2015-10-29,House,"House Third Reading: Given Immediate Effect Roll Call # 400",104,1,0,0,105
784114,482274,2015-12-10,Senate,"Reported Favorably Without Amendment",5,0,0,0,5
784114,482671,2015-12-16,Senate,"Senate Third Reading: Given Immediate Effect Roll Call # 631",38,0,0,0,38
784133,477416,2015-09-30,Senate,"Reported Favorably Without Amendment",9,0,0,0,9
784133,477719,2015-10-14,Senate,"Senate Third Reading: Passed Roll Call # 429",37,0,0,1,38
784133,510826,2016-03-01,House,"Reported With Recommendation Without Amendment",18,0,0,0,18
784133,521327,2016-03-17,House,"House Third Reading: Given Immediate Effect Roll Call # 115",98,11,0,0,109
784145,477349,2015-09-29,House,"Reported With Recommendation With Substitute  H-4",16,0,0,0,16
784145,477593,2015-10-07,House,"House Third Reading: Passed Roll Call # 339",105,1,0,0,106
784145,481789,2015-12-03,Senate,"Reported Favorably Without Amendment",7,0,0,0,7
784145,482461,2015-12-15,Senate,"Senate Third Reading: Given Immediate Effect Roll Call # 593",38,0,0,0,38
784149,480673,2015-10-27,House,"Reported With Recommendation For Referral To Committee On Local Government",10,0,0,0,10
784149,481639,2015-12-02,House,"Reported With Recommendation Without Amendment",6,5,0,0,11
784149,482219,2015-12-10,House,"House Third Reading: Given Immediate Effect Roll Call # 469",55,51,0,0,106
784149,565310,2016-11-29,Senate,"Reported Favorably Without Amendment",3,1,0,0,4
784149,566437,2016-12-14,Senate,"Senate Third Reading: Given Immediate Effect Roll Call # 779",22,15,0,1,38
784556,461464,2015-06-18,Senate,"Reported Favorably Without Amendment",3,0,0,0,3
784556,476378,2015-09-10,Senate,"Senate Third Reading: Passed Roll Call # 356",28,10,0,0,38
784556,476957,2015-09-22,House,"Reported With Recommendation For Referral To Committee On Criminal Justice",11,0,0,0,11
784582,461391,2015-06-18,Senate,"Reported Favorably Without Amendment",3,0,0,0,3
784582,476450,2015-09-10,Senate,"Senate Third Reading: Passed Roll Call # 354",27,11,0,0,38
784582,476451,2015-09-10,Senate,"Senate Third Reading: Passed Roll Call # 355",27,11,0,0,38
784582,476956,2015-09-22,House,"Reported With Recommendation For Referral To Committee On Criminal Justice",10,0,0,0,10
784639,523457,2016-03-22,House,"Reported With Recommendation With Substitute H-1",9,5,0,0,14
784639,523948,2016-03-22,House,"Reported With Recommendation With Substitute  H-1",9,5,0,0,14
784639,533537,2016-04-14,House,"House Third Reading: Given Immediate Effect Roll Call # 157",57,51,0,0,108
784645,564858,2016-11-10,House,"Reported With Recommendation With Substitute  H-2",18,2,0,0,20
784851,473934,2015-08-19,House,"Reported With Recommendation With Substitute  H-3",10,0,0,0,10
784987,477084,2015-09-24,House,"Reported With Recommendation With Substitute  H-1",6,0,0,0,6
784987,477458,2015-10-01,House,"House Third Reading: Given Immediate Effect Roll Call # 330",106,0,0,0,106
784987,482238,2015-12-10,Senate,"Reported Favorably With Substitute  S-2",5,0,0,0,5
784987,482545,2015-12-15,Senate,"Senate Third Reading: Given Immediate Effect Roll Call # 610",38,0,0,0,38
784987,482562,2015-12-16,House,"House Third Reading: Roll Call # 495",106,0,0,0,106
784992,518198,2016-03-10,Senate,"Reported Favorably With Substitute  S-2",7,0,0,0,7
784992,523772,2016-03-23,Senate,"Senate Third Reading: Passed Roll Call # 133",35,2,0,1,38
784993,460803,2015-06-16,House,"Reported With Recommendation Without Amendment",8,0,0,0,8
784993,473919,2015-08-19,House,"House Third Reading: Given Immediate Effect Roll Call # 292",105,0,0,0,105
784993,477326,2015-09-29,Senate,"Reported Favorably Without Amendment",4,0,0,0,4
784993,486634,2015-12-02,Senate,"Senate Third Reading: Given Immediate Effect Roll Call # 539",37,0,0,1,38
784995,565493,2016-12-01,Senate,"Reported Favorably With Substitute  S-1",3,0,0,0,3
784995,565494,2016-12-01,Senate,"Senate Third Reading: Passed Roll Call # 667",34,2,0,2,38
784995,565727,2016-12-06,House,"Reported With Recommendation With Substitute  H-2",16,1,0,0,17
784995,565960,2016-12-07,House,"House Third Reading: Given Immediate Effect Roll Call # 590",97,10,0,0,107
784995,565961,2016-12-08,Senate,"Senate Third Reading: Roll Call # 707",35,2,0,1,38
785001,480379,2015-10-21,Senate,"Reported Favorably With Substitute  S-2",4,0,0,0,4
785001,480911,2015-11-05,Senate,"Senate Third Reading: Passed Roll Call # 493",38,0,0,0,38
785001,482086,2015-12-09,House,"Reported With Recommendation Without Amendment",9,1,0,0,10
785001,487829,2016-01-26,House,"House Third Reading: Given Immediate Effect Roll Call # 16",73,34,0,0,107
785001,489198,2016-01-28,Senate,"Senate Third Reading: House Amendment(s) Concurred In Roll Call # 16",38,0,0,0,38
785006,477541,2015-10-06,House,"Reported With Recommendation With Substitute  H-1",11,4,0,0,15
785017,460718,2015-06-16,House,"Reported With Recommendation Without Amendment",8,0,0,0,8
785017,473920,2015-08-19,House,"House Third Reading: Given Immediate Effect Roll Call # 294",105,0,0,0,105
785017,477335,2015-09-29,Senate,"Reported Favorably Without Amendment",4,0,0,0,4
785017,486596,2015-12-02,Senate,"Senate Third Reading: Given Immediate Effect Roll Call # 541",37,0,0,1,38
785021,461000,2015-06-16,House,"Reported With Recommendation Without Amendment",8,0,0,0,8
785021,473902,2015-08-19,House,"House Third Reading: Given Immediate Effect Roll Call # 293",105,0,0,0,105
785021,477310,2015-09-29,Senate,"Reported Favorably Without Amendment",4,0,0,0,4
785021,485448,2015-12-02,Senate,"Senate Third Reading: Given Immediate Effect Roll Call # 540",37,0,0,1,38
785480,477634,2015-10-08,Senate,"Reported Favorably With Substitute  S-1",5,0,0,0,5
785480,480300,2015-10-20,Senate,"Senate Third Reading: Passed Roll Call # 446",37,0,0,1,38
785480,481139,2015-11-10,House,"Reported With Recommendation Without Amendment",8,0,0,0,8
785480,481978,2015-12-08,House,"House Third Reading: Given Immediate Effect Roll Call # 455",106,0,0,0,106
785489,548611,2016-05-25,Senate,"Reported Favorably Without Amendment",5,0,0,0,5
785489,563997,2016-10-19,Senate,"Senate Third Reading: Passed Roll Call # 545",37,0,0,0,37
785503,477646,2015-10-08,Senate,"Reported Favorably With Substitute  S-1",5,0,0,0,5
785503,480306,2015-10-20,Senate,"Senate Third Reading: Passed Roll Call # 447",37,0,0,1,38
785503,481137,2015-11-10,House,"Reported With Recommendation Without Amendment",8,0,0,0,8
785503,482029,2015-12-08,House,"House Third Reading: Given Immediate Effect Roll Call # 456",106,0,0,0,106
785528,542956,2016-05-04,Senate,"Reported Favorably With Substitute  S-3",4,0,0,0,4
785528,552312,2016-06-09,Senate,"Senate Third Reading: Passed Roll Call # 450",22,15,0,0,37
785528,565420,2016-12-01,House,"Reported With Recommendation Without Amendment",10,4,0,0,14
785541,477650,2015-10-08,Senate,"Reported Favorably With Substitute  S-1",5,0,0,0,5
785541,480268,2015-10-20,Senate,"Senate Third Reading: Passed Roll Call # 445",37,0,0,1,38
785541,481150,2015-11-10,House,"Reported With Recommendation With Substitute  H-1",8,0,0,0,8
785541,481979,2015-12-08,House,"House Third Reading: Given Immediate Effect Roll Call # 454",106,0,0,0,106
785541,482052,2015-12-09,Senate,"Senate Third Reading: Roll Call # 557",37,0,1,0,38
785541,482053,2015-12-09,Senate,"Senate Third Reading: Roll Call # 558",38,0,0,0,38
785606,481674,2015-12-02,House,"Reported With Recommendation Without Amendment",5,0,0,0,5
785606,482081,2015-12-09,House,"House Third Reading: Given Immediate Effect Roll Call # 467",59,46,0,0,105
785664,462068,2015-06-18,House,"Reported With Recommendation Without Amendment",9,0,0,0,9
785670,462075,2015-06-18,House,"Reported With Recommendation Without Amendment",9,0,0,0,9
785685,480364,2015-10-21,House,"House Third Reading: Given Immediate Effect Roll Call # 373",55,51,0,0,106
785685,480827,2015-11-03,Senate,"Senate Third Reading: Passed Roll Call # 475",20,18,0,0,38
785685,480828,2015-11-03,House,"House Third Reading: Roll Call # 406",54,53,0,0,107
785695,477604,2015-10-07,House,"Reported With Recommendation With Substitute  H-1",11,0,0,0,11
785695,480705,2015-10-28,House,"House Third Reading: Given Immediate Effect Roll Call # 390",103,2,0,0,105
785695,494000,2016-02-09,Senate,"Reported Favorably Without Amendment",5,0,0,0,5
785695,505132,2016-02-23,Senate,"Senate Third Reading: Given Immediate Effect Roll Call # 72",37,0,0,1,38
785700,480365,2015-10-21,House,"House Third Reading: Given Immediate Effect Roll Call # 377",101,5,0,0,106
785700,480825,2015-11-03,Senate,"Senate Third Reading: Passed Roll Call # 477",27,11,0,0,38
785700,480826,2015-11-03,House,"House Third Reading: Roll Call # 409",73,34,0,0,107
785701,480353,2015-10-21,House,"House Third Reading: Given Immediate Effect Roll Call # 374",56,50,0,0,106
785701,480829,2015-11-03,Senate,"Senate Third Reading: Passed Roll Call # 476",20,18,0,0,38
785701,480830,2015-11-03,House,"House Third Reading: Roll Call # 405",55,52,0,0,107
785948,477529,2015-10-06,House,"Reported With Recommendation Without Amendment",11,0,0,0,11
785948,480398,2015-10-22,House,"House Third Reading: Given Immediate Effect Roll Call # 387",101,3,0,0,104
785948,481968,2015-12-08,Senate,"Reported Favorably Without Amendment",5,0,0,0,5
785950,481169,2015-11-10,House,"Reported With Recommendation With Substitute  H-1",9,2,0,0,11
785950,481708,2015-12-03,House,"House Third Reading: Given Immediate Effect Roll Call # 447",90,14,0,0,104
785950,502096,2016-02-18,Senate,"Reported Favorably With Substitute  S-1",5,0,0,0,5
785950,518120,2016-03-10,Senate,"Senate Third Reading: Given Immediate Effect Roll Call # 100",36,0,0,2,38
785950,520637,2016-03-16,House,"House Third Reading: Roll Call # 102",92,17,0,0,109
785958,477594,2015-10-07,House,"Reported With Recommendation Without Amendment",11,0,0,0,11
785958,477723,2015-10-14,House,"House Third Reading: Given Immediate Effect Roll Call # 353",106,0,0,0,106
785958,500566,2016-02-03,Senate,"Reported Favorably Without Amendment",4,0,0,0,4
785958,501616,2016-02-17,Senate,"Senate Third Reading: Given Immediate Effect Roll Call # 61",36,0,0,2,38
785964,477672,2015-10-08,Senate,"Reported Favorably With Amendment(s)",3,1,0,0,4
785967,477530,2015-10-06,House,"Reported With Recommendation Without Amendment",11,0,0,0,11
785967,480470,2015-10-22,House,"House Third Reading: Given Immediate Effect Roll Call # 385",102,2,0,0,104
785967,481972,2015-12-08,Senate,"Reported Favorably Without Amendment",5,0,0,0,5
785973,552328,2016-06-08,House,"Reported With Recommendation Without Amendment",6,0,0,0,6
785975,535524,2016-04-19,House,"Reported With Recommendation With Substitute  H-1",15,0,0,0,15
785980,477528,2015-10-06,House,"Reported With Recommendation With Substitute  H-1",11,0,0,0,11
785980,480443,2015-10-22,House,"House Third Reading: Given Immediate Effect Roll Call # 384",102,2,0,0,104
785980,481988,2015-12-08,Senate,"Reported Favorably With Substitute  S-2",5,0,0,0,5
785980,482530,2015-12-15,Senate,"Senate Third Reading: Given Immediate Effect Roll Call # 595",34,4,0,0,38
785980,482573,2015-12-16,House,"House Third Reading: Roll Call # 496",101,5,0,0,106
785986,552280,2016-06-08,House,"Reported With Recommendation Without Amendment",6,0,0,0,6
785989,535401,2016-04-19,House,"Reported With Recommendation With Substitute  H-2",15,0,0,0,15
785995,477531,2015-10-06,House,"Reported With Recommendation Without Amendment",11,0,0,0,11
785995,480453,2015-10-22,House,"House Third Reading: Given Immediate Effect Roll Call # 386",102,2,0,0,104
785995,482013,2015-12-08,Senate,"Reported Favorably Without Amendment",5,0,0,0,5
785995,482540,2015-12-15,Senate,"Senate Third Reading: Given Immediate Effect Roll Call # 596",35,3,0,0,38
785995,482541,2015-12-15,Senate,"Senate Third Reading: Passed Roll Call # 597",34,4,0,0,38
786005,464801,2015-07-01,Senate,"Reported Favorably With Substitute  S-1",4,1,0,0,5
786005,464802,2015-07-01,Senate,"Senate Third Reading: Given Immediate Effect Roll Call # 346",27,11,0,0,38
786005,480357,2015-10-21,House,"House Third Reading: Given Immediate Effect Roll Call # 375",61,45,0,0,106
786005,480841,2015-11-03,Senate,"Senate Third Reading: Roll Call # 479",28,10,0,0,38
786005,480842,2015-11-03,House,"House Third Reading: Roll Call # 407",61,46,0,0,107
786006,512316,2016-03-02,Senate,"Reported Favorably With Recommendation For Referral To Committee On Families, Seniors And Human Services",4,0,0,0,4
786008,477397,2015-09-30,Senate,"Reported Favorably Without Amendment",4,0,0,0,4
786008,477698,2015-10-13,Senate,"Senate Third Reading: Passed Roll Call # 419",38,0,0,0,38
786008,505212,2016-02-23,House,"Reported With Recommendation Without Amendment",8,0,0,0,8
786008,544520,2016-05-10,House,"House Third Reading: Given Immediate Effect Roll Call # 234",107,1,0,0,108
786012,512853,2016-03-02,Senate,"Reported Favorably With Recommendation For Referral To Committee On Families, Seniors And Human Services",4,0,0,0,4
786014,481718,2015-12-03,Senate,"Reported Favorably With Substitute  S-1",5,0,0,0,5
786014,481719,2015-12-03,Senate,"Senate Third Reading: Passed Roll Call # 545",36,0,0,2,38
786014,481995,2015-12-08,House,"Reported With Recommendation Without Amendment",16,0,0,0,16
786014,482462,2015-12-15,House,"House Third Reading: Given Immediate Effect Roll Call # 481",106,0,0,0,106
786015,477414,2015-09-30,Senate,"Reported Favorably Without Amendment",4,0,0,0,4
786015,477694,2015-10-13,Senate,"Senate Third Reading: Passed Roll Call # 418",38,0,0,0,38
786015,505203,2016-02-23,House,"Reported With Recommendation Without Amendment",8,0,0,0,8
786015,544668,2016-05-10,House,"House Third Reading: Given Immediate Effect Roll Call # 233",107,1,0,0,108
786016,512891,2016-03-02,Senate,"Reported Favorably With Recommendation For Referral To Committee On Families, Seniors And Human Services",4,0,0,0,4
786019,512983,2016-03-02,Senate,"Reported Favorably With Recommendation For Referral To Committee On Families, Seniors And Human Services",4,0,0,0,4
786499,464808,2015-07-01,Senate,"Reported Favorably Without Amendment",4,0,0,0,4
786801,477415,2015-09-30,Senate,"Reported Favorably Without Amendment",4,0,0,0,4
786801,477699,2015-10-13,Senate,"Senate Third Reading: Passed Roll Call # 420",38,0,0,0,38
786851,477328,2015-09-29,Senate,"Reported Favorably Without Amendment",4,0,0,0,4
786851,480366,2015-10-21,Senate,"Senate Third Reading: Passed Roll Call # 451",36,2,0,0,38
786864,477304,2015-09-29,Senate,"Reported Favorably Without Amendment",4,0,0,0,4
786864,480368,2015-10-21,Senate,"Senate Third Reading: Passed Roll Call # 452",36,2,0,0,38
786896,476841,2015-09-17,Senate,"Reported Favorably With Substitute  S-1",4,0,0,0,4
786928,550127,2016-05-31,Senate,"Reported Favorably With Substitute  S-4",7,0,0,0,7
786928,564832,2016-11-10,Senate,"Senate Third Reading: Passed Roll Call # 628",26,10,1,0,37
786928,566496,2016-12-15,House,"House Third Reading: Passed Roll Call # 751",76,31,0,0,107
786928,566497,2016-12-15,Senate,"Senate Third Reading: Roll Call # 857",33,4,0,1,38
786930,477656,2015-10-08,Senate,"Reported Favorably Without Amendment",6,0,0,0,6
786930,480407,2015-10-22,Senate,"Senate Third Reading: Passed Roll Call # 455",37,0,0,1,38
786930,488558,2016-01-27,House,"Reported With Recommendation Without Amendment",13,0,0,0,13
786930,550555,2016-06-01,House,"House Third Reading: Given Immediate Effect Roll Call # 345",108,1,0,0,109
786931,550184,2016-05-31,Senate,"Reported Favorably With Substitute  S-4",6,1,0,0,7
786931,564829,2016-11-10,Senate,"Senate Third Reading: Passed Roll Call # 629",26,11,0,0,37
786931,566492,2016-12-15,House,"House Third Reading: Passed Roll Call # 750",79,28,0,0,107
786931,566493,2016-12-15,Senate,"Senate Third Reading: Roll Call # 856",33,4,0,1,38
786932,477317,2015-09-29,Senate,"Reported Favorably With Substitute  S-1",4,0,0,0,4
786932,477602,2015-10-07,Senate,"Senate Third Reading: Passed Roll Call # 398",38,0,0,0,38
786932,480854,2015-11-03,House,"Reported With Recommendation Without Amendment",8,0,0,0,8
786932,481172,2015-11-10,House,"House Third Reading: Given Immediate Effect Roll Call # 431",105,0,0,0,105
786933,481713,2015-12-03,Senate,"Reported Favorably With Substitute  S-1",5,0,0,0,5
786933,481714,2015-12-03,Senate,"Senate Third Reading: Passed Roll Call # 546",36,0,0,2,38
786933,482035,2015-12-08,House,"Reported With Recommendation Without Amendment",16,0,0,0,16
786933,482465,2015-12-15,House,"House Third Reading: Given Immediate Effect Roll Call # 482",105,1,0,0,106
786933,482466,2015-12-15,Senate,"Senate Third Reading: Roll Call # 623",38,0,0,0,38
786936,550279,2016-05-31,Senate,"Reported Favorably Without Amendment",5,0,0,0,5
786938,481778,2015-12-03,Senate,"Reported Favorably With Substitute  S-1",5,0,0,0,5
786938,481779,2015-12-03,Senate,"Senate Third Reading: Passed Roll Call # 547",36,0,0,2,38
786938,481976,2015-12-08,House,"Reported With Recommendation Without Amendment",16,0,0,0,16
786938,482455,2015-12-15,House,"House Third Reading: Given Immediate Effect Roll Call # 483",105,1,0,0,106
786938,482486,2015-12-15,Senate,"Senate Third Reading: Roll Call # 624",38,0,0,0,38
786939,550209,2016-05-31,Senate,"Reported Favorably With Substitute  S-1",5,0,0,0,5
786941,477651,2015-10-08,Senate,"Reported Favorably With Substitute  S-3",5,0,0,0,5
786941,485968,2016-01-20,Senate,"Senate Third Reading: Passed Roll Call # 6",28,10,0,0,38
786941,523413,2016-03-22,House,"Reported With Recommendation With Substitute H-1",7,3,0,0,10
786941,523910,2016-03-22,House,"Reported With Recommendation With Substitute  H-1",7,3,0,0,10
786941,552388,2016-06-09,House,"House Third Reading: Given Immediate Effect Roll Call # 423",70,37,0,0,107
786941,552389,2016-06-09,Senate,"Senate Third Reading: Roll Call # 476",27,10,0,0,37
786942,477642,2015-10-08,Senate,"Reported Favorably With Substitute  S-1",6,0,0,0,6
786942,480393,2015-10-22,Senate,"Senate Third Reading: Passed Roll Call # 456",37,0,0,1,38
786942,488678,2016-01-27,House,"Reported With Recommendation With Substitute  H-1",13,0,0,0,13
786942,550718,2016-06-01,House,"House Third Reading: Given Immediate Effect Roll Call # 346",107,2,0,0,109
786942,551886,2016-06-07,Senate,"Senate Third Reading: Roll Call # 359",37,0,0,0,37
787459,477379,2015-09-29,House,"Reported With Recommendation Without Amendment",5,3,0,0,8
787459,524779,2016-03-24,House,"House Third Reading: Given Immediate Effect Roll Call # 142",65,43,0,0,108
787459,543080,2016-05-05,Senate,"Reported Favorably Without Amendment",3,1,0,0,4
787459,548511,2016-05-25,Senate,"Senate Third Reading: Given Immediate Effect Roll Call # 329",26,11,0,0,37
787463,477682,2015-10-13,House,"Reported With Recommendation Without Amendment",7,0,0,0,7
787463,480698,2015-10-28,House,"House Third Reading: Given Immediate Effect Roll Call # 398",99,6,0,0,105
787463,536625,2016-04-20,Senate,"Reported Favorably Without Amendment",5,0,0,0,5
787463,543365,2016-05-05,Senate,"Senate Third Reading: Given Immediate Effect Roll Call # 242",35,0,0,2,37
787471,477683,2015-10-13,House,"Reported With Recommendation Without Amendment",7,0,0,0,7
787471,480723,2015-10-28,House,"House Third Reading: Given Immediate Effect Roll Call # 397",103,2,0,0,105
787473,476960,2015-09-22,House,"Reported With Recommendation Without Amendment",4,0,0,0,4
787473,477744,2015-10-15,House,"House Third Reading: Given Immediate Effect Roll Call # 362",103,2,0,0,105
787473,491891,2016-02-04,Senate,"Reported Favorably Without Amendment",5,0,0,0,5
787473,533327,2016-04-14,Senate,"Senate Third Reading: Given Immediate Effect Roll Call # 173",37,0,0,0,37
787479,477716,2015-10-14,House,"Reported With Recommendation Without Amendment",25,0,0,0,25
787479,489251,2016-01-28,House,"House Third Reading: Given Immediate Effect Roll Call # 20",77,29,0,0,106
787485,477684,2015-10-13,House,"Reported With Recommendation Without Amendment",7,0,0,0,7
787485,480727,2015-10-28,House,"House Third Reading: Given Immediate Effect Roll Call # 396",104,1,0,0,105
787488,481170,2015-11-10,House,"Reported With Recommendation With Substitute  H-3",8,0,0,0,8
787577,502306,2016-02-18,House,"Reported With Recommendation With Substitute  H-2",17,0,0,0,17
787584,477405,2015-09-30,House,"Reported With Recommendation Without Amendment",15,0,0,0,15
787584,488428,2016-01-27,House,"House Third Reading: Given Immediate Effect Roll Call # 17",107,0,0,0,107
787584,512121,2016-03-02,Senate,"Reported Favorably Without Amendment",10,0,0,0,10
787584,521224,2016-03-17,Senate,"Senate Third Reading: Given Immediate Effect Roll Call # 119",37,0,0,1,38
787586,476409,2015-09-10,House,"Reported With Recommendation Without Amendment",15,0,0,0,15
787586,476826,2015-09-17,House,"House Third Reading: Given Immediate Effect Roll Call # 303",101,0,0,0,101
787586,481606,2015-12-01,Senate,"Reported Favorably With Substitute  S-1",4,0,0,0,4
787586,482110,2015-12-09,Senate,"Senate Third Reading: Given Immediate Effect Roll Call # 564",38,0,0,0,38
787586,482287,2015-12-10,House,"House Third Reading: Roll Call # 468",106,0,0,0,106
789469,476457,2015-09-10,House,"Reported With Recommendation Without Amendment",5,2,0,0,7
789476,481761,2015-12-03,House,"Reported With Recommendation With Substitute  H-4",8,6,0,0,14
789476,484956,2016-01-13,House,"House Third Reading: Given Immediate Effect Roll Call # 4",58,49,0,0,107
789476,517979,2016-03-10,Senate,"Reported Favorably With Substitute  S-2",3,1,0,0,4
789476,523858,2016-03-23,Senate,"Senate Third Reading: Given Immediate Effect Roll Call # 132",22,15,0,1,38
789476,524596,2016-03-24,House,"House Third Reading: Roll Call # 144",60,48,0,0,108
789481,476936,2015-09-22,House,"Reported With Recommendation Without Amendment",9,2,0,0,11
789481,477579,2015-10-07,House,"House Third Reading: Given Immediate Effect Roll Call # 344",99,7,0,0,106
789481,562297,2016-09-08,Senate,"Senate Third Reading: Given Immediate Effect Roll Call # 497",27,10,0,0,37
789481,562529,2016-09-14,House,"House Third Reading: Roll Call # 452",85,20,0,0,105
789483,477065,2015-09-24,House,"Reported With Recommendation With Substitute  H-5",13,3,0,0,16
789483,477729,2015-10-15,House,"House Third Reading: Given Immediate Effect Roll Call # 355",57,48,0,0,105
789483,523897,2016-03-23,Senate,"Reported Favorably With Substitute  S-6",4,1,0,0,5
789483,523898,2016-03-23,Senate,"Senate Third Reading: Given Immediate Effect Roll Call # 137",31,6,0,1,38
789483,524463,2016-03-24,House,"House Third Reading: Roll Call # 132",49,59,0,0,108
789483,562939,2016-09-21,House,"House Third Reading: Conference Report Adopted Roll Call # 462",60,47,0,0,107
789483,563060,2016-09-21,Senate,"Senate Third Reading: Senate Adopted Conference Report Roll Call # 533",25,10,0,2,37
789494,524595,2016-03-24,House,"Reported With Recommendation With Substitute  H-1",6,0,0,0,6
789494,539396,2016-04-26,House,"House Third Reading: Passed Roll Call # 170",107,1,0,0,108
789494,562872,2016-09-20,Senate,"Reported Favorably Without Amendment",4,0,0,0,4
789494,565499,2016-12-01,Senate,"Senate Third Reading: Given Immediate Effect Roll Call # 652",36,0,0,2,38
789494,566562,2016-12-14,House,"House Third Reading: Senate Amendment(s) Concurred In Roll Call # 672",107,0,0,0,107
789497,476770,2015-09-16,House,"Reported With Recommendation Without Amendment",12,0,0,0,12
789497,480348,2015-10-21,House,"House Third Reading: Given Immediate Effect Roll Call # 371",105,1,0,0,106
789497,502584,2016-02-18,Senate,"Reported Favorably With Substitute  S-1",7,0,0,0,7
789497,550547,2016-06-01,Senate,"Senate Third Reading: Given Immediate Effect Roll Call # 350",36,0,0,1,37
789497,551205,2016-06-02,House,"House Third Reading: Roll Call # 393",107,1,0,0,108
789498,480853,2015-11-03,House,"Reported With Recommendation With Substitute  H-2",17,1,0,0,18
789498,481142,2015-11-10,House,"House Third Reading: Given Immediate Effect Roll Call # 429",101,5,0,0,106
789498,502233,2016-02-18,Senate,"Reported Favorably With Substitute  S-1",10,0,0,0,10
789501,473930,2015-08-19,House,"Reported With Recommendation Without Amendment",10,0,0,0,10
789505,481601,2015-12-01,House,"Reported With Recommendation For Referral To Committee On Local Government",11,0,0,0,11
789505,543740,2016-05-04,House,"Reported With Recommendation With Substitute  H-4",6,3,0,0,9
789507,477539,2015-10-06,House,"Reported With Recommendation Without Amendment",9,0,0,0,9
789507,480314,2015-10-20,House,"House Third Reading: Given Immediate Effect Roll Call # 366",105,0,0,0,105
789507,544591,2016-05-10,Senate,"Reported Favorably Without Amendment",5,0,0,0,5
789507,550556,2016-06-01,Senate,"Senate Third Reading: Given Immediate Effect Roll Call # 351",36,0,0,1,37
789511,476786,2015-09-16,House,"Reported With Recommendation Without Amendment",12,0,0,0,12
789511,480372,2015-10-21,House,"House Third Reading: Given Immediate Effect Roll Call # 370",105,1,0,0,106
789511,502588,2016-02-18,Senate,"Reported Favorably With Substitute  S-1",7,0,0,0,7
789511,550737,2016-06-01,Senate,"Senate Third Reading: Given Immediate Effect Roll Call # 349",36,0,0,1,37
789511,551052,2016-06-02,House,"House Third Reading: Roll Call # 392",107,1,0,0,108
789513,477693,2015-10-13,House,"Reported With Recommendation Without Amendment",6,4,0,0,10
789513,505355,2016-02-23,House,"House Third Reading: Given Immediate Effect Roll Call # 54",106,0,0,0,106
789513,533512,2016-04-14,Senate,"Reported Favorably Without Amendment",4,0,0,0,4
789513,538616,2016-04-26,Senate,"Senate Third Reading: Given Immediate Effect Roll Call # 192",36,0,0,1,37
789517,477425,2015-09-30,House,"Reported With Recommendation Without Amendment",28,0,0,0,28
789517,480304,2015-10-20,Senate,"Reported Favorably Without Amendment",16,0,0,0,16
789578,481171,2015-11-10,House,"Reported With Recommendation Without Amendment",5,3,0,0,8
789579,477355,2015-09-29,House,"Reported With Recommendation Without Amendment",5,3,0,0,8
789579,524778,2016-03-24,House,"House Third Reading: Given Immediate Effect Roll Call # 143",65,43,0,0,108
789579,543101,2016-05-05,Senate,"Reported Favorably Without Amendment",3,1,0,0,4
789579,548439,2016-05-25,Senate,"Senate Third Reading: Given Immediate Effect Roll Call # 330",26,11,0,0,37
789581,481135,2015-11-10,House,"Reported With Recommendation Without Amendment",5,3,0,0,8
789596,546689,2016-05-18,House,"Reported With Recommendation Without Amendment",15,0,0,0,15
789597,477649,2015-10-08,House,"Reported With Recommendation Without Amendment",17,0,0,0,17
789597,477721,2015-10-14,House,"House Third Reading: Given Immediate Effect Roll Call # 351",106,0,0,0,106
789597,480745,2015-10-29,Senate,"Reported Favorably Without Amendment",8,0,0,0,8
789597,481123,2015-11-10,Senate,"Senate Third Reading: Given Immediate Effect Roll Call # 513",36,0,0,2,38
789602,546692,2016-05-18,House,"Reported With Recommendation Without Amendment",15,0,0,0,15
789605,477554,2015-10-06,House,"Reported With Recommendation Without Amendment",7,0,0,0,7
789605,477718,2015-10-14,House,"House Third Reading: Given Immediate Effect Roll Call # 352",106,0,0,0,106
789605,481133,2015-11-10,Senate,"Reported Favorably Without Amendment",4,0,0,0,4
789605,486649,2015-12-09,Senate,"Senate Third Reading: Given Immediate Effect Roll Call # 562",38,0,0,0,38
790040,476782,2015-09-16,Senate,"Reported Favorably Without Amendment",10,0,0,0,10
790279,480352,2015-10-21,Senate,"Reported Favorably Without Amendment",10,0,0,0,10
790279,480912,2015-11-05,Senate,"Senate Third Reading: Passed Roll Call # 492",38,0,0,0,38
790279,494032,2016-02-09,House,"Reported With Recommendation Without Amendment",20,0,0,0,20
790279,510928,2016-03-01,House,"House Third Reading: Given Immediate Effect Roll Call # 73",103,2,0,0,105
790285,477174,2015-09-24,Senate,"Reported Favorably Without Amendment",4,0,0,0,4
790286,477731,2015-10-15,Senate,"Reported Favorably With Substitute  S-2",4,1,0,0,5
790299,492041,2016-02-04,Senate,"Reported Favorably Without Amendment",7,0,0,0,7
790302,491967,2016-02-04,Senate,"Reported Favorably Without Amendment",7,0,0,0,7
790340,492013,2016-02-04,Senate,"Reported Favorably Without Amendment",7,0,0,0,7
790360,491750,2016-02-04,Senate,"Reported Favorably Without Amendment",7,0,0,0,7
790363,477324,2015-09-29,Senate,"Reported Favorably With Substitute  S-1",4,0,0,0,4
790363,477653,2015-10-08,Senate,"Senate Third Reading: Passed Roll Call # 417",31,5,0,2,38
790363,531442,2016-04-12,House,"Reported With Recommendation Without Amendment",8,1,0,0,9
790363,546902,2016-05-18,House,"House Third Reading: Given Immediate Effect Roll Call # 298",64,45,0,0,109
790366,477438,2015-10-01,Senate,"Reported Favorably With Substitute  S-1",5,0,0,0,5
790366,477734,2015-10-15,Senate,"Senate Third Reading: Passed Roll Call # 436",37,0,0,1,38
790366,481974,2015-12-08,House,"Reported With Recommendation With Substitute  H-1",9,0,0,0,9
790366,482559,2015-12-16,House,"House Third Reading: Given Immediate Effect Roll Call # 489",105,0,0,0,105
790366,482596,2015-12-16,Senate,"Senate Third Reading: Roll Call # 635",38,0,0,0,38
790401,477305,2015-09-29,Senate,"Reported Favorably With Substitute  S-1",3,0,0,0,3
790401,477465,2015-10-01,Senate,"Senate Third Reading: Passed Roll Call # 390",34,1,0,3,38
790401,531429,2016-04-12,House,"Reported With Recommendation Without Amendment",7,1,0,0,8
790401,546293,2016-05-17,House,"House Third Reading: Given Immediate Effect Roll Call # 276",102,7,0,0,109
790404,476783,2015-09-16,Senate,"Reported Favorably Without Amendment",10,0,0,0,10
790404,476820,2015-09-17,Senate,"Senate Third Reading: Passed Roll Call # 372",34,3,0,1,38
790404,476939,2015-09-22,House,"Reported With Recommendation Without Amendment",19,0,0,0,19
790404,477072,2015-09-24,House,"House Third Reading: Given Immediate Effect Roll Call # 322",104,1,0,0,105
790407,547101,2016-05-19,Senate,"Reported Favorably With Substitute  S-1",8,0,0,0,8
790407,563049,2016-09-21,Senate,"Senate Third Reading: Passed Roll Call # 520",34,1,0,2,37
790407,565980,2016-12-07,House,"Reported With Recommendation With Substitute  H-4",13,1,0,0,14
790429,476731,2015-09-10,House,"Reported With Recommendation Without Amendment",4,0,0,0,4
790429,476732,2015-09-11,House,"House Third Reading: Adopted By 2/3 Vote Roll Call # 296",91,12,0,0,103
790433,480647,2015-10-27,House,"Reported With Recommendation Without Amendment",15,1,0,0,16
790433,481167,2015-11-10,House,"House Third Reading: Given Immediate Effect Roll Call # 419",95,11,0,0,106
790433,490398,2016-02-02,Senate,"Reported Favorably Without Amendment",5,0,0,0,5
790433,494001,2016-02-09,Senate,"Senate Third Reading: Given Immediate Effect Roll Call # 35",27,10,0,1,38
790443,480624,2015-10-27,House,"Reported With Recommendation Without Amendment",16,0,0,0,16
790443,481148,2015-11-10,House,"House Third Reading: Given Immediate Effect Roll Call # 420",101,5,0,0,106
790443,490396,2016-02-02,Senate,"Reported Favorably Without Amendment",5,0,0,0,5
790443,494031,2016-02-09,Senate,"Senate Third Reading: Given Immediate Effect Roll Call # 36",33,4,0,1,38
790448,476364,2015-09-10,House,"Reported With Recommendation Without Amendment",4,0,0,0,4
790448,476365,2015-09-10,House,"House Third Reading: Not Adopted Roll Call # 295",67,14,0,0,81
790452,520030,2016-03-15,House,"Reported With Recommendation For Referral To Committee On Agriculture",6,0,0,0,6
790452,539235,2016-04-27,House,"Reported With Recommendation With Substitute  H-1",16,0,0,0,16
790452,546280,2016-05-17,House,"House Third Reading: Given Immediate Effect Roll Call # 279",104,5,0,0,109
790452,565726,2016-12-06,Senate,"Reported Favorably With Substitute  S-1",4,0,0,0,4
790452,565958,2016-12-07,Senate,"Senate Third Reading: Given Immediate Effect Roll Call # 697",35,1,1,1,38
790452,566197,2016-12-13,House,"House Third Reading: Roll Call # 621",101,6,0,0,107
790503,480631,2015-10-27,House,"Reported With Recommendation With Substitute H-1",16,0,0,0,16
790503,480787,2015-10-27,House,"Reported With Recommendation With Substitute  H-1",16,0,0,0,16
790516,480425,2015-10-22,Senate,"Reported Favorably With Substitute  S-1",4,0,0,0,4
790519,480696,2015-10-28,Senate,"Reported Favorably With Substitute  S-3",5,0,0,0,5
790519,481162,2015-11-10,Senate,"Senate Third Reading: Passed Roll Call # 512",36,0,0,2,38
790519,499394,2016-02-16,House,"Reported With Recommendation Without Amendment",10,0,0,0,10
790519,511169,2016-03-01,House,"House Third Reading: Given Immediate Effect Roll Call # 78",105,0,0,0,105
790522,477687,2015-10-13,House,"Reported With Recommendation Without Amendment",7,0,0,0,7
790522,480703,2015-10-28,House,"House Third Reading: Given Immediate Effect Roll Call # 399",103,2,0,0,105
790522,536579,2016-04-20,Senate,"Reported Favorably With Substitute  S-1",5,0,0,0,5
790522,543061,2016-05-05,Senate,"Senate Third Reading: Given Immediate Effect Roll Call # 243",35,0,0,2,37
790522,544574,2016-05-10,House,"House Third Reading: Roll Call # 228",107,1,0,0,108
790526,481845,2015-12-03,Senate,"Reported Favorably With Substitute  S-1",5,0,0,0,5
790526,482181,2015-12-10,Senate,"Senate Third Reading: Passed Roll Call # 581",38,0,0,0,38
790526,501176,2016-02-17,House,"Reported With Recommendation With Substitute  H-2",28,0,0,0,28
790526,512189,2016-03-02,House,"House Third Reading: Given Immediate Effect Roll Call # 82",103,0,0,0,103
790526,513885,2016-03-03,Senate,"Senate Third Reading: Roll Call # 84",38,0,0,0,38
790530,481119,2015-11-10,Senate,"Reported Favorably Without Amendment",4,0,0,0,4
790530,482023,2015-12-08,Senate,"Senate Third Reading: Passed Roll Call # 556",37,0,0,1,38
790531,481579,2015-12-01,Senate,"Reported Favorably With Substitute  S-1",4,1,0,0,5
790531,485869,2015-12-08,Senate,"Senate Third Reading: Passed Roll Call # 553",36,1,0,1,38
790531,524003,2016-03-23,House,"Reported With Recommendation With Substitute  H-1",10,0,0,0,10
790531,550186,2016-05-31,House,"House Third Reading: Given Immediate Effect Roll Call # 335",104,5,0,0,109
790531,550516,2016-06-01,Senate,"Senate Third Reading: Roll Call # 357",36,0,0,1,37
790534,481712,2015-12-03,Senate,"Reported Favorably Without Amendment",5,0,0,0,5
790534,482186,2015-12-10,Senate,"Senate Third Reading: Passed Roll Call # 582",38,0,0,0,38
790534,500938,2016-02-17,House,"Reported With Recommendation With Substitute  H-1",25,3,0,0,28
790534,524579,2016-03-24,House,"House Third Reading: Given Immediate Effect Roll Call # 140",90,18,0,0,108
790534,524580,2016-03-24,Senate,"Senate Third Reading: Roll Call # 153",36,0,0,2,38
790539,481109,2015-11-10,Senate,"Reported Favorably Without Amendment",4,0,0,0,4
790539,481977,2015-12-08,Senate,"Senate Third Reading: Passed Roll Call # 555",37,0,0,1,38
790539,535121,2016-04-19,House,"Reported With Recommendation With Substitute  H-2",11,0,0,0,11
790539,551132,2016-06-02,House,"House Third Reading: Given Immediate Effect Roll Call # 352",108,0,0,0,108
790539,551964,2016-06-07,Senate,"Senate Third Reading: Roll Call # 360",37,0,0,0,37
790542,482216,2015-12-10,Senate,"Reported Favorably With Substitute  S-1",5,0,0,0,5
790542,482510,2015-12-15,Senate,"Senate Third Reading: Passed Roll Call # 611",38,0,0,0,38
790542,505398,2016-02-23,House,"Reported With Recommendation With Substitute  H-1",14,3,0,0,17
790542,524710,2016-03-24,House,"House Third Reading: Given Immediate Effect Roll Call # 147",59,49,0,0,108
790542,532386,2016-04-12,Senate,"Senate Third Reading: Roll Call # 161",28,8,0,1,37
790543,477073,2015-09-24,Senate,"Reported Favorably Without Amendment",5,0,0,0,5
790543,477648,2015-10-08,Senate,"Senate Third Reading: Passed Roll Call # 416",36,0,0,2,38
790543,480369,2015-10-21,House,"Reported With Recommendation Without Amendment",16,0,0,0,16
790543,552392,2016-06-09,House,"House Third Reading: Given Immediate Effect Roll Call # 429",103,6,0,0,109
790546,481175,2015-11-10,Senate,"Reported Favorably With Substitute  S-1",4,0,0,0,4
790546,482027,2015-12-08,Senate,"Senate Third Reading: Passed Roll Call # 554",37,0,0,1,38
790549,480442,2015-10-22,Senate,"Reported Favorably Without Amendment",4,0,0,0,4
790553,481753,2015-12-03,Senate,"Reported Favorably With Substitute  S-2",5,0,0,0,5
790553,482279,2015-12-10,Senate,"Senate Third Reading: Passed Roll Call # 580",38,0,0,0,38
790553,500961,2016-02-17,House,"Reported With Recommendation With Substitute  H-1",28,0,0,0,28
790553,513011,2016-03-02,House,"House Third Reading: Given Immediate Effect Roll Call # 81",103,0,0,0,103
790553,513720,2016-03-03,Senate,"Senate Third Reading: Roll Call # 83",38,0,0,0,38
790780,477640,2015-10-08,Senate,"Reported Favorably Without Amendment",4,1,0,0,5
790780,481173,2015-11-10,Senate,"Senate Third Reading: Passed Roll Call # 510",27,10,0,1,38
790780,482037,2015-12-08,House,"Reported With Recommendation Without Amendment",11,6,0,0,17
790780,482569,2015-12-16,House,"House Third Reading: Given Immediate Effect Roll Call # 493",59,46,0,0,105
790786,477633,2015-10-08,Senate,"Reported Favorably With Substitute  S-2",4,1,0,0,5
790786,480930,2015-11-05,Senate,"Senate Third Reading: Passed Roll Call # 490",30,8,0,0,38
790786,480931,2015-11-05,Senate,"Senate Third Reading: Passed Roll Call # 501",27,11,0,0,38
790787,477639,2015-10-08,Senate,"Reported Favorably Without Amendment",4,1,0,0,5
790787,481143,2015-11-10,Senate,"Senate Third Reading: Passed Roll Call # 511",26,10,1,1,38
790787,481981,2015-12-08,House,"Reported With Recommendation Without Amendment",11,6,0,0,17
790787,482567,2015-12-16,House,"House Third Reading: Given Immediate Effect Roll Call # 494",60,45,0,0,105
790793,499703,2016-02-16,Senate,"Reported Favorably Without Amendment",5,0,0,0,5
790793,512209,2016-03-02,Senate,"Senate Third Reading: Passed Roll Call # 82",38,0,0,0,38
790795,477306,2015-09-29,Senate,"Reported Favorably With Substitute  S-1",5,2,0,0,7
790795,477447,2015-10-01,Senate,"Senate Third Reading: Passed Roll Call # 393",26,9,0,3,38
790795,481759,2015-12-03,House,"Reported With Recommendation Without Amendment",8,5,0,0,13
790795,482278,2015-12-10,House,"House Third Reading: Given Immediate Effect Roll Call # 474",60,46,0,0,106
790804,482000,2015-12-08,House,"Reported With Recommendation With Substitute  H-2",7,0,0,0,7
790804,489221,2016-01-28,House,"House Third Reading: Given Immediate Effect Roll Call # 21",89,17,0,0,106
790804,495677,2016-02-10,Senate,"Reported Favorably Without Amendment",4,0,0,0,4
790806,481146,2015-11-10,House,"Reported With Recommendation For Referral To Committee On Judiciary",8,0,0,0,8
790814,490442,2016-02-02,House,"Reported With Recommendation With Substitute  H-2",9,1,0,0,10
790814,520887,2016-03-16,House,"House Third Reading: Given Immediate Effect Roll Call # 110",95,14,0,0,109
790825,500034,2016-02-16,House,"Reported With Recommendation With Substitute  H-1",14,0,0,0,14
790825,510975,2016-03-01,House,"House Third Reading: Given Immediate Effect Roll Call # 80",105,0,0,0,105
790825,565729,2016-12-06,Senate,"Senate Third Reading: Given Immediate Effect Roll Call # 680",37,0,0,1,38
790827,480367,2015-10-21,House,"Reported With Recommendation With Substitute H-2",13,0,0,0,13
790888,481588,2015-12-01,Senate,"Reported Favorably With Substitute  S-2",8,2,0,0,10
790888,500831,2016-02-03,Senate,"Senate Third Reading: Passed Roll Call # 23",36,0,0,2,38
790888,516057,2016-03-08,House,"Reported With Recommendation Without Amendment",18,0,0,0,18
790888,521240,2016-03-17,House,"House Third Reading: Given Immediate Effect Roll Call # 120",109,0,0,0,109
790894,490485,2016-02-02,Senate,"Reported Favorably With Substitute  S-3",5,0,0,0,5
790894,499740,2016-02-04,Senate,"Senate Third Reading: Passed Roll Call # 32",37,0,0,1,38
790894,522816,2016-03-22,House,"Reported With Recommendation With Substitute H-1",12,2,0,0,14
790894,523864,2016-03-22,House,"Reported With Recommendation With Substitute  H-1",12,2,0,0,14
790894,545412,2016-05-12,House,"House Third Reading: Passed Roll Call # 263",90,18,0,0,108
790894,546229,2016-05-17,Senate,"Senate Third Reading: Roll Call # 264",37,0,0,0,37
791077,517097,2016-03-09,House,"Reported With Recommendation With Amendment(s)",12,3,0,0,15
791077,521338,2016-03-17,House,"House Third Reading: Given Immediate Effect Roll Call # 124",68,41,0,0,109
791077,524456,2016-03-24,Senate,"Reported Favorably With Substitute  S-1",6,1,0,0,7
791077,524457,2016-03-24,Senate,"Senate Third Reading: Given Immediate Effect Roll Call # 149",28,8,0,2,38
791078,480892,2015-11-04,House,"Reported With Recommendation Without Amendment",13,0,0,0,13
791078,481634,2015-12-02,House,"House Third Reading: Given Immediate Effect Roll Call # 437",106,0,0,0,106
791078,502363,2016-02-18,Senate,"Reported Favorably Without Amendment",7,0,0,0,7
791078,516909,2016-03-09,Senate,"Senate Third Reading: Given Immediate Effect Roll Call # 91",37,0,0,1,38
791079,480355,2015-10-21,House,"Reported With Recommendation With Substitute  H-4",24,2,0,0,26
791079,512686,2016-03-02,House,"House Third Reading: Given Immediate Effect Roll Call # 83",83,20,0,0,103
791079,565732,2016-12-06,Senate,"Reported Favorably With Substitute  S-2",4,0,0,0,4
791083,477095,2015-09-24,House,"Reported With Recommendation With Amendment(s)",8,0,0,0,8
791083,477463,2015-10-01,House,"House Third Reading: Given Immediate Effect Roll Call # 334",105,1,0,0,106
791083,480608,2015-10-27,Senate,"Reported Favorably Without Amendment",5,0,0,0,5
791083,480916,2015-11-05,Senate,"Senate Third Reading: Given Immediate Effect Roll Call # 497",38,0,0,0,38
791083,481106,2015-11-10,House,"House Third Reading: Senate Amendment(s) Concurred In Roll Call # 418",105,1,0,0,106
791085,488633,2016-01-27,House,"Reported With Recommendation Without Amendment",13,0,0,0,13
791092,488878,2016-01-27,House,"Reported With Recommendation With Substitute  H-1",13,0,0,0,13
791094,480922,2015-11-05,House,"Reported With Recommendation With Substitute  H-2",11,0,0,0,11
791094,481147,2015-11-10,House,"House Third Reading: Given Immediate Effect Roll Call # 428",105,1,0,0,106
791094,494892,2016-02-10,Senate,"Reported Favorably Without Amendment",4,0,0,0,4
791094,505837,2016-02-23,Senate,"Senate Third Reading: Given Immediate Effect Roll Call # 73",37,0,0,1,38
791099,480318,2015-10-20,House,"Reported With Recommendation For Referral To Committee On Criminal Justice",16,0,0,0,16
791156,477582,2015-10-07,House,"Reported With Recommendation Without Amendment",7,0,0,0,7
791159,480310,2015-10-20,Senate,"Reported Favorably Without Amendment",3,0,0,0,3
791159,480893,2015-11-04,Senate,"Senate Third Reading: Passed Roll Call # 482",38,0,0,0,38
791159,490446,2016-02-02,House,"Reported With Recommendation Without Amendment",10,1,0,0,11
791159,495141,2016-02-10,House,"House Third Reading: Given Immediate Effect Roll Call # 37",106,0,0,0,106
791161,480851,2015-11-03,Senate,"Reported Favorably With Substitute  S-1",5,0,0,0,5
791161,481969,2015-12-08,Senate,"Senate Third Reading: Passed Roll Call # 552",37,0,0,1,38
791161,487907,2016-01-26,House,"Reported With Recommendation Without Amendment",15,0,0,0,15
791161,493952,2016-02-09,House,"House Third Reading: Given Immediate Effect Roll Call # 29",105,0,0,0,105
791162,538782,2016-04-26,Senate,"Reported Favorably With Substitute  S-1",4,0,0,0,4
791162,544819,2016-05-10,Senate,"Senate Third Reading: Passed Roll Call # 261",31,6,0,0,37
791162,548655,2016-05-25,House,"Reported With Recommendation Without Amendment",15,0,0,0,15
791162,551990,2016-06-07,House,"House Third Reading: Given Immediate Effect Roll Call # 400",104,4,0,0,108
791162,552324,2016-06-09,Senate,"Senate Third Reading: Roll Call # 435",36,1,0,0,37
791164,481723,2015-12-03,Senate,"Reported Favorably Without Amendment",4,0,0,0,4
791164,482283,2015-12-10,Senate,"Senate Third Reading: Passed Roll Call # 583",37,1,0,0,38
791164,505397,2016-02-23,House,"Reported With Recommendation Without Amendment",9,0,0,0,9
791164,521080,2016-03-16,House,"House Third Reading: Given Immediate Effect Roll Call # 107",99,10,0,0,109
791165,544956,2016-05-11,House,"Reported With Recommendation Without Amendment",8,0,0,0,8
791166,500074,2016-02-16,Senate,"Reported Favorably Without Amendment",5,0,0,0,5
791166,518500,2016-03-10,Senate,"Senate Third Reading: Passed Roll Call # 99",36,0,0,2,38
791166,565988,2016-12-07,House,"Reported With Recommendation With Substitute  H-1",14,0,0,0,14
791166,566756,2016-12-14,House,"House Third Reading: Passed Roll Call # 691",107,0,0,0,107
791166,566757,2016-12-14,Senate,"Senate Third Reading: Roll Call # 808",37,0,0,1,38
791167,481590,2015-12-01,Senate,"Reported Favorably Without Amendment",5,0,0,0,5
791167,482088,2015-12-09,Senate,"Senate Third Reading: Passed Roll Call # 570",38,0,0,0,38
791167,510809,2016-03-01,House,"Reported With Recommendation Without Amendment",7,0,0,0,7
791167,532689,2016-04-13,House,"House Third Reading: Given Immediate Effect Roll Call # 154",109,0,0,0,109
791168,481586,2015-12-01,Senate,"Reported Favorably With Substitute  S-3",5,0,0,0,5
791168,482063,2015-12-09,Senate,"Senate Third Reading: Passed Roll Call # 569",38,0,0,0,38
791168,511057,2016-03-01,House,"Reported With Recommendation Without Amendment",7,0,0,0,7
791168,532492,2016-04-13,House,"House Third Reading: Given Immediate Effect Roll Call # 153",109,0,0,0,109
791169,477659,2015-10-08,Senate,"Reported Favorably With Substitute  S-2",4,0,0,0,4
791169,480320,2015-10-20,Senate,"Senate Third Reading: Passed Roll Call # 444",30,7,0,1,38
791169,480839,2015-11-03,House,"Reported With Recommendation With Substitute  H-1",8,3,0,0,11
791169,481107,2015-11-10,House,"House Third Reading: Given Immediate Effect Roll Call # 421",83,23,0,0,106
791169,481108,2015-11-10,Senate,"Senate Third Reading: Roll Call # 531",28,8,0,2,38
791172,538610,2016-04-26,Senate,"Reported Favorably With Substitute  S-2",4,0,0,0,4
791172,544500,2016-05-10,Senate,"Senate Third Reading: Passed Roll Call # 260",30,7,0,0,37
791172,548549,2016-05-25,House,"Reported With Recommendation With Substitute  H-3",16,0,0,0,16
791172,551809,2016-06-07,House,"House Third Reading: Given Immediate Effect Roll Call # 399",104,4,0,0,108
791172,552311,2016-06-09,Senate,"Senate Third Reading: Roll Call # 434",36,1,0,0,37
791174,477550,2015-10-06,House,"Reported With Recommendation Without Amendment",9,0,0,0,9
791175,480362,2015-10-21,Senate,"Reported Favorably With Substitute  S-2",5,0,0,0,5
791175,480878,2015-11-04,Senate,"Senate Third Reading: Passed Roll Call # 487",38,0,0,0,38
791175,564841,2016-11-10,House,"Reported With Recommendation With Substitute  H-2",12,2,0,0,14
791175,566074,2016-12-07,House,"House Third Reading: Given Immediate Effect Roll Call # 565",83,23,0,0,106
791175,566075,2016-12-08,Senate,"Senate Third Reading: Roll Call # 703",37,0,0,1,38
791757,480708,2015-10-28,House,"Reported With Recommendation With Substitute  H-1",15,0,0,0,15
791763,482230,2015-12-10,Senate,"Reported Favorably With Substitute  S-2",5,0,0,0,5
791763,482514,2015-12-15,Senate,"Senate Third Reading: Passed Roll Call # 616",38,0,0,0,38
791763,488456,2016-01-27,House,"Reported With Recommendation Without Amendment",7,0,0,0,7
791763,551204,2016-06-02,House,"House Third Reading: Given Immediate Effect Roll Call # 379",106,2,0,0,108
791763,551822,2016-06-07,Senate,"Senate Third Reading: House Amendment(s) Concurred In Roll Call # 361",37,0,0,0,37
791766,480629,2015-10-27,Senate,"Reported Favorably Without Amendment",4,0,0,0,4
791766,481128,2015-11-10,Senate,"Senate Third Reading: Passed Roll Call # 519",33,3,0,2,38
791767,486535,2016-01-21,Senate,"Reported Favorably With Substitute  S-1",5,0,0,0,5
791767,490748,2016-02-02,Senate,"Senate Third Reading: Passed Roll Call # 20",37,0,0,1,38
791767,565957,2016-12-07,House,"Reported With Recommendation Without Amendment",29,0,0,0,29
791767,566494,2016-12-15,House,"House Third Reading: Passed Roll Call # 731",104,4,0,0,108
791768,480664,2015-10-27,Senate,"Reported Favorably Without Amendment",4,0,0,0,4
791768,481132,2015-11-10,Senate,"Senate Third Reading: Passed Roll Call # 520",32,4,0,2,38
791768,481970,2015-12-08,House,"Reported With Recommendation With Substitute  H-1",11,0,0,0,11
791768,482556,2015-12-16,House,"House Third Reading: Given Immediate Effect Roll Call # 490",99,6,0,0,105
791768,482595,2015-12-16,Senate,"Senate Third Reading: Roll Call # 636",33,5,0,0,38
791770,480284,2015-10-20,Senate,"Reported Favorably Without Amendment",3,0,0,0,3
791770,480882,2015-11-04,Senate,"Senate Third Reading: Passed Roll Call # 483",38,0,0,0,38
791770,481111,2015-11-10,House,"Reported With Recommendation With Substitute  H-1",10,0,0,0,10
791770,482031,2015-12-08,House,"House Third Reading: Given Immediate Effect Roll Call # 457",106,0,0,0,106
791770,482049,2015-12-09,Senate,"Senate Third Reading: Roll Call # 559",38,0,0,0,38
791776,565668,2016-12-06,House,"Reported With Recommendation With Substitute  H-2",8,0,0,0,8
791777,505224,2016-02-23,House,"Reported With Recommendation With Substitute  H-1",9,1,0,0,10
791777,521215,2016-03-17,House,"House Third Reading: Given Immediate Effect Roll Call # 119",102,7,0,0,109
791777,564033,2016-10-20,Senate,"Reported Favorably With Substitute S-1",4,0,0,0,4
791777,564034,2016-10-20,Senate,"Senate Third Reading: Given Immediate Effect Roll Call # 605",22,14,0,1,37
791777,564842,2016-11-09,House,"House Third Reading: Roll Call # 501",93,12,0,0,105
791784,480305,2015-10-20,Senate,"Reported Favorably With Substitute  S-1",3,0,0,0,3
791784,480886,2015-11-04,Senate,"Senate Third Reading: Passed Roll Call # 484",38,0,0,0,38
791784,481136,2015-11-10,House,"Reported With Recommendation With Substitute  H-1",11,0,0,0,11
791784,482039,2015-12-08,House,"House Third Reading: Given Immediate Effect Roll Call # 458",106,0,0,0,106
791784,482074,2015-12-09,Senate,"Senate Third Reading: Roll Call # 560",38,0,0,0,38
791788,480634,2015-10-27,House,"Reported With Recommendation Without Amendment",9,0,0,0,9
791790,486537,2016-01-21,Senate,"Reported Favorably With Substitute  S-1",5,0,0,0,5
791790,490853,2016-02-02,Senate,"Senate Third Reading: Passed Roll Call # 19",37,0,0,1,38
791790,566055,2016-12-07,House,"Reported With Recommendation Without Amendment",28,0,0,0,28
791790,566517,2016-12-15,House,"House Third Reading: Passed Roll Call # 730",106,2,0,0,108
791793,480670,2015-10-27,Senate,"Reported Favorably Without Amendment",5,0,0,0,5
791793,481127,2015-11-10,Senate,"Senate Third Reading: Passed Roll Call # 522",30,6,0,2,38
791794,480655,2015-10-27,Senate,"Reported Favorably Without Amendment",4,0,0,0,4
791794,481144,2015-11-10,Senate,"Senate Third Reading: Passed Roll Call # 521",31,5,0,2,38
791794,482012,2015-12-08,House,"Reported With Recommendation With Substitute  H-1",11,0,0,0,11
791794,482563,2015-12-16,House,"House Third Reading: Given Immediate Effect Roll Call # 491",100,5,0,0,105
791794,482733,2015-12-16,Senate,"Senate Third Reading: Roll Call # 637",33,5,0,0,38
791801,546273,2016-05-17,House,"Reported With Recommendation With Substitute  H-2",11,0,0,0,11
791801,565453,2016-12-01,House,"House Third Reading: Given Immediate Effect Roll Call # 532",105,3,0,0,108
791868,477662,2015-10-08,Senate,"Reported Favorably With Substitute  S-2",5,0,0,0,5
791868,477730,2015-10-15,Senate,"Senate Third Reading: Passed Roll Call # 438",35,2,0,1,38
791868,481154,2015-11-10,House,"Reported With Recommendation With Substitute  H-2",10,0,0,0,10
791868,482490,2015-12-15,House,"House Third Reading: Given Immediate Effect Roll Call # 478",100,6,0,0,106
791868,482491,2015-12-15,Senate,"Senate Third Reading: Roll Call # 619",34,1,3,0,38
791868,482492,2015-12-15,Senate,"Senate Third Reading: Roll Call # 620",36,1,1,0,38
791873,477632,2015-10-08,Senate,"Reported Favorably With Substitute  S-1",5,0,0,0,5
791873,477752,2015-10-15,Senate,"Senate Third Reading: Passed Roll Call # 439",37,0,0,1,38
791873,481149,2015-11-10,House,"Reported With Recommendation With Substitute  H-1",10,0,0,0,10
791873,482458,2015-12-15,House,"House Third Reading: Given Immediate Effect Roll Call # 479",97,9,0,0,106
791873,482546,2015-12-15,Senate,"Senate Third Reading: Roll Call # 621",38,0,0,0,38
791875,477655,2015-10-08,Senate,"Reported Favorably With Substitute  S-1",5,0,0,0,5
791875,477748,2015-10-15,Senate,"Senate Third Reading: Passed Roll Call # 440",37,0,0,1,38
791875,481165,2015-11-10,House,"Reported With Recommendation With Substitute  H-2",11,0,0,0,11
791875,482528,2015-12-15,House,"House Third Reading: Given Immediate Effect Roll Call # 480",98,8,0,0,106
791875,482529,2015-12-15,Senate,"Senate Third Reading: Roll Call # 622",38,0,0,0,38
791968,477737,2015-10-15,Senate,"Reported Favorably With Substitute  S-1",7,0,0,0,7
791968,480707,2015-10-28,Senate,"Senate Third Reading: Passed Roll Call # 464",37,0,0,1,38
791968,481581,2015-12-01,House,"Reported With Recommendation With Substitute  H-2",18,0,0,0,18
791968,482224,2015-12-10,House,"House Third Reading: Given Immediate Effect Roll Call # 471",106,0,0,0,106
791968,482527,2015-12-15,Senate,"Senate Third Reading: Roll Call # 588",38,0,0,0,38
791971,480315,2015-10-20,Senate,"Reported Favorably With Substitute  S-2",7,0,0,0,7
791971,480733,2015-10-29,Senate,"Senate Third Reading: Passed Roll Call # 473",36,0,0,2,38
791971,484979,2016-01-14,House,"Reported With Recommendation With Substitute  H-1",13,0,0,0,13
791971,488880,2016-01-27,House,"House Third Reading: Given Immediate Effect Roll Call # 18",98,9,0,0,107
791971,489158,2016-01-28,Senate,"Senate Third Reading: Roll Call # 17",38,0,0,0,38
791972,480295,2015-10-20,Senate,"Reported Favorably Without Amendment",7,0,0,0,7
791972,480741,2015-10-29,Senate,"Senate Third Reading: Passed Roll Call # 474",36,0,0,2,38
791972,485015,2016-01-14,House,"Reported With Recommendation Without Amendment",13,0,0,0,13
791972,488907,2016-01-27,House,"House Third Reading: Given Immediate Effect Roll Call # 19",100,7,0,0,107
791974,480896,2015-11-04,House,"Reported With Recommendation With Substitute  H-1",13,0,0,0,13
791974,481161,2015-11-10,House,"House Third Reading: Given Immediate Effect Roll Call # 427",81,25,0,0,106
791974,482239,2015-12-10,Senate,"Reported Favorably Without Amendment",7,0,0,0,7
791974,482523,2015-12-15,Senate,"Senate Third Reading: Given Immediate Effect Roll Call # 615",38,0,0,0,38
791974,482571,2015-12-16,House,"House Third Reading: Roll Call # 497",81,25,0,0,106
791978,480751,2015-10-29,House,"Reported With Recommendation With Substitute  H-1",17,0,0,0,17
791978,481134,2015-11-10,House,"House Third Reading: Given Immediate Effect Roll Call # 422",105,1,0,0,106
791978,550793,2016-06-01,Senate,"Reported Favorably With Substitute  S-1",7,0,0,0,7
791978,552342,2016-06-09,Senate,"Senate Third Reading: Given Immediate Effect Roll Call # 442",36,1,0,0,37
791978,552343,2016-06-09,House,"House Third Reading: Roll Call # 438",108,1,0,0,109
791982,480768,2015-10-29,House,"Reported With Recommendation With Substitute  H-1",17,0,0,0,17
791982,481159,2015-11-10,House,"House Third Reading: Given Immediate Effect Roll Call # 424",103,3,0,0,106
791982,550612,2016-06-01,Senate,"Reported Favorably With Substitute  S-1",7,0,0,0,7
791982,552289,2016-06-09,Senate,"Senate Third Reading: Given Immediate Effect Roll Call # 444",35,2,0,0,37
791982,552290,2016-06-09,House,"House Third Reading: Roll Call # 440",106,3,0,0,109
791986,480740,2015-10-29,House,"Reported With Recommendation With Substitute  H-1",17,0,0,0,17
791986,481158,2015-11-10,House,"House Third Reading: Given Immediate Effect Roll Call # 423",105,1,0,0,106
791986,550781,2016-06-01,Senate,"Reported Favorably With Substitute  S-1",7,0,0,0,7
791986,552384,2016-06-09,Senate,"Senate Third Reading: Given Immediate Effect Roll Call # 443",36,1,0,0,37
791986,552385,2016-06-09,House,"House Third Reading: Roll Call # 439",108,1,0,0,109
792168,494447,2016-02-09,Senate,"Reported Favorably With Substitute  S-3",5,0,0,0,5
792168,518475,2016-03-10,Senate,"Senate Third Reading: Passed Roll Call # 98",36,0,0,2,38
792168,565630,2016-11-29,House,"Reported With Recommendation Without Amendment",14,0,0,0,14
792168,566502,2016-12-14,House,"House Third Reading: Passed Roll Call # 684",101,5,0,0,106
792174,477742,2015-10-15,Senate,"Reported Favorably Without Amendment",7,0,0,0,7
792174,480710,2015-10-28,Senate,"Senate Third Reading: Passed Roll Call # 465",37,0,0,1,38
792174,520709,2016-03-16,House,"Reported With Recommendation Without Amendment",13,0,0,0,13
792184,477728,2015-10-15,Senate,"Reported Favorably Without Amendment",7,0,0,0,7
792184,480697,2015-10-28,Senate,"Senate Third Reading: Passed Roll Call # 466",37,0,0,1,38
792184,520583,2016-03-16,House,"Reported With Recommendation Without Amendment",13,0,0,0,13
792269,482220,2015-12-10,Senate,"Reported Favorably With Substitute  S-1",3,2,0,0,5
792269,482459,2015-12-15,Senate,"Senate Third Reading: Passed Roll Call # 608",38,0,0,0,38
792269,510966,2016-03-01,House,"Reported With Recommendation With Substitute H-1",11,0,0,0,11
792269,520731,2016-03-16,House,"House Third Reading: Given Immediate Effect Roll Call # 104",109,0,0,0,109
792269,521163,2016-03-17,Senate,"Senate Third Reading: Roll Call # 116",37,0,0,1,38
792279,499415,2016-02-16,House,"Reported With Recommendation Without Amendment",8,0,0,0,8
792279,539111,2016-04-27,House,"House Third Reading: Passed Roll Call # 194",92,16,0,0,108
792282,499331,2016-02-16,House,"Reported With Recommendation With Substitute  H-2",8,0,0,0,8
792282,539798,2016-04-28,House,"House Third Reading: Passed Roll Call # 202",96,13,0,0,109
792283,499300,2016-02-16,House,"Reported With Recommendation Without Amendment",8,0,0,0,8
792283,539131,2016-04-27,House,"House Third Reading: Passed Roll Call # 190",91,17,0,0,108
792286,499412,2016-02-16,House,"Reported With Recommendation With Substitute  H-1",8,0,0,0,8
792286,539109,2016-04-27,House,"House Third Reading: Passed Roll Call # 195",92,16,0,0,108
792288,499430,2016-02-16,House,"Reported With Recommendation With Substitute  H-1",8,0,0,0,8
792288,539115,2016-04-27,House,"House Third Reading: Passed Roll Call # 193",92,16,0,0,108
792290,501196,2016-02-16,House,"Reported With Recommendation Without Amendment",8,0,0,0,8
792290,540389,2016-04-28,House,"House Third Reading: Passed Roll Call # 200",90,19,0,0,109
792292,501194,2016-02-16,House,"Reported With Recommendation Without Amendment",8,0,0,0,8
792292,539071,2016-04-27,House,"House Third Reading: Passed Roll Call # 189",93,15,0,0,108
792294,500980,2016-02-16,House,"Reported With Recommendation Without Amendment",8,0,0,0,8
792294,540335,2016-04-28,House,"House Third Reading: Passed Roll Call # 203",93,16,0,0,109
792296,500954,2016-02-16,House,"Reported With Recommendation Without Amendment",8,0,0,0,8
792296,539081,2016-04-27,House,"House Third Reading: Passed Roll Call # 192",93,15,0,0,108
792299,499449,2016-02-16,House,"Reported With Recommendation With Substitute  H-1",8,0,0,0,8
792299,539428,2016-04-27,House,"House Third Reading: Passed Roll Call # 197",91,17,0,0,108
792300,500818,2016-02-16,House,"Reported With Recommendation Without Amendment",8,0,0,0,8
792300,539133,2016-04-27,House,"House Third Reading: Passed Roll Call # 182",92,16,0,0,108
792303,500989,2016-02-16,House,"Reported With Recommendation Without Amendment",8,0,0,0,8
792303,539475,2016-04-27,House,"House Third Reading: Passed Roll Call # 186",93,15,0,0,108
792304,501052,2016-02-16,House,"Reported With Recommendation Without Amendment",8,0,0,0,8
792304,539519,2016-04-27,House,"House Third Reading: Passed Roll Call # 184",92,16,0,0,108
792307,499303,2016-02-16,House,"Reported With Recommendation With Substitute  H-1",8,0,0,0,8
792307,539586,2016-04-27,House,"House Third Reading: Passed Roll Call # 183",92,16,0,0,108
792308,500986,2016-02-16,House,"Reported With Recommendation Without Amendment",8,0,0,0,8
792308,539253,2016-04-27,House,"House Third Reading: Passed Roll Call # 187",92,16,0,0,108
792311,500098,2016-02-16,House,"Reported With Recommendation Without Amendment",8,0,0,0,8
792311,539093,2016-04-27,House,"House Third Reading: Passed Roll Call # 196",91,17,0,0,108
792312,539591,2016-04-26,House,"Reported With Recommendation With Substitute  H-1",7,0,0,0,7
792312,540351,2016-04-28,House,"House Third Reading: Passed Roll Call # 204",99,10,0,0,109
792316,500964,2016-02-16,House,"Reported With Recommendation Without Amendment",8,0,0,0,8
792316,539935,2016-04-28,House,"House Third Reading: Passed Roll Call # 201",97,12,0,0,109
792319,499384,2016-02-16,House,"Reported With Recommendation Without Amendment",8,0,0,0,8
792319,539543,2016-04-27,House,"House Third Reading: Passed Roll Call # 188",92,16,0,0,108
792320,499298,2016-02-16,House,"Reported With Recommendation Without Amendment",8,0,0,0,8
792320,539135,2016-04-27,House,"House Third Reading: Passed Roll Call # 191",92,16,0,0,108
792373,480890,2015-11-04,Senate,"Reported Favorably Without Amendment",5,0,0,0,5
792375,481711,2015-12-03,Senate,"Reported Favorably Without Amendment",9,0,0,0,9
792375,482284,2015-12-10,Senate,"Senate Third Reading: Passed Roll Call # 584",38,0,0,0,38
792375,489032,2016-01-27,House,"Reported With Recommendation Without Amendment",15,0,0,0,15
792375,501101,2016-02-17,House,"House Third Reading: Given Immediate Effect Roll Call # 44",104,2,0,0,106
792377,480678,2015-10-27,Senate,"Reported Favorably Without Amendment",5,0,0,0,5
792377,480894,2015-11-04,Senate,"Senate Third Reading: Passed Roll Call # 488",38,0,0,0,38
792377,480925,2015-11-05,House,"Reported With Recommendation Without Amendment",4,0,0,0,4
792377,481636,2015-12-02,House,"House Third Reading: Given Immediate Effect Roll Call # 436",87,19,0,0,106
792378,480933,2015-11-05,Senate,"Reported Favorably Without Amendment",9,1,0,0,10
792378,481117,2015-11-10,Senate,"Senate Third Reading: Passed Roll Call # 508",23,12,2,1,38
792378,481118,2015-11-10,Senate,"Senate Third Reading: Passed Roll Call # 509",25,12,0,1,38
792378,481675,2015-12-02,House,"Reported With Recommendation With Substitute  H-3",18,10,0,0,28
792378,482260,2015-12-10,House,"House Third Reading: Given Immediate Effect Roll Call # 470",59,47,0,0,106
792378,482533,2015-12-15,Senate,"Senate Third Reading: Roll Call # 589",20,18,0,0,38
792380,481794,2015-12-03,Senate,"Reported Favorably Without Amendment",9,0,0,0,9
792380,482285,2015-12-10,Senate,"Senate Third Reading: Passed Roll Call # 585",38,0,0,0,38
792380,489173,2016-01-27,House,"Reported With Recommendation With Substitute  H-1",15,0,0,0,15
792380,501619,2016-02-17,House,"House Third Reading: Given Immediate Effect Roll Call # 45",104,2,0,0,106
792380,502556,2016-02-18,Senate,"Senate Third Reading: Roll Call # 65",37,0,0,1,38
792697,480391,2015-10-22,Senate,"Reported Favorably With Substitute  S-1",5,0,0,0,5
792697,480921,2015-11-05,Senate,"Senate Third Reading: Passed Roll Call # 494",34,4,0,0,38
792697,565570,2016-11-29,House,"Reported With Recommendation With Substitute  H-2",6,3,0,0,9
792697,566207,2016-12-13,House,"House Third Reading: Passed Roll Call # 634",66,42,0,0,108
792697,566208,2016-12-13,Senate,"Senate Third Reading: Roll Call # 746",32,4,1,1,38
792697,566209,2016-12-13,Senate,"Senate Third Reading: Roll Call # 747",33,4,0,1,38
792698,480426,2015-10-22,Senate,"Reported Favorably Without Amendment",5,0,0,0,5
792698,480927,2015-11-05,Senate,"Senate Third Reading: Passed Roll Call # 495",34,4,0,0,38
792700,477747,2015-10-15,Senate,"Reported Favorably With Substitute  S-1",4,1,0,0,5
792702,550170,2016-05-31,Senate,"Reported Favorably Without Amendment",6,1,0,0,7
792702,550171,2016-05-31,Senate,"Senate Third Reading: Passed Roll Call # 348",37,0,0,0,37
792702,552380,2016-06-08,House,"Reported With Recommendation Without Amendment",14,0,0,0,14
792702,552381,2016-06-09,House,"House Third Reading: Given Immediate Effect Roll Call # 431",109,0,0,0,109
792704,480441,2015-10-22,Senate,"Reported Favorably With Substitute  S-1",5,0,0,0,5
792704,480915,2015-11-05,Senate,"Senate Third Reading: Passed Roll Call # 496",34,4,0,0,38
792704,565562,2016-11-29,House,"Reported With Recommendation With Substitute  H-1",6,3,0,0,9
792704,566228,2016-12-13,House,"House Third Reading: Passed Roll Call # 635",66,42,0,0,108
792704,566229,2016-12-13,Senate,"Senate Third Reading: Roll Call # 748",33,4,0,1,38
792709,481637,2015-12-02,House,"Reported With Recommendation With Substitute  H-1",8,0,0,0,8
792709,545501,2016-05-12,House,"House Third Reading: Given Immediate Effect Roll Call # 260",108,0,0,0,108
792709,565718,2016-12-06,Senate,"Reported Favorably Without Amendment",5,0,0,0,5
792711,481635,2015-12-02,House,"Reported With Recommendation Without Amendment",8,0,0,0,8
792711,545539,2016-05-12,House,"House Third Reading: Given Immediate Effect Roll Call # 261",107,1,0,0,108
792711,565698,2016-12-06,Senate,"Reported Favorably Without Amendment",5,0,0,0,5
792713,491752,2016-02-04,House,"Reported With Recommendation With Substitute  H-1",8,0,0,0,8
792713,513289,2016-03-03,House,"House Third Reading: Given Immediate Effect Roll Call # 86",103,0,0,0,103
792713,562827,2016-09-20,Senate,"Reported Favorably Without Amendment",4,0,0,0,4
792713,566383,2016-12-14,Senate,"Senate Third Reading: Given Immediate Effect Roll Call # 784",37,0,0,1,38
792717,539722,2016-04-28,House,"Reported With Recommendation For Referral To Committee On Families, Children, And Seniors",7,3,0,0,10
792718,518383,2016-03-09,House,"Reported With Recommendation Without Amendment",13,0,0,0,13
792718,532135,2016-04-12,House,"House Third Reading: Given Immediate Effect Roll Call # 148",108,0,0,0,108
792718,543370,2016-05-05,Senate,"Reported Favorably Without Amendment",7,0,0,0,7
792718,548027,2016-05-24,Senate,"Senate Third Reading: Given Immediate Effect Roll Call # 314",37,0,0,0,37
792722,481589,2015-12-01,House,"Reported With Recommendation Without Amendment",9,1,0,0,10
792722,486120,2016-01-20,House,"House Third Reading: Given Immediate Effect Roll Call # 8",92,14,0,0,106
792722,491976,2016-02-04,Senate,"Reported Favorably Without Amendment",4,0,0,0,4
792722,502469,2016-02-18,Senate,"Senate Third Reading: Given Immediate Effect Roll Call # 67",37,0,0,1,38
792725,559083,2016-08-03,House,"Reported With Recommendation With Substitute H-6",5,0,0,0,5
792725,566027,2016-12-08,House,"House Third Reading: Passed Roll Call # 613",108,0,0,0,108
792725,566402,2016-12-14,Senate,"Reported Favorably Without Amendment",4,1,0,0,5
792725,566403,2016-12-14,Senate,"Senate Third Reading: Passed Roll Call # 786",37,0,0,1,38
792726,480351,2015-10-21,House,"Reported With Recommendation With Substitute  H-1",7,0,0,0,7
792726,481598,2015-12-01,House,"House Third Reading: Given Immediate Effect Roll Call # 434",87,19,0,0,106
792726,482248,2015-12-10,Senate,"Reported Favorably With Substitute  S-1",5,0,0,0,5
792726,482808,2015-12-16,Senate,"Senate Third Reading: Given Immediate Effect Roll Call # 633",38,0,0,0,38
792726,484920,2016-01-13,House,"House Third Reading: Roll Call # 2",93,14,0,0,107
792728,540377,2016-04-28,House,"Reported With Recommendation For Referral To Committee On Families, Children, And Seniors",7,3,0,0,10
792731,540253,2016-04-28,House,"Reported With Recommendation For Referral To Committee On Families, Children, And Seniors",7,3,0,0,10
792732,531370,2016-04-12,House,"Reported With Recommendation For Referral To Committee On Appropriations",13,1,0,0,14
792733,481677,2015-12-02,House,"Reported With Recommendation With Substitute  H-3",8,0,0,0,8
792733,545517,2016-05-12,House,"House Third Reading: Given Immediate Effect Roll Call # 259",107,1,0,0,108
792733,565711,2016-12-06,Senate,"Reported Favorably Without Amendment",5,0,0,0,5
792832,494887,2016-02-10,Senate,"Reported Favorably Without Amendment",5,0,0,0,5
792832,505872,2016-02-23,Senate,"Senate Third Reading: Passed Roll Call # 74",37,0,0,1,38
792834,499950,2016-02-16,Senate,"Reported Favorably Without Amendment",4,1,0,0,5
792834,539528,2016-04-27,Senate,"Senate Third Reading: Passed Roll Call # 196",26,10,0,1,37
792834,565678,2016-12-06,House,"Reported With Recommendation With Substitute  H-1",14,5,0,0,19
792834,566529,2016-12-14,House,"House Third Reading: Passed Roll Call # 688",69,37,0,0,106
792834,566530,2016-12-14,Senate,"Senate Third Reading: Roll Call # 806",26,11,0,1,38
792841,499605,2016-02-16,Senate,"Reported Favorably Without Amendment",4,1,0,0,5
792841,539028,2016-04-27,Senate,"Senate Third Reading: Passed Roll Call # 197",26,10,0,1,37
792841,565736,2016-12-06,House,"Reported With Recommendation With Substitute  H-1",13,6,0,0,19
792841,566558,2016-12-14,House,"House Third Reading: Passed Roll Call # 689",68,39,0,0,107
792841,566559,2016-12-14,Senate,"Senate Third Reading: Roll Call # 807",26,11,0,1,38
792865,480926,2015-11-05,House,"Reported With Recommendation With Substitute  H-1",11,0,0,0,11
792865,482022,2015-12-08,House,"House Third Reading: Given Immediate Effect Roll Call # 448",102,4,0,0,106
792865,536816,2016-04-20,Senate,"Reported Favorably With Substitute  S-1",5,0,0,0,5
792865,541522,2016-05-03,Senate,"Senate Third Reading: Given Immediate Effect Roll Call # 223",34,0,2,1,37
792865,544817,2016-05-10,House,"House Third Reading: Roll Call # 223",104,4,0,0,108
792867,480932,2015-11-05,House,"Reported With Recommendation With Substitute  H-1",11,0,0,0,11
792867,481973,2015-12-08,House,"House Third Reading: Given Immediate Effect Roll Call # 452",102,4,0,0,106
792867,536591,2016-04-20,Senate,"Reported Favorably With Substitute  S-1",5,0,0,0,5
792867,542162,2016-05-03,Senate,"Senate Third Reading: Given Immediate Effect Roll Call # 227",37,0,0,0,37
792867,544752,2016-05-10,House,"House Third Reading: Roll Call # 227",104,4,0,0,108
792869,480924,2015-11-05,House,"Reported With Recommendation With Substitute  H-1",11,0,0,0,11
792869,482036,2015-12-08,House,"House Third Reading: Given Immediate Effect Roll Call # 449",102,4,0,0,106
792869,536614,2016-04-20,Senate,"Reported Favorably With Substitute  S-1",5,0,0,0,5
792869,541751,2016-05-03,Senate,"Senate Third Reading: Given Immediate Effect Roll Call # 224",35,0,0,2,37
792869,544505,2016-05-10,House,"House Third Reading: Roll Call # 224",104,4,0,0,108
792870,480908,2015-11-05,House,"Reported With Recommendation With Substitute  H-1",11,0,0,0,11
792870,482011,2015-12-08,House,"House Third Reading: Given Immediate Effect Roll Call # 450",102,4,0,0,106
792870,536599,2016-04-20,Senate,"Reported Favorably With Substitute  S-1",5,0,0,0,5
792870,541749,2016-05-03,Senate,"Senate Third Reading: Given Immediate Effect Roll Call # 225",37,0,0,0,37
792870,544495,2016-05-10,House,"House Third Reading: Roll Call # 225",104,4,0,0,108
792871,480928,2015-11-05,House,"Reported With Recommendation With Substitute  H-1",11,0,0,0,11
792871,482001,2015-12-08,House,"House Third Reading: Given Immediate Effect Roll Call # 451",102,4,0,0,106
792871,536651,2016-04-20,Senate,"Reported Favorably With Substitute  S-1",5,0,0,0,5
792871,541784,2016-05-03,Senate,"Senate Third Reading: Given Immediate Effect Roll Call # 226",37,0,0,0,37
792871,544531,2016-05-10,House,"House Third Reading: Roll Call # 226",104,4,0,0,108
792999,500484,2016-02-03,Senate,"Reported Favorably Without Amendment",4,0,0,0,4
792999,501123,2016-02-17,Senate,"Senate Third Reading: Passed Roll Call # 60",36,0,0,2,38
792999,545018,2016-05-11,House,"Reported With Recommendation Without Amendment",10,0,0,0,10
792999,548019,2016-05-24,House,"House Third Reading: Given Immediate Effect Roll Call # 315",105,1,0,0,106
793018,519973,2016-03-15,House,"Reported With Recommendation Without Amendment",18,0,0,0,18
793036,480767,2015-10-29,Senate,"Reported Favorably Without Amendment",5,0,0,0,5
793036,480891,2015-11-04,Senate,"Senate Third Reading: Given Immediate Effect Roll Call # 489",38,0,0,0,38
793036,482117,2015-12-09,House,"Reported With Recommendation Without Amendment",8,0,0,0,8
793036,482560,2015-12-16,House,"House Third Reading: Given Immediate Effect Roll Call # 504",58,48,0,0,106
793036,482597,2015-12-16,Senate,"Senate Third Reading: Roll Call # 655",25,12,0,1,38
793054,552204,2016-06-08,Senate,"Reported Favorably With Substitute  S-1",5,2,0,0,7
793054,563134,2016-09-21,Senate,"Senate Third Reading: Passed Roll Call # 523",24,10,1,2,37
793057,481138,2015-11-10,House,"Reported With Recommendation Without Amendment",16,0,0,0,16
793057,495079,2016-02-10,House,"House Third Reading: Given Immediate Effect Roll Call # 32",106,0,0,0,106
793057,523608,2016-03-22,Senate,"Reported Favorably Without Amendment",5,0,0,0,5
793057,524662,2016-03-24,Senate,"Senate Third Reading: Given Immediate Effect Roll Call # 147",36,0,0,2,38
793081,482076,2015-12-09,House,"Reported With Recommendation With Substitute  H-1",14,0,0,0,14
793081,486163,2016-01-20,House,"House Third Reading: Given Immediate Effect Roll Call # 11",105,1,0,0,106
793081,562337,2016-09-07,Senate,"Reported Favorably With Substitute  S-2",9,0,0,0,9
793081,562389,2016-09-07,Senate,"Reported Favorably With Substitute S-2",9,0,0,0,9
793081,565859,2016-12-07,Senate,"Senate Third Reading: Given Immediate Effect Roll Call # 686",37,0,0,1,38
793081,566289,2016-12-13,House,"House Third Reading: Roll Call # 622",107,0,0,0,107
793088,480895,2015-11-04,House,"Reported With Recommendation With Substitute  H-1",16,1,0,0,17
793088,481790,2015-12-03,House,"House Third Reading: Given Immediate Effect Roll Call # 446",99,5,0,0,104
793088,500071,2016-02-16,Senate,"Reported Favorably Without Amendment",5,0,0,0,5
793088,509122,2016-02-24,Senate,"Senate Third Reading: Given Immediate Effect Roll Call # 78",37,1,0,0,38
795728,481587,2015-12-01,Senate,"Reported Favorably Without Amendment",7,0,0,0,7
795728,482242,2015-12-10,Senate,"Senate Third Reading: Passed Roll Call # 577",38,0,0,0,38
795728,494930,2016-02-10,House,"Reported With Recommendation With Substitute  H-1",8,0,0,0,8
795728,505172,2016-02-23,House,"House Third Reading: Passed Roll Call # 56",96,10,0,0,106
795728,505173,2016-02-23,House,"House Third Reading: Given Immediate Effect Roll Call # 57",93,13,0,0,106
795728,509165,2016-02-24,Senate,"Senate Third Reading: Roll Call # 75",36,0,0,2,38
795744,482507,2015-12-15,House,"Reported With Recommendation With Substitute  H-5",11,1,0,0,12
795936,481176,2015-11-10,House,"Reported With Recommendation With Substitute  H-1",10,0,0,0,10
795936,482054,2015-12-09,House,"House Third Reading: Given Immediate Effect Roll Call # 465",104,1,0,0,105
795936,518199,2016-03-10,Senate,"Reported Favorably With Substitute  S-1",8,0,0,0,8
795936,546696,2016-05-18,Senate,"Senate Third Reading: Given Immediate Effect Roll Call # 306",37,0,0,0,37
795936,550204,2016-05-31,House,"House Third Reading: Roll Call # 332",107,2,0,0,109
795937,481174,2015-11-10,House,"Reported With Recommendation With Substitute  H-2",10,0,0,0,10
795937,482085,2015-12-09,House,"House Third Reading: Given Immediate Effect Roll Call # 460",104,2,0,0,106
795937,518214,2016-03-10,Senate,"Reported Favorably With Substitute  S-1",8,0,0,0,8
795937,546947,2016-05-18,Senate,"Senate Third Reading: Given Immediate Effect Roll Call # 301",37,0,0,0,37
795937,550282,2016-05-31,House,"House Third Reading: Roll Call # 327",109,0,0,0,109
795939,481181,2015-11-10,House,"Reported With Recommendation With Substitute  H-2",10,0,0,0,10
795939,482057,2015-12-09,House,"House Third Reading: Given Immediate Effect Roll Call # 462",89,17,0,0,106
795939,518421,2016-03-10,Senate,"Reported Favorably With Substitute  S-1",8,0,0,0,8
795939,546641,2016-05-18,Senate,"Senate Third Reading: Given Immediate Effect Roll Call # 303",37,0,0,0,37
795939,550158,2016-05-31,House,"House Third Reading: Roll Call # 329",109,0,0,0,109
795943,562952,2016-09-21,House,"Reported With Recommendation With Substitute  H-3",15,0,0,0,15
795943,565516,2016-12-01,House,"House Third Reading: Passed Roll Call # 537",103,4,0,0,107
795947,510906,2016-03-01,House,"Reported With Recommendation With Substitute H-1",10,1,0,0,11
795947,537199,2016-03-01,House,"Reported With Recommendation With Substitute  H-1",10,1,0,0,11
795947,539172,2016-04-26,House,"House Third Reading: Given Immediate Effect Roll Call # 169",107,1,0,0,108
795947,565394,2016-11-30,Senate,"Reported Favorably Without Amendment",5,0,0,0,5
795947,565883,2016-12-07,Senate,"Senate Third Reading: Given Immediate Effect Roll Call # 689",37,0,0,1,38
795950,481179,2015-11-10,House,"Reported With Recommendation With Substitute  H-1",10,0,0,0,10
795950,482108,2015-12-09,House,"House Third Reading: Given Immediate Effect Roll Call # 463",105,1,0,0,106
795950,518190,2016-03-10,Senate,"Reported Favorably With Substitute  S-1",8,0,0,0,8
795950,546972,2016-05-18,Senate,"Senate Third Reading: Given Immediate Effect Roll Call # 304",37,0,0,0,37
795950,550166,2016-05-31,House,"House Third Reading: Roll Call # 330",109,0,0,0,109
795951,481178,2015-11-10,House,"Reported With Recommendation Without Amendment",10,0,0,0,10
795951,482058,2015-12-09,House,"House Third Reading: Given Immediate Effect Roll Call # 464",105,1,0,0,106
795951,518196,2016-03-10,Senate,"Reported Favorably With Substitute  S-1",8,0,0,0,8
795951,546936,2016-05-18,Senate,"Senate Third Reading: Given Immediate Effect Roll Call # 305",37,0,0,0,37
795951,550322,2016-05-31,House,"House Third Reading: Roll Call # 331",109,0,0,0,109
795953,481116,2015-11-10,House,"Reported With Recommendation With Substitute  H-1",10,0,0,0,10
795953,482062,2015-12-09,House,"House Third Reading: Given Immediate Effect Roll Call # 461",105,1,0,0,106
795953,518191,2016-03-10,Senate,"Reported Favorably With Substitute  S-1",8,0,0,0,8
795953,546694,2016-05-18,Senate,"Senate Third Reading: Given Immediate Effect Roll Call # 302",37,0,0,0,37
795953,550063,2016-05-31,House,"House Third Reading: Roll Call # 328",109,0,0,0,109
795954,480706,2015-10-28,House,"Reported With Recommendation Without Amendment",7,1,0,0,8
795954,481124,2015-11-10,House,"House Third Reading: Given Immediate Effect Roll Call # 425",88,18,0,0,106
795954,486538,2016-01-21,Senate,"Reported Favorably Without Amendment",5,0,0,0,5
795954,503065,2016-02-03,Senate,"Senate Third Reading: Given Immediate Effect Roll Call # 22",36,0,0,2,38
795960,481735,2015-12-03,Senate,"Reported Favorably Without Amendment",6,0,0,0,6
795960,520860,2016-03-16,Senate,"Senate Third Reading: Passed Roll Call # 108",37,1,0,0,38
795960,565554,2016-11-30,House,"Reported With Recommendation Without Amendment",8,2,0,0,10
795961,482213,2015-12-10,Senate,"Reported Favorably Without Amendment",7,0,0,0,7
795961,482479,2015-12-15,Senate,"Senate Third Reading: Passed Roll Call # 613",38,0,0,0,38
795961,520719,2016-03-16,House,"Reported With Recommendation With Substitute  H-2",13,0,0,0,13
795961,524727,2016-03-24,House,"House Third Reading: Given Immediate Effect Roll Call # 138",108,0,0,0,108
795961,524728,2016-03-24,Senate,"Senate Third Reading: Roll Call # 155",36,0,0,2,38
795968,482191,2015-12-10,Senate,"Reported Favorably Without Amendment",7,0,0,0,7
795968,482537,2015-12-15,Senate,"Senate Third Reading: Passed Roll Call # 612",38,0,0,0,38
795968,520752,2016-03-16,House,"Reported With Recommendation With Substitute  H-3",13,0,0,0,13
795968,524766,2016-03-24,House,"House Third Reading: Given Immediate Effect Roll Call # 137",108,0,0,0,108
795968,524767,2016-03-24,Senate,"Senate Third Reading: Roll Call # 154",36,0,0,2,38
795976,482178,2015-12-10,Senate,"Reported Favorably With Substitute  S-1",5,0,0,0,5
795976,482520,2015-12-15,Senate,"Senate Third Reading: Passed Roll Call # 617",38,0,0,0,38
795976,488661,2016-01-27,House,"Reported With Recommendation Without Amendment",7,0,0,0,7
795976,500860,2016-02-17,House,"House Third Reading: Given Immediate Effect Roll Call # 43",102,4,0,0,106
795980,481122,2015-11-10,Senate,"Reported Favorably With Substitute  S-1",4,0,0,0,4
795980,482112,2015-12-09,Senate,"Senate Third Reading: Passed Roll Call # 568",37,1,0,0,38
795980,523648,2016-03-22,House,"Reported With Recommendation With Substitute H-2",7,2,0,0,9
795980,524176,2016-03-22,House,"Reported With Recommendation With Substitute  H-2",7,2,0,0,9
795985,480846,2015-11-03,Senate,"Reported Favorably Without Amendment",5,0,0,0,5
795986,481131,2015-11-10,Senate,"Reported Favorably Without Amendment",4,0,0,0,4
796038,480760,2015-10-29,House,"Reported With Recommendation Without Amendment",9,0,0,0,9
796047,481157,2015-11-10,House,"Reported With Recommendation With Substitute  H-1",10,0,0,0,10
796047,481680,2015-12-02,House,"House Third Reading: Given Immediate Effect Roll Call # 441",94,12,0,0,106
796047,482481,2015-12-15,Senate,"Senate Third Reading: Given Immediate Effect Roll Call # 592",38,0,0,0,38
796052,481160,2015-11-10,House,"Reported With Recommendation With Substitute  H-1",10,0,0,0,10
796052,481640,2015-12-02,House,"House Third Reading: Given Immediate Effect Roll Call # 439",101,5,0,0,106
796052,482543,2015-12-15,Senate,"Senate Third Reading: Given Immediate Effect Roll Call # 590",38,0,0,0,38
796055,562876,2016-09-20,House,"Reported With Recommendation Without Amendment",20,0,0,0,20
796055,565432,2016-11-30,House,"House Third Reading: Given Immediate Effect Roll Call # 522",106,0,0,0,106
796060,481163,2015-11-10,House,"Reported With Recommendation With Substitute  H-1",10,0,0,0,10
796060,481673,2015-12-02,House,"House Third Reading: Given Immediate Effect Roll Call # 440",93,13,0,0,106
796060,482539,2015-12-15,Senate,"Senate Third Reading: Given Immediate Effect Roll Call # 591",38,0,0,0,38
796060,482574,2015-12-16,House,"House Third Reading: Senate Amendment(s) Concurred In Roll Call # 498",93,13,0,0,106
796061,481153,2015-11-10,House,"Reported With Recommendation With Substitute  H-1",13,0,0,0,13
796061,481676,2015-12-02,House,"House Third Reading: Given Immediate Effect Roll Call # 438",106,0,0,0,106
796061,494889,2016-02-10,Senate,"Reported Favorably With Substitute  S-1",4,0,0,0,4
796061,521154,2016-03-17,Senate,"Senate Third Reading: Given Immediate Effect Roll Call # 118",37,0,0,1,38
796061,523239,2016-03-22,House,"House Third Reading: Roll Call # 126",107,0,0,0,107
796103,481710,2015-12-03,Senate,"Reported Favorably Without Amendment",3,1,0,0,4
796103,482464,2015-12-15,Senate,"Senate Third Reading: Passed Roll Call # 605",25,13,0,0,38
796103,547983,2016-05-24,House,"Reported With Recommendation With Substitute  H-3",8,0,0,0,8
796103,566244,2016-12-13,House,"House Third Reading: Passed Roll Call # 633",99,9,0,0,108
796103,566245,2016-12-13,Senate,"Senate Third Reading: Roll Call # 749",26,11,0,1,38
796327,523570,2016-03-22,Senate,"Reported Favorably With Substitute  S-2",5,0,0,0,5
796327,524568,2016-03-24,Senate,"Senate Third Reading: Passed Roll Call # 148",36,0,0,2,38
796336,538560,2016-04-26,Senate,"Reported Favorably With Substitute  S-1",5,0,0,0,5
796336,544726,2016-05-10,Senate,"Senate Third Reading: Passed Roll Call # 256",37,0,0,0,37
796336,565551,2016-11-30,House,"Reported With Recommendation Without Amendment",15,0,0,0,15
796336,566205,2016-12-13,House,"House Third Reading: Passed Roll Call # 660",107,1,0,0,108
796340,481582,2015-12-01,Senate,"Reported Favorably With Substitute  S-1",10,0,0,0,10
796340,482082,2015-12-09,Senate,"Senate Third Reading: Passed Roll Call # 571",38,0,0,0,38
796340,505200,2016-02-23,House,"Reported With Recommendation With Substitute H-1",14,0,0,0,14
796340,509695,2016-02-23,House,"Reported With Recommendation With Substitute  H-1",14,0,0,0,14
796340,513455,2016-03-03,House,"House Third Reading: Given Immediate Effect Roll Call # 91",100,3,0,0,103
796340,524129,2016-03-23,Senate,"Senate Third Reading: Roll Call # 141",36,0,0,2,38
796349,544521,2016-05-10,House,"Reported With Recommendation With Substitute  H-2",8,0,0,0,8
796439,488624,2016-01-27,House,"Reported With Recommendation Without Amendment",16,0,0,0,16
796439,510148,2016-02-24,House,"House Third Reading: Given Immediate Effect Roll Call # 64",102,1,0,0,103
796439,548613,2016-05-25,Senate,"Reported Favorably Without Amendment",5,0,0,0,5
796439,551915,2016-06-07,Senate,"Senate Third Reading: Given Immediate Effect Roll Call # 374",37,0,0,0,37
796441,482806,2015-12-16,Senate,"Reported Favorably With Substitute  S-4",6,0,0,0,6
796441,499675,2016-02-16,Senate,"Senate Third Reading: Passed Roll Call # 50",31,7,0,0,38
796441,543619,2016-05-04,House,"Reported With Recommendation With Substitute  H-1",7,2,0,0,9
796441,550973,2016-06-02,House,"House Third Reading: Given Immediate Effect Roll Call # 353",91,17,0,0,108
796441,551871,2016-06-07,Senate,"Senate Third Reading: Roll Call # 362",30,7,0,0,37
796444,482594,2015-12-16,Senate,"Reported Favorably Without Amendment",7,0,0,0,7
796444,500578,2016-02-16,Senate,"Senate Third Reading: Passed Roll Call # 55",33,5,0,0,38
796444,543788,2016-05-04,House,"Reported With Recommendation With Substitute  H-1",10,0,0,0,10
796444,551149,2016-06-02,House,"House Third Reading: Given Immediate Effect Roll Call # 358",95,13,0,0,108
796444,551794,2016-06-07,Senate,"Senate Third Reading: Roll Call # 367",31,6,0,0,37
796445,488647,2016-01-27,House,"Reported With Recommendation Without Amendment",16,0,0,0,16
796445,510267,2016-02-24,House,"House Third Reading: Given Immediate Effect Roll Call # 62",103,0,0,0,103
796445,548618,2016-05-25,Senate,"Reported Favorably Without Amendment",5,0,0,0,5
796445,551914,2016-06-07,Senate,"Senate Third Reading: Given Immediate Effect Roll Call # 373",37,0,0,0,37
796450,491067,2016-02-03,House,"Reported With Recommendation Without Amendment",17,0,0,0,17
796450,509804,2016-02-24,House,"House Third Reading: Given Immediate Effect Roll Call # 65",102,1,0,0,103
796450,548528,2016-05-25,Senate,"Reported Favorably Without Amendment",5,0,0,0,5
796450,551867,2016-06-07,Senate,"Senate Third Reading: Passed Roll Call # 375",36,0,1,0,37
796450,551868,2016-06-07,Senate,"Senate Third Reading: Given Immediate Effect Roll Call # 376",37,0,0,0,37
796453,494938,2016-02-10,House,"Reported With Recommendation Without Amendment",17,0,0,0,17
796453,511000,2016-03-01,House,"House Third Reading: Given Immediate Effect Roll Call # 71",104,1,0,0,105
796453,548625,2016-05-25,Senate,"Reported Favorably Without Amendment",5,0,0,0,5
796453,551943,2016-06-07,Senate,"Senate Third Reading: Given Immediate Effect Roll Call # 379",37,0,0,0,37
796459,482829,2015-12-16,Senate,"Reported Favorably With Substitute  S-1",7,0,0,0,7
796459,499645,2016-02-16,Senate,"Senate Third Reading: Passed Roll Call # 53",33,5,0,0,38
796459,543786,2016-05-04,House,"Reported With Recommendation With Substitute  H-1",9,0,0,0,9
796459,551049,2016-06-02,House,"House Third Reading: Given Immediate Effect Roll Call # 356",96,12,0,0,108
796459,551824,2016-06-07,Senate,"Senate Third Reading: Roll Call # 365",31,6,0,0,37
796460,486459,2016-01-21,Senate,"Reported Favorably Without Amendment",4,0,0,0,4
796460,500810,2016-02-17,Senate,"Senate Third Reading: Passed Roll Call # 59",36,0,0,2,38
796463,486388,2016-01-21,Senate,"Reported Favorably With Substitute  S-1",4,0,0,0,4
796463,500958,2016-02-17,Senate,"Senate Third Reading: Passed Roll Call # 58",36,0,0,2,38
796463,562464,2016-09-13,House,"Reported With Recommendation With Substitute H-1",10,1,0,0,11
796463,562502,2016-09-13,House,"Reported With Recommendation With Substitute  H-1",10,1,0,0,11
796463,564830,2016-11-09,House,"House Third Reading: Given Immediate Effect Roll Call # 504",87,18,0,0,105
796463,564831,2016-11-10,Senate,"Senate Third Reading: Roll Call # 618",37,0,0,0,37
796464,494953,2016-02-10,House,"Reported With Recommendation Without Amendment",17,0,0,0,17
796464,511029,2016-03-01,House,"House Third Reading: Given Immediate Effect Roll Call # 72",105,0,0,0,105
796464,548619,2016-05-25,Senate,"Reported Favorably Without Amendment",5,0,0,0,5
796464,551942,2016-06-07,Senate,"Senate Third Reading: Given Immediate Effect Roll Call # 380",37,0,0,0,37
796466,482679,2015-12-16,Senate,"Reported Favorably Without Amendment",7,0,0,0,7
796466,500250,2016-02-16,Senate,"Senate Third Reading: Passed Roll Call # 51",33,5,0,0,38
796466,543787,2016-05-04,House,"Reported With Recommendation With Substitute  H-1",9,0,0,0,9
796466,551171,2016-06-02,House,"House Third Reading: Given Immediate Effect Roll Call # 354",97,11,0,0,108
796466,551944,2016-06-07,Senate,"Senate Third Reading: Roll Call # 363",31,6,0,0,37
796469,482613,2015-12-16,Senate,"Reported Favorably With Substitute  S-1",7,0,0,0,7
796469,499464,2016-02-16,Senate,"Senate Third Reading: Passed Roll Call # 54",32,6,0,0,38
796469,543746,2016-05-04,House,"Reported With Recommendation With Substitute  H-2",10,0,0,0,10
796469,551107,2016-06-02,House,"House Third Reading: Given Immediate Effect Roll Call # 357",95,13,0,0,108
796469,551954,2016-06-07,Senate,"Senate Third Reading: Roll Call # 366",31,6,0,0,37
796470,491084,2016-02-03,House,"Reported With Recommendation Without Amendment",17,0,0,0,17
796470,510262,2016-02-24,House,"House Third Reading: Given Immediate Effect Roll Call # 67",96,7,0,0,103
796470,548513,2016-05-25,Senate,"Reported Favorably Without Amendment",5,0,0,0,5
796470,551872,2016-06-07,Senate,"Senate Third Reading: Given Immediate Effect Roll Call # 378",37,0,0,0,37
796475,488676,2016-01-27,House,"Reported With Recommendation Without Amendment",16,0,0,0,16
796475,510099,2016-02-24,House,"House Third Reading: Given Immediate Effect Roll Call # 63",102,1,0,0,103
796475,548617,2016-05-25,Senate,"Reported Favorably Without Amendment",5,0,0,0,5
796475,551826,2016-06-07,Senate,"Senate Third Reading: Given Immediate Effect Roll Call # 372",37,0,0,0,37
796479,491220,2016-02-03,House,"Reported With Recommendation Without Amendment",17,0,0,0,17
796479,510318,2016-02-24,House,"House Third Reading: Given Immediate Effect Roll Call # 66",103,0,0,0,103
796479,548357,2016-05-25,Senate,"Reported Favorably Without Amendment",5,0,0,0,5
796479,551837,2016-06-07,Senate,"Senate Third Reading: Given Immediate Effect Roll Call # 377",37,0,0,0,37
796481,482598,2015-12-16,Senate,"Reported Favorably Without Amendment",7,0,0,0,7
796481,499447,2016-02-16,Senate,"Senate Third Reading: Passed Roll Call # 52",33,5,0,0,38
796481,543797,2016-05-04,House,"Reported With Recommendation With Substitute  H-1",9,0,0,0,9
796481,551196,2016-06-02,House,"House Third Reading: Given Immediate Effect Roll Call # 355",96,12,0,0,108
796481,551829,2016-06-07,Senate,"Senate Third Reading: Roll Call # 364",31,6,0,0,37
796482,495080,2016-02-10,House,"Reported With Recommendation Without Amendment",17,0,0,0,17
796535,492011,2016-02-04,Senate,"Reported Favorably With Substitute  S-1",7,0,0,0,7
796535,501178,2016-02-17,Senate,"Senate Third Reading: Passed Roll Call # 62",36,0,0,2,38
796535,539086,2016-04-27,House,"Reported With Recommendation Without Amendment",13,0,0,0,13
796535,545572,2016-05-12,House,"House Third Reading: Given Immediate Effect Roll Call # 264",108,0,0,0,108
796538,481605,2015-12-01,House,"Reported With Recommendation Without Amendment",13,6,0,0,19
796542,488875,2016-01-27,Senate,"Reported Favorably With Substitute  S-1",8,0,0,0,8
796542,500443,2016-02-04,Senate,"Senate Third Reading: Passed Roll Call # 30",37,0,0,1,38
796542,512306,2016-03-02,House,"Reported With Recommendation With Substitute H-1",9,0,0,0,9
796542,544499,2016-03-02,House,"Reported With Recommendation With Substitute  H-1",9,0,0,0,9
796542,545565,2016-05-12,House,"House Third Reading: Given Immediate Effect Roll Call # 255",107,1,0,0,108
796542,546224,2016-05-17,Senate,"Senate Third Reading: Roll Call # 265",37,0,0,0,37
796913,501043,2016-02-17,House,"Reported With Recommendation With Substitute  H-1",18,0,0,0,18
796913,543781,2016-05-04,House,"House Third Reading: Given Immediate Effect Roll Call # 215",76,32,0,0,108
796914,482016,2015-12-08,House,"Reported With Recommendation Without Amendment",12,6,0,0,18
796914,482570,2015-12-16,House,"House Third Reading: Given Immediate Effect Roll Call # 502",60,46,0,0,106
796914,492067,2016-02-04,Senate,"Reported Favorably Without Amendment",4,1,0,0,5
796914,496355,2016-02-11,Senate,"Senate Third Reading: Given Immediate Effect Roll Call # 49",26,11,0,1,38
796916,481975,2015-12-08,House,"Reported With Recommendation Without Amendment",12,6,0,0,18
796916,482568,2015-12-16,House,"House Third Reading: Given Immediate Effect Roll Call # 500",59,47,0,0,106
796916,492074,2016-02-04,Senate,"Reported Favorably Without Amendment",4,1,0,0,5
796916,496279,2016-02-11,Senate,"Senate Third Reading: Given Immediate Effect Roll Call # 45",26,11,0,1,38
796917,501011,2016-02-17,House,"Reported With Recommendation With Substitute  H-1",27,0,0,0,27
796917,543738,2016-05-04,House,"House Third Reading: Given Immediate Effect Roll Call # 213",95,13,0,0,108
796919,501001,2016-02-17,House,"Reported With Recommendation Without Amendment",26,0,0,0,26
796919,543695,2016-05-04,House,"House Third Reading: Given Immediate Effect Roll Call # 214",94,14,0,0,108
796923,481659,2015-12-02,House,"Reported With Recommendation With Substitute  H-2",8,5,0,0,13
796925,481984,2015-12-08,House,"Reported With Recommendation Without Amendment",12,6,0,0,18
796925,482565,2015-12-16,House,"House Third Reading: Given Immediate Effect Roll Call # 501",60,46,0,0,106
796925,491737,2016-02-04,Senate,"Reported Favorably Without Amendment",4,1,0,0,5
796925,495973,2016-02-11,Senate,"Senate Third Reading: Given Immediate Effect Roll Call # 47",26,11,0,1,38
796927,481671,2015-12-02,House,"Reported With Recommendation With Substitute  H-2",8,5,0,0,13
796928,500975,2016-02-17,House,"Reported With Recommendation With Substitute  H-1",27,0,0,0,27
796931,482014,2015-12-08,House,"Reported With Recommendation Without Amendment",12,6,0,0,18
796931,482561,2015-12-16,House,"House Third Reading: Given Immediate Effect Roll Call # 499",59,47,0,0,106
796931,492075,2016-02-04,Senate,"Reported Favorably Without Amendment",4,1,0,0,5
796931,496035,2016-02-11,Senate,"Senate Third Reading: Passed Roll Call # 42",26,11,0,1,38
796931,496036,2016-02-11,Senate,"Senate Third Reading: Given Immediate Effect Roll Call # 43",26,11,0,1,38
796933,481638,2015-12-02,House,"Reported With Recommendation With Substitute  H-2",8,5,0,0,13
797023,485794,2015-12-02,Senate,"Reported Favorably Without Amendment",4,0,0,0,4
797023,485795,2015-12-10,Senate,"Senate Third Reading: Passed Roll Call # 579",38,0,0,0,38
797023,487823,2016-01-26,House,"Reported With Recommendation Without Amendment",11,0,0,0,11
797023,491390,2016-02-03,House,"House Third Reading: Given Immediate Effect Roll Call # 26",106,0,0,0,106
797026,481785,2015-12-03,Senate,"Reported Favorably Without Amendment",6,0,0,0,6
797026,520914,2016-03-16,Senate,"Senate Third Reading: Passed Roll Call # 109",36,2,0,0,38
797026,565480,2016-11-30,House,"Reported With Recommendation Without Amendment",9,1,0,0,10
797026,566737,2016-12-14,House,"House Third Reading: Given Immediate Effect Roll Call # 713",70,38,0,0,108
797026,566738,2016-12-15,Senate,"Senate Third Reading: Roll Call # 832",35,2,0,1,38
797027,481772,2015-12-03,Senate,"Reported Favorably With Substitute  S-1",5,0,0,0,5
797027,481773,2015-12-03,Senate,"Senate Third Reading: Given Immediate Effect Roll Call # 543",21,15,0,2,38
797027,482091,2015-12-09,House,"Reported With Recommendation With Substitute  H-1",8,5,0,0,13
797027,482456,2015-12-15,House,"House Third Reading: Given Immediate Effect Roll Call # 488",61,45,0,0,106
797027,482544,2015-12-15,Senate,"Senate Third Reading: Roll Call # 628",26,12,0,0,38
797029,481796,2015-12-03,Senate,"Reported Favorably Without Amendment",6,0,0,0,6
797029,481797,2015-12-03,Senate,"Reported Favorably Without Amendment",6,0,0,0,6
797029,520911,2016-03-16,Senate,"Senate Third Reading: Passed Roll Call # 111",36,2,0,0,38
797029,565534,2016-11-30,House,"Reported With Recommendation Without Amendment",9,1,0,0,10
797029,566682,2016-12-14,House,"House Third Reading: Given Immediate Effect Roll Call # 715",69,39,0,0,108
797029,566683,2016-12-15,Senate,"Senate Third Reading: Roll Call # 834",33,3,1,1,38
797030,481757,2015-12-03,Senate,"Reported Favorably With Substitute  S-1",5,0,0,0,5
797030,481758,2015-12-03,Senate,"Senate Third Reading: Given Immediate Effect Roll Call # 544",21,15,0,2,38
797030,482100,2015-12-09,House,"Reported With Recommendation With Substitute H-1",7,5,0,0,12
797031,481747,2015-12-03,Senate,"Reported Favorably Without Amendment",6,0,0,0,6
797031,520883,2016-03-16,Senate,"Senate Third Reading: Passed Roll Call # 114",36,2,0,0,38
797031,565492,2016-11-30,House,"Reported With Recommendation Without Amendment",9,1,0,0,10
797031,566500,2016-12-15,House,"House Third Reading: Given Immediate Effect Roll Call # 725",61,47,0,0,108
797031,566501,2016-12-15,Senate,"Senate Third Reading: Roll Call # 837",35,2,0,1,38
797032,481739,2015-12-03,Senate,"Reported Favorably Without Amendment",6,0,0,0,6
797032,520940,2016-03-16,Senate,"Senate Third Reading: Passed Roll Call # 110",36,2,0,0,38
797032,565497,2016-11-30,House,"Reported With Recommendation Without Amendment",9,1,0,0,10
797032,566730,2016-12-14,House,"House Third Reading: Given Immediate Effect Roll Call # 714",68,40,0,0,108
797032,566731,2016-12-15,Senate,"Senate Third Reading: Roll Call # 833",35,2,0,1,38
797034,481717,2015-12-03,Senate,"Reported Favorably Without Amendment",6,0,0,0,6
797034,520922,2016-03-16,Senate,"Senate Third Reading: Passed Roll Call # 112",36,2,0,0,38
797034,565520,2016-11-30,House,"Reported With Recommendation Without Amendment",9,1,0,0,10
797034,566762,2016-12-14,House,"House Third Reading: Given Immediate Effect Roll Call # 716",66,42,0,0,108
797034,566763,2016-12-15,Senate,"Senate Third Reading: Roll Call # 835",35,2,0,1,38
797035,481724,2015-12-03,Senate,"Reported Favorably With Substitute  S-1",5,0,0,0,5
797035,481725,2015-12-03,Senate,"Senate Third Reading: Passed Roll Call # 549",36,0,0,2,38
797035,481971,2015-12-08,House,"Reported With Recommendation Without Amendment",16,0,0,0,16
797035,482454,2015-12-15,House,"House Third Reading: Given Immediate Effect Roll Call # 485",105,1,0,0,106
797035,482538,2015-12-15,Senate,"Senate Third Reading: House Amendment(s) Concurred In Roll Call # 625",38,0,0,0,38
797036,481715,2015-12-03,Senate,"Reported Favorably With Substitute  S-1",5,0,0,0,5
797036,481716,2015-12-03,Senate,"Senate Third Reading: Passed Roll Call # 550",36,0,0,2,38
797036,482008,2015-12-08,House,"Reported With Recommendation Without Amendment",16,0,0,0,16
797036,482534,2015-12-15,House,"House Third Reading: Given Immediate Effect Roll Call # 486",105,1,0,0,106
797036,482535,2015-12-15,Senate,"Senate Third Reading: House Amendment(s) Concurred In Roll Call # 626",38,0,0,0,38
797037,512880,2016-03-02,Senate,"Reported Favorably With Substitute  S-1",3,0,0,0,3
797037,518450,2016-03-10,Senate,"Senate Third Reading: Passed Roll Call # 104",36,0,0,2,38
797037,546812,2016-05-18,House,"Reported With Recommendation With Substitute H-1",11,0,0,0,11
797037,550765,2016-06-01,House,"House Third Reading: Given Immediate Effect Roll Call # 349",109,0,0,0,109
797037,551876,2016-06-07,Senate,"Senate Third Reading: Roll Call # 368",37,0,0,0,37
797039,481798,2015-12-03,Senate,"Reported Favorably With Substitute  S-1",5,0,0,0,5
797039,481799,2015-12-03,Senate,"Senate Third Reading: Given Immediate Effect Roll Call # 542",21,15,0,2,38
797039,482094,2015-12-09,House,"Reported With Recommendation With Substitute  H-1",8,5,0,0,13
797039,482487,2015-12-15,House,"House Third Reading: Given Immediate Effect Roll Call # 487",61,45,0,0,106
797039,482488,2015-12-15,Senate,"Senate Third Reading: Roll Call # 627",26,12,0,0,38
797040,481764,2015-12-03,Senate,"Reported Favorably Without Amendment",6,0,0,0,6
797040,520960,2016-03-16,Senate,"Senate Third Reading: Passed Roll Call # 113",36,2,0,0,38
797040,565550,2016-11-30,House,"Reported With Recommendation Without Amendment",9,1,0,0,10
797040,566669,2016-12-14,House,"House Third Reading: Given Immediate Effect Roll Call # 717",67,41,0,0,108
797040,566670,2016-12-15,Senate,"Senate Third Reading: Roll Call # 836",35,2,0,1,38
797041,481726,2015-12-03,Senate,"Reported Favorably Without Amendment",5,0,0,0,5
797041,481727,2015-12-03,Senate,"Senate Third Reading: Passed Roll Call # 548",36,0,0,2,38
797041,481996,2015-12-08,House,"Reported With Recommendation Without Amendment",16,0,0,0,16
797041,482474,2015-12-15,House,"House Third Reading: Given Immediate Effect Roll Call # 484",105,1,0,0,106
798055,562488,2016-09-08,Senate,"Reported Favorably Without Amendment",4,0,0,0,4
798055,562489,2016-09-08,Senate,"Senate Third Reading: Roll Call # 495",37,0,0,0,37
798055,562944,2016-09-21,House,"Reported With Recommendation Without Amendment",29,0,0,0,29
798055,562945,2016-09-21,House,"House Third Reading: Roll Call # 477",106,0,0,0,106
798110,563986,2016-10-18,Senate,"Reported Favorably With Substitute  S-1",5,0,0,0,5
798110,565295,2016-11-29,Senate,"Senate Third Reading: Defeated Roll Call # 636",18,19,0,1,38
798110,565495,2016-12-01,Senate,"Senate Third Reading: Passed Roll Call # 648",30,6,0,2,38
798110,565496,2016-12-01,Senate,"Senate Third Reading: Passed Roll Call # 666",28,8,0,2,38
798111,537407,2016-04-21,Senate,"Reported Favorably With Substitute  S-2",8,0,0,0,8
798111,544522,2016-05-10,Senate,"Senate Third Reading: Passed Roll Call # 259",36,1,0,0,37
798131,547993,2016-05-24,House,"Reported With Recommendation With Substitute  H-3",5,3,0,0,8
798132,481681,2015-12-02,House,"Reported With Recommendation Without Amendment",28,0,0,0,28
798132,481983,2015-12-08,House,"House Third Reading: Passed Roll Call # 459",83,23,0,0,106
798132,482267,2015-12-10,Senate,"Reported Favorably Without Amendment",10,5,0,0,15
798132,509782,2016-02-24,Senate,"Senate Third Reading: Passed Roll Call # 76",21,17,0,0,38
798132,509783,2016-02-24,House,"House Third Reading: Senate Amendment(s) Concurred In Roll Call # 60",77,25,0,0,102
798136,548435,2016-05-25,House,"Reported With Recommendation With Substitute  H-1",14,0,0,0,14
798136,551838,2016-06-07,House,"House Third Reading: Given Immediate Effect Roll Call # 402",108,0,0,0,108
798136,565440,2016-12-01,Senate,"Reported Favorably With Substitute  S-1",6,0,0,0,6
798140,547998,2016-05-24,House,"Reported With Recommendation Without Amendment",5,3,0,0,8
798172,486466,2016-01-21,Senate,"Reported Favorably Without Amendment",5,0,0,0,5
798172,489057,2016-01-28,Senate,"Senate Third Reading: Passed Roll Call # 12",38,0,0,0,38
798172,547994,2016-05-24,House,"Reported With Recommendation With Substitute  H-1",9,0,0,0,9
798172,551055,2016-06-02,House,"House Third Reading: Given Immediate Effect Roll Call # 367",93,15,0,0,108
798172,551941,2016-06-07,Senate,"Senate Third Reading: Roll Call # 369",37,0,0,0,37
798176,485669,2015-12-10,Senate,"Reported Favorably Without Amendment",5,0,0,0,5
798176,485670,2015-12-15,Senate,"Senate Third Reading: Passed Roll Call # 609",38,0,0,0,38
798180,486539,2016-01-21,Senate,"Reported Favorably Without Amendment",5,0,0,0,5
798180,489231,2016-01-28,Senate,"Senate Third Reading: Passed Roll Call # 13",38,0,0,0,38
798225,490439,2016-02-02,House,"Reported With Recommendation With Substitute  H-1",7,0,0,0,7
798225,513040,2016-03-02,House,"House Third Reading: Given Immediate Effect Roll Call # 84",95,8,0,0,103
798225,524001,2016-03-22,Senate,"Reported Favorably With Substitute  S-1",5,0,0,0,5
798225,524434,2016-03-24,Senate,"Senate Third Reading: Given Immediate Effect Roll Call # 146",36,0,0,2,38
798225,524777,2016-03-24,House,"House Third Reading: Roll Call # 145",99,9,0,0,108
798244,537597,2016-04-21,House,"Reported With Recommendation With Substitute  H-1",8,0,0,0,8
798244,548045,2016-05-24,House,"House Third Reading: Given Immediate Effect Roll Call # 313",104,2,0,0,106
798244,562895,2016-09-20,Senate,"Reported Favorably Without Amendment",4,0,0,0,4
798244,563133,2016-09-21,Senate,"Senate Third Reading: Given Immediate Effect Roll Call # 532",35,0,0,2,37
798257,494900,2016-02-10,Senate,"Reported Favorably Without Amendment",4,0,0,0,4
798363,542093,2016-05-03,Senate,"Reported Favorably Without Amendment",4,0,0,0,4
798373,482077,2015-12-09,Senate,"Reported Favorably With Substitute  S-2",5,0,0,0,5
798373,482078,2015-12-09,Senate,"Senate Third Reading: Given Immediate Effect Roll Call # 561",25,13,0,0,38
798376,535413,2016-04-19,Senate,"Reported Favorably Without Amendment",4,0,0,0,4
798376,536476,2016-04-20,Senate,"Senate Third Reading: Passed Roll Call # 184",37,0,0,0,37
798376,543749,2016-05-04,House,"Reported With Recommendation Without Amendment",16,0,0,0,16
798376,545497,2016-05-12,House,"House Third Reading: Given Immediate Effect Roll Call # 272",99,9,0,0,108
798387,520578,2016-03-16,House,"Reported With Recommendation Without Amendment",8,0,0,0,8
798387,531589,2016-04-12,House,"House Third Reading: Given Immediate Effect Roll Call # 149",108,0,0,0,108
798387,565691,2016-12-06,Senate,"Reported Favorably Without Amendment",5,0,0,0,5
798393,545005,2016-05-11,House,"Reported With Recommendation Without Amendment",8,0,0,0,8
798393,548095,2016-05-24,House,"House Third Reading: Given Immediate Effect Roll Call # 314",102,4,0,0,106
798393,565853,2016-12-07,Senate,"Reported Favorably Without Amendment",5,0,0,0,5
798393,566381,2016-12-14,Senate,"Senate Third Reading: Given Immediate Effect Roll Call # 761",28,9,0,1,38
798401,565985,2016-12-08,House,"Reported With Recommendation With Substitute  H-4",5,0,0,0,5
798401,565986,2016-12-08,House,"House Third Reading: Passed Roll Call # 619",107,0,0,0,107
798401,566320,2016-12-14,Senate,"Reported Favorably Without Amendment",4,1,0,0,5
798401,566321,2016-12-14,Senate,"Senate Third Reading: Passed Roll Call # 787",37,0,0,1,38
799039,564076,2016-10-20,Senate,"Reported Favorably With Substitute  S-1",4,0,0,0,4
799048,500731,2016-02-03,Senate,"Reported Favorably Without Amendment",4,1,0,0,5
799048,500732,2016-02-04,Senate,"Senate Third Reading: Passed Roll Call # 33",36,1,0,1,38
799048,500733,2016-02-16,House,"Reported With Recommendation Without Amendment",20,0,0,0,20
799048,510850,2016-03-01,House,"Reported With Recommendation With Substitute H-2",18,0,0,0,18
799048,512349,2016-03-02,House,"House Third Reading: Given Immediate Effect Roll Call # 85",101,2,0,0,103
799048,513740,2016-03-03,Senate,"Senate Third Reading: Roll Call # 85",37,1,0,0,38
799074,512235,2016-03-02,House,"Reported With Recommendation With Substitute H-3",15,0,0,0,15
799074,524782,2016-03-24,House,"House Third Reading: Given Immediate Effect Roll Call # 141",92,16,0,0,108
799105,492078,2016-02-04,Senate,"Reported Favorably With Substitute  S-1",5,0,0,0,5
799105,502393,2016-02-18,Senate,"Senate Third Reading: Passed Roll Call # 69",37,0,0,1,38
799105,548644,2016-05-25,House,"Reported With Recommendation Without Amendment",12,1,0,0,13
799105,552281,2016-06-08,House,"House Third Reading: Given Immediate Effect Roll Call # 417",104,4,0,0,108
799112,491736,2016-02-04,Senate,"Reported Favorably With Substitute  S-1",5,0,0,0,5
799112,502354,2016-02-18,Senate,"Senate Third Reading: Passed Roll Call # 68",37,0,0,1,38
799112,548487,2016-05-25,House,"Reported With Recommendation With Substitute  H-1",12,1,0,0,13
799112,552363,2016-06-08,House,"House Third Reading: Given Immediate Effect Roll Call # 416",104,4,0,0,108
799112,552364,2016-06-09,Senate,"Senate Third Reading: Roll Call # 436",37,0,0,0,37
799116,492010,2016-02-04,Senate,"Reported Favorably With Substitute  S-1",5,0,0,0,5
799116,502112,2016-02-18,Senate,"Senate Third Reading: Passed Roll Call # 70",37,0,0,1,38
799116,548684,2016-05-25,House,"Reported With Recommendation With Substitute  H-1",12,1,0,0,13
799116,552335,2016-06-08,House,"House Third Reading: Given Immediate Effect Roll Call # 418",103,5,0,0,108
799116,552336,2016-06-09,Senate,"Senate Third Reading: Roll Call # 437",37,0,0,0,37
799119,542493,2016-05-04,Senate,"Reported Favorably With Substitute  S-1",5,0,0,0,5
799119,550102,2016-05-31,Senate,"Senate Third Reading: Passed Roll Call # 344",37,0,0,0,37
799119,566769,2016-12-14,House,"House Third Reading: Passed Roll Call # 680",98,8,0,0,106
799119,566770,2016-12-14,Senate,"Senate Third Reading: Roll Call # 805",37,0,0,1,38
799137,505407,2016-02-23,House,"Reported With Recommendation Without Amendment",11,1,0,0,12
799143,491205,2016-02-03,House,"Reported With Recommendation Without Amendment",13,0,0,0,13
799143,502052,2016-02-18,House,"House Third Reading: Given Immediate Effect Roll Call # 52",104,2,0,0,106
799143,537620,2016-04-21,Senate,"Reported Favorably Without Amendment",5,0,0,0,5
799143,548510,2016-05-25,Senate,"Senate Third Reading: Given Immediate Effect Roll Call # 335",37,0,0,0,37
799144,491055,2016-02-03,House,"Reported With Recommendation Without Amendment",13,0,0,0,13
799144,502013,2016-02-18,House,"House Third Reading: Given Immediate Effect Roll Call # 51",104,2,0,0,106
799144,537404,2016-04-21,Senate,"Reported Favorably Without Amendment",5,0,0,0,5
799144,548548,2016-05-25,Senate,"Senate Third Reading: Given Immediate Effect Roll Call # 333",36,1,0,0,37
799146,488688,2016-01-27,House,"Reported With Recommendation Without Amendment",13,0,0,0,13
799146,491972,2016-02-04,House,"House Third Reading: Given Immediate Effect Roll Call # 27",105,1,0,0,106
799146,537383,2016-04-21,Senate,"Reported Favorably Without Amendment",5,0,0,0,5
799146,548410,2016-05-25,Senate,"Senate Third Reading: Given Immediate Effect Roll Call # 331",37,0,0,0,37
799152,494011,2016-02-09,House,"Reported With Recommendation With Substitute  H-1",8,1,0,0,9
799152,511250,2016-03-01,House,"House Third Reading: Given Immediate Effect Roll Call # 74",77,28,0,0,105
799152,564879,2016-11-10,Senate,"Reported Favorably With Substitute S-1",16,0,0,0,16
799152,565531,2016-12-01,Senate,"Senate Third Reading: Given Immediate Effect Roll Call # 655",35,1,0,2,38
799152,565963,2016-12-07,House,"House Third Reading: Roll Call # 559",83,23,0,0,106
799153,490435,2016-02-02,House,"Reported With Recommendation Without Amendment",21,0,0,0,21
799176,516053,2016-03-08,House,"Reported With Recommendation With Substitute  H-2",9,0,0,0,9
799176,546235,2016-05-17,House,"House Third Reading: Given Immediate Effect Roll Call # 277",109,0,0,0,109
799176,563868,2016-10-18,Senate,"Reported Favorably With Substitute  S-1",4,0,0,0,4
799183,485933,2016-01-20,House,"Reported With Recommendation Without Amendment",9,0,0,0,9
799183,495549,2016-02-10,House,"House Third Reading: Given Immediate Effect Roll Call # 34",105,1,0,0,106
799185,502079,2016-02-18,Senate,"Reported Favorably Without Amendment",7,0,0,0,7
799185,513894,2016-03-03,Senate,"Senate Third Reading: Passed Roll Call # 88",38,0,0,0,38
799185,523786,2016-03-23,House,"Reported With Recommendation With Substitute H-1",7,1,0,0,8
799185,523941,2016-03-23,House,"Reported With Recommendation With Substitute  H-1",7,1,0,0,8
799185,547337,2016-05-19,House,"House Third Reading: Given Immediate Effect Roll Call # 302",74,35,0,0,109
799185,548030,2016-05-24,Senate,"Senate Third Reading: Roll Call # 323",37,0,0,0,37
799186,502092,2016-02-18,Senate,"Reported Favorably Without Amendment",7,0,0,0,7
799186,513322,2016-03-03,Senate,"Senate Third Reading: Passed Roll Call # 89",38,0,0,0,38
799186,524031,2016-03-23,House,"Reported With Recommendation With Substitute  H-1",7,1,0,0,8
799186,546403,2016-03-23,House,"Reported With Recommendation With Substitute H-1",7,1,0,0,8
799186,547336,2016-05-19,House,"House Third Reading: Given Immediate Effect Roll Call # 303",74,35,0,0,109
799186,548020,2016-05-24,Senate,"Senate Third Reading: Roll Call # 324",37,0,0,0,37
799191,491987,2016-02-04,Senate,"Reported Favorably With Substitute  S-2",9,0,0,0,9
799191,502448,2016-02-18,Senate,"Senate Third Reading: Passed Roll Call # 66",37,0,0,1,38
799191,517088,2016-03-09,House,"Reported With Recommendation Without Amendment",15,0,0,0,15
799191,521340,2016-03-17,House,"House Third Reading: Given Immediate Effect Roll Call # 125",105,4,0,0,109
799199,488226,2016-01-26,Senate,"Reported Favorably With Substitute  S-1",4,0,0,0,4
799199,489054,2016-01-28,Senate,"Senate Third Reading: Passed Roll Call # 14",38,0,0,0,38
799199,543748,2016-05-04,House,"Reported With Recommendation Without Amendment",9,0,0,0,9
799199,545498,2016-05-12,House,"House Third Reading: Given Immediate Effect Roll Call # 271",108,0,0,0,108
799204,565428,2016-12-01,Senate,"Reported Favorably With Substitute  S-4",3,0,0,0,3
799204,565429,2016-12-01,Senate,"Senate Third Reading: Passed Roll Call # 675",22,14,0,2,38
800549,502507,2016-02-18,Senate,"Reported Favorably Without Amendment",4,0,0,0,4
800549,513306,2016-03-03,Senate,"Senate Third Reading: Passed Roll Call # 90",38,0,0,0,38
800549,535137,2016-04-19,House,"Reported With Recommendation With Substitute  H-2",10,0,0,0,10
800549,550746,2016-06-01,House,"House Third Reading: Given Immediate Effect Roll Call # 347",108,1,0,0,109
800549,551795,2016-06-07,Senate,"Senate Third Reading: Roll Call # 370",37,0,0,0,37
800551,500073,2016-02-16,Senate,"Reported Favorably With Recommendation For Referral To Committee On Regulatory Reform",5,0,0,0,5
800551,531523,2016-04-12,Senate,"Reported Favorably With Substitute  S-2",8,0,0,0,8
800551,546233,2016-05-17,Senate,"Senate Third Reading: Passed Roll Call # 285",37,0,0,0,37
800551,562948,2016-09-21,House,"Reported With Recommendation With Substitute  H-1",15,0,0,0,15
800565,487865,2016-01-26,Senate,"Reported Favorably Without Amendment",6,0,0,0,6
800565,490401,2016-02-02,Senate,"Senate Third Reading: Passed Roll Call # 21",37,0,0,1,38
800565,544947,2016-05-11,House,"Reported With Recommendation Without Amendment",9,4,0,0,13
800565,551844,2016-06-07,House,"House Third Reading: Given Immediate Effect Roll Call # 398",94,14,0,0,108
800574,551839,2016-06-07,Senate,"Reported Favorably Without Amendment",5,0,0,0,5
800574,563994,2016-10-19,Senate,"Senate Third Reading: Passed Roll Call # 546",37,0,0,0,37
800589,491741,2016-02-04,House,"Reported With Recommendation With Substitute  H-2",11,6,0,0,17
800589,514074,2016-03-03,House,"House Third Reading: Passed Roll Call # 87",55,48,0,0,103
800599,491756,2016-02-04,House,"Reported With Recommendation With Substitute  H-5",17,0,0,0,17
800599,513295,2016-03-03,House,"House Third Reading: Passed Roll Call # 90",89,14,0,0,103
800605,491757,2016-02-04,House,"Reported With Recommendation With Substitute  H-4",17,0,0,0,17
800605,513240,2016-03-03,House,"House Third Reading: Passed Roll Call # 89",88,15,0,0,103
800615,491749,2016-02-04,House,"Reported With Recommendation With Substitute  H-4",17,0,0,0,17
800615,513270,2016-03-03,House,"House Third Reading: Passed Roll Call # 88",89,14,0,0,103
800620,545585,2016-05-12,House,"Reported With Recommendation With Substitute H-2",14,1,0,0,15
800713,564054,2016-10-20,Senate,"Reported Favorably Without Amendment",4,0,0,0,4
800732,564114,2016-10-20,Senate,"Reported Favorably Without Amendment",4,0,0,0,4
800743,486224,2016-01-20,Senate,"Reported Favorably Without Amendment",10,0,0,0,10
800743,488431,2016-01-27,Senate,"Senate Third Reading: Passed Roll Call # 8",34,3,0,1,38
800743,490444,2016-02-02,House,"Reported With Recommendation Without Amendment",14,5,0,0,19
800743,502569,2016-02-18,House,"House Third Reading: Given Immediate Effect Roll Call # 50",79,27,0,0,106
800866,543796,2016-05-04,House,"Reported With Recommendation With Substitute  H-1",10,0,0,0,10
800866,548825,2016-05-26,House,"House Third Reading: Given Immediate Effect Roll Call # 322",105,3,0,0,108
800866,551969,2016-06-07,Senate,"Reported Favorably Without Amendment",7,0,0,0,7
800866,552181,2016-06-08,Senate,"Senate Third Reading: Given Immediate Effect Roll Call # 388",30,7,0,0,37
800869,543794,2016-05-04,House,"Reported With Recommendation With Substitute  H-1",10,0,0,0,10
800869,548748,2016-05-26,House,"House Third Reading: Given Immediate Effect Roll Call # 323",103,5,0,0,108
800869,551978,2016-06-07,Senate,"Reported Favorably Without Amendment",7,0,0,0,7
800869,552187,2016-06-08,Senate,"Senate Third Reading: Given Immediate Effect Roll Call # 389",30,7,0,0,37
800870,488652,2016-01-27,House,"Reported With Recommendation Without Amendment",29,0,0,0,29
800870,494922,2016-02-10,House,"House Third Reading: Given Immediate Effect Roll Call # 36",104,2,0,0,106
800870,523981,2016-03-23,Senate,"Reported Favorably Without Amendment",4,0,0,0,4
800870,539122,2016-04-27,Senate,"Senate Third Reading: Given Immediate Effect Roll Call # 199",36,0,0,1,37
801016,495926,2016-02-11,House,"Reported With Recommendation With Substitute H-1",14,0,0,0,14
801016,510980,2016-03-01,House,"House Third Reading: Given Immediate Effect Roll Call # 75",105,0,0,0,105
801019,491023,2016-02-03,House,"Reported With Recommendation With Substitute  H-1",16,1,0,0,17
801019,510818,2016-03-01,House,"House Third Reading: Given Immediate Effect Roll Call # 70",105,0,0,0,105
801019,538566,2016-04-26,Senate,"Reported Favorably Without Amendment",5,0,0,0,5
801019,552113,2016-06-08,Senate,"Senate Third Reading: Given Immediate Effect Roll Call # 419",37,0,0,0,37
801019,552300,2016-06-09,House,"House Third Reading: Senate Amendment(s) Concurred In Roll Call # 434",109,0,0,0,109
801023,491147,2016-02-03,House,"Reported With Recommendation With Substitute  H-1",17,0,0,0,17
801023,510952,2016-03-01,House,"House Third Reading: Given Immediate Effect Roll Call # 68",105,0,0,0,105
801023,538524,2016-04-26,Senate,"Reported Favorably With Substitute  S-1",5,0,0,0,5
801023,552114,2016-06-08,Senate,"Senate Third Reading: Given Immediate Effect Roll Call # 417",36,1,0,0,37
801023,552297,2016-06-09,House,"House Third Reading: Roll Call # 432",109,0,0,0,109
801025,495895,2016-02-11,House,"Reported With Recommendation Without Amendment",9,7,0,0,16
801028,494927,2016-02-10,House,"Reported With Recommendation Without Amendment",13,0,0,0,13
801028,505175,2016-02-23,House,"House Third Reading: Given Immediate Effect Roll Call # 58",106,0,0,0,106
801028,521148,2016-03-17,Senate,"Reported Favorably Without Amendment",5,0,0,0,5
801028,524587,2016-03-24,Senate,"Senate Third Reading: Given Immediate Effect Roll Call # 145",36,0,0,2,38
801030,510869,2016-03-01,House,"Reported With Recommendation Without Amendment",20,0,0,0,20
801030,520638,2016-03-15,House,"House Third Reading: Given Immediate Effect Roll Call # 98",107,1,0,0,108
801030,543155,2016-05-05,Senate,"Reported Favorably Without Amendment",10,0,0,0,10
801030,546807,2016-05-18,Senate,"Senate Third Reading: Given Immediate Effect Roll Call # 296",37,0,0,0,37
801034,495920,2016-02-11,House,"Reported With Recommendation With Substitute H-1",15,1,0,0,16
801034,534340,2016-02-11,House,"Reported With Recommendation With Substitute  H-1",15,1,0,0,16
801042,488627,2016-01-27,House,"Reported With Recommendation Without Amendment",13,0,0,0,13
801042,491964,2016-02-04,House,"House Third Reading: Given Immediate Effect Roll Call # 28",105,1,0,0,106
801042,539781,2016-04-28,Senate,"Reported Favorably With Substitute  S-2",7,0,0,0,7
801042,539782,2016-04-28,Senate,"Senate Third Reading: Given Immediate Effect Roll Call # 202",36,0,0,1,37
801042,544497,2016-05-10,House,"House Third Reading: Roll Call # 222",108,0,0,0,108
801042,546529,2016-05-17,Senate,"Senate Third Reading: Roll Call # 266",37,0,0,0,37
801045,510841,2016-03-01,House,"Reported With Recommendation Without Amendment",20,0,0,0,20
801045,520640,2016-03-15,House,"House Third Reading: Given Immediate Effect Roll Call # 100",107,1,0,0,108
801045,543168,2016-05-05,Senate,"Reported Favorably Without Amendment",10,0,0,0,10
801045,546695,2016-05-18,Senate,"Senate Third Reading: Given Immediate Effect Roll Call # 299",37,0,0,0,37
801059,510821,2016-03-01,House,"Reported With Recommendation Without Amendment",20,0,0,0,20
801059,517135,2016-03-09,House,"House Third Reading: Given Immediate Effect Roll Call # 96",105,0,0,0,105
801059,543131,2016-05-05,Senate,"Reported Favorably Without Amendment",10,0,0,0,10
801059,546897,2016-05-18,Senate,"Senate Third Reading: Given Immediate Effect Roll Call # 295",37,0,0,0,37
801063,511047,2016-03-01,House,"Reported With Recommendation Without Amendment",20,0,0,0,20
801063,517773,2016-03-09,House,"House Third Reading: Given Immediate Effect Roll Call # 97",105,0,0,0,105
801063,543164,2016-05-05,Senate,"Reported Favorably Without Amendment",10,0,0,0,10
801063,546734,2016-05-18,Senate,"Senate Third Reading: Given Immediate Effect Roll Call # 297",37,0,0,0,37
801064,510815,2016-03-01,House,"Reported With Recommendation Without Amendment",20,0,0,0,20
801064,520639,2016-03-15,House,"House Third Reading: Given Immediate Effect Roll Call # 99",107,1,0,0,108
801064,543113,2016-05-05,Senate,"Reported Favorably Without Amendment",10,0,0,0,10
801064,546714,2016-05-18,Senate,"Senate Third Reading: Given Immediate Effect Roll Call # 298",37,0,0,0,37
801066,510823,2016-03-01,House,"Reported With Recommendation Without Amendment",20,0,0,0,20
801066,517065,2016-03-09,House,"House Third Reading: Given Immediate Effect Roll Call # 95",105,0,0,0,105
801066,543140,2016-05-05,Senate,"Reported Favorably Without Amendment",10,0,0,0,10
801066,546733,2016-05-18,Senate,"Senate Third Reading: Given Immediate Effect Roll Call # 294",37,0,0,0,37
801079,490443,2016-02-02,House,"Reported With Recommendation Without Amendment",7,0,0,0,7
801079,546308,2016-05-17,House,"House Third Reading: Given Immediate Effect Roll Call # 274",89,20,0,0,109
801079,563946,2016-10-18,Senate,"Reported Favorably Without Amendment",5,0,0,0,5
801079,564023,2016-10-20,Senate,"Senate Third Reading: Given Immediate Effect Roll Call # 574",36,0,0,1,37
801079,564875,2016-11-10,Senate,"Senate Third Reading: Passed Roll Call # 617",36,0,0,1,37
801079,564876,2016-11-10,House,"House Third Reading: Senate Amendment(s) Concurred In Roll Call # 511",84,23,0,0,107
801084,510855,2016-03-01,House,"Reported With Recommendation Without Amendment",20,0,0,0,20
801084,520641,2016-03-15,House,"House Third Reading: Given Immediate Effect Roll Call # 101",107,1,0,0,108
801084,543170,2016-05-05,Senate,"Reported Favorably Without Amendment",10,0,0,0,10
801084,546646,2016-05-18,Senate,"Senate Third Reading: Given Immediate Effect Roll Call # 300",37,0,0,0,37
801087,516041,2016-03-08,House,"Reported With Recommendation Without Amendment",16,0,0,0,16
801087,521182,2016-03-17,House,"House Third Reading: Given Immediate Effect Roll Call # 121",109,0,0,0,109
801087,562810,2016-09-20,Senate,"Reported Favorably Without Amendment",5,0,0,0,5
801087,565816,2016-12-07,Senate,"Senate Third Reading: Given Immediate Effect Roll Call # 688",37,0,0,1,38
801089,491058,2016-02-03,House,"Reported With Recommendation With Substitute  H-1",17,0,0,0,17
801089,510881,2016-03-01,House,"House Third Reading: Given Immediate Effect Roll Call # 69",105,0,0,0,105
801089,538563,2016-04-26,Senate,"Reported Favorably With Substitute  S-1",5,0,0,0,5
801089,552109,2016-06-08,Senate,"Senate Third Reading: Given Immediate Effect Roll Call # 418",36,1,0,0,37
801089,552308,2016-06-09,House,"House Third Reading: Roll Call # 433",109,0,0,0,109
813719,509081,2016-02-25,Senate,"Reported Favorably With Substitute  S-2",3,0,0,0,3
813719,518246,2016-03-10,Senate,"Senate Third Reading: Passed Roll Call # 101",35,1,0,2,38
813787,543251,2016-05-05,Senate,"Reported Favorably Without Amendment",10,0,0,0,10
813787,546253,2016-05-17,Senate,"Senate Third Reading: Passed Roll Call # 288",37,0,0,0,37
813787,547985,2016-05-24,House,"Reported With Recommendation Without Amendment",19,0,0,0,19
813787,551202,2016-06-02,House,"House Third Reading: Given Immediate Effect Roll Call # 383",106,2,0,0,108
813825,509093,2016-02-25,Senate,"Reported Favorably With Substitute  S-2",3,0,0,0,3
813825,518460,2016-03-10,Senate,"Senate Third Reading: Passed Roll Call # 102",34,1,1,2,38
813825,518461,2016-03-10,Senate,"Senate Third Reading: Passed Roll Call # 103",35,1,0,2,38
813825,565545,2016-12-01,House,"Reported With Recommendation Without Amendment",14,2,0,0,16
813825,566216,2016-12-13,House,"House Third Reading: Passed Roll Call # 647",100,8,0,0,108
814032,541630,2016-05-03,House,"Reported With Recommendation With Substitute  H-2",9,0,0,0,9
814032,551863,2016-06-07,House,"House Third Reading: Given Immediate Effect Roll Call # 397",79,29,0,0,108
814032,564030,2016-10-20,Senate,"Reported Favorably With Substitute  S-1",4,0,0,0,4
814032,564857,2016-11-10,Senate,"Senate Third Reading: Given Immediate Effect Roll Call # 624",36,1,0,0,37
814032,565925,2016-12-07,House,"House Third Reading: Roll Call # 554",79,27,0,0,106
814204,543158,2016-05-05,Senate,"Reported Favorably Without Amendment",10,0,0,0,10
814204,546368,2016-05-17,Senate,"Senate Third Reading: Passed Roll Call # 287",37,0,0,0,37
814204,547991,2016-05-24,House,"Reported With Recommendation Without Amendment",19,0,0,0,19
814204,551083,2016-06-02,House,"House Third Reading: Given Immediate Effect Roll Call # 382",106,2,0,0,108
814306,523303,2016-03-22,Senate,"Reported Favorably Without Amendment",4,0,0,0,4
814306,532072,2016-04-12,Senate,"Senate Third Reading: Passed Roll Call # 165",27,9,0,1,37
814306,565416,2016-11-30,House,"Reported With Recommendation Without Amendment",15,0,0,0,15
814306,566249,2016-12-13,House,"House Third Reading: Passed Roll Call # 661",108,0,0,0,108
814376,543148,2016-05-05,Senate,"Reported Favorably Without Amendment",10,0,0,0,10
814376,546240,2016-05-17,Senate,"Senate Third Reading: Passed Roll Call # 289",37,0,0,0,37
814376,547984,2016-05-24,House,"Reported With Recommendation Without Amendment",19,0,0,0,19
814376,551200,2016-06-02,House,"House Third Reading: Given Immediate Effect Roll Call # 384",106,2,0,0,108
814447,543147,2016-05-05,Senate,"Reported Favorably With Substitute  S-1",10,0,0,0,10
814447,546443,2016-05-17,Senate,"Senate Third Reading: Passed Roll Call # 290",37,0,0,0,37
814447,547992,2016-05-24,House,"Reported With Recommendation Without Amendment",19,0,0,0,19
814447,551022,2016-06-02,House,"House Third Reading: Given Immediate Effect Roll Call # 385",106,2,0,0,108
814512,543157,2016-05-05,Senate,"Reported Favorably With Substitute  S-1",10,0,0,0,10
814512,546216,2016-05-17,Senate,"Senate Third Reading: Passed Roll Call # 286",37,0,0,0,37
814512,547981,2016-05-24,House,"Reported With Recommendation Without Amendment",19,0,0,0,19
814512,551090,2016-06-02,House,"House Third Reading: Given Immediate Effect Roll Call # 394",106,2,0,0,108
816574,523187,2016-03-22,Senate,"Senate Third Reading: Passed Roll Call # 125",29,8,0,1,38
816574,541553,2016-05-03,House,"Reported With Recommendation With Substitute  H-1",17,11,0,0,28
816574,543640,2016-05-05,House,"House Third Reading: Given Immediate Effect Roll Call # 220",61,47,0,0,108
816574,551198,2016-06-02,House,"House Third Reading: Passed Roll Call # 391",60,48,0,0,108
816574,552237,2016-06-08,Senate,"Senate Third Reading: Roll Call # 430",23,14,0,0,37
816599,523650,2016-03-22,Senate,"Senate Third Reading: Passed Roll Call # 124",21,16,0,1,38
816628,538614,2016-04-26,Senate,"Reported Favorably Without Amendment",5,0,0,0,5
816628,547971,2016-05-24,Senate,"Senate Third Reading: Passed Roll Call # 319",37,0,0,0,37
816628,565488,2016-11-30,House,"Reported With Recommendation With Substitute  H-1",15,0,0,0,15
816628,566250,2016-12-13,House,"House Third Reading: Passed Roll Call # 665",108,0,0,0,108
816628,566251,2016-12-13,Senate,"Senate Third Reading: Roll Call # 756",37,0,0,1,38
816656,491097,2016-02-03,House,"Reported With Recommendation With Substitute  H-1",6,1,0,0,7
816656,505179,2016-02-23,House,"House Third Reading: Given Immediate Effect Roll Call # 53",60,46,0,0,106
816713,486439,2016-01-21,Senate,"Reported Favorably Without Amendment",4,1,0,0,5
816713,499688,2016-02-03,Senate,"Senate Third Reading: Passed Roll Call # 26",27,10,0,1,38
816768,538536,2016-04-26,Senate,"Reported Favorably Without Amendment",5,0,0,0,5
816768,548170,2016-05-24,Senate,"Senate Third Reading: Passed Roll Call # 317",34,3,0,0,37
816768,565477,2016-11-30,House,"Reported With Recommendation Without Amendment",15,0,0,0,15
816768,566261,2016-12-13,House,"House Third Reading: Passed Roll Call # 662",107,1,0,0,108
816799,485923,2016-01-20,House,"Reported With Recommendation With Substitute  H-1",29,0,0,0,29
816799,485924,2016-01-20,House,"House Third Reading: Given Immediate Effect Roll Call # 12",106,0,0,0,106
816799,489205,2016-01-28,Senate,"Reported Favorably With Substitute  S-1",17,0,0,0,17
816799,489206,2016-01-28,Senate,"Senate Third Reading: Given Immediate Effect Roll Call # 9",38,0,0,0,38
816799,489207,2016-01-28,House,"House Third Reading: Roll Call # 22",106,0,0,0,106
816856,538607,2016-04-26,Senate,"Reported Favorably Without Amendment",4,0,0,0,4
816856,548205,2016-05-24,Senate,"Senate Third Reading: Passed Roll Call # 318",27,10,0,0,37
816856,565470,2016-11-30,House,"Reported With Recommendation Without Amendment",15,0,0,0,15
816856,566259,2016-12-13,House,"House Third Reading: Passed Roll Call # 663",107,1,0,0,108
821394,500411,2016-02-03,Senate,"Reported Favorably Without Amendment",4,1,0,0,5
821767,500851,2016-02-03,Senate,"Reported Favorably With Substitute  S-2",4,1,0,0,5
821859,500395,2016-02-03,Senate,"Reported Favorably With Substitute  S-1",4,1,0,0,5
821949,521152,2016-03-17,Senate,"Reported Favorably With Substitute  S-2",4,1,0,0,5
821949,532066,2016-04-12,Senate,"Senate Third Reading: Passed Roll Call # 164",27,9,0,1,37
821949,562820,2016-09-20,House,"Reported With Recommendation With Substitute  H-1",7,1,0,0,8
821949,566083,2016-12-07,House,"House Third Reading: Passed Roll Call # 561",67,39,0,0,106
821949,566084,2016-12-08,Senate,"Senate Third Reading: Roll Call # 704",27,10,0,1,38
822876,535133,2016-04-19,House,"Reported With Recommendation With Substitute  H-2",10,0,0,0,10
822876,548691,2016-05-25,House,"House Third Reading: Given Immediate Effect Roll Call # 319",101,8,0,0,109
827690,488494,2016-01-27,Senate,"Reported Favorably Without Amendment",8,0,0,0,8
827690,500358,2016-02-04,Senate,"Senate Third Reading: Passed Roll Call # 31",37,0,0,1,38
827690,512266,2016-03-02,House,"Reported With Recommendation Without Amendment",9,0,0,0,9
827690,545555,2016-05-12,House,"House Third Reading: Given Immediate Effect Roll Call # 256",107,1,0,0,108
828047,491230,2016-02-03,House,"Reported With Recommendation Without Amendment",10,0,0,0,10
828047,495534,2016-02-10,House,"House Third Reading: Given Immediate Effect Roll Call # 35",104,2,0,0,106
828047,542949,2016-05-04,Senate,"Reported Favorably With Substitute  S-1",7,0,0,0,7
828047,546634,2016-05-18,Senate,"Senate Third Reading: Given Immediate Effect Roll Call # 308",37,0,0,0,37
828047,547484,2016-05-19,House,"House Third Reading: Roll Call # 301",106,3,0,0,109
828075,516043,2016-03-08,House,"Reported With Recommendation With Substitute  H-2",12,4,0,0,16
828075,523541,2016-03-22,House,"House Third Reading: Given Immediate Effect Roll Call # 128",97,10,0,0,107
828075,544526,2016-05-10,Senate,"Reported Favorably Without Amendment",5,0,0,0,5
828075,548168,2016-05-24,Senate,"Senate Third Reading: Given Immediate Effect Roll Call # 322",37,0,0,0,37
828112,499380,2016-02-16,House,"Reported With Recommendation Without Amendment",15,0,0,0,15
828112,517747,2016-03-09,House,"House Third Reading: Given Immediate Effect Roll Call # 94",98,7,0,0,105
828112,550309,2016-05-31,Senate,"Reported Favorably Without Amendment",5,0,0,0,5
828112,566354,2016-12-14,Senate,"Senate Third Reading: Given Immediate Effect Roll Call # 811",36,1,0,1,38
829220,543784,2016-05-04,House,"Reported With Recommendation With Substitute  H-2",26,0,0,0,26
829220,544624,2016-05-10,House,"House Third Reading: Passed Roll Call # 239",69,39,0,0,108
829220,546294,2016-05-17,Senate,"Senate Third Reading: Passed Roll Call # 278",27,10,0,0,37
829220,546989,2016-05-18,House,"House Third Reading: Roll Call # 286",0,109,0,0,109
829270,512261,2016-03-02,House,"Reported With Recommendation Without Amendment",15,0,0,0,15
829270,520642,2016-03-16,House,"House Third Reading: Given Immediate Effect Roll Call # 103",103,6,0,0,109
829270,531471,2016-04-12,Senate,"Reported Favorably Without Amendment",8,0,0,0,8
829270,537325,2016-04-21,Senate,"Senate Third Reading: Given Immediate Effect Roll Call # 185",35,1,0,1,37
829291,543647,2016-05-04,House,"Reported With Recommendation With Substitute  H-2",26,0,0,0,26
829291,544795,2016-05-10,House,"House Third Reading: Passed Roll Call # 238",70,38,0,0,108
829291,546462,2016-05-17,Senate,"Senate Third Reading: Passed Roll Call # 277",27,10,0,0,37
829291,546776,2016-05-18,House,"House Third Reading: Roll Call # 285",0,109,0,0,109
829401,500869,2016-02-17,House,"Reported With Recommendation With Substitute  H-2",10,0,0,0,10
832662,545519,2016-05-12,Senate,"Reported Favorably Without Amendment",5,0,0,0,5
833084,543792,2016-05-04,House,"Reported With Recommendation With Substitute  H-2",27,0,0,0,27
833084,544642,2016-05-10,House,"House Third Reading: Passed Roll Call # 243",69,39,0,0,108
833084,546307,2016-05-17,Senate,"Senate Third Reading: Passed Roll Call # 282",27,10,0,0,37
833084,546642,2016-05-18,House,"House Third Reading: Roll Call # 290",0,109,0,0,109
833123,543743,2016-05-04,House,"Reported With Recommendation With Substitute  H-2",27,0,0,0,27
833123,544552,2016-05-10,House,"House Third Reading: Passed Roll Call # 242",71,37,0,0,108
833123,546217,2016-05-17,Senate,"Senate Third Reading: Passed Roll Call # 281",27,10,0,0,37
833123,546929,2016-05-18,House,"House Third Reading: Roll Call # 289",0,109,0,0,109
833164,543693,2016-05-04,House,"Reported With Recommendation With Substitute  H-2",27,0,0,0,27
833164,544580,2016-05-10,House,"House Third Reading: Passed Roll Call # 241",71,37,0,0,108
833164,546256,2016-05-17,Senate,"Senate Third Reading: Passed Roll Call # 280",27,10,0,0,37
833164,546961,2016-05-18,House,"House Third Reading: Roll Call # 288",0,109,0,0,109
833185,509769,2016-02-24,House,"Reported With Recommendation With Substitute H-2",10,0,0,0,10
833185,512780,2016-02-24,House,"Reported With Recommendation With Substitute  H-2",10,0,0,0,10
833185,516664,2016-03-08,House,"House Third Reading: Given Immediate Effect Roll Call # 92",99,6,0,0,105
833185,532560,2016-04-13,Senate,"Reported Favorably Without Amendment",4,0,0,0,4
833185,538629,2016-04-26,Senate,"Senate Third Reading: Given Immediate Effect Roll Call # 191",36,0,0,1,37
833202,543682,2016-05-04,House,"Reported With Recommendation With Substitute  H-2",27,0,0,0,27
833202,544813,2016-05-10,House,"House Third Reading: Passed Roll Call # 240",69,39,0,0,108
833202,546393,2016-05-17,Senate,"Senate Third Reading: Passed Roll Call # 279",27,10,0,0,37
833202,546725,2016-05-18,House,"House Third Reading: Roll Call # 287",0,109,0,0,109
833258,495076,2016-02-10,House,"Reported With Recommendation Without Amendment",7,0,0,0,7
833258,520703,2016-03-16,House,"House Third Reading: Given Immediate Effect Roll Call # 108",68,41,0,0,109
833258,547095,2016-05-19,Senate,"Reported Favorably With Substitute  S-1",4,1,0,0,5
833258,562405,2016-09-08,Senate,"Senate Third Reading: Given Immediate Effect Roll Call # 511",28,9,0,0,37
833258,562829,2016-09-20,House,"House Third Reading: Roll Call # 454",68,38,0,0,106
833279,519965,2016-03-15,House,"Reported With Recommendation For Referral To Committee On Criminal Justice",11,0,0,0,11
833279,535144,2016-04-19,House,"Reported With Recommendation With Substitute H-1",8,0,0,0,8
833279,545411,2016-05-12,House,"House Third Reading: Given Immediate Effect Roll Call # 257",96,12,0,0,108
833279,562300,2016-09-08,Senate,"Reported Favorably Without Amendment",4,0,0,0,4
833279,565772,2016-12-07,Senate,"Senate Third Reading: Given Immediate Effect Roll Call # 687",36,1,0,1,38
834957,548612,2016-05-25,Senate,"Reported Favorably Without Amendment",3,1,0,0,4
834957,562398,2016-09-07,Senate,"Senate Third Reading: Passed Roll Call # 480",32,4,0,1,37
834982,492064,2016-02-04,Senate,"Reported Favorably Without Amendment",16,0,0,0,16
834982,494994,2016-02-10,Senate,"Senate Third Reading: Passed Roll Call # 40",37,0,0,1,38
834982,536443,2016-04-20,House,"Reported With Recommendation Without Amendment",9,0,0,0,9
834982,545529,2016-05-12,House,"House Third Reading: Given Immediate Effect Roll Call # 265",108,0,0,0,108
835007,502600,2016-02-18,Senate,"Reported Favorably With Substitute  S-1",17,0,0,0,17
835007,511586,2016-03-01,Senate,"Senate Third Reading: Passed Roll Call # 81",38,0,0,0,38
835007,520567,2016-03-16,House,"Reported With Recommendation Without Amendment",10,0,0,0,10
835007,524833,2016-03-23,House,"House Third Reading: Given Immediate Effect Roll Call # 131",108,0,0,0,108
835031,502077,2016-02-18,Senate,"Reported Favorably Without Amendment",7,0,0,0,7
835031,563995,2016-10-19,Senate,"Senate Third Reading: Passed Roll Call # 544",31,6,0,0,37
835045,494941,2016-02-10,Senate,"Reported Favorably Without Amendment",5,0,0,0,5
835082,499626,2016-02-03,Senate,"Reported Favorably Without Amendment",6,0,0,0,6
835082,499627,2016-02-16,Senate,"Senate Third Reading: Passed Roll Call # 56",30,8,0,0,38
835082,543778,2016-05-04,House,"Reported With Recommendation With Substitute  H-1",10,0,0,0,10
835082,551193,2016-06-02,House,"House Third Reading: Given Immediate Effect Roll Call # 359",97,11,0,0,108
835082,551951,2016-06-07,Senate,"Senate Third Reading: Roll Call # 371",30,7,0,0,37
835154,545484,2016-05-12,House,"Reported With Recommendation For Referral To Committee On Military And Veterans Affairs",5,0,0,0,5
835154,562570,2016-09-15,House,"Reported With Recommendation With Substitute  H-1",7,0,0,0,7
835154,563154,2016-09-22,House,"House Third Reading: Given Immediate Effect Roll Call # 498",106,1,0,0,107
835154,566242,2016-12-13,Senate,"Reported Favorably Without Amendment",5,0,0,0,5
835154,566364,2016-12-14,Senate,"Senate Third Reading: Given Immediate Effect Roll Call # 800",37,0,0,1,38
835161,546789,2016-05-18,House,"Reported With Recommendation With Substitute  H-2",18,10,0,0,28
835161,566098,2016-12-08,House,"House Third Reading: Given Immediate Effect Roll Call # 600",96,11,0,0,107
835196,545594,2016-05-12,House,"Reported With Recommendation For Referral To Committee On Military And Veterans Affairs",5,0,0,0,5
835196,562567,2016-09-15,House,"Reported With Recommendation With Substitute  H-1",7,0,0,0,7
835196,563153,2016-09-22,House,"House Third Reading: Given Immediate Effect Roll Call # 497",106,1,0,0,107
835196,566227,2016-12-13,Senate,"Reported Favorably Without Amendment",5,0,0,0,5
835196,566349,2016-12-14,Senate,"Senate Third Reading: Given Immediate Effect Roll Call # 799",37,0,0,1,38
835211,520770,2016-03-16,House,"Reported With Recommendation With Substitute  H-4",13,0,0,0,13
835211,531528,2016-04-12,House,"House Third Reading: Given Immediate Effect Roll Call # 150",75,33,0,0,108
835211,552071,2016-06-08,Senate,"Reported Favorably With Substitute  S-2",7,0,0,0,7
835211,562346,2016-09-08,Senate,"Senate Third Reading: Given Immediate Effect Roll Call # 504",37,0,0,0,37
835211,562830,2016-09-20,House,"House Third Reading: Roll Call # 455",78,28,0,0,106
835228,533535,2016-04-14,House,"Reported With Recommendation With Substitute  H-1",19,9,0,0,28
835228,539095,2016-04-26,House,"House Third Reading: Given Immediate Effect Roll Call # 181",72,36,0,0,108
835228,562288,2016-09-08,Senate,"Reported Favorably With Substitute  S-3",4,0,0,0,4
835228,562289,2016-09-08,Senate,"Senate Third Reading: Given Immediate Effect Roll Call # 512",37,0,0,0,37
835228,562410,2016-09-08,Senate,"Reported Favorably With Substitute S-3",4,0,0,0,4
835228,562834,2016-09-20,House,"House Third Reading: Roll Call # 458",106,0,0,0,106
835228,563065,2016-09-21,Senate,"Senate Third Reading: Roll Call # 516",35,0,0,2,37
835235,548670,2016-05-25,House,"Reported With Recommendation With Substitute  H-2",6,1,0,0,7
835235,565508,2016-11-30,House,"House Third Reading: Passed Roll Call # 520",62,44,0,0,106
835254,543707,2016-05-04,House,"Reported With Recommendation With Substitute  H-2",27,0,0,0,27
835254,544487,2016-05-10,House,"House Third Reading: Passed Roll Call # 244",70,38,0,0,108
835254,546510,2016-05-17,Senate,"Senate Third Reading: Passed Roll Call # 283",27,10,0,0,37
835254,546864,2016-05-18,House,"House Third Reading: Roll Call # 291",0,109,0,0,109
835278,537532,2016-04-21,House,"Reported With Recommendation With Substitute  H-1",22,0,0,0,22
835278,539391,2016-04-27,House,"House Third Reading: Given Immediate Effect Roll Call # 185",76,32,0,0,108
835278,546291,2016-05-17,Senate,"Senate Third Reading: Passed Roll Call # 276",24,13,0,0,37
835278,546676,2016-05-18,House,"House Third Reading: Roll Call # 284",0,109,0,0,109
835278,552284,2016-06-08,House,"House Third Reading: Conference Report Adopted Roll Call # 413",71,37,0,0,108
835278,552285,2016-06-08,Senate,"Senate Third Reading: Senate Adopted Conference Report With Immediate Effect Roll Call # 416",26,11,0,0,37
835329,520686,2016-03-16,House,"Reported With Recommendation With Substitute  H-1",27,2,0,0,29
835329,521232,2016-03-17,House,"House Third Reading: Given Immediate Effect Roll Call # 123",104,5,0,0,109
835329,524549,2016-03-24,Senate,"Senate Third Reading: Given Immediate Effect Roll Call # 142",29,7,0,2,38
835329,524550,2016-03-24,House,"House Third Reading: Senate Amendment(s) To House Amendment(s) Nonconcurred In Roll Call # 134",104,4,0,0,108
835329,547894,2016-03-24,House,"House Third Reading: Senate Amendment(s) Concurred In Roll Call # 134",104,4,0,0,108
835910,524526,2016-03-24,Senate,"Reported Favorably Without Amendment",6,1,0,0,7
835954,505376,2016-02-23,Senate,"Reported Favorably Without Amendment",4,0,0,0,4
835954,544576,2016-05-10,Senate,"Senate Third Reading: Passed Roll Call # 258",32,5,0,0,37
837175,509152,2016-02-25,Senate,"Reported Favorably With Substitute  S-2",7,0,0,0,7
837175,517656,2016-03-09,Senate,"Senate Third Reading: Passed By 2/3 Vote Roll Call # 92",36,1,0,1,38
837175,545019,2016-05-11,House,"Reported With Recommendation Without Amendment",10,0,0,0,10
837175,546931,2016-05-18,House,"House Third Reading: Given Immediate Effect Roll Call # 295",105,4,0,0,109
837184,522877,2016-03-22,House,"Reported With Recommendation With Substitute H-1",21,0,0,0,21
837184,524244,2016-03-22,House,"Reported With Recommendation With Substitute  H-1",21,0,0,0,21
837184,545526,2016-05-12,House,"House Third Reading: Given Immediate Effect Roll Call # 262",107,1,0,0,108
837184,562338,2016-09-07,Senate,"Reported Favorably Without Amendment",9,0,0,0,9
837195,509181,2016-02-25,Senate,"Reported Favorably Without Amendment",8,0,0,0,8
837195,517708,2016-03-09,Senate,"Senate Third Reading: Passed By 2/3 Vote Roll Call # 95",37,0,0,1,38
837224,552371,2016-06-09,Senate,"Reported Favorably With Substitute S-1",3,0,0,0,3
837241,508340,2016-02-25,Senate,"Reported Favorably Without Amendment",8,0,0,0,8
837241,517024,2016-03-09,Senate,"Senate Third Reading: Passed Roll Call # 96",37,0,0,1,38
837241,539143,2016-04-27,House,"Reported With Recommendation With Substitute  H-1",10,0,0,0,10
837241,546700,2016-05-18,House,"House Third Reading: Given Immediate Effect Roll Call # 294",105,4,0,0,109
837241,547973,2016-05-24,Senate,"Senate Third Reading: Roll Call # 325",37,0,0,0,37
837254,509136,2016-02-25,Senate,"Reported Favorably With Substitute  S-1",8,0,0,0,8
837254,517611,2016-03-09,Senate,"Senate Third Reading: Passed By 2/3 Vote Roll Call # 94",37,0,0,1,38
837254,545021,2016-05-11,House,"Reported With Recommendation Without Amendment",10,0,0,0,10
837254,546711,2016-05-18,House,"House Third Reading: Given Immediate Effect Roll Call # 297",108,1,0,0,109
837271,509185,2016-02-25,Senate,"Reported Favorably With Substitute  S-1",8,0,0,0,8
837271,517724,2016-03-09,Senate,"Senate Third Reading: Passed By 2/3 Vote Roll Call # 93",37,0,0,1,38
837271,545022,2016-05-11,House,"Reported With Recommendation Without Amendment",9,0,0,0,9
837271,546941,2016-05-18,House,"House Third Reading: Given Immediate Effect Roll Call # 296",108,1,0,0,109
837281,521006,2016-03-16,Senate,"Reported Favorably With Substitute  S-1",5,0,0,0,5
837281,524180,2016-03-23,Senate,"Senate Third Reading: Passed Roll Call # 134",37,0,0,1,38
837281,539053,2016-04-26,House,"Reported With Recommendation With Substitute  H-2",7,0,0,0,7
837281,566758,2016-12-15,House,"House Third Reading: Passed Roll Call # 757",76,31,0,0,107
837281,566759,2016-12-15,Senate,"Senate Third Reading: Roll Call # 858",37,0,0,1,38
837292,521004,2016-03-16,Senate,"Reported Favorably With Substitute  S-2",5,0,0,0,5
837292,523862,2016-03-23,Senate,"Senate Third Reading: Passed Roll Call # 135",37,0,0,1,38
837292,539057,2016-04-26,House,"Reported With Recommendation Without Amendment",7,0,0,0,7
837292,566765,2016-12-15,House,"House Third Reading: Passed Roll Call # 758",74,33,0,0,107
840989,532384,2016-04-13,Senate,"Reported Favorably Without Amendment",5,0,0,0,5
840989,540360,2016-04-28,Senate,"Senate Third Reading: Passed Roll Call # 218",34,2,0,1,37
840989,564850,2016-11-10,House,"Reported With Recommendation Without Amendment",17,0,0,0,17
840989,566001,2016-12-07,House,"House Third Reading: Given Immediate Effect Roll Call # 584",107,0,0,0,107
841085,533093,2016-04-13,Senate,"Reported Favorably Without Amendment",5,0,0,0,5
841085,540051,2016-04-28,Senate,"Senate Third Reading: Passed Roll Call # 212",36,0,0,1,37
841085,564817,2016-11-10,House,"Reported With Recommendation Without Amendment",17,0,0,0,17
841762,532650,2016-04-13,Senate,"Reported Favorably Without Amendment",5,0,0,0,5
841762,540370,2016-04-28,Senate,"Senate Third Reading: Passed Roll Call # 220",36,0,0,1,37
841762,564819,2016-11-10,House,"Reported With Recommendation Without Amendment",17,0,0,0,17
841762,566040,2016-12-07,House,"House Third Reading: Given Immediate Effect Roll Call # 586",107,0,0,0,107
841910,548616,2016-05-25,Senate,"Reported Favorably With Substitute  S-1",5,0,0,0,5
841910,550727,2016-06-01,Senate,"Senate Third Reading: Passed Roll Call # 354",32,4,0,1,37
841910,552358,2016-06-08,House,"Reported With Recommendation Without Amendment",12,1,0,0,13
841910,552359,2016-06-09,House,"House Third Reading: Given Immediate Effect Roll Call # 430",82,27,0,0,109
842057,533079,2016-04-13,Senate,"Reported Favorably Without Amendment",5,0,0,0,5
842057,540290,2016-04-28,Senate,"Senate Third Reading: Passed Roll Call # 222",33,3,0,1,37
842057,564825,2016-11-10,House,"Reported With Recommendation Without Amendment",17,0,0,0,17
842057,566006,2016-12-07,House,"House Third Reading: Given Immediate Effect Roll Call # 587",107,0,0,0,107
842104,532785,2016-04-13,Senate,"Reported Favorably With Substitute  S-1",5,0,0,0,5
842104,540378,2016-04-28,Senate,"Senate Third Reading: Passed Roll Call # 208",36,0,0,1,37
842104,564881,2016-11-10,House,"Reported With Recommendation With Substitute  H-1",16,1,0,0,17
842104,565982,2016-12-07,House,"House Third Reading: Given Immediate Effect Roll Call # 566",106,0,0,0,106
842104,565983,2016-12-08,Senate,"Senate Third Reading: Roll Call # 705",37,0,0,1,38
842199,536422,2016-04-20,Senate,"Reported Favorably With Substitute  S-2",10,0,0,0,10
842199,539065,2016-04-27,Senate,"Senate Third Reading: Passed Roll Call # 200",36,0,0,1,37
842199,562835,2016-09-20,House,"Reported With Recommendation With Substitute  H-1",20,0,0,0,20
842199,565418,2016-12-01,House,"House Third Reading: Passed Roll Call # 536",108,0,0,0,108
842199,565705,2016-12-06,Senate,"Senate Third Reading: Roll Call # 679",36,0,1,1,38
842233,532952,2016-04-13,Senate,"Reported Favorably Without Amendment",5,0,0,0,5
842233,539724,2016-04-28,Senate,"Senate Third Reading: Passed Roll Call # 213",36,0,0,1,37
842233,564863,2016-11-10,House,"Reported With Recommendation Without Amendment",17,0,0,0,17
842233,565987,2016-12-07,House,"House Third Reading: Given Immediate Effect Roll Call # 579",107,0,0,0,107
842292,533070,2016-04-13,Senate,"Reported Favorably Without Amendment",5,0,0,0,5
842292,539791,2016-04-28,Senate,"Senate Third Reading: Passed Roll Call # 217",35,1,0,1,37
842292,564833,2016-11-10,House,"Reported With Recommendation With Substitute  H-1",17,0,0,0,17
842292,565954,2016-12-07,House,"House Third Reading: Given Immediate Effect Roll Call # 583",107,0,0,0,107
842292,565955,2016-12-08,Senate,"Senate Third Reading: Roll Call # 708",36,1,0,1,38
842325,513891,2016-03-03,Senate,"Reported Favorably Without Amendment",5,0,0,0,5
842325,520280,2016-03-15,Senate,"Senate Third Reading: Passed Roll Call # 105",38,0,0,0,38
842341,532630,2016-04-13,Senate,"Reported Favorably With Substitute  S-1",5,0,0,0,5
842341,539811,2016-04-28,Senate,"Senate Third Reading: Passed Roll Call # 209",36,0,0,1,37
842341,564822,2016-11-10,House,"Reported With Recommendation With Substitute  H-1",17,0,0,0,17
842341,566016,2016-12-07,House,"House Third Reading: Given Immediate Effect Roll Call # 576",106,1,0,0,107
842341,566017,2016-12-08,Senate,"Senate Third Reading: Roll Call # 706",37,0,0,1,38
842356,533080,2016-04-13,Senate,"Reported Favorably Without Amendment",5,0,0,0,5
842356,540231,2016-04-28,Senate,"Senate Third Reading: Passed Roll Call # 219",36,0,0,1,37
842356,564864,2016-11-10,House,"Reported With Recommendation Without Amendment",17,0,0,0,17
842356,566018,2016-12-07,House,"House Third Reading: Given Immediate Effect Roll Call # 585",107,0,0,0,107
842434,532899,2016-04-13,Senate,"Reported Favorably Without Amendment",5,0,0,0,5
842434,540275,2016-04-28,Senate,"Senate Third Reading: Passed Roll Call # 211",36,0,0,1,37
842434,564826,2016-11-10,House,"Reported With Recommendation Without Amendment",17,0,0,0,17
842434,566021,2016-12-07,House,"House Third Reading: Given Immediate Effect Roll Call # 578",107,0,0,0,107
842479,524440,2016-03-23,House,"Reported With Recommendation For Referral To Committee On Natural Resources",29,0,0,0,29
842496,532497,2016-04-13,Senate,"Reported Favorably Without Amendment",5,0,0,0,5
842496,540279,2016-04-28,Senate,"Senate Third Reading: Passed Roll Call # 210",36,0,0,1,37
842496,564878,2016-11-10,House,"Reported With Recommendation Without Amendment",17,0,0,0,17
842496,566044,2016-12-07,House,"House Third Reading: Given Immediate Effect Roll Call # 577",107,0,0,0,107
842512,532662,2016-04-13,Senate,"Reported Favorably Without Amendment",5,0,0,0,5
842512,539729,2016-04-28,Senate,"Senate Third Reading: Passed Roll Call # 216",35,1,0,1,37
842512,564870,2016-11-10,House,"Reported With Recommendation Without Amendment",17,0,0,0,17
842512,565951,2016-12-07,House,"House Third Reading: Given Immediate Effect Roll Call # 582",107,0,0,0,107
842526,532668,2016-04-13,Senate,"Reported Favorably Without Amendment",5,0,0,0,5
842526,540337,2016-04-28,Senate,"Senate Third Reading: Passed Roll Call # 214",36,0,0,1,37
842526,564835,2016-11-10,House,"Reported With Recommendation Without Amendment",16,0,0,0,16
842526,565979,2016-12-07,House,"House Third Reading: Given Immediate Effect Roll Call # 580",107,0,0,0,107
842542,543741,2016-05-04,House,"Reported With Recommendation With Substitute  H-2",27,0,0,0,27
842542,544545,2016-05-10,House,"House Third Reading: Passed Roll Call # 245",70,38,0,0,108
842542,546228,2016-05-17,Senate,"Senate Third Reading: Passed Roll Call # 284",27,10,0,0,37
842542,546937,2016-05-18,House,"House Third Reading: Roll Call # 292",0,109,0,0,109
842576,532376,2016-04-13,Senate,"Reported Favorably Without Amendment",5,0,0,0,5
842576,540345,2016-04-28,Senate,"Senate Third Reading: Passed Roll Call # 215",30,6,0,1,37
842576,564866,2016-11-10,House,"Reported With Recommendation Without Amendment",17,0,0,0,17
842576,565953,2016-12-07,House,"House Third Reading: Given Immediate Effect Roll Call # 581",107,0,0,0,107
842604,539592,2016-04-26,House,"Reported With Recommendation With Substitute  H-3",21,0,0,0,21
842604,545534,2016-05-12,House,"House Third Reading: Given Immediate Effect Roll Call # 266",108,0,0,0,108
842604,565410,2016-11-30,Senate,"Reported Favorably With Substitute  S-1",9,0,0,0,9
842604,565858,2016-12-07,Senate,"Senate Third Reading: Given Immediate Effect Roll Call # 690",37,0,0,1,38
842604,566224,2016-12-13,House,"House Third Reading: Roll Call # 623",108,0,0,0,108
843755,516582,2016-03-08,Senate,"Reported Favorably Without Amendment",4,1,0,0,5
843755,518030,2016-03-10,Senate,"Senate Third Reading: Given Immediate Effect Roll Call # 97",26,10,0,2,38
843755,539239,2016-04-27,House,"Reported With Recommendation With Amendment(s)",5,3,0,0,8
843755,546727,2016-05-18,House,"House Third Reading: Given Immediate Effect Roll Call # 293",57,52,0,0,109
843791,538881,2016-04-26,Senate,"Reported Favorably With Substitute S-1",17,0,0,0,17
843791,542470,2016-05-04,Senate,"Senate Third Reading: Passed Roll Call # 228",34,3,0,0,37
843854,501025,2016-02-17,House,"Reported With Recommendation With Substitute H-1",22,0,0,0,22
843854,504270,2016-02-17,House,"Reported With Recommendation With Substitute  H-1",22,0,0,0,22
844009,535491,2016-04-19,House,"Reported With Recommendation With Substitute  H-1",9,0,0,0,9
844009,539481,2016-04-26,House,"House Third Reading: Given Immediate Effect Roll Call # 176",108,0,0,0,108
844009,551921,2016-06-07,Senate,"Reported Favorably Without Amendment",7,0,0,0,7
844009,552117,2016-06-08,Senate,"Senate Third Reading: Given Immediate Effect Roll Call # 394",37,0,0,0,37
844031,535164,2016-04-19,House,"Reported With Recommendation Without Amendment",9,0,0,0,9
844031,539128,2016-04-26,House,"House Third Reading: Given Immediate Effect Roll Call # 177",108,0,0,0,108
844031,551912,2016-06-07,Senate,"Reported Favorably Without Amendment",7,0,0,0,7
844031,552214,2016-06-08,Senate,"Senate Third Reading: Given Immediate Effect Roll Call # 395",37,0,0,0,37
844056,535160,2016-04-19,House,"Reported With Recommendation Without Amendment",9,0,0,0,9
844056,541721,2016-05-03,House,"House Third Reading: Given Immediate Effect Roll Call # 207",107,0,0,0,107
844056,551821,2016-06-07,Senate,"Reported Favorably Without Amendment",7,0,0,0,7
844056,552213,2016-06-08,Senate,"Senate Third Reading: Given Immediate Effect Roll Call # 401",37,0,0,0,37
844066,535570,2016-04-19,House,"Reported With Recommendation With Substitute  H-1",9,0,0,0,9
844066,543765,2016-05-04,House,"House Third Reading: Given Immediate Effect Roll Call # 211",105,0,0,0,105
844066,551830,2016-06-07,Senate,"Reported Favorably Without Amendment",7,0,0,0,7
844066,552223,2016-06-08,Senate,"Senate Third Reading: Given Immediate Effect Roll Call # 405",37,0,0,0,37
844088,535170,2016-04-19,House,"Reported With Recommendation With Substitute  H-1",9,0,0,0,9
844088,539219,2016-04-26,House,"House Third Reading: Given Immediate Effect Roll Call # 173",108,0,0,0,108
844088,551933,2016-06-07,Senate,"Reported Favorably Without Amendment",7,0,0,0,7
844088,552090,2016-06-08,Senate,"Senate Third Reading: Given Immediate Effect Roll Call # 392",37,0,0,0,37
844112,535154,2016-04-19,House,"Reported With Recommendation With Substitute  H-1",9,0,0,0,9
844112,543622,2016-05-04,House,"House Third Reading: Given Immediate Effect Roll Call # 212",108,0,0,0,108
844112,551848,2016-06-07,Senate,"Reported Favorably Without Amendment",7,0,0,0,7
844112,552097,2016-06-08,Senate,"Senate Third Reading: Given Immediate Effect Roll Call # 406",37,0,0,0,37
844145,535387,2016-04-19,House,"Reported With Recommendation With Substitute  H-1",9,0,0,0,9
844145,543629,2016-05-04,House,"House Third Reading: Given Immediate Effect Roll Call # 210",105,0,0,0,105
844145,551831,2016-06-07,Senate,"Reported Favorably Without Amendment",7,0,0,0,7
844145,552222,2016-06-08,Senate,"Senate Third Reading: Given Immediate Effect Roll Call # 404",37,0,0,0,37
844163,535483,2016-04-19,House,"Reported With Recommendation Without Amendment",9,0,0,0,9
844163,539216,2016-04-26,House,"House Third Reading: Given Immediate Effect Roll Call # 179",108,0,0,0,108
844163,551940,2016-06-07,Senate,"Reported Favorably Without Amendment",7,0,0,0,7
844163,552155,2016-06-08,Senate,"Senate Third Reading: Given Immediate Effect Roll Call # 397",37,0,0,0,37
844210,535165,2016-04-19,House,"Reported With Recommendation With Substitute  H-1",9,0,0,0,9
844210,539468,2016-04-26,House,"House Third Reading: Given Immediate Effect Roll Call # 180",108,0,0,0,108
844210,551918,2016-06-07,Senate,"Reported Favorably Without Amendment",7,0,0,0,7
844210,552119,2016-06-08,Senate,"Senate Third Reading: Given Immediate Effect Roll Call # 398",37,0,0,0,37
844222,535423,2016-04-19,House,"Reported With Recommendation With Substitute  H-1",9,0,0,0,9
844222,543618,2016-05-04,House,"House Third Reading: Given Immediate Effect Roll Call # 209",105,0,0,0,105
844222,551851,2016-06-07,Senate,"Reported Favorably Without Amendment",7,0,0,0,7
844222,552228,2016-06-08,Senate,"Senate Third Reading: Given Immediate Effect Roll Call # 403",37,0,0,0,37
844265,535918,2016-04-19,House,"Reported With Recommendation With Substitute  H-1",9,0,0,0,9
844265,539433,2016-04-26,House,"House Third Reading: Given Immediate Effect Roll Call # 171",108,0,0,0,108
844265,551890,2016-06-07,Senate,"Reported Favorably Without Amendment",7,0,0,0,7
844265,552105,2016-06-08,Senate,"Senate Third Reading: Given Immediate Effect Roll Call # 390",37,0,0,0,37
844288,535172,2016-04-19,House,"Reported With Recommendation Without Amendment",9,0,0,0,9
844288,541739,2016-05-03,House,"House Third Reading: Given Immediate Effect Roll Call # 208",107,0,0,0,107
844288,551986,2016-06-07,Senate,"Reported Favorably Without Amendment",7,0,0,0,7
844288,552193,2016-06-08,Senate,"Senate Third Reading: Given Immediate Effect Roll Call # 402",37,0,0,0,37
844301,535590,2016-04-19,House,"Reported With Recommendation Without Amendment",9,0,0,0,9
844301,539118,2016-04-26,House,"House Third Reading: Passed Roll Call # 174",107,0,0,0,107
844301,539119,2016-04-26,House,"House Third Reading: Given Immediate Effect Roll Call # 175",108,0,0,0,108
844301,551961,2016-06-07,Senate,"Reported Favorably Without Amendment",7,0,0,0,7
844301,552174,2016-06-08,Senate,"Senate Third Reading: Given Immediate Effect Roll Call # 393",37,0,0,0,37
844323,535173,2016-04-19,House,"Reported With Recommendation Without Amendment",9,0,0,0,9
844323,539492,2016-04-26,House,"House Third Reading: Given Immediate Effect Roll Call # 172",108,0,0,0,108
844323,551911,2016-06-07,Senate,"Reported Favorably Without Amendment",7,0,0,0,7
844323,552115,2016-06-08,Senate,"Senate Third Reading: Given Immediate Effect Roll Call # 391",37,0,0,0,37
844344,535511,2016-04-19,House,"Reported With Recommendation With Substitute  H-1",9,0,0,0,9
844344,541903,2016-05-03,House,"House Third Reading: Given Immediate Effect Roll Call # 206",107,0,0,0,107
844344,551818,2016-06-07,Senate,"Reported Favorably Without Amendment",7,0,0,0,7
844344,552212,2016-06-08,Senate,"Senate Third Reading: Given Immediate Effect Roll Call # 400",37,0,0,0,37
844363,535509,2016-04-19,House,"Reported With Recommendation Without Amendment",9,0,0,0,9
844363,541516,2016-05-03,House,"House Third Reading: Given Immediate Effect Roll Call # 205",107,0,0,0,107
844363,551823,2016-06-07,Senate,"Reported Favorably Without Amendment",7,0,0,0,7
844363,552217,2016-06-08,Senate,"Senate Third Reading: Given Immediate Effect Roll Call # 399",36,1,0,0,37
844371,535176,2016-04-19,House,"Reported With Recommendation With Substitute  H-1",9,0,0,0,9
844371,539483,2016-04-26,House,"House Third Reading: Given Immediate Effect Roll Call # 178",108,0,0,0,108
844371,551920,2016-06-07,Senate,"Reported Favorably Without Amendment",7,0,0,0,7
844371,552234,2016-06-08,Senate,"Senate Third Reading: Given Immediate Effect Roll Call # 396",37,0,0,0,37
845739,520738,2016-03-16,House,"Reported With Recommendation Without Amendment",6,3,0,0,9
848506,537002,2016-04-20,Senate,"Reported Favorably With Substitute  S-1",16,0,0,0,16
848506,543298,2016-05-05,Senate,"Senate Third Reading: Passed Roll Call # 249",26,10,0,1,37
848506,544512,2016-05-10,House,"House Third Reading: Passed Roll Call # 252",69,39,0,0,108
848506,546220,2016-05-17,Senate,"Senate Third Reading: Roll Call # 270",0,37,0,0,37
848530,538763,2016-04-26,Senate,"Reported Favorably With Substitute  S-1",17,0,0,0,17
848539,535013,2016-04-19,Senate,"Reported Favorably With Substitute  S-1",17,0,0,0,17
848555,536460,2016-04-20,Senate,"Reported Favorably With Substitute  S-1",16,0,0,0,16
848555,543273,2016-05-05,Senate,"Senate Third Reading: Passed Roll Call # 247",27,9,0,1,37
848555,544613,2016-05-10,House,"House Third Reading: Passed Roll Call # 250",69,39,0,0,108
848555,546254,2016-05-17,Senate,"Senate Third Reading: Roll Call # 267",0,34,3,0,37
848589,536463,2016-04-20,Senate,"Reported Favorably With Substitute  S-1",16,0,0,0,16
848610,542607,2016-05-04,Senate,"Senate Third Reading: Passed Roll Call # 240",23,13,0,1,37
848610,544673,2016-05-10,House,"House Third Reading: Given Immediate Effect Roll Call # 246",69,39,0,0,108
848610,546322,2016-05-17,Senate,"Senate Third Reading: Roll Call # 275",0,37,0,0,37
848610,552229,2016-06-08,Senate,"Senate Third Reading: Senate Adopted Conference Report With Immediate Effect Roll Call # 415",20,17,0,0,37
848610,552321,2016-06-08,House,"House Third Reading: Conference Report Adopted Roll Call # 415",74,34,0,0,108
848651,538904,2016-04-26,Senate,"Reported Favorably With Substitute  S-1",13,1,0,0,14
848670,538896,2016-04-26,Senate,"Reported Favorably With Substitute  S-1",17,0,0,0,17
848676,535024,2016-04-19,Senate,"Reported Favorably With Substitute  S-1",17,0,0,0,17
848676,543089,2016-05-05,Senate,"Senate Third Reading: Passed Roll Call # 246",27,8,0,2,37
848676,544830,2016-05-10,House,"House Third Reading: Passed Roll Call # 249",70,38,0,0,108
848676,546454,2016-05-17,Senate,"Senate Third Reading: Roll Call # 273",0,37,0,0,37
848700,536366,2016-04-20,Senate,"Reported Favorably With Substitute  S-1",16,0,0,0,16
848700,543323,2016-05-05,Senate,"Senate Third Reading: Passed Roll Call # 248",26,10,0,1,37
848700,544609,2016-05-10,House,"House Third Reading: Passed Roll Call # 251",69,39,0,0,108
848700,546440,2016-05-17,Senate,"Senate Third Reading: Roll Call # 268",0,37,0,0,37
848708,536462,2016-04-20,Senate,"Reported Favorably With Substitute  S-1",16,0,0,0,16
848735,546270,2016-05-17,House,"Reported With Recommendation Without Amendment",11,0,0,0,11
848735,565515,2016-12-01,House,"House Third Reading: Given Immediate Effect Roll Call # 533",104,4,0,0,108
848743,521260,2016-03-17,Senate,"Reported Favorably With Substitute  S-1",5,0,0,0,5
848743,521261,2016-03-17,Senate,"Senate Third Reading: Given Immediate Effect Roll Call # 117",37,0,0,1,38
848751,537011,2016-04-20,Senate,"Reported Favorably With Substitute  S-1",13,4,0,0,17
848751,543316,2016-05-05,Senate,"Senate Third Reading: Passed Roll Call # 250",26,10,1,0,37
848751,544492,2016-05-10,House,"House Third Reading: Passed Roll Call # 253",69,39,0,0,108
848751,546236,2016-05-17,Senate,"Senate Third Reading: Roll Call # 274",0,37,0,0,37
848763,535055,2016-04-19,Senate,"Reported Favorably With Substitute  S-1",17,0,0,0,17
848777,535018,2016-04-19,Senate,"Reported Favorably With Substitute  S-1",12,5,0,0,17
848777,543288,2016-05-05,Senate,"Senate Third Reading: Passed Roll Call # 244",27,8,0,2,37
848777,544757,2016-05-10,House,"House Third Reading: Passed Roll Call # 247",69,39,0,0,108
848777,546456,2016-05-17,Senate,"Senate Third Reading: Roll Call # 269",0,37,0,0,37
848807,546532,2016-05-17,House,"Reported With Recommendation With Substitute  H-1",11,0,0,0,11
848807,565454,2016-12-01,House,"House Third Reading: Given Immediate Effect Roll Call # 534",104,4,0,0,108
848813,538723,2016-04-26,Senate,"Reported Favorably With Substitute  S-1",17,0,0,0,17
848813,543257,2016-05-05,Senate,"Senate Third Reading: Passed Roll Call # 251",27,10,0,0,37
848813,544814,2016-05-10,House,"House Third Reading: Passed Roll Call # 254",70,38,0,0,108
848813,546491,2016-05-17,Senate,"Senate Third Reading: Roll Call # 272",0,37,0,0,37
848831,538897,2016-04-26,Senate,"Reported Favorably With Substitute  S-1",13,4,0,0,17
848840,513330,2016-03-03,House,"Reported With Recommendation Without Amendment",26,0,0,0,26
848840,517183,2016-03-09,House,"House Third Reading: Given Immediate Effect Roll Call # 93",103,2,0,0,105
848840,521307,2016-03-17,Senate,"Reported Favorably Without Amendment",17,0,0,0,17
848840,524153,2016-03-23,Senate,"Senate Third Reading: Given Immediate Effect Roll Call # 136",37,0,0,1,38
848850,542489,2016-05-04,Senate,"Senate Third Reading: Passed Roll Call # 234",26,11,0,0,37
848850,565928,2016-12-07,House,"Reported With Recommendation With Substitute  H-1",28,0,0,0,28
848850,565929,2016-12-07,House,"House Third Reading: Given Immediate Effect Roll Call # 560",106,0,0,0,106
848850,565930,2016-12-07,Senate,"Senate Third Reading: Roll Call # 699",37,0,0,1,38
848865,535021,2016-04-19,Senate,"Reported Favorably With Substitute  S-1",17,0,0,0,17
848865,543378,2016-05-05,Senate,"Senate Third Reading: Passed Roll Call # 245",27,8,0,2,37
848865,544544,2016-05-10,House,"House Third Reading: Passed Roll Call # 248",70,38,0,0,108
848865,546490,2016-05-17,Senate,"Senate Third Reading: Roll Call # 271",0,37,0,0,37
849584,563998,2016-10-19,Senate,"Reported Favorably Without Amendment",10,0,0,0,10
849584,564079,2016-10-20,Senate,"Senate Third Reading: Passed Roll Call # 580",36,0,0,1,37
849584,565737,2016-12-06,House,"Reported With Recommendation Without Amendment",19,0,0,0,19
849584,566651,2016-12-14,House,"House Third Reading: Passed Roll Call # 690",107,0,0,0,107
849910,563996,2016-10-19,Senate,"Reported Favorably With Substitute  S-2",10,0,0,0,10
849910,564078,2016-10-20,Senate,"Senate Third Reading: Passed Roll Call # 584",36,0,0,1,37
849910,565735,2016-12-06,House,"Reported With Recommendation Without Amendment",19,0,0,0,19
849910,566705,2016-12-14,House,"House Third Reading: Passed Roll Call # 697",107,0,0,0,107
850223,545530,2016-05-12,House,"Reported With Recommendation Without Amendment",17,0,0,0,17
850223,548257,2016-05-24,House,"House Third Reading: Given Immediate Effect Roll Call # 316",106,0,0,0,106
850951,544772,2016-05-10,Senate,"Reported Favorably With Substitute  S-1",5,0,0,0,5
850951,546752,2016-05-18,Senate,"Senate Third Reading: Passed Roll Call # 311",37,0,0,0,37
850951,551803,2016-06-07,House,"Reported With Recommendation Without Amendment",23,0,0,0,23
850951,552353,2016-06-08,House,"House Third Reading: Given Immediate Effect Roll Call # 414",108,0,0,0,108
851023,524490,2016-03-23,House,"Reported With Recommendation Without Amendment",5,1,0,0,6
851035,524080,2016-03-23,House,"Reported With Recommendation Without Amendment",5,1,0,0,6
851069,541552,2016-05-03,House,"Reported With Recommendation With Substitute H-1",17,12,0,0,29
851123,541783,2016-05-03,House,"Reported With Recommendation Without Amendment",17,12,0,0,29
851123,543780,2016-05-05,House,"House Third Reading: Given Immediate Effect Roll Call # 219",55,53,0,0,108
851123,550989,2016-06-02,House,"House Third Reading: Passed Roll Call # 389",57,51,0,0,108
851123,552102,2016-06-08,Senate,"Senate Third Reading: Given Immediate Effect Roll Call # 422",20,17,0,0,37
851123,552382,2016-06-09,House,"House Third Reading: Senate Amendment(s) Concurred In Roll Call # 419",57,52,0,0,109
851229,520655,2016-03-16,House,"Reported With Recommendation With Substitute  H-1",18,7,0,0,25
851229,521336,2016-03-17,House,"House Third Reading: Given Immediate Effect Roll Call # 122",66,43,0,0,109
851229,524415,2016-03-24,Senate,"Senate Third Reading: Given Immediate Effect Roll Call # 143",26,10,0,2,38
851229,524634,2016-03-24,House,"House Third Reading: Roll Call # 133",95,13,0,0,108
851311,541538,2016-05-03,House,"Reported With Recommendation With Substitute  H-2",15,14,0,0,29
851311,543755,2016-05-05,House,"House Third Reading: Given Immediate Effect Roll Call # 218",59,49,0,0,108
851311,551180,2016-06-02,House,"House Third Reading: Passed Roll Call # 388",58,50,0,0,108
851311,552210,2016-06-08,Senate,"Senate Third Reading: Given Immediate Effect Roll Call # 429",23,14,0,0,37
851968,523281,2016-03-22,Senate,"Reported Favorably Without Amendment",7,0,0,0,7
852130,541666,2016-05-03,House,"Reported With Recommendation With Substitute  H-1",15,14,0,0,29
852130,543764,2016-05-05,House,"House Third Reading: Given Immediate Effect Roll Call # 216",57,51,0,0,108
852130,551080,2016-06-02,House,"House Third Reading: Passed Roll Call # 386",55,53,0,0,108
852130,552124,2016-06-08,Senate,"Senate Third Reading: Given Immediate Effect Roll Call # 428",19,18,0,0,37
852130,552292,2016-06-09,House,"House Third Reading: Senate Amendment(s) Concurred In Roll Call # 420",55,54,0,0,109
854789,517235,2016-03-09,House,"Reported With Recommendation Without Amendment",14,0,0,0,14
854789,524832,2016-03-23,House,"House Third Reading: Given Immediate Effect Roll Call # 130",73,35,0,0,108
854789,548429,2016-05-25,Senate,"Reported Favorably With Substitute  S-1",5,0,0,0,5
854789,551816,2016-06-07,Senate,"Senate Third Reading: Given Immediate Effect Roll Call # 381",37,0,0,0,37
854789,552341,2016-06-08,House,"House Third Reading: Roll Call # 406",89,19,0,0,108
855129,517458,2016-03-09,House,"Reported With Recommendation With Substitute H-1",15,0,0,0,15
855285,522852,2016-03-22,Senate,"Senate Third Reading: Passed Roll Call # 126",21,16,0,1,38
855336,516048,2016-03-08,House,"Reported With Recommendation Without Amendment",9,0,0,0,9
855336,520915,2016-03-16,House,"House Third Reading: Given Immediate Effect Roll Call # 109",106,3,0,0,109
855336,537422,2016-04-21,Senate,"Reported Favorably Without Amendment",5,0,0,0,5
855336,548193,2016-05-24,Senate,"Senate Third Reading: Given Immediate Effect Roll Call # 316",37,0,0,0,37
855336,550232,2016-05-31,House,"House Third Reading: Roll Call # 333",103,6,0,0,109
855344,522835,2016-03-22,Senate,"Senate Third Reading: Passed Roll Call # 127",21,16,0,1,38
855344,541536,2016-05-03,House,"Reported With Recommendation With Substitute  H-1",17,12,0,0,29
855344,543621,2016-05-05,House,"House Third Reading: Given Immediate Effect Roll Call # 221",59,49,0,0,108
855344,550988,2016-06-02,House,"House Third Reading: Passed Roll Call # 390",59,49,0,0,108
855344,552086,2016-06-08,Senate,"Senate Third Reading: Roll Call # 431",22,15,0,0,37
855368,522773,2016-03-22,Senate,"Senate Third Reading: Passed Roll Call # 129",21,16,0,1,38
855368,541793,2016-05-03,House,"Reported With Recommendation With Substitute  H-2",15,14,0,0,29
855368,543687,2016-05-05,House,"House Third Reading: Given Immediate Effect Roll Call # 217",55,53,0,0,108
855368,551217,2016-06-02,House,"House Third Reading: Passed Roll Call # 387",56,52,0,0,108
855368,552239,2016-06-08,Senate,"Senate Third Reading: Roll Call # 433",21,16,0,0,37
855374,562822,2016-09-20,House,"Reported With Recommendation With Substitute  H-2",20,0,0,0,20
855374,565250,2016-11-29,House,"House Third Reading: Given Immediate Effect Roll Call # 514",102,5,0,0,107
855374,565921,2016-12-07,Senate,"Reported Favorably Without Amendment",10,0,0,0,10
855374,566433,2016-12-14,Senate,"Senate Third Reading: Given Immediate Effect Roll Call # 764",36,1,0,1,38
855374,566642,2016-12-15,House,"House Third Reading: Roll Call # 720",101,7,0,0,108
855382,532048,2016-04-12,Senate,"Reported Favorably Without Amendment",8,0,0,0,8
855382,532494,2016-04-13,Senate,"Senate Third Reading: Passed Roll Call # 166",35,0,0,2,37
855382,539251,2016-04-27,House,"Reported With Recommendation Without Amendment",14,0,0,0,14
855382,546408,2016-05-17,House,"House Third Reading: Given Immediate Effect Roll Call # 280",92,17,0,0,109
855388,523586,2016-03-22,Senate,"Senate Third Reading: Passed Roll Call # 128",21,16,0,1,38
857480,532679,2016-04-13,House,"Reported With Recommendation With Substitute  H-1",11,1,0,0,12
857480,546868,2016-05-18,House,"House Third Reading: Given Immediate Effect Roll Call # 299",70,39,0,0,109
857565,517118,2016-03-09,House,"Reported With Recommendation Without Amendment",5,3,0,0,8
857565,524608,2016-03-24,House,"House Third Reading: Given Immediate Effect Roll Call # 146",72,36,0,0,108
857565,541924,2016-05-03,Senate,"Reported Favorably Without Amendment",4,0,0,0,4
858197,539054,2016-04-27,Senate,"Reported Favorably Without Amendment",4,1,0,0,5
858228,563081,2016-09-22,House,"Reported With Recommendation With Substitute H-1",14,3,0,0,17
858228,565995,2016-12-07,House,"House Third Reading: Passed Roll Call # 568",84,23,0,0,107
858228,566362,2016-12-14,Senate,"Reported Favorably Without Amendment",4,1,0,0,5
858228,566363,2016-12-14,Senate,"Senate Third Reading: Passed Roll Call # 791",37,0,0,1,38
858234,563135,2016-09-22,House,"Reported With Recommendation With Substitute H-3",13,4,0,0,17
858234,566007,2016-12-07,House,"House Third Reading: Passed Roll Call # 571",85,22,0,0,107
858234,566365,2016-12-14,Senate,"Reported Favorably Without Amendment",4,1,0,0,5
858234,566366,2016-12-14,Senate,"Senate Third Reading: Passed Roll Call # 794",37,0,0,1,38
858237,563130,2016-09-22,House,"Reported With Recommendation With Substitute H-1",13,4,0,0,17
858237,565989,2016-12-07,House,"House Third Reading: Passed Roll Call # 574",85,22,0,0,107
858237,566370,2016-12-14,Senate,"Reported Favorably Without Amendment",4,1,0,0,5
858237,566371,2016-12-14,Senate,"Senate Third Reading: Passed Roll Call # 797",36,1,0,1,38
858247,563152,2016-09-22,House,"Reported With Recommendation With Substitute H-3",12,4,0,0,16
858247,565998,2016-12-07,House,"House Third Reading: Passed Roll Call # 575",84,23,0,0,107
858247,566455,2016-12-14,Senate,"Reported Favorably Without Amendment",4,1,0,0,5
858247,566456,2016-12-14,Senate,"Senate Third Reading: Passed Roll Call # 798",37,0,0,1,38
858256,563077,2016-09-22,House,"Reported With Recommendation With Substitute H-1",13,4,0,0,17
858256,566029,2016-12-07,House,"House Third Reading: Passed Roll Call # 570",83,24,0,0,107
858256,566375,2016-12-14,Senate,"Reported Favorably Without Amendment",4,1,0,0,5
858256,566376,2016-12-14,Senate,"Senate Third Reading: Passed Roll Call # 793",36,1,0,1,38
858266,563078,2016-09-22,House,"Reported With Recommendation With Substitute H-1",13,4,0,0,17
858266,565972,2016-12-07,House,"House Third Reading: Passed Roll Call # 572",84,23,0,0,107
858266,566368,2016-12-14,Senate,"Reported Favorably Without Amendment",4,1,0,0,5
858266,566369,2016-12-14,Senate,"Senate Third Reading: Passed Roll Call # 795",36,1,0,1,38
858274,523881,2016-03-23,House,"Reported With Recommendation With Substitute  H-1",9,0,0,0,9
858274,533534,2016-04-14,House,"House Third Reading: Given Immediate Effect Roll Call # 156",103,5,0,0,108
858274,562369,2016-09-08,Senate,"Reported Favorably Without Amendment",4,0,0,0,4
858274,566359,2016-12-14,Senate,"Senate Third Reading: Given Immediate Effect Roll Call # 785",37,0,0,1,38
858274,566720,2016-12-15,House,"House Third Reading: Roll Call # 752",105,2,0,0,107
858287,520343,2016-03-15,House,"Reported With Recommendation Without Amendment",8,0,0,0,8
858287,552296,2016-06-08,House,"House Third Reading: Given Immediate Effect Roll Call # 407",105,3,0,0,108
858287,566192,2016-12-13,Senate,"Reported Favorably Without Amendment",5,0,0,0,5
858287,566387,2016-12-14,Senate,"Senate Third Reading: Passed Roll Call # 819",37,0,0,1,38
858301,563151,2016-09-22,House,"Reported With Recommendation Without Amendment",14,3,0,0,17
858301,565968,2016-12-07,House,"House Third Reading: Passed Roll Call # 569",84,23,0,0,107
858301,566373,2016-12-14,Senate,"Reported Favorably Without Amendment",4,1,0,0,5
858301,566374,2016-12-14,Senate,"Senate Third Reading: Passed Roll Call # 792",36,1,0,1,38
858320,563074,2016-09-22,House,"Reported With Recommendation With Substitute H-1",13,3,0,0,16
858320,566031,2016-12-07,House,"House Third Reading: Passed Roll Call # 573",84,23,0,0,107
858320,566377,2016-12-14,Senate,"Reported Favorably Without Amendment",4,1,0,0,5
858320,566378,2016-12-14,Senate,"Senate Third Reading: Passed Roll Call # 796",36,1,0,1,38
858324,563072,2016-09-22,House,"Reported With Recommendation With Substitute H-1",14,3,0,0,17
858324,565967,2016-12-07,House,"House Third Reading: Passed Roll Call # 567",81,25,0,0,106
858324,566395,2016-12-14,Senate,"Reported Favorably Without Amendment",4,1,0,0,5
858324,566396,2016-12-14,Senate,"Senate Third Reading: Passed Roll Call # 790",36,1,0,1,38
858330,563080,2016-09-22,House,"Reported With Recommendation With Substitute H-1",13,4,0,0,17
858333,520048,2016-03-15,House,"Reported With Recommendation With Substitute  H-1",8,0,0,0,8
858793,543358,2016-05-05,Senate,"Reported Favorably Without Amendment",17,0,0,0,17
858793,550208,2016-05-31,Senate,"Senate Third Reading: Passed Roll Call # 345",37,0,0,0,37
858793,566024,2016-12-07,House,"Reported With Recommendation With Substitute  H-2",28,0,0,0,28
858793,566727,2016-12-15,House,"House Third Reading: Passed Roll Call # 724",108,0,0,0,108
858793,566728,2016-12-15,Senate,"Senate Third Reading: Roll Call # 825",37,0,0,1,38
858810,523245,2016-03-22,House,"Reported With Recommendation Without Amendment",18,0,0,0,18
861424,524714,2016-03-24,Senate,"Reported Favorably With Substitute  S-1",5,0,0,0,5
861555,532660,2016-04-13,Senate,"Reported Favorably Without Amendment",4,0,0,0,4
861555,536757,2016-04-20,Senate,"Senate Third Reading: Passed Roll Call # 183",37,0,0,0,37
861555,546803,2016-05-18,House,"Reported With Recommendation Without Amendment",27,0,0,0,27
861555,550335,2016-05-31,House,"House Third Reading: Given Immediate Effect Roll Call # 338",108,1,0,0,109
861612,547999,2016-05-24,House,"Reported With Recommendation With Substitute  H-2",9,0,0,0,9
861612,550759,2016-06-01,House,"House Third Reading: Given Immediate Effect Roll Call # 350",108,1,0,0,109
861612,559087,2016-08-03,Senate,"Reported Favorably Without Amendment",4,0,0,0,4
861612,562343,2016-09-08,Senate,"Senate Third Reading: Given Immediate Effect Roll Call # 507",37,0,0,0,37
862025,535697,2016-04-19,House,"Reported With Recommendation With Substitute  H-1",14,0,0,0,14
862025,544502,2016-05-10,House,"House Third Reading: Given Immediate Effect Roll Call # 235",106,2,0,0,108
862025,548808,2016-05-26,Senate,"Reported Favorably With Substitute  S-1",5,0,0,0,5
862025,552304,2016-06-09,Senate,"Senate Third Reading: Given Immediate Effect Roll Call # 439",37,0,0,0,37
862025,552305,2016-06-09,House,"House Third Reading: Roll Call # 436",107,2,0,0,109
862037,524112,2016-03-23,House,"Reported With Recommendation Without Amendment",13,0,0,0,13
862037,533491,2016-04-14,House,"House Third Reading: Given Immediate Effect Roll Call # 155",97,11,0,0,108
862037,543275,2016-05-05,Senate,"Reported Favorably Without Amendment",7,0,0,0,7
862037,544635,2016-05-10,Senate,"Senate Third Reading: Given Immediate Effect Roll Call # 262",33,4,0,0,37
862470,565689,2016-12-06,Senate,"Senate Third Reading: Passed Roll Call # 681",34,3,0,1,38
862719,539595,2016-04-26,House,"Reported With Recommendation With Substitute  H-3",15,0,0,0,15
862719,545559,2016-05-12,House,"House Third Reading: Given Immediate Effect Roll Call # 258",90,18,0,0,108
862719,563955,2016-10-18,Senate,"Reported Favorably Without Amendment",4,0,0,0,4
862719,565237,2016-11-29,Senate,"Senate Third Reading: Given Immediate Effect Roll Call # 630",37,0,0,1,38
862719,565238,2016-11-29,House,"House Third Reading: Roll Call # 512",97,10,0,0,107
862779,535115,2016-04-19,House,"Reported With Recommendation With Substitute  H-1",14,0,0,0,14
862779,544519,2016-05-10,House,"House Third Reading: Given Immediate Effect Roll Call # 236",104,4,0,0,108
864740,539702,2016-04-28,Senate,"Reported Favorably Without Amendment",4,1,0,0,5
864740,544537,2016-05-10,Senate,"Senate Third Reading: Passed Roll Call # 255",25,12,0,0,37
864740,562825,2016-09-20,House,"Reported With Recommendation Without Amendment",11,6,0,0,17
864740,565458,2016-12-01,House,"House Third Reading: Given Immediate Effect Roll Call # 535",62,46,0,0,108
864763,524770,2016-03-24,House,"Reported With Recommendation Without Amendment",6,0,0,0,6
864763,532945,2016-04-13,House,"House Third Reading: Given Immediate Effect Roll Call # 152",109,0,0,0,109
864792,547374,2016-05-19,House,"Reported With Recommendation With Substitute  H-1",10,4,0,0,14
864792,550239,2016-05-31,House,"House Third Reading: Given Immediate Effect Roll Call # 339",71,38,0,0,109
864810,550998,2016-06-02,House,"House Third Reading: Given Immediate Effect Roll Call # 396",79,29,0,0,108
864810,552110,2016-06-08,Senate,"Senate Third Reading: Given Immediate Effect Roll Call # 383",29,7,0,1,37
864810,552302,2016-06-08,House,"House Third Reading: Senate Amendment(s) Concurred In Roll Call # 405",80,28,0,0,108
864829,551062,2016-06-02,House,"House Third Reading: Given Immediate Effect Roll Call # 395",78,30,0,0,108
864829,552236,2016-06-08,Senate,"Senate Third Reading: Given Immediate Effect Roll Call # 382",29,7,0,1,37
864829,552360,2016-06-08,House,"House Third Reading: Senate Amendment(s) Concurred In Roll Call # 404",80,28,0,0,108
865302,547365,2016-05-19,House,"Reported With Recommendation Without Amendment",6,0,0,0,6
865302,562985,2016-09-21,House,"House Third Reading: Given Immediate Effect Roll Call # 469",100,6,0,0,106
865315,547475,2016-05-19,House,"Reported With Recommendation With Substitute  H-3",6,0,0,0,6
865315,562977,2016-09-21,House,"House Third Reading: Given Immediate Effect Roll Call # 472",100,6,0,0,106
865327,547467,2016-05-19,House,"Reported With Recommendation With Substitute  H-1",6,0,0,0,6
865327,562986,2016-09-21,House,"House Third Reading: Given Immediate Effect Roll Call # 464",100,6,0,0,106
865340,547405,2016-05-19,House,"Reported With Recommendation With Substitute  H-1",6,0,0,0,6
865340,562989,2016-09-21,House,"House Third Reading: Given Immediate Effect Roll Call # 468",99,7,0,0,106
865353,547381,2016-05-19,House,"Reported With Recommendation Without Amendment",6,0,0,0,6
865353,562988,2016-09-21,House,"House Third Reading: Given Immediate Effect Roll Call # 465",100,6,0,0,106
865367,547379,2016-05-19,House,"Reported With Recommendation Without Amendment",6,0,0,0,6
865367,562984,2016-09-21,House,"House Third Reading: Given Immediate Effect Roll Call # 473",99,7,0,0,106
865380,547376,2016-05-19,House,"Reported With Recommendation Without Amendment",6,0,0,0,6
865380,562967,2016-09-21,House,"House Third Reading: Given Immediate Effect Roll Call # 471",100,6,0,0,106
865405,547378,2016-05-19,House,"Reported With Recommendation Without Amendment",6,0,0,0,6
865405,562981,2016-09-21,House,"House Third Reading: Given Immediate Effect Roll Call # 467",100,6,0,0,106
865417,547363,2016-05-19,House,"Reported With Recommendation With Substitute  H-1",6,0,0,0,6
865417,562987,2016-09-21,House,"House Third Reading: Given Immediate Effect Roll Call # 470",100,6,0,0,106
865426,547373,2016-05-19,House,"Reported With Recommendation Without Amendment",6,0,0,0,6
865426,562992,2016-09-21,House,"House Third Reading: Given Immediate Effect Roll Call # 466",100,6,0,0,106
865847,545557,2016-05-12,Senate,"Reported Favorably With Substitute  S-1",5,0,0,0,5
865847,546647,2016-05-18,Senate,"Senate Third Reading: Passed Roll Call # 312",37,0,0,0,37
865847,547997,2016-05-24,House,"Reported With Recommendation Without Amendment",7,0,0,0,7
865847,548624,2016-05-25,House,"House Third Reading: Given Immediate Effect Roll Call # 321",100,9,0,0,109
866072,565608,2016-11-29,House,"Reported With Recommendation Without Amendment",10,0,0,0,10
866118,565610,2016-11-29,House,"Reported With Recommendation Without Amendment",10,1,0,0,11
866174,565561,2016-11-29,House,"Reported With Recommendation Without Amendment",10,0,0,0,10
866180,565611,2016-11-29,House,"Reported With Recommendation Without Amendment",10,1,0,0,11
866186,541592,2016-05-03,House,"Reported With Recommendation Without Amendment",9,0,0,0,9
866186,551042,2016-06-02,House,"House Third Reading: Given Immediate Effect Roll Call # 380",78,30,0,0,108
866186,565475,2016-12-01,Senate,"Reported Favorably With Substitute  S-1",3,0,0,0,3
866186,566061,2016-12-08,Senate,"Senate Third Reading: Given Immediate Effect Roll Call # 713",36,1,0,1,38
866186,566218,2016-12-13,House,"House Third Reading: Roll Call # 631",81,27,0,0,108
867170,565365,2016-11-30,Senate,"Reported Favorably With Substitute  S-1",5,0,0,0,5
867170,566077,2016-12-08,Senate,"Senate Third Reading: Passed Roll Call # 726",37,0,0,1,38
867208,562457,2016-09-13,House,"Reported With Recommendation With Substitute H-1",10,1,0,0,11
867208,562499,2016-09-13,House,"Reported With Recommendation With Substitute  H-1",10,1,0,0,11
867208,563144,2016-09-22,House,"House Third Reading: Given Immediate Effect Roll Call # 491",96,11,0,0,107
867208,565353,2016-11-30,Senate,"Reported Favorably Without Amendment",3,1,0,0,4
867208,565532,2016-12-01,Senate,"Senate Third Reading: Given Immediate Effect Roll Call # 665",36,0,0,2,38
867212,565540,2016-11-30,House,"Reported With Recommendation Without Amendment",11,0,0,0,11
867214,547988,2016-05-24,House,"Reported With Recommendation With Substitute  H-1",8,0,0,0,8
867214,551085,2016-06-02,House,"House Third Reading: Given Immediate Effect Roll Call # 366",93,15,0,0,108
867214,559088,2016-08-03,Senate,"Reported Favorably Without Amendment",4,0,0,0,4
867214,562365,2016-09-07,Senate,"Senate Third Reading: Given Immediate Effect Roll Call # 490",36,0,0,1,37
867224,540028,2016-04-28,House,"Reported With Recommendation Without Amendment",11,0,0,0,11
867224,547461,2016-05-19,House,"House Third Reading: Given Immediate Effect Roll Call # 312",109,0,0,0,109
867224,559052,2016-08-03,Senate,"Reported Favorably Without Amendment",4,0,0,0,4
867224,562392,2016-09-07,Senate,"Senate Third Reading: Given Immediate Effect Roll Call # 489",36,0,0,1,37
867257,540021,2016-04-28,House,"Reported With Recommendation With Substitute  H-1",11,0,0,0,11
867257,547311,2016-05-19,House,"House Third Reading: Given Immediate Effect Roll Call # 305",109,0,0,0,109
867257,559060,2016-08-03,Senate,"Reported Favorably Without Amendment",4,0,0,0,4
867257,562391,2016-09-07,Senate,"Senate Third Reading: Given Immediate Effect Roll Call # 482",36,0,0,1,37
867267,540018,2016-04-28,House,"Reported With Recommendation With Substitute  H-1",11,0,0,0,11
867267,547464,2016-05-19,House,"House Third Reading: Given Immediate Effect Roll Call # 306",109,0,0,0,109
867267,559085,2016-08-03,Senate,"Reported Favorably Without Amendment",4,0,0,0,4
867267,562292,2016-09-07,Senate,"Senate Third Reading: Given Immediate Effect Roll Call # 483",36,0,0,1,37
867268,540088,2016-04-28,House,"Reported With Recommendation Without Amendment",11,0,0,0,11
867268,547323,2016-05-19,House,"House Third Reading: Given Immediate Effect Roll Call # 309",109,0,0,0,109
867268,559066,2016-08-03,Senate,"Reported Favorably Without Amendment",4,0,0,0,4
867268,562403,2016-09-07,Senate,"Senate Third Reading: Given Immediate Effect Roll Call # 486",36,0,0,1,37
867298,540095,2016-04-28,House,"Reported With Recommendation Without Amendment",11,0,0,0,11
867298,547526,2016-05-19,House,"House Third Reading: Given Immediate Effect Roll Call # 307",109,0,0,0,109
867298,559084,2016-08-03,Senate,"Reported Favorably Without Amendment",4,0,0,0,4
867298,562374,2016-09-07,Senate,"Senate Third Reading: Given Immediate Effect Roll Call # 484",36,0,0,1,37
867305,540068,2016-04-28,House,"Reported With Recommendation Without Amendment",11,0,0,0,11
867305,547462,2016-05-19,House,"House Third Reading: Given Immediate Effect Roll Call # 310",109,0,0,0,109
867305,559077,2016-08-03,Senate,"Reported Favorably Without Amendment",4,0,0,0,4
867305,562293,2016-09-07,Senate,"Senate Third Reading: Given Immediate Effect Roll Call # 487",36,0,0,1,37
867309,540111,2016-04-28,House,"Reported With Recommendation With Substitute  H-1",11,0,0,0,11
867309,547556,2016-05-19,House,"House Third Reading: Given Immediate Effect Roll Call # 308",109,0,0,0,109
867309,559086,2016-08-03,Senate,"Reported Favorably Without Amendment",4,0,0,0,4
867309,562394,2016-09-07,Senate,"Senate Third Reading: Given Immediate Effect Roll Call # 485",36,0,0,1,37
867313,540050,2016-04-28,House,"Reported With Recommendation Without Amendment",11,0,0,0,11
867313,547523,2016-05-19,House,"House Third Reading: Given Immediate Effect Roll Call # 311",109,0,0,0,109
867313,559082,2016-08-03,Senate,"Reported Favorably Without Amendment",4,0,0,0,4
867313,562375,2016-09-07,Senate,"Senate Third Reading: Given Immediate Effect Roll Call # 488",36,0,0,1,37
867738,525442,2016-03-24,House,"Reported With Recommendation With Substitute H-2",9,0,0,0,9
867838,537397,2016-04-21,House,"Reported With Recommendation With Substitute  H-1",29,0,0,0,29
867838,545535,2016-05-12,House,"House Third Reading: Given Immediate Effect Roll Call # 267",108,0,0,0,108
867838,547100,2016-05-19,Senate,"Reported Favorably Without Amendment",17,0,0,0,17
867838,548395,2016-05-25,Senate,"Senate Third Reading: Given Immediate Effect Roll Call # 339",34,3,0,0,37
868249,562493,2016-09-13,House,"Reported With Recommendation Without Amendment",15,4,0,0,19
868253,533307,2016-04-14,Senate,"Reported Favorably Without Amendment",4,0,0,0,4
868253,537524,2016-04-21,Senate,"Senate Third Reading: Passed Roll Call # 189",36,0,0,1,37
868253,540394,2016-04-28,House,"Reported With Recommendation Without Amendment",11,0,0,0,11
868253,562399,2016-09-08,House,"House Third Reading: Given Immediate Effect Roll Call # 449",107,0,0,0,107
868262,532683,2016-04-13,House,"Reported With Recommendation With Substitute  H-1",13,0,0,0,13
868262,536413,2016-04-20,House,"House Third Reading: Given Immediate Effect Roll Call # 165",107,1,0,0,108
868262,540352,2016-04-28,Senate,"Reported Favorably Without Amendment",7,0,0,0,7
868262,540353,2016-04-28,Senate,"Senate Third Reading: Given Immediate Effect Roll Call # 204",36,0,0,1,37
868284,532720,2016-04-13,House,"Reported With Recommendation Without Amendment",13,0,0,0,13
868284,536464,2016-04-20,House,"House Third Reading: Given Immediate Effect Roll Call # 166",107,1,0,0,108
868284,539805,2016-04-28,Senate,"Reported Favorably Without Amendment",7,0,0,0,7
868284,539806,2016-04-28,Senate,"Senate Third Reading: Given Immediate Effect Roll Call # 205",36,0,0,1,37
868304,535148,2016-04-19,House,"Reported With Recommendation With Substitute  H-2",11,0,0,0,11
868304,547553,2016-05-19,House,"House Third Reading: Given Immediate Effect Roll Call # 304",108,1,0,0,109
868304,550803,2016-06-01,Senate,"Senate Third Reading: Given Immediate Effect Roll Call # 353",36,0,0,1,37
868309,565559,2016-11-29,House,"Reported With Recommendation Without Amendment",6,3,0,0,9
868309,565934,2016-12-07,House,"House Third Reading: Given Immediate Effect Roll Call # 591",64,43,0,0,107
868309,566233,2016-12-13,Senate,"Reported Favorably Without Amendment",4,1,0,0,5
868309,566234,2016-12-13,Senate,"Senate Third Reading: Given Immediate Effect Roll Call # 745",32,5,0,1,38
868319,533313,2016-04-14,Senate,"Reported Favorably Without Amendment",4,0,0,0,4
868319,537556,2016-04-21,Senate,"Senate Third Reading: Passed Roll Call # 188",36,0,0,1,37
868319,540062,2016-04-28,House,"Reported With Recommendation Without Amendment",11,0,0,0,11
868319,562377,2016-09-08,House,"House Third Reading: Given Immediate Effect Roll Call # 448",107,0,0,0,107
868319,563121,2016-09-21,Senate,"Senate Third Reading: Roll Call # 515",35,0,0,2,37
868323,533312,2016-04-14,Senate,"Reported Favorably Without Amendment",4,0,0,0,4
868323,537574,2016-04-21,Senate,"Senate Third Reading: Passed Roll Call # 186",36,0,0,1,37
868323,540035,2016-04-28,House,"Reported With Recommendation Without Amendment",11,0,0,0,11
868323,562401,2016-09-08,House,"House Third Reading: Given Immediate Effect Roll Call # 446",107,0,0,0,107
868353,545494,2016-05-12,House,"Reported With Recommendation With Substitute H-1",17,0,0,0,17
868353,548159,2016-05-24,House,"House Third Reading: Given Immediate Effect Roll Call # 317",106,0,0,0,106
868353,566045,2016-12-08,Senate,"Reported Favorably With Substitute  S-1",10,0,0,0,10
868353,566379,2016-12-14,Senate,"Senate Third Reading: Given Immediate Effect Roll Call # 766",37,0,0,1,38
868353,566724,2016-12-15,House,"House Third Reading: Roll Call # 718",107,1,0,0,108
868361,533305,2016-04-14,Senate,"Reported Favorably Without Amendment",4,0,0,0,4
868361,537576,2016-04-21,Senate,"Senate Third Reading: Passed Roll Call # 187",36,0,0,1,37
868361,540061,2016-04-28,House,"Reported With Recommendation Without Amendment",11,0,0,0,11
868361,562395,2016-09-08,House,"House Third Reading: Given Immediate Effect Roll Call # 447",107,0,0,0,107
868370,532716,2016-04-13,House,"Reported With Recommendation With Substitute  H-1",13,0,0,0,13
868370,536474,2016-04-20,House,"House Third Reading: Given Immediate Effect Roll Call # 164",107,1,0,0,108
868370,540356,2016-04-28,Senate,"Reported Favorably With Substitute  S-1",7,0,0,0,7
868370,540357,2016-04-28,Senate,"Senate Third Reading: Given Immediate Effect Roll Call # 203",36,0,0,1,37
868370,540358,2016-04-28,House,"House Third Reading: Roll Call # 198",108,1,0,0,109
868390,562460,2016-09-13,House,"Reported With Recommendation Without Amendment",10,0,0,0,10
872064,544960,2016-05-11,House,"Reported With Recommendation Without Amendment",8,0,0,0,8
872124,562838,2016-09-20,House,"Reported With Recommendation Without Amendment",20,0,0,0,20
872124,565541,2016-11-30,House,"House Third Reading: Given Immediate Effect Roll Call # 523",104,2,0,0,106
872124,565933,2016-12-07,Senate,"Reported Favorably Without Amendment",10,0,0,0,10
872124,566391,2016-12-14,Senate,"Senate Third Reading: Given Immediate Effect Roll Call # 777",37,0,0,1,38
872164,541556,2016-05-03,House,"Reported With Recommendation Without Amendment",7,0,0,0,7
872164,546448,2016-05-17,House,"House Third Reading: Given Immediate Effect Roll Call # 282",109,0,0,0,109
872164,562299,2016-09-08,Senate,"Reported Favorably Without Amendment",4,0,0,0,4
872164,565547,2016-12-01,Senate,"Senate Third Reading: Given Immediate Effect Roll Call # 650",36,0,0,2,38
872224,541535,2016-05-03,House,"Reported With Recommendation Without Amendment",8,0,0,0,8
872224,546501,2016-05-17,House,"House Third Reading: Given Immediate Effect Roll Call # 283",109,0,0,0,109
872224,562298,2016-09-08,Senate,"Reported Favorably Without Amendment",4,0,0,0,4
872224,565555,2016-12-01,Senate,"Senate Third Reading: Given Immediate Effect Roll Call # 651",36,0,0,2,38
872257,539230,2016-04-27,House,"Reported With Recommendation Without Amendment",10,7,0,0,17
872257,550227,2016-05-31,House,"House Third Reading: Given Immediate Effect Roll Call # 336",57,52,0,0,109
872257,566189,2016-12-13,Senate,"Reported Favorably Without Amendment",4,0,0,0,4
872257,566401,2016-12-14,Senate,"Senate Third Reading: Passed Roll Call # 818",26,11,0,1,38
872275,541804,2016-05-03,House,"Reported With Recommendation Without Amendment",7,0,0,0,7
872275,546479,2016-05-17,House,"House Third Reading: Given Immediate Effect Roll Call # 281",109,0,0,0,109
872275,562294,2016-09-08,Senate,"Reported Favorably Without Amendment",4,0,0,0,4
872275,565435,2016-12-01,Senate,"Senate Third Reading: Given Immediate Effect Roll Call # 649",36,0,0,2,38
872527,536015,2016-04-19,House,"Reported With Recommendation Without Amendment",9,0,0,0,9
872527,544803,2016-05-10,House,"House Third Reading: Given Immediate Effect Roll Call # 231",108,0,0,0,108
872527,551834,2016-06-07,Senate,"Reported Favorably Without Amendment",7,0,0,0,7
872527,552226,2016-06-08,Senate,"Senate Third Reading: Given Immediate Effect Roll Call # 409",37,0,0,0,37
872534,535294,2016-04-19,House,"Reported With Recommendation Without Amendment",9,0,0,0,9
872534,544515,2016-05-10,House,"House Third Reading: Given Immediate Effect Roll Call # 229",108,0,0,0,108
872534,551885,2016-06-07,Senate,"Reported Favorably Without Amendment",7,0,0,0,7
872534,552111,2016-06-08,Senate,"Senate Third Reading: Given Immediate Effect Roll Call # 407",37,0,0,0,37
872540,539514,2016-04-27,House,"Reported With Recommendation With Substitute  H-3",8,5,0,0,13
872554,535477,2016-04-19,House,"Reported With Recommendation Without Amendment",9,0,0,0,9
872554,544794,2016-05-10,House,"House Third Reading: Given Immediate Effect Roll Call # 230",108,0,0,0,108
872554,551828,2016-06-07,Senate,"Reported Favorably Without Amendment",7,0,0,0,7
872554,552168,2016-06-08,Senate,"Senate Third Reading: Given Immediate Effect Roll Call # 408",37,0,0,0,37
872568,536441,2016-04-20,House,"Reported With Recommendation Without Amendment",13,0,0,0,13
872568,536442,2016-04-20,House,"House Third Reading: Given Immediate Effect Roll Call # 167",107,1,0,0,108
872568,540284,2016-04-28,Senate,"Reported Favorably With Substitute  S-1",7,0,0,0,7
872568,540285,2016-04-28,Senate,"Senate Third Reading: Given Immediate Effect Roll Call # 206",36,0,0,1,37
872568,540286,2016-04-28,House,"House Third Reading: Roll Call # 199",107,1,0,0,108
872577,539243,2016-04-27,House,"Reported With Recommendation With Substitute  H-1",8,5,0,0,13
872583,565400,2016-11-30,Senate,"Senate Third Reading: Passed Roll Call # 642",36,0,0,2,38
872583,565667,2016-12-06,House,"Reported With Recommendation With Substitute  H-1",13,1,0,0,14
872583,566684,2016-12-15,House,"House Third Reading: Passed Roll Call # 745",107,0,0,0,107
872590,535479,2016-04-19,House,"Reported With Recommendation Without Amendment",9,0,0,0,9
872590,544807,2016-05-10,House,"House Third Reading: Given Immediate Effect Roll Call # 232",108,0,0,0,108
872590,551833,2016-06-07,Senate,"Reported Favorably Without Amendment",7,0,0,0,7
872590,552225,2016-06-08,Senate,"Senate Third Reading: Given Immediate Effect Roll Call # 410",37,0,0,0,37
872608,548927,2016-05-26,Senate,"Reported Favorably With Substitute  S-1",5,0,0,0,5
872608,550632,2016-06-01,Senate,"Senate Third Reading: Passed Roll Call # 355",36,0,0,1,37
872608,551825,2016-06-07,House,"Reported With Recommendation Without Amendment",9,0,0,0,9
872608,552313,2016-06-08,House,"House Third Reading: Given Immediate Effect Roll Call # 410",107,1,0,0,108
872612,564868,2016-11-10,House,"Reported With Recommendation Without Amendment",17,2,0,0,19
872627,539035,2016-04-27,Senate,"Reported Favorably With Substitute  S-1",5,0,0,0,5
872627,563048,2016-09-21,Senate,"Senate Third Reading: Passed Roll Call # 518",35,0,0,2,37
872627,565433,2016-11-30,House,"Reported With Recommendation With Substitute  H-1",27,0,0,0,27
872627,566178,2016-12-13,House,"House Third Reading: Given Immediate Effect Roll Call # 636",108,0,0,0,108
872627,566179,2016-12-13,Senate,"Senate Third Reading: Roll Call # 750",37,0,0,1,38
872808,545275,2016-05-12,Senate,"Reported Favorably Without Amendment",8,0,0,0,8
872808,548434,2016-05-25,Senate,"Senate Third Reading: Passed Roll Call # 336",37,0,0,0,37
872808,562531,2016-09-14,House,"Reported With Recommendation Without Amendment",15,0,0,0,15
872808,564823,2016-11-09,House,"House Third Reading: Given Immediate Effect Roll Call # 505",101,4,0,0,105
872820,548134,2016-05-24,Senate,"Reported Favorably Without Amendment",5,0,0,0,5
872820,562328,2016-09-08,Senate,"Senate Third Reading: Passed Roll Call # 501",37,0,0,0,37
872820,565539,2016-11-30,House,"Reported With Recommendation Without Amendment",27,0,0,0,27
872820,566212,2016-12-13,House,"House Third Reading: Passed Roll Call # 654",108,0,0,0,108
872851,552286,2016-06-09,Senate,"Reported Favorably With Substitute  S-1",8,1,0,0,9
872856,542075,2016-05-03,Senate,"Reported Favorably Without Amendment",4,0,0,0,4
872856,550152,2016-05-31,Senate,"Senate Third Reading: Passed Roll Call # 343",37,0,0,0,37
872862,537545,2016-04-21,House,"Reported With Recommendation Without Amendment",8,0,0,0,8
872893,543106,2016-05-05,Senate,"Reported Favorably Without Amendment",17,0,0,0,17
872893,546984,2016-05-18,Senate,"Senate Third Reading: Passed Roll Call # 309",37,0,0,0,37
872893,551812,2016-06-07,House,"Reported With Recommendation Without Amendment",28,1,0,0,29
872893,552331,2016-06-08,House,"House Third Reading: Given Immediate Effect Roll Call # 412",108,0,0,0,108
872899,552294,2016-06-09,Senate,"Reported Favorably Without Amendment",8,1,0,0,9
872908,539256,2016-04-27,House,"Reported With Recommendation Without Amendment",27,0,0,0,27
872908,545568,2016-05-12,House,"House Third Reading: Given Immediate Effect Roll Call # 269",106,2,0,0,108
872908,552075,2016-06-08,Senate,"Reported Favorably With Substitute S-2",5,2,0,0,7
872908,552372,2016-06-09,Senate,"Senate Third Reading: Given Immediate Effect Roll Call # 441",37,0,0,0,37
872908,552373,2016-06-09,House,"House Third Reading: Roll Call # 435",107,2,0,0,109
872953,535118,2016-04-19,House,"Reported With Recommendation With Substitute  H-1",14,0,0,0,14
872953,544786,2016-05-10,House,"House Third Reading: Given Immediate Effect Roll Call # 237",104,4,0,0,108
872953,548928,2016-05-26,Senate,"Reported Favorably With Substitute  S-1",5,0,0,0,5
872953,552361,2016-06-09,Senate,"Senate Third Reading: Given Immediate Effect Roll Call # 440",37,0,0,0,37
872953,552362,2016-06-09,House,"House Third Reading: Roll Call # 437",104,5,0,0,109
872973,565506,2016-11-30,House,"Reported With Recommendation With Substitute  H-2",11,0,0,0,11
872973,566076,2016-12-08,House,"House Third Reading: Passed Roll Call # 603",104,3,0,0,107
873536,537412,2016-04-21,House,"Reported With Recommendation Without Amendment",15,0,0,0,15
873571,546779,2016-05-18,House,"Reported With Recommendation With Substitute H-1",14,0,0,0,14
873571,551003,2016-06-02,House,"House Third Reading: Given Immediate Effect Roll Call # 360",96,12,0,0,108
873571,563911,2016-10-18,Senate,"Reported Favorably Without Amendment",8,0,0,0,8
873571,566358,2016-12-14,Senate,"Senate Third Reading: Given Immediate Effect Roll Call # 759",36,1,0,1,38
873577,547274,2016-05-19,Senate,"Reported Favorably With Substitute  S-1",12,3,0,0,15
873589,539783,2016-04-28,House,"Reported With Recommendation For Referral To Committee On Elections",11,6,0,0,17
873603,547987,2016-05-24,House,"Reported With Recommendation Without Amendment",14,2,0,0,16
873603,562946,2016-09-21,House,"House Third Reading: Given Immediate Effect Roll Call # 463",102,5,0,0,107
873603,564043,2016-10-20,Senate,"Reported Favorably Without Amendment",4,0,0,0,4
873603,564044,2016-10-20,Senate,"Senate Third Reading: Given Immediate Effect Roll Call # 586",36,0,0,1,37
873605,543384,2016-05-05,Senate,"Reported Favorably Without Amendment",5,0,0,0,5
873605,547970,2016-05-24,Senate,"Senate Third Reading: Passed Roll Call # 320",37,0,0,0,37
873605,550597,2016-06-01,House,"Reported With Recommendation With Substitute  H-1",14,0,0,0,14
873605,552298,2016-06-09,House,"House Third Reading: Given Immediate Effect Roll Call # 426",109,0,0,0,109
873605,552299,2016-06-09,Senate,"Senate Third Reading: Roll Call # 477",37,0,0,0,37
873615,539262,2016-04-27,House,"Reported With Recommendation Without Amendment",15,0,0,0,15
873619,545321,2016-05-12,Senate,"Reported Favorably Without Amendment",5,0,0,0,5
873633,543364,2016-05-05,Senate,"Reported Favorably Without Amendment",5,0,0,0,5
873633,548090,2016-05-24,Senate,"Senate Third Reading: Passed Roll Call # 321",37,0,0,0,37
873633,550622,2016-06-01,House,"Reported With Recommendation Without Amendment",14,0,0,0,14
873633,552301,2016-06-09,House,"House Third Reading: Given Immediate Effect Roll Call # 427",109,0,0,0,109
873656,546946,2016-05-18,House,"Reported With Recommendation With Substitute  H-3",21,1,0,0,22
873656,548835,2016-05-26,House,"House Third Reading: Given Immediate Effect Roll Call # 326",106,2,0,0,108
873656,552374,2016-06-09,Senate,"Reported Favorably Without Amendment",17,0,0,0,17
873656,566399,2016-12-14,Senate,"Senate Third Reading: Given Immediate Effect Roll Call # 758",37,0,0,1,38
873754,545406,2016-05-12,Senate,"Reported Favorably Without Amendment",8,0,0,0,8
873754,546866,2016-05-18,Senate,"Senate Third Reading: Passed Roll Call # 313",37,0,0,0,37
873754,548639,2016-05-25,House,"House Third Reading: Given Immediate Effect Roll Call # 320",107,2,0,0,109
873770,545273,2016-05-12,Senate,"Reported Favorably Without Amendment",5,0,0,0,5
873770,552351,2016-06-09,Senate,"Senate Third Reading: Passed Roll Call # 451",36,1,0,0,37
873770,562933,2016-09-21,House,"Reported With Recommendation Without Amendment",18,0,0,0,18
873770,563116,2016-09-22,House,"House Third Reading: Given Immediate Effect Roll Call # 499",86,21,0,0,107
873784,546790,2016-05-18,House,"Reported With Recommendation With Substitute  H-1",11,2,0,0,13
873784,552316,2016-06-08,House,"House Third Reading: Given Immediate Effect Roll Call # 408",97,11,0,0,108
873809,539267,2016-04-27,House,"Reported With Recommendation Without Amendment",26,1,0,0,27
873809,545336,2016-05-12,House,"House Third Reading: Given Immediate Effect Roll Call # 270",84,24,0,0,108
873815,565663,2016-12-06,Senate,"Reported Favorably Without Amendment",9,0,0,0,9
873933,548890,2016-05-26,Senate,"Reported Favorably Without Amendment",5,0,0,0,5
873933,563954,2016-10-18,Senate,"Senate Third Reading: Passed Roll Call # 539",35,1,1,0,37
873933,565681,2016-12-06,House,"Reported With Recommendation Without Amendment",9,0,0,0,9
873933,566584,2016-12-14,House,"House Third Reading: Passed Roll Call # 704",106,2,0,0,108
873936,548889,2016-05-26,Senate,"Reported Favorably Without Amendment",5,0,0,0,5
873936,563957,2016-10-18,Senate,"Senate Third Reading: Passed Roll Call # 535",37,0,0,0,37
873936,565680,2016-12-06,House,"Reported With Recommendation With Amendment(s)",9,0,0,0,9
873936,566690,2016-12-14,House,"House Third Reading: Passed Roll Call # 700",106,2,0,0,108
873936,566691,2016-12-15,Senate,"Senate Third Reading: House Amendment(s) Concurred In Roll Call # 826",37,0,0,1,38
873941,548879,2016-05-26,Senate,"Reported Favorably Without Amendment",5,0,0,0,5
873941,563940,2016-10-18,Senate,"Senate Third Reading: Passed Roll Call # 538",37,0,0,0,37
873941,565674,2016-12-06,House,"Reported With Recommendation Without Amendment",9,0,0,0,9
873941,566663,2016-12-14,House,"House Third Reading: Passed Roll Call # 703",106,2,0,0,108
873943,548881,2016-05-26,Senate,"Reported Favorably Without Amendment",5,0,0,0,5
873943,563888,2016-10-18,Senate,"Senate Third Reading: Passed Roll Call # 537",37,0,0,0,37
873943,565676,2016-12-06,House,"Reported With Recommendation Without Amendment",9,0,0,0,9
873943,566681,2016-12-14,House,"House Third Reading: Passed Roll Call # 702",106,2,0,0,108
873947,548742,2016-05-26,Senate,"Reported Favorably Without Amendment",5,0,0,0,5
873947,563942,2016-10-18,Senate,"Senate Third Reading: Passed Roll Call # 536",37,0,0,0,37
873947,565683,2016-12-06,House,"Reported With Recommendation Without Amendment",9,0,0,0,9
873947,566697,2016-12-14,House,"House Third Reading: Passed Roll Call # 701",106,2,0,0,108
873954,548892,2016-05-26,Senate,"Reported Favorably Without Amendment",5,0,0,0,5
873954,563931,2016-10-18,Senate,"Senate Third Reading: Passed Roll Call # 540",37,0,0,0,37
873954,565696,2016-12-06,House,"Reported With Recommendation Without Amendment",9,0,0,0,9
873954,566668,2016-12-14,House,"House Third Reading: Passed Roll Call # 705",106,2,0,0,108
873994,548471,2016-05-25,House,"Reported With Recommendation Without Amendment",10,0,0,0,10
873994,562964,2016-09-21,House,"House Third Reading: Given Immediate Effect Roll Call # 461",101,6,0,0,107
873994,565844,2016-12-07,Senate,"Reported Favorably Without Amendment",5,0,0,0,5
873994,565948,2016-12-08,Senate,"Senate Third Reading: Given Immediate Effect Roll Call # 723",37,0,0,1,38
874337,543172,2016-05-05,Senate,"Reported Favorably Without Amendment",16,1,0,0,17
874337,546911,2016-05-18,Senate,"Senate Third Reading: Passed Roll Call # 310",36,1,0,0,37
874337,551797,2016-06-07,House,"Reported With Recommendation Without Amendment",28,1,0,0,29
874337,552332,2016-06-08,House,"House Third Reading: Given Immediate Effect Roll Call # 411",107,1,0,0,108
874499,562468,2016-09-13,House,"Reported With Recommendation With Substitute  H-1",5,3,0,0,8
874512,547989,2016-05-24,House,"Reported With Recommendation Without Amendment",9,0,0,0,9
874512,550734,2016-06-01,House,"House Third Reading: Given Immediate Effect Roll Call # 351",90,19,0,0,109
874512,565548,2016-12-01,Senate,"Reported Favorably With Substitute  S-2",3,1,0,0,4
874512,566064,2016-12-08,Senate,"Senate Third Reading: Given Immediate Effect Roll Call # 714",27,10,0,1,38
874512,566183,2016-12-13,House,"House Third Reading: Roll Call # 632",80,28,0,0,108
874890,548664,2016-05-25,House,"Reported With Recommendation Without Amendment",8,3,0,0,11
874898,564090,2016-10-20,Senate,"Reported Favorably Without Amendment",4,0,0,0,4
874898,564091,2016-10-20,Senate,"Senate Third Reading: Passed Roll Call # 609",36,0,0,1,37
874900,563899,2016-10-18,Senate,"Reported Favorably With Substitute  S-2",5,0,0,0,5
874900,564058,2016-10-20,Senate,"Senate Third Reading: Passed Roll Call # 567",37,0,0,0,37
874913,545268,2016-05-12,Senate,"Reported Favorably With Substitute  S-1",5,0,0,0,5
874913,546835,2016-05-18,Senate,"Senate Third Reading: Passed Roll Call # 293",37,0,0,0,37
874913,562465,2016-09-13,House,"Reported With Recommendation For Referral To Committee On Regulatory Reform",18,0,0,0,18
874913,564807,2016-11-09,House,"Reported With Recommendation With Substitute  H-4",12,1,0,0,13
874913,566015,2016-12-08,House,"House Third Reading: Given Immediate Effect Roll Call # 611",69,37,0,0,106
874913,566191,2016-12-13,Senate,"Senate Third Reading: Roll Call # 731",35,1,0,2,38
874916,548673,2016-05-25,House,"Reported With Recommendation Without Amendment",9,6,0,0,15
874916,551793,2016-06-07,House,"House Third Reading: Given Immediate Effect Roll Call # 401",61,47,0,0,108
874922,564080,2016-10-20,Senate,"Reported Favorably Without Amendment",4,0,0,0,4
874922,564081,2016-10-20,Senate,"Senate Third Reading: Passed Roll Call # 608",36,0,0,1,37
874935,548662,2016-05-25,House,"Reported With Recommendation With Substitute  H-2",8,3,0,0,11
874937,563905,2016-10-18,Senate,"Reported Favorably With Substitute  S-2",5,0,0,0,5
874937,564122,2016-10-20,Senate,"Senate Third Reading: Passed Roll Call # 566",37,0,0,0,37
874945,564088,2016-10-20,Senate,"Reported Favorably Without Amendment",4,0,0,0,4
874945,564089,2016-10-20,Senate,"Senate Third Reading: Passed Roll Call # 606",36,0,0,1,37
874951,564082,2016-10-20,Senate,"Reported Favorably Without Amendment",4,0,0,0,4
874951,564083,2016-10-20,Senate,"Senate Third Reading: Passed Roll Call # 607",36,0,0,1,37
874951,565664,2016-12-06,House,"Reported With Recommendation Without Amendment",9,1,0,0,10
874951,566752,2016-12-14,House,"House Third Reading: Passed Roll Call # 698",105,2,0,0,107
874951,566753,2016-12-14,Senate,"Senate Third Reading: House Amendment(s) Concurred In Roll Call # 810",37,0,0,1,38
875645,550784,2016-06-01,Senate,"Reported Favorably Without Amendment",4,0,0,0,4
875664,548877,2016-05-26,Senate,"Reported Favorably With Substitute  S-1",5,0,0,0,5
875664,552355,2016-06-09,Senate,"Senate Third Reading: Passed Roll Call # 456",37,0,0,0,37
875673,550278,2016-05-31,Senate,"Reported Favorably Without Amendment",3,0,0,0,3
875673,552346,2016-06-09,Senate,"Senate Third Reading: Passed Roll Call # 461",37,0,0,0,37
875676,550786,2016-06-01,Senate,"Reported Favorably Without Amendment",5,0,0,0,5
875676,552314,2016-06-09,Senate,"Senate Third Reading: Passed Roll Call # 467",37,0,0,0,37
875685,550146,2016-05-31,Senate,"Reported Favorably Without Amendment",3,0,0,0,3
875685,552319,2016-06-09,Senate,"Senate Third Reading: Passed Roll Call # 458",37,0,0,0,37
875696,548732,2016-05-26,House,"Reported With Recommendation With Substitute H-1",16,0,0,0,16
875696,551213,2016-06-02,House,"House Third Reading: Given Immediate Effect Roll Call # 370",108,0,0,0,108
875696,563896,2016-10-18,Senate,"Reported Favorably Without Amendment",4,0,0,0,4
875696,566290,2016-12-13,Senate,"Senate Third Reading: Given Immediate Effect Roll Call # 736",37,0,0,1,38
875696,566726,2016-12-14,House,"House Third Reading: Senate Amendment(s) Concurred In Roll Call # 675",108,0,0,0,108
875697,550789,2016-06-01,Senate,"Reported Favorably With Substitute  S-1",5,0,0,0,5
875697,552318,2016-06-09,Senate,"Senate Third Reading: Passed Roll Call # 466",37,0,0,0,37
875701,548908,2016-05-26,Senate,"Reported Favorably Without Amendment",5,0,0,0,5
875701,552287,2016-06-09,Senate,"Senate Third Reading: Passed Roll Call # 457",37,0,0,0,37
875706,548727,2016-05-26,House,"Reported With Recommendation With Substitute H-1",16,0,0,0,16
875706,551215,2016-06-02,House,"House Third Reading: Given Immediate Effect Roll Call # 371",108,0,0,0,108
875706,563927,2016-10-18,Senate,"Reported Favorably Without Amendment",4,0,0,0,4
875706,566256,2016-12-13,Senate,"Senate Third Reading: Given Immediate Effect Roll Call # 737",37,0,0,1,38
875706,566518,2016-12-14,House,"House Third Reading: Senate Amendment(s) Concurred In Roll Call # 676",108,0,0,0,108
875710,548931,2016-05-26,Senate,"Reported Favorably Without Amendment",5,0,0,0,5
875710,552356,2016-06-09,Senate,"Senate Third Reading: Passed Roll Call # 453",37,0,0,0,37
875717,550780,2016-06-01,Senate,"Reported Favorably With Substitute  S-1",4,0,0,0,4
875717,552352,2016-06-09,Senate,"Senate Third Reading: Passed Roll Call # 469",37,0,0,0,37
875719,550790,2016-06-01,Senate,"Reported Favorably Without Amendment",4,0,0,0,4
875719,552377,2016-06-09,Senate,"Senate Third Reading: Passed Roll Call # 465",37,0,0,0,37
875722,550794,2016-06-01,Senate,"Reported Favorably Without Amendment",4,1,0,0,5
875722,552329,2016-06-09,Senate,"Senate Third Reading: Passed Roll Call # 468",36,1,0,0,37
875729,548725,2016-05-26,House,"Reported With Recommendation With Substitute H-1",16,0,0,0,16
875729,551208,2016-06-02,House,"House Third Reading: Given Immediate Effect Roll Call # 369",108,0,0,0,108
875729,563949,2016-10-18,Senate,"Reported Favorably Without Amendment",4,0,0,0,4
875729,566230,2016-12-13,Senate,"Senate Third Reading: Given Immediate Effect Roll Call # 735",37,0,0,1,38
875729,566715,2016-12-14,House,"House Third Reading: Senate Amendment(s) Concurred In Roll Call # 674",108,0,0,0,108
875732,565675,2016-12-06,House,"Reported With Recommendation Without Amendment",9,1,0,0,10
875732,565999,2016-12-08,House,"House Third Reading: Passed Roll Call # 615",107,1,0,0,108
875732,566319,2016-12-14,Senate,"Senate Third Reading: Passed Roll Call # 782",37,0,0,1,38
875733,550263,2016-05-31,Senate,"Reported Favorably With Substitute  S-1",3,0,0,0,3
875733,552279,2016-06-09,Senate,"Senate Third Reading: Passed Roll Call # 460",37,0,0,0,37
875741,548734,2016-05-26,House,"Reported With Recommendation With Substitute H-5",16,0,0,0,16
875741,551216,2016-06-02,House,"House Third Reading: Given Immediate Effect Roll Call # 368",108,0,0,0,108
875741,563952,2016-10-18,Senate,"Reported Favorably With Substitute  S-2",4,0,0,0,4
875741,566280,2016-12-13,Senate,"Senate Third Reading: Given Immediate Effect Roll Call # 734",37,0,0,1,38
875741,566600,2016-12-14,House,"House Third Reading: Roll Call # 673",107,1,0,0,108
875745,565682,2016-12-06,House,"Reported With Recommendation Without Amendment",9,1,0,0,10
875745,566003,2016-12-08,House,"House Third Reading: Passed Roll Call # 616",107,1,0,0,108
875745,566295,2016-12-14,Senate,"Senate Third Reading: Passed Roll Call # 783",37,0,0,1,38
875746,548922,2016-05-26,Senate,"Reported Favorably With Substitute  S-1",5,0,0,0,5
875746,552278,2016-06-09,Senate,"Senate Third Reading: Passed Roll Call # 455",37,0,0,0,37
875753,550145,2016-05-31,Senate,"Reported Favorably With Substitute  S-1",3,0,0,0,3
875753,552375,2016-06-09,Senate,"Senate Third Reading: Passed Roll Call # 459",37,0,0,0,37
875755,548790,2016-05-26,Senate,"Reported Favorably With Substitute  S-2",5,0,0,0,5
875755,552320,2016-06-09,Senate,"Senate Third Reading: Passed Roll Call # 454",37,0,0,0,37
875775,550776,2016-06-01,Senate,"Reported Favorably Without Amendment",5,0,0,0,5
875775,552383,2016-06-09,Senate,"Senate Third Reading: Passed Roll Call # 464",37,0,0,0,37
875777,550588,2016-06-01,Senate,"Reported Favorably Without Amendment",4,0,0,0,4
875777,552322,2016-06-09,Senate,"Senate Third Reading: Passed Roll Call # 463",37,0,0,0,37
875787,565712,2016-12-06,House,"Reported With Recommendation Without Amendment",9,0,0,0,9
875787,565978,2016-12-08,House,"House Third Reading: Passed Roll Call # 614",108,0,0,0,108
875787,566308,2016-12-14,Senate,"Senate Third Reading: Passed Roll Call # 781",37,0,0,1,38
875787,566569,2016-12-15,House,"House Third Reading: Senate Amendment(s) Concurred In Roll Call # 754",107,0,0,0,107
875790,550583,2016-06-01,Senate,"Reported Favorably With Substitute  S-1",5,0,0,0,5
875790,552368,2016-06-09,Senate,"Senate Third Reading: Passed Roll Call # 462",37,0,0,0,37
875791,550787,2016-06-01,Senate,"Reported Favorably With Substitute  S-1",4,0,0,0,4
875791,552317,2016-06-09,Senate,"Senate Third Reading: Passed Roll Call # 470",37,0,0,0,37
876256,564106,2016-10-20,Senate,"Reported Favorably Without Amendment",4,0,0,0,4
876256,564107,2016-10-20,Senate,"Senate Third Reading: Passed Roll Call # 589",36,0,0,1,37
876256,565673,2016-12-06,House,"Reported With Recommendation With Substitute  H-2",9,0,0,0,9
876256,566511,2016-12-14,House,"House Third Reading: Given Immediate Effect Roll Call # 683",105,1,0,0,106
876256,566512,2016-12-14,Senate,"Senate Third Reading: Roll Call # 801",35,0,2,1,38
876262,547122,2016-05-19,Senate,"Reported Favorably Without Amendment",8,0,0,0,8
876262,550106,2016-05-31,Senate,"Senate Third Reading: Passed Roll Call # 347",36,1,0,0,37
876262,562530,2016-09-14,House,"Reported With Recommendation With Substitute  H-1",15,0,0,0,15
876262,565943,2016-12-08,House,"House Third Reading: Given Immediate Effect Roll Call # 609",106,1,0,0,107
876262,566198,2016-12-13,Senate,"Senate Third Reading: Roll Call # 732",35,1,0,2,38
876289,563934,2016-10-18,Senate,"Reported Favorably With Substitute  S-1",3,0,0,0,3
876289,564124,2016-10-20,Senate,"Senate Third Reading: Passed Roll Call # 616",23,13,0,1,37
876289,565669,2016-12-06,House,"Reported With Recommendation With Substitute  H-2",11,2,0,0,13
876289,566638,2016-12-15,House,"House Third Reading: Given Immediate Effect Roll Call # 742",63,44,0,0,107
876289,566639,2016-12-15,Senate,"Senate Third Reading: Roll Call # 851",27,10,0,1,38
876299,546778,2016-05-18,House,"Reported With Recommendation With Substitute  H-1",26,2,0,0,28
876299,550966,2016-06-02,House,"House Third Reading: Given Immediate Effect Roll Call # 378",107,1,0,0,108
876299,552072,2016-06-08,Senate,"Reported Favorably Without Amendment",5,2,0,0,7
876299,552073,2016-06-08,Senate,"Senate Third Reading: Given Immediate Effect Roll Call # 421",34,2,1,0,37
876337,547230,2016-05-19,Senate,"Reported Favorably Without Amendment",17,0,0,0,17
876337,548446,2016-05-25,Senate,"Senate Third Reading: Passed Roll Call # 337",37,0,0,0,37
876337,562538,2016-09-14,House,"Reported With Recommendation Without Amendment",27,0,0,0,27
876337,562877,2016-09-20,House,"House Third Reading: Given Immediate Effect Roll Call # 459",103,3,0,0,106
876971,547103,2016-05-19,Senate,"Reported Favorably Without Amendment",17,0,0,0,17
876971,548396,2016-05-25,Senate,"Senate Third Reading: Passed Roll Call # 338",35,2,0,0,37
876971,551802,2016-06-07,House,"Reported With Recommendation With Substitute  H-1",28,0,0,0,28
876971,552337,2016-06-09,House,"House Third Reading: Given Immediate Effect Roll Call # 428",106,3,0,0,109
876971,552338,2016-06-09,Senate,"Senate Third Reading: Roll Call # 479",35,2,0,0,37
877177,564123,2016-10-18,Senate,"Reported Favorably Without Amendment",4,0,0,0,4
877190,564120,2016-10-20,Senate,"Reported Favorably With Substitute  S-1",4,0,0,0,4
877203,565709,2016-12-06,Senate,"Reported Favorably With Substitute  S-1",5,0,0,0,5
877203,565902,2016-12-07,Senate,"Senate Third Reading: Passed Roll Call # 696",37,0,0,1,38
877216,550215,2016-05-31,Senate,"Reported Favorably Without Amendment",5,0,0,0,5
877216,563137,2016-09-21,Senate,"Senate Third Reading: Passed Roll Call # 521",35,2,0,0,37
877216,566046,2016-12-07,House,"Reported With Recommendation Without Amendment",28,0,0,0,28
877216,566539,2016-12-15,House,"House Third Reading: Passed Roll Call # 746",107,0,0,0,107
877216,566540,2016-12-15,Senate,"Senate Third Reading: House Amendment(s) Concurred In Roll Call # 852",37,0,0,1,38
877266,547986,2016-05-24,House,"Reported With Recommendation Without Amendment",13,0,0,0,13
877266,551040,2016-06-02,House,"House Third Reading: Given Immediate Effect Roll Call # 365",107,1,0,0,108
877266,552118,2016-06-08,Senate,"Reported Favorably Without Amendment",5,2,0,0,7
877266,552283,2016-06-09,Senate,"Senate Third Reading: Given Immediate Effect Roll Call # 447",37,0,0,0,37
877274,547990,2016-05-24,House,"Reported With Recommendation With Substitute  H-1",13,0,0,0,13
877274,551088,2016-06-02,House,"House Third Reading: Given Immediate Effect Roll Call # 364",107,1,0,0,108
877274,552167,2016-06-08,Senate,"Reported Favorably Without Amendment",5,2,0,0,7
877274,552334,2016-06-09,Senate,"Senate Third Reading: Given Immediate Effect Roll Call # 446",37,0,0,0,37
877303,548801,2016-05-26,House,"Reported With Recommendation With Substitute H-1",6,0,0,0,6
877303,551218,2016-06-02,House,"House Third Reading: Given Immediate Effect Roll Call # 375",108,0,0,0,108
877303,563902,2016-10-18,Senate,"Reported Favorably Without Amendment",4,0,0,0,4
877303,563992,2016-10-19,Senate,"Senate Third Reading: Given Immediate Effect Roll Call # 542",37,0,0,0,37
877318,565671,2016-12-06,House,"Reported With Recommendation With Substitute  H-3",9,0,0,0,9
877500,548674,2016-05-25,House,"Reported With Recommendation For Referral To Committee On Commerce And Trade",10,1,0,0,11
877500,562875,2016-09-20,House,"Reported With Recommendation Without Amendment",14,2,0,0,16
877500,563075,2016-09-22,House,"House Third Reading: Given Immediate Effect Roll Call # 496",96,11,0,0,107
877509,562873,2016-09-20,House,"Reported With Recommendation With Substitute  H-1",14,2,0,0,16
877509,563071,2016-09-22,House,"House Third Reading: Given Immediate Effect Roll Call # 495",98,9,0,0,107
877560,546232,2016-05-17,House,"Reported With Recommendation Without Amendment",8,0,0,0,8
877560,548807,2016-05-26,House,"House Third Reading: Given Immediate Effect Roll Call # 325",107,1,0,0,108
877560,559062,2016-08-03,Senate,"Reported Favorably With Substitute  S-2",3,1,0,0,4
877560,562330,2016-09-08,Senate,"Senate Third Reading: Given Immediate Effect Roll Call # 509",30,7,0,0,37
877560,562833,2016-09-20,House,"House Third Reading: Roll Call # 457",104,2,0,0,106
877584,546258,2016-05-17,House,"Reported With Recommendation Without Amendment",8,0,0,0,8
877584,548809,2016-05-26,House,"House Third Reading: Given Immediate Effect Roll Call # 324",107,1,0,0,108
877584,559078,2016-08-03,Senate,"Reported Favorably With Substitute  S-2",3,1,0,0,4
877584,562287,2016-09-08,Senate,"Senate Third Reading: Given Immediate Effect Roll Call # 508",30,7,0,0,37
877584,562809,2016-09-20,House,"House Third Reading: Roll Call # 456",105,1,0,0,106
878100,565501,2016-11-30,House,"Reported With Recommendation With Substitute  H-1",10,0,0,0,10
878106,565511,2016-11-30,House,"Reported With Recommendation Without Amendment",27,0,0,0,27
878106,565512,2016-12-01,House,"House Third Reading: Given Immediate Effect Roll Call # 546",108,0,0,0,108
878106,566047,2016-12-08,Senate,"Reported Favorably With Substitute  S-2",17,0,0,0,17
878106,566323,2016-12-14,Senate,"Senate Third Reading: Given Immediate Effect Roll Call # 767",37,0,0,1,38
878106,566582,2016-12-15,House,"House Third Reading: Roll Call # 721",106,2,0,0,108
878137,548003,2016-05-24,House,"Reported With Recommendation With Substitute  H-1",16,0,0,0,16
878137,551077,2016-06-02,House,"House Third Reading: Given Immediate Effect Roll Call # 363",108,0,0,0,108
878137,564860,2016-11-09,Senate,"Reported Favorably Without Amendment",5,0,0,0,5
878137,564861,2016-11-10,Senate,"Senate Third Reading: Given Immediate Effect Roll Call # 627",37,0,0,0,37
878145,558961,2016-07-13,Senate,"Reported Favorably With Substitute  S-1",3,0,0,0,3
878145,562353,2016-09-08,Senate,"Senate Third Reading: Passed Roll Call # 506",26,11,0,0,37
878145,565567,2016-11-29,House,"Reported With Recommendation With Substitute  H-1",4,2,0,0,6
878145,566774,2016-12-15,House,"House Third Reading: Given Immediate Effect Roll Call # 732",62,46,0,0,108
878145,566775,2016-12-15,Senate,"Senate Third Reading: Roll Call # 842",26,11,0,1,38
878175,547980,2016-05-24,House,"Reported With Recommendation With Substitute  H-1",16,0,0,0,16
878175,550957,2016-06-02,House,"House Third Reading: Given Immediate Effect Roll Call # 362",108,0,0,0,108
878175,564820,2016-11-09,Senate,"Reported Favorably Without Amendment",5,0,0,0,5
878175,564821,2016-11-10,Senate,"Senate Third Reading: Given Immediate Effect Roll Call # 626",37,0,0,0,37
878409,564071,2016-10-20,Senate,"Reported Favorably With Substitute  S-1",4,0,0,0,4
878409,564072,2016-10-20,Senate,"Senate Third Reading: Passed Roll Call # 594",36,0,0,1,37
878409,565526,2016-11-30,House,"Reported With Recommendation Without Amendment",14,0,0,0,14
878409,566217,2016-12-13,House,"House Third Reading: Passed Roll Call # 642",106,2,0,0,108
878419,564024,2016-10-20,Senate,"Reported Favorably Without Amendment",4,0,0,0,4
878419,564025,2016-10-20,Senate,"Senate Third Reading: Passed Roll Call # 603",36,0,0,1,37
878419,565556,2016-11-30,House,"Reported With Recommendation Without Amendment",14,0,0,0,14
878419,566236,2016-12-13,House,"House Third Reading: Passed Roll Call # 646",106,2,0,0,108
878426,564118,2016-10-20,Senate,"Reported Favorably Without Amendment",4,0,0,0,4
878426,564119,2016-10-20,Senate,"Senate Third Reading: Passed Roll Call # 598",36,0,0,1,37
878426,565504,2016-11-30,House,"Reported With Recommendation Without Amendment",14,0,0,0,14
878426,566235,2016-12-13,House,"House Third Reading: Passed Roll Call # 640",106,2,0,0,108
878442,564073,2016-10-20,Senate,"Reported Favorably Without Amendment",4,0,0,0,4
878442,564074,2016-10-20,Senate,"Senate Third Reading: Passed Roll Call # 602",36,0,0,1,37
878442,565517,2016-11-30,House,"Reported With Recommendation Without Amendment",14,0,0,0,14
878442,566215,2016-12-13,House,"House Third Reading: Passed Roll Call # 645",106,2,0,0,108
878447,564097,2016-10-20,Senate,"Reported Favorably Without Amendment",4,0,0,0,4
878447,564098,2016-10-20,Senate,"Senate Third Reading: Passed Roll Call # 600",36,0,0,1,37
878447,565536,2016-11-30,House,"Reported With Recommendation Without Amendment",14,0,0,0,14
878447,566243,2016-12-13,House,"House Third Reading: Passed Roll Call # 643",106,2,0,0,108
878458,564110,2016-10-20,Senate,"Reported Favorably Without Amendment",4,0,0,0,4
878458,564111,2016-10-20,Senate,"Senate Third Reading: Passed Roll Call # 595",35,0,1,1,37
878458,564112,2016-10-20,Senate,"Senate Third Reading: Passed Roll Call # 597",36,0,0,1,37
878458,565529,2016-11-30,House,"Reported With Recommendation Without Amendment",14,0,0,0,14
878458,566257,2016-12-13,House,"House Third Reading: Passed Roll Call # 638",106,2,0,0,108
878464,564851,2016-11-10,Senate,"Reported Favorably With Substitute S-1",6,0,0,0,6
878464,565491,2016-11-30,Senate,"Senate Third Reading: Passed Roll Call # 647",36,0,0,2,38
878464,566072,2016-12-07,House,"Reported With Recommendation Without Amendment",15,0,0,0,15
878464,566673,2016-12-14,House,"House Third Reading: Passed Roll Call # 712",104,4,0,0,108
878471,564068,2016-10-20,Senate,"Reported Favorably Without Amendment",4,0,0,0,4
878471,564069,2016-10-20,Senate,"Senate Third Reading: Passed Roll Call # 596",36,0,0,1,37
878471,565530,2016-11-30,House,"Reported With Recommendation Without Amendment",14,0,0,0,14
878471,566255,2016-12-13,House,"House Third Reading: Passed Roll Call # 639",106,2,0,0,108
878480,564116,2016-10-20,Senate,"Reported Favorably Without Amendment",4,0,0,0,4
878480,564117,2016-10-20,Senate,"Senate Third Reading: Passed Roll Call # 601",36,0,0,1,37
878480,565552,2016-11-30,House,"Reported With Recommendation Without Amendment",14,0,0,0,14
878480,566239,2016-12-13,House,"House Third Reading: Passed Roll Call # 644",106,2,0,0,108
878487,564045,2016-10-20,Senate,"Reported Favorably Without Amendment",4,0,0,0,4
878487,564046,2016-10-20,Senate,"Senate Third Reading: Passed Roll Call # 599",36,0,0,1,37
878487,565498,2016-11-30,House,"Reported With Recommendation Without Amendment",14,0,0,0,14
878487,566276,2016-12-13,House,"House Third Reading: Passed Roll Call # 641",106,2,0,0,108
878492,564062,2016-10-20,Senate,"Reported Favorably With Substitute  S-1",4,0,0,0,4
878492,564063,2016-10-20,Senate,"Senate Third Reading: Passed Roll Call # 593",36,0,0,1,37
878492,565521,2016-11-30,House,"Reported With Recommendation With Amendment(s)",14,0,0,0,14
878492,566240,2016-12-13,House,"House Third Reading: Passed Roll Call # 637",106,2,0,0,108
878492,566241,2016-12-13,Senate,"Senate Third Reading: House Amendment(s) Concurred In Roll Call # 751",37,0,0,1,38
878668,548806,2016-05-26,Senate,"Reported Favorably With Substitute  S-1",4,0,0,0,4
878668,550653,2016-06-01,Senate,"Senate Third Reading: Passed Roll Call # 356",36,0,0,1,37
878668,551854,2016-06-07,House,"Reported With Recommendation Without Amendment",10,0,0,0,10
878668,552295,2016-06-08,House,"House Third Reading: Given Immediate Effect Roll Call # 409",104,4,0,0,108
878679,550801,2016-06-01,Senate,"Reported Favorably Without Amendment",4,0,0,0,4
878679,552323,2016-06-09,Senate,"Senate Third Reading: Passed Roll Call # 471",37,0,0,0,37
878686,550223,2016-05-31,Senate,"Reported Favorably Without Amendment",5,0,0,0,5
878701,550742,2016-06-01,Senate,"Reported Favorably Without Amendment",4,0,0,0,4
878701,552303,2016-06-09,Senate,"Senate Third Reading: Passed Roll Call # 472",37,0,0,0,37
878707,550313,2016-05-31,Senate,"Reported Favorably Without Amendment",5,0,0,0,5
878722,550532,2016-06-01,House,"Reported With Recommendation Without Amendment",9,6,0,0,15
878732,562886,2016-09-20,House,"Reported With Recommendation With Substitute  H-1",8,0,0,0,8
878751,562816,2016-09-20,House,"Reported With Recommendation With Substitute  H-1",7,0,0,0,7
878751,566022,2016-12-07,House,"House Third Reading: Passed Roll Call # 592",102,5,0,0,107
878779,550531,2016-06-01,House,"Reported With Recommendation Without Amendment",9,6,0,0,15
879499,548934,2016-05-26,Senate,"Reported Favorably Without Amendment",5,0,0,0,5
879499,552259,2016-06-08,Senate,"Senate Third Reading: Passed Roll Call # 411",37,0,0,0,37
879499,562569,2016-09-15,House,"Reported With Recommendation With Substitute  H-1",12,0,0,0,12
879499,563149,2016-09-22,House,"House Third Reading: Given Immediate Effect Roll Call # 480",62,45,0,0,107
879499,564028,2016-10-20,Senate,"Senate Third Reading: Roll Call # 554",37,0,0,0,37
879512,552325,2016-06-09,Senate,"Reported Favorably Without Amendment",5,0,0,0,5
879512,562290,2016-09-08,Senate,"Senate Third Reading: Passed Roll Call # 505",36,1,0,0,37
879523,548933,2016-05-26,Senate,"Reported Favorably Without Amendment",5,0,0,0,5
879523,552121,2016-06-08,Senate,"Senate Third Reading: Passed Roll Call # 413",34,3,0,0,37
879523,562572,2016-09-15,House,"Reported With Recommendation With Substitute  H-1",11,1,0,0,12
879523,563147,2016-09-22,House,"House Third Reading: Given Immediate Effect Roll Call # 482",61,46,0,0,107
879523,564129,2016-10-20,Senate,"Senate Third Reading: Roll Call # 556",32,5,0,0,37
879526,550535,2016-06-01,House,"Reported With Recommendation With Substitute  H-1",6,2,0,0,8
879540,548737,2016-05-26,Senate,"Reported Favorably Without Amendment",5,0,0,0,5
879540,552099,2016-06-08,Senate,"Senate Third Reading: Passed Roll Call # 412",35,2,0,0,37
879540,562573,2016-09-15,House,"Reported With Recommendation With Substitute  H-2",11,1,0,0,12
879540,563150,2016-09-22,House,"House Third Reading: Given Immediate Effect Roll Call # 481",61,46,0,0,107
879540,564127,2016-10-20,Senate,"Senate Third Reading: Roll Call # 555",34,3,0,0,37
879546,565945,2016-12-08,Senate,"Reported Favorably Without Amendment",4,0,0,0,4
879546,565946,2016-12-08,Senate,"Senate Third Reading: Passed Roll Call # 728",37,0,0,1,38
879550,563938,2016-10-18,Senate,"Reported Favorably With Substitute  S-2",5,0,0,0,5
879550,564121,2016-10-20,Senate,"Senate Third Reading: Passed Roll Call # 578",36,0,0,1,37
879555,562296,2016-09-08,Senate,"Reported Favorably Without Amendment",4,0,0,0,4
879555,564067,2016-10-20,Senate,"Senate Third Reading: Passed Roll Call # 563",37,0,0,0,37
879555,565704,2016-12-06,House,"Reported With Recommendation With Substitute H-1",9,0,0,0,9
879555,566570,2016-12-15,House,"House Third Reading: Passed Roll Call # 729",107,1,0,0,108
879555,566571,2016-12-15,Senate,"Senate Third Reading: Roll Call # 841",37,0,0,1,38
879557,552276,2016-06-09,Senate,"Reported Favorably Without Amendment",9,0,0,0,9
879557,562376,2016-09-07,Senate,"Senate Third Reading: Passed Roll Call # 481",36,0,0,1,37
879557,562980,2016-09-21,House,"Reported With Recommendation With Substitute  H-2",15,0,0,0,15
879557,563127,2016-09-22,House,"House Third Reading: Given Immediate Effect Roll Call # 484",104,3,0,0,107
879557,564132,2016-10-20,Senate,"Senate Third Reading: Roll Call # 553",37,0,0,0,37
879561,562301,2016-09-08,Senate,"Reported Favorably Without Amendment",4,0,0,0,4
879561,564029,2016-10-20,Senate,"Senate Third Reading: Passed Roll Call # 562",37,0,0,0,37
879561,565677,2016-12-06,House,"Reported With Recommendation With Substitute  H-1",9,0,0,0,9
879561,566733,2016-12-15,House,"House Third Reading: Passed Roll Call # 728",107,1,0,0,108
879561,566734,2016-12-15,Senate,"Senate Third Reading: Roll Call # 840",37,0,0,1,38
879573,562303,2016-09-08,Senate,"Reported Favorably With Substitute  S-2",4,0,0,0,4
879573,562378,2016-09-08,Senate,"Reported Favorably With Substitute S-2",4,0,0,0,4
879573,562692,2016-09-08,Senate,"Reported Favorably With Substitute S-1",4,0,0,0,4
879573,564070,2016-10-20,Senate,"Senate Third Reading: Passed Roll Call # 560",37,0,0,0,37
879573,565697,2016-12-06,House,"Reported With Recommendation With Substitute  H-1",9,0,0,0,9
879573,566490,2016-12-15,House,"House Third Reading: Passed Roll Call # 726",107,1,0,0,108
879573,566491,2016-12-15,Senate,"Senate Third Reading: Roll Call # 838",37,0,0,1,38
879575,562295,2016-09-08,Senate,"Reported Favorably Without Amendment",4,0,0,0,4
879575,564031,2016-10-20,Senate,"Senate Third Reading: Passed Roll Call # 561",37,0,0,0,37
879575,565672,2016-12-06,House,"Reported With Recommendation With Substitute  H-1",9,0,0,0,9
879575,566633,2016-12-15,House,"House Third Reading: Passed Roll Call # 727",107,1,0,0,108
879575,566634,2016-12-15,Senate,"Senate Third Reading: Roll Call # 839",37,0,0,1,38
879587,548929,2016-05-26,Senate,"Reported Favorably Without Amendment",5,0,0,0,5
879587,552094,2016-06-08,Senate,"Senate Third Reading: Passed Roll Call # 414",34,3,0,0,37
879587,562571,2016-09-15,House,"Reported With Recommendation With Substitute  H-1",11,1,0,0,12
879587,563138,2016-09-22,House,"House Third Reading: Given Immediate Effect Roll Call # 483",62,45,0,0,107
879587,564032,2016-10-20,Senate,"Senate Third Reading: Roll Call # 557",33,3,1,0,37
879707,548799,2016-05-26,House,"Reported With Recommendation Without Amendment",16,0,0,0,16
879707,550992,2016-06-02,House,"House Third Reading: Given Immediate Effect Roll Call # 372",103,5,0,0,108
879707,563924,2016-10-18,Senate,"Reported Favorably Without Amendment",4,0,0,0,4
879707,566187,2016-12-13,Senate,"Senate Third Reading: Given Immediate Effect Roll Call # 738",37,0,0,1,38
879707,566706,2016-12-14,House,"House Third Reading: Roll Call # 677",107,1,0,0,108
879714,548792,2016-05-26,House,"Reported With Recommendation Without Amendment",16,0,0,0,16
879714,551160,2016-06-02,House,"House Third Reading: Given Immediate Effect Roll Call # 373",108,0,0,0,108
879714,563973,2016-10-18,Senate,"Reported Favorably Without Amendment",4,0,0,0,4
879714,566226,2016-12-13,Senate,"Senate Third Reading: Given Immediate Effect Roll Call # 739",37,0,0,1,38
879719,562225,2016-09-06,Senate,"Reported Favorably Without Amendment",6,0,0,0,6
879719,562388,2016-09-07,Senate,"Senate Third Reading: Passed Roll Call # 492",36,0,0,1,37
879719,562818,2016-09-20,House,"Reported With Recommendation With Substitute  H-1",13,0,0,0,13
879719,564836,2016-11-10,House,"House Third Reading: Given Immediate Effect Roll Call # 507",105,2,0,0,107
879719,564837,2016-11-10,Senate,"Senate Third Reading: Roll Call # 620",37,0,0,0,37
879727,550198,2016-05-31,Senate,"Reported Favorably Without Amendment",5,0,0,0,5
879729,562216,2016-09-06,Senate,"Reported Favorably With Substitute S-2",6,0,0,0,6
879729,562387,2016-09-07,Senate,"Senate Third Reading: Passed Roll Call # 491",36,0,0,1,37
879729,562813,2016-09-20,House,"Reported With Recommendation With Substitute  H-4",13,0,0,0,13
879729,564843,2016-11-10,House,"House Third Reading: Passed Roll Call # 506",104,2,0,0,106
879729,564844,2016-11-10,House,"House Third Reading: Given Immediate Effect Roll Call # 510",105,2,0,0,107
879729,564892,2016-11-10,Senate,"Senate Third Reading: Roll Call # 619",37,0,0,0,37
879736,562219,2016-09-06,Senate,"Reported Favorably With Substitute S-2",6,0,0,0,6
879736,562385,2016-09-07,Senate,"Senate Third Reading: Passed Roll Call # 493",36,0,0,1,37
879736,562817,2016-09-20,House,"Reported With Recommendation With Substitute  H-4",13,0,0,0,13
879736,564845,2016-11-10,House,"House Third Reading: Given Immediate Effect Roll Call # 508",105,2,0,0,107
879736,564846,2016-11-10,Senate,"Senate Third Reading: Roll Call # 621",35,0,2,0,37
879736,564847,2016-11-10,Senate,"Senate Third Reading: Roll Call # 622",37,0,0,0,37
879741,548791,2016-05-26,House,"Reported With Recommendation Without Amendment",16,0,0,0,16
879741,551211,2016-06-02,House,"House Third Reading: Given Immediate Effect Roll Call # 374",107,1,0,0,108
879741,563920,2016-10-18,Senate,"Reported Favorably Without Amendment",4,0,0,0,4
879741,566220,2016-12-13,Senate,"Senate Third Reading: Given Immediate Effect Roll Call # 740",37,0,0,1,38
879741,566564,2016-12-14,House,"House Third Reading: Senate Amendment(s) Concurred In Roll Call # 678",107,1,0,0,108
879747,552209,2016-06-08,Senate,"Reported Favorably Without Amendment",6,0,0,0,6
879747,564022,2016-10-20,Senate,"Senate Third Reading: Passed Roll Call # 559",37,0,0,0,37
879747,565670,2016-12-06,House,"Reported With Recommendation Without Amendment",13,1,0,0,14
879747,566735,2016-12-15,House,"House Third Reading: Passed Roll Call # 739",76,32,0,0,108
879747,566736,2016-12-15,Senate,"Senate Third Reading: Roll Call # 848",37,0,0,1,38
879749,562336,2016-09-06,Senate,"Reported Favorably Without Amendment",6,0,0,0,6
879749,562386,2016-09-07,Senate,"Senate Third Reading: Passed Roll Call # 494",36,0,0,1,37
879749,562815,2016-09-20,House,"Reported With Recommendation Without Amendment",13,0,0,0,13
879749,564824,2016-11-10,House,"House Third Reading: Given Immediate Effect Roll Call # 509",104,3,0,0,107
879750,563977,2016-10-18,Senate,"Reported Favorably Without Amendment",5,0,0,0,5
879750,563999,2016-10-19,Senate,"Senate Third Reading: Passed Roll Call # 552",37,0,0,0,37
879750,565568,2016-11-29,House,"Reported With Recommendation With Substitute  H-2",13,0,0,0,13
879750,566174,2016-11-29,House,"Reported With Recommendation With Substitute H-2",13,0,0,0,13
879750,566231,2016-12-13,House,"House Third Reading: Passed Roll Call # 648",103,5,0,0,108
879750,566232,2016-12-13,Senate,"Senate Third Reading: Roll Call # 752",37,0,0,1,38
879903,550534,2016-06-01,House,"Reported With Recommendation With Substitute H-1",27,2,0,0,29
879903,551191,2016-06-02,House,"House Third Reading: Given Immediate Effect Roll Call # 376",106,2,0,0,108
879903,552350,2016-06-09,Senate,"Senate Third Reading: Given Immediate Effect Roll Call # 445",37,0,0,0,37
879912,562811,2016-09-20,House,"Reported With Recommendation With Substitute  H-1",8,0,0,0,8
879912,565527,2016-11-30,House,"House Third Reading: Passed Roll Call # 529",106,0,0,0,106
879912,566011,2016-12-08,Senate,"Reported Favorably Without Amendment",4,0,0,0,4
879912,566012,2016-12-08,Senate,"Senate Third Reading: Passed Roll Call # 730",37,0,0,1,38
879926,550533,2016-06-01,House,"Reported With Recommendation Without Amendment",29,0,0,0,29
879926,551188,2016-06-02,House,"House Third Reading: Given Immediate Effect Roll Call # 377",84,24,0,0,108
879926,552083,2016-06-08,Senate,"Reported Favorably Without Amendment",5,2,0,0,7
879926,552084,2016-06-08,Senate,"Senate Third Reading: Given Immediate Effect Roll Call # 420",35,2,0,0,37
880197,563941,2016-10-18,Senate,"Reported Favorably With Substitute S-1",5,0,0,0,5
880197,564075,2016-10-20,Senate,"Senate Third Reading: Passed Roll Call # 579",35,1,0,1,37
880202,552077,2016-06-08,Senate,"Reported Favorably With Substitute S-2",5,2,0,0,7
880202,552376,2016-06-09,Senate,"Senate Third Reading: Passed Roll Call # 448",37,0,0,0,37
880202,562525,2016-09-14,House,"Reported With Recommendation Without Amendment",28,0,0,0,28
880202,562878,2016-09-20,House,"House Third Reading: Given Immediate Effect Roll Call # 460",106,0,0,0,106
880232,552250,2016-06-08,Senate,"Senate Third Reading: Passed Roll Call # 387",26,11,0,0,37
880232,565553,2016-11-30,House,"Reported With Recommendation With Substitute  H-1",17,10,0,0,27
880232,566210,2016-12-13,House,"House Third Reading: Given Immediate Effect Roll Call # 669",60,48,0,0,108
880232,566211,2016-12-13,Senate,"Senate Third Reading: Roll Call # 757",26,11,0,1,38
880381,552206,2016-06-08,Senate,"Reported Favorably Without Amendment",7,0,0,0,7
880381,562305,2016-09-08,Senate,"Senate Third Reading: Passed Roll Call # 503",37,0,0,0,37
880381,565542,2016-11-30,House,"Reported With Recommendation Without Amendment",12,0,0,0,12
880381,566258,2016-12-13,House,"House Third Reading: Passed Roll Call # 659",108,0,0,0,108
880384,565519,2016-12-01,Senate,"Reported Favorably With Substitute  S-1",6,0,0,0,6
880384,565981,2016-12-08,Senate,"Senate Third Reading: Passed Roll Call # 716",27,10,0,1,38
880390,565478,2016-12-01,Senate,"Reported Favorably Without Amendment",6,0,0,0,6
880390,565974,2016-12-08,Senate,"Senate Third Reading: Passed Roll Call # 715",27,10,0,1,38
880560,562526,2016-09-14,House,"Reported With Recommendation Without Amendment",12,0,0,0,12
880560,565457,2016-11-30,House,"House Third Reading: Passed Roll Call # 525",104,2,0,0,106
880560,565842,2016-12-07,Senate,"Reported Favorably Without Amendment",6,0,0,0,6
880560,566315,2016-12-14,Senate,"Senate Third Reading: Passed Roll Call # 813",37,0,0,1,38
881031,552387,2016-06-09,Senate,"Reported Favorably Without Amendment",4,1,0,0,5
881031,562313,2016-09-08,Senate,"Senate Third Reading: Passed Roll Call # 510",22,15,0,0,37
881041,562368,2016-09-08,Senate,"Reported Favorably Without Amendment",7,0,0,0,7
881041,563118,2016-09-21,Senate,"Senate Third Reading: Passed Roll Call # 529",34,1,0,2,37
881041,565609,2016-11-29,House,"Reported With Recommendation Without Amendment",18,0,0,0,18
881041,566541,2016-12-14,House,"House Third Reading: Passed Roll Call # 682",89,17,0,0,106
881042,562354,2016-09-08,Senate,"Reported Favorably With Substitute  S-2",7,0,0,0,7
881042,562400,2016-09-08,Senate,"Reported Favorably With Substitute S-2",7,0,0,0,7
881042,563109,2016-09-21,Senate,"Senate Third Reading: Passed Roll Call # 528",34,1,0,2,37
881042,565607,2016-11-29,House,"Reported With Recommendation Without Amendment",18,0,0,0,18
881042,566679,2016-12-14,House,"House Third Reading: Passed Roll Call # 681",87,19,0,0,106
881053,562329,2016-09-08,Senate,"Senate Third Reading: Given Immediate Effect Roll Call # 499",26,11,0,0,37
881057,559053,2016-08-03,Senate,"Reported Favorably With Substitute  S-1",3,1,0,0,4
881063,566000,2016-12-07,House,"Reported With Recommendation With Substitute  H-1",6,1,0,0,7
881067,566050,2016-12-07,House,"Reported With Recommendation With Substitute  H-1",6,1,0,0,7
881068,559089,2016-08-03,Senate,"Reported Favorably With Substitute  S-1",3,1,0,0,4
881209,563098,2016-09-21,Senate,"Reported Favorably With Substitute S-1",6,0,0,0,6
881209,563926,2016-10-18,Senate,"Senate Third Reading: Passed Roll Call # 541",37,0,0,0,37
881225,559079,2016-08-03,Senate,"Reported Favorably Without Amendment",4,0,0,0,4
881225,563104,2016-09-21,Senate,"Senate Third Reading: Passed Roll Call # 525",35,0,0,2,37
881225,565579,2016-11-29,House,"Reported With Recommendation Without Amendment",10,1,0,0,11
881225,566186,2016-12-13,House,"House Third Reading: Passed Roll Call # 650",107,1,0,0,108
881229,562367,2016-09-08,Senate,"Reported Favorably Without Amendment",8,1,0,0,9
881229,563047,2016-09-21,Senate,"Senate Third Reading: Passed Roll Call # 530",34,1,0,2,37
881229,565509,2016-11-30,House,"Reported With Recommendation Without Amendment",14,0,0,0,14
881229,566034,2016-12-08,House,"House Third Reading: Given Immediate Effect Roll Call # 610",106,1,0,0,107
881229,566194,2016-12-13,Senate,"Senate Third Reading: House Amendment(s) Concurred In Roll Call # 733",35,1,0,2,38
881230,559059,2016-08-03,Senate,"Reported Favorably Without Amendment",4,0,0,0,4
881230,563061,2016-09-21,Senate,"Senate Third Reading: Passed Roll Call # 526",35,0,0,2,37
881238,562568,2016-09-15,House,"Reported With Recommendation With Substitute  H-1",7,0,0,0,7
881238,563148,2016-09-22,House,"House Third Reading: Given Immediate Effect Roll Call # 494",107,0,0,0,107
881244,562453,2016-09-13,House,"Reported With Recommendation Without Amendment",8,0,0,0,8
881245,562459,2016-09-13,House,"Reported With Recommendation Without Amendment",11,0,0,0,11
881253,565603,2016-11-29,House,"Reported With Recommendation With Substitute  H-1",14,0,0,0,14
881253,565604,2016-12-01,House,"House Third Reading: Passed Roll Call # 545",108,0,0,0,108
881253,566185,2016-12-13,Senate,"Reported Favorably Without Amendment",5,0,0,0,5
881254,562462,2016-09-13,House,"Reported With Recommendation Without Amendment",8,0,0,0,8
881298,562777,2016-09-15,House,"Reported With Recommendation Without Amendment",7,0,0,0,7
881328,562381,2016-09-08,House,"Reported With Recommendation With Substitute H-1",13,1,0,0,14
881328,562517,2016-09-08,House,"Reported With Recommendation With Substitute  H-1",13,1,0,0,14
881328,562940,2016-09-21,House,"House Third Reading: Given Immediate Effect Roll Call # 476",85,21,0,0,106
881328,565336,2016-11-30,Senate,"Reported Favorably Without Amendment",3,1,0,0,4
881328,566322,2016-12-14,Senate,"Senate Third Reading: Given Immediate Effect Roll Call # 760",28,9,0,1,38
881340,565549,2016-11-30,House,"Reported With Recommendation With Substitute  H-3",25,1,0,0,26
881353,562302,2016-09-08,Senate,"Reported Favorably Without Amendment",4,0,0,0,4
881361,562949,2016-09-21,House,"Reported With Recommendation With Substitute  H-2",10,0,0,0,10
881361,565304,2016-11-29,House,"House Third Reading: Given Immediate Effect Roll Call # 516",107,0,0,0,107
881361,565904,2016-12-07,Senate,"Reported Favorably Without Amendment",6,0,0,0,6
881361,566422,2016-12-14,Senate,"Senate Third Reading: Given Immediate Effect Roll Call # 763",36,1,0,1,38
881364,563877,2016-10-18,Senate,"Reported Favorably Without Amendment",5,0,0,0,5
881370,563917,2016-10-18,Senate,"Reported Favorably Without Amendment",5,0,0,0,5
881372,559068,2016-08-03,Senate,"Reported Favorably With Substitute  S-2",4,0,0,0,4
883685,562352,2016-09-07,House,"Reported With Recommendation Without Amendment",8,0,0,0,8
883686,562355,2016-09-07,House,"Reported With Recommendation With Substitute  H-1",8,0,0,0,8
883688,562358,2016-09-07,House,"Reported With Recommendation Without Amendment",8,0,0,0,8
883689,562357,2016-09-07,House,"Reported With Recommendation With Substitute  H-1",8,0,0,0,8
883689,565455,2016-11-30,House,"House Third Reading: Passed Roll Call # 528",106,0,0,0,106
883689,566222,2016-12-13,Senate,"Reported Favorably With Substitute  S-1",4,1,0,0,5
883689,566291,2016-12-14,Senate,"Senate Third Reading: Passed Roll Call # 768",37,0,0,1,38
883689,566495,2016-12-15,House,"House Third Reading: Roll Call # 722",106,2,0,0,108
883692,562532,2016-09-14,House,"Reported With Recommendation Without Amendment",8,5,0,0,13
883701,562527,2016-09-14,House,"Reported With Recommendation With Substitute  H-1",8,5,0,0,13
883702,562308,2016-09-07,House,"Reported With Recommendation Without Amendment",8,0,0,0,8
883703,562824,2016-09-20,House,"Reported With Recommendation Without Amendment",19,0,0,0,19
883703,565510,2016-11-30,House,"House Third Reading: Given Immediate Effect Roll Call # 524",104,2,0,0,106
883703,565845,2016-12-07,Senate,"Reported Favorably Without Amendment",8,0,0,0,8
883703,566304,2016-12-14,Senate,"Senate Third Reading: Passed Roll Call # 814",37,0,0,1,38
883703,566723,2016-12-15,House,"House Third Reading: Senate Amendment(s) Concurred In Roll Call # 755",106,1,0,0,107
883707,562331,2016-09-07,House,"Reported With Recommendation Without Amendment",8,0,0,0,8
883708,564869,2016-11-10,House,"Reported With Recommendation With Substitute  H-3",19,1,0,0,20
883710,562356,2016-09-07,House,"Reported With Recommendation Without Amendment",8,0,0,0,8
884363,562943,2016-09-21,House,"Reported With Recommendation Without Amendment",9,0,0,0,9
884363,565463,2016-11-30,House,"House Third Reading: Passed Roll Call # 530",104,2,0,0,106
884375,565588,2016-11-29,House,"Reported With Recommendation With Substitute  H-1",11,0,0,0,11
884375,566054,2016-12-08,House,"House Third Reading: Passed Roll Call # 601",107,0,0,0,107
884379,564852,2016-11-10,House,"Reported With Recommendation Without Amendment",11,6,0,0,17
884379,565446,2016-12-01,House,"House Third Reading: Given Immediate Effect Roll Call # 544",58,50,0,0,108
884379,565790,2016-12-07,Senate,"Reported Favorably Without Amendment",4,0,0,0,4
884379,566434,2016-12-14,Senate,"Senate Third Reading: Given Immediate Effect Roll Call # 762",26,11,0,1,38
884379,566787,2016-12-01,House,"House Third Reading: Passed Roll Call # 544",58,50,0,0,108
884384,562469,2016-09-13,House,"Reported With Recommendation Without Amendment",21,0,0,0,21
884384,563083,2016-09-22,House,"House Third Reading: Given Immediate Effect Roll Call # 485",107,0,0,0,107
884384,566221,2016-12-13,Senate,"Reported Favorably Without Amendment",5,0,0,0,5
885103,564105,2016-10-20,Senate,"Reported Favorably Without Amendment",4,0,0,0,4
885104,564056,2016-10-19,Senate,"Reported Favorably Without Amendment",3,1,0,0,4
885104,564057,2016-10-20,Senate,"Senate Third Reading: Passed Roll Call # 583",28,8,0,1,37
885105,564094,2016-10-20,Senate,"Reported Favorably Without Amendment",4,0,0,0,4
885105,564095,2016-10-20,Senate,"Senate Third Reading: Passed Roll Call # 612",36,0,0,1,37
885105,566049,2016-12-07,House,"Reported With Recommendation With Substitute  H-1",7,0,0,0,7
885105,566664,2016-12-15,House,"House Third Reading: Passed Roll Call # 735",107,1,0,0,108
885105,566665,2016-12-15,Senate,"Senate Third Reading: Roll Call # 845",37,0,0,1,38
885107,563097,2016-09-21,Senate,"Reported Favorably With Substitute S-1",7,0,0,0,7
885107,564026,2016-10-20,Senate,"Senate Third Reading: Passed Roll Call # 565",35,2,0,0,37
885107,565931,2016-12-07,House,"Reported With Recommendation With Substitute  H-1",26,0,0,0,26
885107,566676,2016-12-14,House,"House Third Reading: Given Immediate Effect Roll Call # 707",103,5,0,0,108
885107,566677,2016-12-15,Senate,"Senate Third Reading: Roll Call # 827",35,2,0,1,38
885108,564084,2016-10-20,Senate,"Reported Favorably Without Amendment",4,0,0,0,4
885108,564085,2016-10-20,Senate,"Senate Third Reading: Passed Roll Call # 611",36,0,0,1,37
885108,566070,2016-12-07,House,"Reported With Recommendation With Substitute  H-1",7,0,0,0,7
885108,566685,2016-12-15,House,"House Third Reading: Passed Roll Call # 734",107,1,0,0,108
885108,566686,2016-12-15,Senate,"Senate Third Reading: Roll Call # 844",37,0,0,1,38
885113,562402,2016-09-08,Senate,"Reported Favorably Without Amendment",4,0,0,0,4
885113,563129,2016-09-21,Senate,"Senate Third Reading: Passed Roll Call # 527",35,0,0,2,37
885113,565563,2016-11-29,House,"Reported With Recommendation Without Amendment",10,0,0,0,10
885113,566177,2016-12-13,House,"House Third Reading: Given Immediate Effect Roll Call # 651",107,1,0,0,108
885115,564086,2016-10-20,Senate,"Reported Favorably Without Amendment",4,0,0,0,4
885115,564087,2016-10-20,Senate,"Senate Third Reading: Passed Roll Call # 610",36,0,0,1,37
885115,566042,2016-12-07,House,"Reported With Recommendation With Substitute  H-1",7,0,0,0,7
885115,566772,2016-12-15,House,"House Third Reading: Passed Roll Call # 733",107,1,0,0,108
885115,566773,2016-12-15,Senate,"Senate Third Reading: Roll Call # 843",37,0,0,1,38
885119,564092,2016-10-20,Senate,"Reported Favorably Without Amendment",4,0,0,0,4
885119,564093,2016-10-20,Senate,"Senate Third Reading: Passed Roll Call # 613",36,0,0,1,37
885119,566088,2016-12-07,House,"Reported With Recommendation With Substitute  H-1",7,0,0,0,7
885119,566780,2016-12-15,House,"House Third Reading: Passed Roll Call # 736",107,1,0,0,108
885119,566781,2016-12-15,Senate,"Senate Third Reading: Roll Call # 846",37,0,0,1,38
885120,564099,2016-10-20,Senate,"Reported Favorably With Substitute  S-1",4,0,0,0,4
885120,564100,2016-10-20,Senate,"Senate Third Reading: Passed Roll Call # 604",36,0,0,1,37
885121,562814,2016-09-20,Senate,"Reported Favorably With Substitute S-1",5,0,0,0,5
885121,565456,2016-12-01,Senate,"Senate Third Reading: Passed Roll Call # 653",36,0,0,2,38
885150,562404,2016-09-08,House,"Reported With Recommendation Without Amendment",28,0,0,0,28
885150,563342,2016-09-21,Senate,"Senate Third Reading: Roll Call # 534",35,0,0,2,37
885157,562828,2016-09-20,House,"Reported With Recommendation With Substitute  H-1",6,0,0,0,6
885157,563145,2016-09-22,House,"House Third Reading: Given Immediate Effect Roll Call # 479",102,5,0,0,107
885163,565424,2016-12-01,House,"Reported With Recommendation Without Amendment",4,0,0,0,4
885163,566073,2016-12-08,House,"House Third Reading: Passed Roll Call # 617",107,1,0,0,108
885203,565423,2016-12-01,House,"Reported With Recommendation Without Amendment",4,0,0,0,4
885203,566086,2016-12-08,House,"House Third Reading: Given Immediate Effect Roll Call # 606",97,10,0,0,107
885203,566410,2016-12-14,Senate,"Senate Third Reading: Given Immediate Effect Roll Call # 776",34,3,0,1,38
885206,562947,2016-09-21,House,"Reported With Recommendation With Substitute  H-1",19,0,0,0,19
885206,565292,2016-11-29,House,"House Third Reading: Passed Roll Call # 515",70,37,0,0,107
885206,566053,2016-12-08,Senate,"Reported Favorably Without Amendment",11,6,0,0,17
885207,562458,2016-09-13,House,"Reported With Recommendation Without Amendment",8,0,0,0,8
885207,563076,2016-09-22,House,"House Third Reading: Given Immediate Effect Roll Call # 490",100,7,0,0,107
885207,566188,2016-12-13,Senate,"Reported Favorably Without Amendment",4,1,0,0,5
885207,566400,2016-12-14,Senate,"Senate Third Reading: Given Immediate Effect Roll Call # 774",37,0,0,1,38
885208,563088,2016-09-21,House,"Reported With Recommendation With Substitute  H-1",6,5,0,0,11
885208,565460,2016-12-01,House,"House Third Reading: Passed Roll Call # 543",63,45,0,0,108
885210,562821,2016-09-20,House,"Reported With Recommendation Without Amendment",8,0,0,0,8
885211,562454,2016-09-13,House,"Reported With Recommendation Without Amendment",8,0,0,0,8
885211,563096,2016-09-22,House,"House Third Reading: Given Immediate Effect Roll Call # 488",100,7,0,0,107
885211,566184,2016-12-13,Senate,"Reported Favorably Without Amendment",4,1,0,0,5
885211,566398,2016-12-14,Senate,"Senate Third Reading: Given Immediate Effect Roll Call # 772",37,0,0,1,38
885215,565431,2016-12-01,House,"Reported With Recommendation Without Amendment",4,0,0,0,4
885215,566099,2016-12-08,House,"House Third Reading: Given Immediate Effect Roll Call # 605",99,8,0,0,107
885215,566421,2016-12-14,Senate,"Senate Third Reading: Given Immediate Effect Roll Call # 775",34,3,0,1,38
885217,563136,2016-09-21,House,"Reported With Recommendation With Substitute  H-2",6,5,0,0,11
885217,565546,2016-12-01,House,"House Third Reading: Passed Roll Call # 538",60,48,0,0,108
885218,563084,2016-09-21,House,"Reported With Recommendation With Substitute  H-2",6,5,0,0,11
885218,565448,2016-12-01,House,"House Third Reading: Passed Roll Call # 539",60,48,0,0,108
885219,562467,2016-09-13,House,"Reported With Recommendation Without Amendment",8,0,0,0,8
885219,563068,2016-09-22,House,"House Third Reading: Given Immediate Effect Roll Call # 487",101,6,0,0,107
885219,566213,2016-12-13,Senate,"Reported Favorably Without Amendment",4,1,0,0,5
885219,566296,2016-12-14,Senate,"Senate Third Reading: Given Immediate Effect Roll Call # 771",37,0,0,1,38
885220,564796,2016-11-09,House,"Reported With Recommendation With Substitute  H-1",13,0,0,0,13
885220,565481,2016-11-30,House,"House Third Reading: Passed Roll Call # 526",85,21,0,0,106
885220,565795,2016-12-07,Senate,"Reported Favorably Without Amendment",6,0,0,0,6
885220,566176,2016-12-13,Senate,"Senate Third Reading: Given Immediate Effect Roll Call # 742",37,0,0,1,38
885225,565605,2016-11-29,House,"Reported With Recommendation Without Amendment",14,0,0,0,14
885225,566039,2016-12-08,House,"House Third Reading: Passed Roll Call # 607",107,0,0,0,107
885226,562472,2016-09-13,House,"Reported With Recommendation Without Amendment",8,0,0,0,8
885226,563126,2016-09-22,House,"House Third Reading: Given Immediate Effect Roll Call # 486",100,7,0,0,107
885226,566219,2016-12-13,Senate,"Reported Favorably Without Amendment",4,1,0,0,5
885226,566367,2016-12-14,Senate,"Senate Third Reading: Given Immediate Effect Roll Call # 770",37,0,0,1,38
885230,563085,2016-09-21,House,"Reported With Recommendation With Substitute  H-2",6,5,0,0,11
885230,565487,2016-12-01,House,"House Third Reading: Passed Roll Call # 540",61,47,0,0,108
885232,564798,2016-11-09,House,"Reported With Recommendation With Substitute  H-1",13,0,0,0,13
885232,565417,2016-11-30,House,"House Third Reading: Passed Roll Call # 527",79,27,0,0,106
885232,565792,2016-12-07,Senate,"Reported Favorably Without Amendment",6,0,0,0,6
885232,566175,2016-12-13,Senate,"Senate Third Reading: Passed Roll Call # 744",37,0,0,1,38
885235,562841,2016-09-20,House,"Reported With Recommendation Without Amendment",8,0,0,0,8
885235,565942,2016-12-07,House,"House Third Reading: Passed Roll Call # 562",106,0,0,0,106
885235,566181,2016-12-13,Senate,"Reported Favorably Without Amendment",5,0,0,0,5
885235,566397,2016-12-14,Senate,"Senate Third Reading: Passed Roll Call # 820",37,0,0,1,38
885237,563090,2016-09-21,House,"Reported With Recommendation With Substitute  H-2",6,5,0,0,11
885237,565419,2016-12-01,House,"House Third Reading: Passed Roll Call # 542",62,46,0,0,108
885241,562456,2016-09-13,House,"Reported With Recommendation Without Amendment",6,0,0,0,6
885241,562995,2016-09-21,House,"House Third Reading: Given Immediate Effect Roll Call # 475",101,5,0,0,106
885241,566246,2016-12-13,Senate,"Reported Favorably Without Amendment",5,0,0,0,5
885241,566384,2016-12-14,Senate,"Senate Third Reading: Passed Roll Call # 822",37,0,0,1,38
885244,562463,2016-09-13,House,"Reported With Recommendation Without Amendment",6,0,0,0,6
885244,562996,2016-09-21,House,"House Third Reading: Given Immediate Effect Roll Call # 474",102,4,0,0,106
885244,566237,2016-12-13,Senate,"Reported Favorably Without Amendment",5,0,0,0,5
885244,566459,2016-12-14,Senate,"Senate Third Reading: Passed Roll Call # 821",37,0,0,1,38
885245,565422,2016-12-01,House,"Reported With Recommendation Without Amendment",14,0,0,0,14
885248,562475,2016-09-13,House,"Reported With Recommendation Without Amendment",8,0,0,0,8
885248,563146,2016-09-22,House,"House Third Reading: Given Immediate Effect Roll Call # 489",101,6,0,0,107
885248,566204,2016-12-13,Senate,"Reported Favorably Without Amendment",4,1,0,0,5
885248,566416,2016-12-14,Senate,"Senate Third Reading: Given Immediate Effect Roll Call # 773",37,0,0,1,38
885249,562819,2016-09-20,House,"Reported With Recommendation Without Amendment",14,2,0,0,16
885249,565437,2016-12-01,House,"House Third Reading: Passed Roll Call # 549",86,22,0,0,108
885249,565959,2016-12-08,Senate,"Reported Favorably Without Amendment",7,0,0,0,7
885249,566382,2016-12-14,Senate,"Senate Third Reading: Passed Roll Call # 765",36,0,1,1,38
885251,563059,2016-09-21,House,"Reported With Recommendation With Substitute  H-4",6,5,0,0,11
885251,563636,2016-09-21,House,"Reported With Recommendation With Substitute  H-2",6,5,0,0,11
885251,565465,2016-12-01,House,"House Third Reading: Passed Roll Call # 541",61,47,0,0,108
885304,565782,2016-12-07,Senate,"Senate Third Reading: Passed Roll Call # 698",37,0,0,1,38
885304,566071,2016-12-08,House,"Reported With Recommendation Without Amendment",5,0,0,0,5
885304,566560,2016-12-15,House,"House Third Reading: Passed Roll Call # 747",106,1,0,0,107
885304,566561,2016-12-15,Senate,"Senate Third Reading: Roll Call # 853",37,0,0,1,38
885306,563111,2016-09-21,Senate,"Reported Favorably With Substitute S-1",7,0,0,0,7
885306,565330,2016-11-29,Senate,"Senate Third Reading: Passed Roll Call # 631",29,8,0,1,38
885316,563107,2016-09-21,Senate,"Reported Favorably Without Amendment",7,0,0,0,7
885316,565240,2016-11-29,Senate,"Senate Third Reading: Passed Roll Call # 635",29,8,0,1,38
885318,564115,2016-10-20,Senate,"Reported Favorably With Substitute  S-2",4,0,0,0,4
885323,563113,2016-09-21,Senate,"Reported Favorably Without Amendment",7,0,0,0,7
885323,565239,2016-11-29,Senate,"Senate Third Reading: Passed Roll Call # 633",29,8,0,1,38
885325,565397,2016-11-30,Senate,"Reported Favorably With Substitute  S-1",3,1,0,0,4
885325,565485,2016-12-01,Senate,"Senate Third Reading: Passed Roll Call # 660",36,0,0,2,38
885328,565443,2016-12-01,Senate,"Reported Favorably With Substitute  S-1",5,0,0,0,5
885328,565950,2016-12-08,Senate,"Senate Third Reading: Passed Roll Call # 717",37,0,0,1,38
885330,565348,2016-11-30,Senate,"Reported Favorably Without Amendment",5,0,0,0,5
885332,563953,2016-10-18,Senate,"Reported Favorably Without Amendment",5,0,0,0,5
885332,564010,2016-10-19,Senate,"Senate Third Reading: Passed Roll Call # 551",37,0,0,0,37
885332,565505,2016-11-30,House,"Reported With Recommendation Without Amendment",7,0,0,0,7
885332,566247,2016-12-13,House,"House Third Reading: Passed Roll Call # 657",108,0,0,0,108
885332,566248,2016-12-13,Senate,"Senate Third Reading: Roll Call # 754",37,0,0,1,38
885334,563962,2016-10-18,Senate,"Reported Favorably Without Amendment",5,0,0,0,5
885334,564035,2016-10-19,Senate,"Senate Third Reading: Passed Roll Call # 550",37,0,0,0,37
885334,565464,2016-11-30,House,"Reported With Recommendation Without Amendment",7,0,0,0,7
885334,566277,2016-12-13,House,"House Third Reading: Passed Roll Call # 656",108,0,0,0,108
885334,566278,2016-12-13,Senate,"Senate Third Reading: Roll Call # 753",35,0,2,1,38
885336,563916,2016-10-18,Senate,"Reported Favorably With Substitute  S-2",5,0,0,0,5
885336,564047,2016-10-20,Senate,"Senate Third Reading: Passed Roll Call # 570",34,2,0,1,37
885341,564113,2016-10-20,Senate,"Reported Favorably Without Amendment",4,0,0,0,4
885341,565350,2016-11-30,Senate,"Senate Third Reading: Passed Roll Call # 644",34,2,0,2,38
885341,565701,2016-12-06,Senate,"Senate Third Reading: Passed Roll Call # 677",33,4,0,1,38
885341,566051,2016-12-07,House,"Reported With Recommendation Without Amendment",28,0,0,0,28
885341,566754,2016-12-14,House,"House Third Reading: Passed Roll Call # 693",107,0,0,0,107
885343,563062,2016-09-21,Senate,"Reported Favorably Without Amendment",7,0,0,0,7
885343,563063,2016-09-21,Senate,"Reported Favorably Without Amendment",7,0,0,0,7
885343,565306,2016-11-29,Senate,"Senate Third Reading: Passed Roll Call # 632",30,7,0,1,38
885343,565307,2016-11-29,Senate,"Senate Third Reading: Passed Roll Call # 632",30,7,0,1,38
885345,564101,2016-10-20,Senate,"Reported Favorably Without Amendment",4,0,0,0,4
885345,565332,2016-11-30,Senate,"Senate Third Reading: Passed Roll Call # 645",29,7,0,2,38
885345,565685,2016-12-06,Senate,"Senate Third Reading: Passed Roll Call # 678",29,8,0,1,38
885345,565947,2016-12-07,House,"Reported With Recommendation Without Amendment",28,0,0,0,28
885345,566751,2016-12-14,House,"House Third Reading: Passed Roll Call # 694",105,2,0,0,107
885347,563108,2016-09-21,Senate,"Reported Favorably Without Amendment",7,0,0,0,7
885347,565294,2016-11-29,Senate,"Senate Third Reading: Passed Roll Call # 634",29,8,0,1,38
885349,565344,2016-11-30,Senate,"Reported Favorably With Substitute  S-1",3,1,0,0,4
885349,565474,2016-12-01,Senate,"Senate Third Reading: Passed Roll Call # 661",36,0,0,2,38
885354,563979,2016-10-18,Senate,"Reported Favorably Without Amendment",5,0,0,0,5
885354,564048,2016-10-20,Senate,"Senate Third Reading: Passed Roll Call # 572",36,0,0,1,37
885357,564064,2016-10-20,Senate,"Reported Favorably With Substitute S-2",4,0,0,0,4
885360,563895,2016-10-18,Senate,"Reported Favorably With Substitute  S-2",5,0,0,0,5
885360,564077,2016-10-20,Senate,"Senate Third Reading: Passed Roll Call # 571",34,2,0,1,37
885362,564055,2016-10-20,Senate,"Reported Favorably Without Amendment",4,0,0,0,4
885362,565349,2016-11-30,Senate,"Senate Third Reading: Passed Roll Call # 643",35,1,0,2,38
885362,565690,2016-12-06,Senate,"Senate Third Reading: Passed Roll Call # 676",34,3,0,1,38
885362,565920,2016-12-07,House,"Reported With Recommendation Without Amendment",28,0,0,0,28
885362,566748,2016-12-14,House,"House Third Reading: Passed Roll Call # 692",107,0,0,0,107
885366,563964,2016-10-18,Senate,"Reported Favorably Without Amendment",5,0,0,0,5
885366,564061,2016-10-19,Senate,"Senate Third Reading: Passed Roll Call # 549",37,0,0,0,37
885366,565503,2016-11-30,House,"Reported With Recommendation Without Amendment",7,0,0,0,7
885366,566265,2016-12-13,House,"House Third Reading: Passed Roll Call # 655",108,0,0,0,108
885368,564102,2016-10-20,Senate,"Reported Favorably With Substitute  S-2",4,0,0,0,4
885539,562957,2016-09-21,House,"Reported With Recommendation Without Amendment",5,3,0,0,8
885590,563119,2016-09-22,House,"Reported With Recommendation With Substitute H-1",8,0,0,0,8
885590,565247,2016-11-29,House,"House Third Reading: Passed Roll Call # 519",107,0,0,0,107
885652,563486,2016-09-21,House,"Reported With Recommendation With Substitute  H-2",16,0,0,0,16
885652,565279,2016-11-29,House,"House Third Reading: Passed Roll Call # 517",107,0,0,0,107
885652,565717,2016-12-06,Senate,"Reported Favorably Without Amendment",4,0,0,0,4
885652,566085,2016-12-08,Senate,"Senate Third Reading: Passed Roll Call # 721",37,0,0,1,38
885652,566523,2016-12-14,House,"House Third Reading: Senate Amendment(s) Concurred In As Amended Roll Call # 670",107,0,0,0,107
885652,566524,2016-12-14,Senate,"Senate Third Reading: House Amendment(s) To Senate Amendment(s) Concurred In Roll Call # 802",37,0,0,1,38
885658,562823,2016-09-20,House,"Reported With Recommendation With Substitute  H-1",20,0,0,0,20
885658,565483,2016-11-30,House,"House Third Reading: Given Immediate Effect Roll Call # 521",105,1,0,0,106
885658,565484,2016-11-30,House,"House Third Reading: Passed Roll Call # 531",106,0,0,0,106
885658,565789,2016-12-07,Senate,"Reported Favorably Without Amendment",10,0,0,0,10
885658,566292,2016-12-14,Senate,"Senate Third Reading: Passed Roll Call # 815",37,0,0,1,38
885664,564802,2016-09-21,House,"Reported With Recommendation With Substitute  H-2",16,0,0,0,16
885664,565256,2016-11-29,House,"House Third Reading: Given Immediate Effect Roll Call # 518",107,0,0,0,107
885664,565710,2016-12-06,Senate,"Reported Favorably Without Amendment",4,0,0,0,4
885664,566059,2016-12-08,Senate,"Senate Third Reading: Given Immediate Effect Roll Call # 722",37,0,0,1,38
885664,566488,2016-12-14,House,"House Third Reading: Senate Amendment(s) Concurred In As Amended Roll Call # 671",107,0,0,0,107
885664,566489,2016-12-14,Senate,"Senate Third Reading: House Amendment(s) To Senate Amendment(s) Concurred In Roll Call # 803",37,0,0,1,38
886070,564108,2016-10-20,Senate,"Reported Favorably Without Amendment",4,0,0,0,4
886070,564109,2016-10-20,Senate,"Senate Third Reading: Passed Roll Call # 590",36,0,0,1,37
886070,565560,2016-11-29,House,"Reported With Recommendation Without Amendment",7,0,0,0,7
886070,566223,2016-12-13,House,"House Third Reading: Passed Roll Call # 649",107,1,0,0,108
886073,565364,2016-11-30,Senate,"Reported Favorably With Substitute  S-2",5,0,0,0,5
886082,565363,2016-11-30,Senate,"Reported Favorably With Substitute  S-1",5,0,0,0,5
886085,563982,2016-10-18,Senate,"Reported Favorably Without Amendment",5,0,0,0,5
886085,564051,2016-10-19,Senate,"Senate Third Reading: Passed Roll Call # 548",37,0,0,0,37
886085,565585,2016-11-29,House,"Reported With Recommendation Without Amendment",13,0,0,0,13
886085,565949,2016-12-07,House,"House Third Reading: Given Immediate Effect Roll Call # 598",107,0,0,0,107
886089,564872,2016-11-09,Senate,"Reported Favorably Without Amendment",5,0,0,0,5
886089,564873,2016-11-10,Senate,"Senate Third Reading: Passed Roll Call # 625",37,0,0,0,37
886092,565233,2016-11-29,Senate,"Reported Favorably With Substitute S-1",4,0,0,0,4
886092,565241,2016-11-29,Senate,"Senate Third Reading: Defeated Roll Call # 637",19,18,0,1,38
886092,565390,2016-11-30,Senate,"Senate Third Reading: Passed Roll Call # 641",23,13,0,2,38
886099,563879,2016-10-18,Senate,"Reported Favorably With Substitute  S-1",8,0,0,0,8
886099,564042,2016-10-20,Senate,"Senate Third Reading: Passed Roll Call # 575",36,0,0,1,37
886099,565966,2016-12-08,House,"Reported With Recommendation With Substitute  H-2",16,0,0,0,16
886099,566739,2016-12-14,House,"House Third Reading: Passed Roll Call # 696",93,14,0,0,107
886099,566740,2016-12-14,Senate,"Senate Third Reading: Roll Call # 809",37,0,0,1,38
886197,564133,2016-10-18,Senate,"Reported Favorably Without Amendment",5,0,0,0,5
886212,565252,2016-11-29,Senate,"Reported Favorably With Substitute  S-1",3,1,0,0,4
886212,565482,2016-12-01,Senate,"Senate Third Reading: Passed Roll Call # 659",24,12,0,2,38
886212,566026,2016-12-07,House,"Reported With Recommendation With Substitute  H-1",17,0,0,0,17
886212,566749,2016-12-14,House,"House Third Reading: Given Immediate Effect Roll Call # 711",107,1,0,0,108
886212,566750,2016-12-15,Senate,"Senate Third Reading: Roll Call # 831",37,0,0,1,38
886217,565444,2016-12-01,Senate,"Reported Favorably Without Amendment",3,0,0,0,3
886217,565445,2016-12-01,Senate,"Senate Third Reading: Passed Roll Call # 672",36,0,0,2,38
886217,565665,2016-12-06,House,"Reported With Recommendation Without Amendment",9,0,0,0,9
886217,566565,2016-12-15,House,"House Third Reading: Passed Roll Call # 743",95,12,0,0,107
886220,565276,2016-11-29,Senate,"Reported Favorably Without Amendment",3,1,0,0,4
886220,565436,2016-12-01,Senate,"Senate Third Reading: Passed Roll Call # 656",24,12,0,2,38
886220,565962,2016-12-07,House,"Reported With Recommendation Without Amendment",23,0,0,0,23
886220,566593,2016-12-14,House,"House Third Reading: Given Immediate Effect Roll Call # 708",107,1,0,0,108
886220,566594,2016-12-15,Senate,"Senate Third Reading: House Amendment(s) Concurred In Roll Call # 828",37,0,0,1,38
886221,564039,2016-10-20,Senate,"Reported Favorably Without Amendment",4,0,0,0,4
886221,564040,2016-10-20,Senate,"Senate Third Reading: Passed Roll Call # 615",36,0,0,1,37
886221,565601,2016-11-29,House,"Reported With Recommendation Without Amendment",11,0,0,0,11
886221,566182,2016-12-13,House,"House Third Reading: Passed Roll Call # 653",108,0,0,0,108
886223,563867,2016-10-18,Senate,"Reported Favorably Without Amendment",5,0,0,0,5
886223,564865,2016-11-10,Senate,"Senate Third Reading: Passed Roll Call # 623",37,0,0,0,37
886223,565714,2016-11-30,House,"Reported With Recommendation Without Amendment",15,0,0,0,15
886223,566238,2016-12-13,House,"House Third Reading: Passed Roll Call # 664",108,0,0,0,108
886224,564103,2016-10-20,Senate,"Reported Favorably Without Amendment",4,0,0,0,4
886224,564104,2016-10-20,Senate,"Senate Third Reading: Passed Roll Call # 588",26,10,0,1,37
886224,565944,2016-12-08,House,"Reported With Recommendation Without Amendment",15,2,0,0,17
886224,566193,2016-12-13,House,"House Third Reading: Given Immediate Effect Roll Call # 668",60,48,0,0,108
886230,565253,2016-11-29,Senate,"Reported Favorably Without Amendment",3,1,0,0,4
886230,565489,2016-12-01,Senate,"Senate Third Reading: Passed Roll Call # 657",24,12,0,2,38
886230,566038,2016-12-07,House,"Reported With Recommendation Without Amendment",23,0,0,0,23
886230,566695,2016-12-14,House,"House Third Reading: Given Immediate Effect Roll Call # 709",107,1,0,0,108
886230,566696,2016-12-15,Senate,"Senate Third Reading: House Amendment(s) Concurred In Roll Call # 829",37,0,0,1,38
886238,565522,2016-12-01,House,"House Third Reading: Passed Roll Call # 547",107,1,0,0,108
886238,565557,2016-11-30,House,"Reported With Recommendation Without Amendment",23,0,0,0,23
886238,565851,2016-12-07,Senate,"Reported Favorably Without Amendment",6,0,0,0,6
886238,566479,2016-12-15,Senate,"Senate Third Reading: Given Immediate Effect Roll Call # 855",37,0,0,1,38
886241,565291,2016-11-29,Senate,"Reported Favorably Without Amendment",3,1,0,0,4
886241,565479,2016-12-01,Senate,"Senate Third Reading: Passed Roll Call # 658",24,12,0,2,38
886241,566025,2016-12-07,House,"Reported With Recommendation Without Amendment",26,0,0,0,26
886241,566767,2016-12-14,House,"House Third Reading: Given Immediate Effect Roll Call # 710",107,1,0,0,108
886241,566768,2016-12-15,Senate,"Senate Third Reading: Roll Call # 830",37,0,0,1,38
886251,565425,2016-12-01,House,"Reported With Recommendation Without Amendment",17,0,0,0,17
886253,564125,2016-10-20,Senate,"Reported Favorably Without Amendment",4,0,0,0,4
886253,564126,2016-10-20,Senate,"Senate Third Reading: Passed Roll Call # 614",36,0,0,1,37
886253,565571,2016-11-29,House,"Reported With Recommendation Without Amendment",11,0,0,0,11
886253,566180,2016-12-13,House,"House Third Reading: Passed Roll Call # 652",108,0,0,0,108
886316,565935,2016-12-08,House,"Reported With Recommendation Without Amendment",14,1,0,0,15
886316,565936,2016-12-08,House,"House Third Reading: Passed Roll Call # 612",91,17,0,0,108
886316,566461,2016-12-15,Senate,"Senate Third Reading: Passed Roll Call # 849",37,0,0,1,38
886316,566680,2016-12-15,House,"House Third Reading: Roll Call # 756",87,20,0,0,107
887325,564385,2016-10-19,Senate,"Reported Favorably Without Amendment",4,0,0,0,4
887487,564827,2016-11-09,Senate,"Reported Favorably Without Amendment",5,0,0,0,5
887487,565990,2016-12-08,Senate,"Senate Third Reading: Passed Roll Call # 709",37,0,0,1,38
887490,565388,2016-11-30,Senate,"Reported Favorably Without Amendment",3,1,0,0,4
887490,565538,2016-12-01,Senate,"Senate Third Reading: Passed Roll Call # 662",36,0,0,2,38
887490,566019,2016-12-07,House,"House Third Reading: Given Immediate Effect Roll Call # 599",103,4,0,0,107
887497,564004,2016-10-19,Senate,"Reported Favorably With Substitute  S-1",5,0,0,0,5
887497,565447,2016-12-01,Senate,"Senate Third Reading: Passed Roll Call # 654",36,0,0,2,38
887497,565679,2016-12-06,House,"Reported With Recommendation Without Amendment",9,0,0,0,9
887497,566614,2016-12-15,House,"House Third Reading: Passed Roll Call # 744",75,32,0,0,107
887571,564797,2016-11-09,House,"Reported With Recommendation Without Amendment",13,2,0,0,15
887571,565523,2016-12-01,House,"House Third Reading: Passed Roll Call # 548",66,42,0,0,108
887630,565300,2016-11-29,Senate,"Reported Favorably Without Amendment",4,0,0,0,4
887636,565231,2016-11-29,Senate,"Reported Favorably With Substitute  S-1",4,0,0,0,4
887636,565242,2016-11-29,Senate,"Senate Third Reading: Passed Roll Call # 638",30,7,0,1,38
887641,565274,2016-11-29,Senate,"Reported Favorably With Substitute  S-1",4,0,0,0,4
887641,565275,2016-11-29,Senate,"Senate Third Reading: Passed Roll Call # 639",29,8,0,1,38
887646,565232,2016-11-29,Senate,"Reported Favorably Without Amendment",4,0,0,0,4
887646,565243,2016-11-29,Senate,"Senate Third Reading: Passed Roll Call # 640",29,8,0,1,38
887972,565537,2016-11-30,House,"Reported With Recommendation Without Amendment",7,0,0,0,7
887979,565993,2016-12-08,Senate,"Reported Favorably Without Amendment",4,0,0,0,4
887979,565994,2016-12-08,Senate,"Senate Third Reading: Passed Roll Call # 729",37,0,0,1,38
888305,565430,2016-12-01,House,"Reported With Recommendation Without Amendment",7,0,0,0,7
888305,565702,2016-12-06,House,"House Third Reading: Passed Roll Call # 552",106,0,0,0,106
888305,566252,2016-12-13,Senate,"Reported Favorably Without Amendment",4,1,0,0,5
888305,566386,2016-12-14,Senate,"Senate Third Reading: Passed Roll Call # 769",37,0,0,1,38
888466,565528,2016-11-30,House,"Reported With Recommendation Without Amendment",11,0,0,0,11
888466,566091,2016-12-08,House,"House Third Reading: Passed Roll Call # 604",102,5,0,0,107
888466,566298,2016-12-14,Senate,"Reported Favorably Without Amendment",4,1,0,0,5
888466,566299,2016-12-14,Senate,"Senate Third Reading: Passed Roll Call # 789",37,0,0,1,38
888475,566082,2016-12-07,House,"Reported With Recommendation Without Amendment",7,4,0,0,11
888479,565575,2016-12-01,House,"Reported With Recommendation Without Amendment",5,1,0,0,6
888479,566002,2016-12-07,House,"House Third Reading: Given Immediate Effect Roll Call # 594",107,0,0,0,107
888480,565576,2016-12-01,House,"Reported With Recommendation With Substitute H-1",5,1,0,0,6
888480,566013,2016-12-07,House,"House Third Reading: Given Immediate Effect Roll Call # 593",104,3,0,0,107
888542,565358,2016-11-30,Senate,"Reported Favorably Without Amendment",4,1,0,0,5
888542,565991,2016-12-08,Senate,"Senate Third Reading: Passed Roll Call # 710",31,6,0,1,38
888544,565396,2016-11-30,Senate,"Reported Favorably Without Amendment",4,1,0,0,5
888544,566020,2016-12-08,Senate,"Senate Third Reading: Passed Roll Call # 712",30,7,0,1,38
888546,565451,2016-12-01,Senate,"Reported Favorably With Substitute  S-1",3,0,0,0,3
888546,565452,2016-12-01,Senate,"Senate Third Reading: Passed Roll Call # 673",30,6,0,2,38
888546,566037,2016-12-07,House,"Reported With Recommendation Without Amendment",28,0,0,0,28
888546,566254,2016-12-13,House,"House Third Reading: Given Immediate Effect Roll Call # 667",108,0,0,0,108
888547,565387,2016-11-30,Senate,"Reported Favorably Without Amendment",5,0,0,0,5
888547,566030,2016-12-08,Senate,"Senate Third Reading: Passed Roll Call # 724",37,0,0,1,38
888548,565389,2016-11-30,Senate,"Reported Favorably Without Amendment",5,0,0,0,5
888548,566005,2016-12-08,Senate,"Senate Third Reading: Passed Roll Call # 725",37,0,0,1,38
888552,565391,2016-11-30,Senate,"Reported Favorably Without Amendment",3,1,0,0,4
888552,565459,2016-12-01,Senate,"Senate Third Reading: Passed Roll Call # 664",36,0,0,2,38
888552,565716,2016-12-06,House,"Reported With Recommendation Without Amendment",8,1,0,0,9
888552,566782,2016-12-15,House,"House Third Reading: Passed Roll Call # 741",105,2,0,0,107
888552,566783,2016-12-15,Senate,"Senate Third Reading: House Amendment(s) Concurred In Roll Call # 850",37,0,0,1,38
888554,565335,2016-11-30,Senate,"Senate Third Reading: Passed Roll Call # 646",34,2,0,2,38
888554,566056,2016-12-07,House,"Reported With Recommendation Without Amendment",28,0,0,0,28
888554,566662,2016-12-14,House,"House Third Reading: Passed Roll Call # 695",107,0,0,0,107
888557,565352,2016-11-30,Senate,"Reported Favorably Without Amendment",3,1,0,0,4
888557,565469,2016-12-01,Senate,"Senate Third Reading: Passed Roll Call # 663",36,0,0,2,38
888557,565715,2016-12-06,House,"Reported With Recommendation Without Amendment",8,1,0,0,9
888557,566755,2016-12-15,House,"House Third Reading: Passed Roll Call # 740",105,3,0,0,108
888559,565533,2016-12-01,Senate,"Reported Favorably Without Amendment",9,8,0,0,17
888560,565502,2016-12-01,Senate,"Reported Favorably Without Amendment",9,8,0,0,17
890192,565524,2016-12-01,House,"Reported With Recommendation Without Amendment",8,0,0,0,8
890192,566062,2016-12-07,House,"House Third Reading: Passed Roll Call # 596",101,6,0,0,107
890198,565513,2016-11-30,House,"Reported With Recommendation Without Amendment",14,0,0,0,14
890201,565525,2016-12-01,House,"Reported With Recommendation With Substitute  H-2",8,0,0,0,8
890201,566087,2016-12-07,House,"House Third Reading: Passed Roll Call # 597",99,8,0,0,107
890203,565421,2016-12-01,House,"Reported With Recommendation With Substitute  H-5",5,3,0,0,8
890203,566067,2016-12-07,House,"House Third Reading: Passed Roll Call # 595",57,50,0,0,107
890275,565719,2016-12-06,House,"Reported With Recommendation Without Amendment",10,1,0,0,11
890275,565937,2016-12-08,House,"House Third Reading: Passed Roll Call # 608",107,0,0,0,107
890275,566392,2016-12-14,Senate,"Reported Favorably Without Amendment",4,1,0,0,5
890275,566393,2016-12-14,Senate,"Senate Third Reading: Passed Roll Call # 788",37,0,0,1,38
890353,565971,2016-12-08,Senate,"Senate Third Reading: Passed Roll Call # 720",27,10,0,1,38
890353,566206,2016-12-13,House,"Reported With Recommendation Without Amendment",8,1,0,0,9
890353,566721,2016-12-14,House,"House Third Reading: Given Immediate Effect Roll Call # 699",69,39,0,0,108
890381,565707,2016-12-06,House,"Reported With Recommendation With Substitute  H-1",5,2,0,0,7
