bill_id,roll_call_id,date,chamber,description,yea,nay,nv,absent,total
446706,217848,2013-01-09,House,"House Third Reading:  Roll Call # 3",108,1,0,0,109
446706,382776,2013-01-09,House,"House Third Reading: Roll Call # 3",108,1,0,0,109
446722,217849,2013-01-09,House,"House Third Reading:  Roll Call # 2",109,0,0,0,109
446722,382811,2013-01-09,House,"House Third Reading: Roll Call # 2",109,0,0,0,109
446842,290071,2013-06-19,House,"Reported With Recommendation Without Amendment",15,0,0,0,15
446842,311219,2014-01-23,House,"House Third Reading: Given Immediate Effect Roll Call # 8",107,0,0,0,107
446842,323727,2014-02-18,Senate,"Reported Favorably Without Amendment",7,0,0,0,7
446842,371062,2014-06-11,Senate,"Senate Third Reading: Given Immediate Effect Roll Call # 455",38,0,0,0,38
446842,371296,2014-06-12,House,"House Third Reading:  Roll Call # 428",109,1,0,0,110
446842,382697,2014-06-12,House,"House Third Reading: Roll Call # 428",109,1,0,0,110
446858,243000,2013-03-06,House,"Reported With Recommendation With Substitute H-2",15,0,0,0,15
446858,268966,2013-04-18,House,"House Third Reading: Given Immediate Effect Roll Call # 77",107,0,0,0,107
446858,284736,2013-05-28,Senate,"Reported Favorably Without Amendment",7,0,0,0,7
446858,303216,2013-10-03,Senate,"Senate Third Reading: Given Immediate Effect Roll Call # 388",37,0,0,1,38
446858,303323,2013-10-09,House,"House Third Reading:  Roll Call # 313",108,0,0,0,108
446858,383010,2013-10-09,House,"House Third Reading: Roll Call # 313",108,0,0,0,108
446875,304419,2013-11-13,House,"Reported With Recommendation With Substitute H-4",6,0,0,0,6
446875,338626,2013-11-13,House,"Reported With Recommendation With Substitute  H-4",6,0,0,0,6
446875,346569,2014-03-20,House,"House Third Reading: Given Immediate Effect Roll Call # 147",102,8,0,0,110
446875,383821,2014-12-19,Senate,"Senate Third Reading: Given Immediate Effect Roll Call # 935",30,8,0,0,38
446875,383822,2014-12-19,House,"House Third Reading: Roll Call # 810",101,9,0,0,110
456843,370920,2014-06-11,Senate,"Senate Third Reading: Defeated Roll Call # 414",14,24,0,0,38
456843,381696,2014-11-13,Senate,"Senate Third Reading: Defeated Roll Call # 657",18,19,0,1,38
456850,221845,2013-01-24,Senate,"Reported Favorably Without Amendment",3,1,0,0,4
456852,224253,2013-01-30,Senate,"Reported Favorably Without Amendment",7,0,0,0,7
456852,224778,2013-01-31,Senate,"Senate Third Reading: Passed Roll Call # 7",37,0,0,0,37
456852,240288,2013-02-21,House,"Reported With Recommendation Without Amendment",11,0,0,0,11
456852,241299,2013-02-28,House,"House Third Reading: Given Immediate Effect Roll Call # 17",92,18,0,0,110
456854,224257,2013-01-30,Senate,"Reported Favorably Without Amendment",7,0,0,0,7
456854,224784,2013-01-31,Senate,"Senate Third Reading: Passed Roll Call # 5",36,0,0,1,37
456854,240084,2013-02-21,House,"Reported With Recommendation With Substitute H-2",11,0,0,0,11
456854,241163,2013-02-28,House,"House Third Reading: Given Immediate Effect Roll Call # 16",92,18,0,0,110
456854,242040,2013-03-05,Senate,"Senate Third Reading:  Roll Call # 32",36,0,0,1,37
456854,383003,2013-03-05,Senate,"Senate Third Reading: Roll Call # 32",36,0,0,1,37
456858,221851,2013-01-24,Senate,"Reported Favorably With Substitute S-2",4,0,0,0,4
456858,221852,2013-01-24,Senate,"Senate Third Reading: Passed Roll Call # 2",31,5,0,1,37
456858,230827,2013-02-12,House,"Reported With Recommendation Without Amendment",9,0,0,0,9
456858,241820,2013-02-21,House,"House Third Reading: Given Immediate Effect Roll Call # 10",75,34,0,0,109
456861,227092,2013-02-05,Senate,"Reported Favorably With Substitute S-1",7,0,0,0,7
456861,230855,2013-02-12,Senate,"Senate Third Reading: Passed Roll Call # 21",36,0,0,1,37
456861,360940,2014-04-29,House,"Reported With Recommendation With Substitute  H-1",9,0,0,0,9
456861,366592,2014-05-22,House,"House Third Reading: Given Immediate Effect Roll Call # 277",107,3,0,0,110
456861,367655,2014-05-27,Senate,"Senate Third Reading:  Roll Call # 312",35,0,0,3,38
456861,382886,2014-05-27,Senate,"Senate Third Reading: Roll Call # 312",35,0,0,3,38
456863,227082,2013-02-05,Senate,"Reported Favorably With Substitute S-1",7,0,0,0,7
456863,230850,2013-02-12,Senate,"Senate Third Reading: Passed Roll Call # 20",36,0,0,1,37
456863,242810,2013-03-06,House,"Reported With Recommendation Without Amendment",9,0,0,0,9
456863,283452,2013-05-23,House,"House Third Reading: Given Immediate Effect Roll Call # 175",89,18,0,0,107
456866,227106,2013-02-05,Senate,"Reported Favorably With Substitute S-1",7,0,0,0,7
456866,230861,2013-02-12,Senate,"Senate Third Reading: Passed Roll Call # 19",36,0,0,1,37
456866,242567,2013-03-06,House,"Reported With Recommendation Without Amendment",9,0,0,0,9
456866,283454,2013-05-23,House,"House Third Reading: Given Immediate Effect Roll Call # 174",89,18,0,0,107
456869,227101,2013-02-05,Senate,"Reported Favorably With Substitute S-1",7,0,0,0,7
456869,230860,2013-02-12,Senate,"Senate Third Reading: Passed Roll Call # 18",36,0,0,1,37
456869,242771,2013-03-06,House,"Reported With Recommendation Without Amendment",9,0,0,0,9
456869,283412,2013-05-23,House,"House Third Reading: Given Immediate Effect Roll Call # 173",87,20,0,0,107
456869,285623,2013-05-29,Senate,"Senate Third Reading:  Roll Call # 225",36,0,0,2,38
456869,382998,2013-05-29,Senate,"Senate Third Reading: Roll Call # 225",36,0,0,2,38
456872,227108,2013-02-05,Senate,"Reported Favorably With Substitute S-1",7,0,0,0,7
456872,229937,2013-02-12,Senate,"Senate Third Reading: Passed Roll Call # 17",36,0,0,1,37
456872,242821,2013-03-06,House,"Reported With Recommendation Without Amendment",9,0,0,0,9
456872,283362,2013-05-23,House,"House Third Reading: Given Immediate Effect Roll Call # 172",80,27,0,0,107
456874,227118,2013-02-05,Senate,"Reported Favorably With Substitute S-1",7,0,0,0,7
456874,229938,2013-02-12,Senate,"Senate Third Reading: Passed Roll Call # 16",35,0,0,2,37
456874,242829,2013-03-06,House,"Reported With Recommendation Without Amendment",9,0,0,0,9
456874,283372,2013-05-23,House,"House Third Reading: Given Immediate Effect Roll Call # 171",82,25,0,0,107
456877,227121,2013-02-05,Senate,"Reported Favorably With Substitute S-1",7,0,0,0,7
456877,229941,2013-02-12,Senate,"Senate Third Reading: Passed Roll Call # 15",35,0,0,2,37
456880,227130,2013-02-05,Senate,"Reported Favorably With Substitute S-2",7,0,0,0,7
456880,229949,2013-02-12,Senate,"Senate Third Reading: Passed Roll Call # 14",35,0,0,2,37
456880,382086,2014-12-02,House,"Reported With Recommendation For Referral To Committee On Appropriations",9,0,0,0,9
456880,382345,2014-12-03,House,"Reported With Recommendation With Substitute  H-1",10,5,0,0,15
456883,226151,2013-02-05,Senate,"Reported Favorably With Substitute S-1",7,0,0,0,7
456883,229957,2013-02-12,Senate,"Senate Third Reading: Passed Roll Call # 13",35,0,0,2,37
456883,242817,2013-03-06,House,"Reported With Recommendation Without Amendment",9,0,0,0,9
456883,283436,2013-05-23,House,"House Third Reading: Given Immediate Effect Roll Call # 170",79,28,0,0,107
456883,285631,2013-05-29,Senate,"Senate Third Reading:  Roll Call # 224",36,0,0,2,38
456883,382995,2013-05-29,Senate,"Senate Third Reading: Roll Call # 224",36,0,0,2,38
456885,288608,2013-06-12,Senate,"Reported Favorably With Substitute S-1",5,2,0,0,7
456885,288929,2013-06-13,Senate,"Senate Third Reading: Passed Roll Call # 270",27,11,0,0,38
456885,289755,2013-06-18,House,"Reported With Recommendation With Substitute H-1",7,0,0,0,7
456885,299786,2013-09-12,House,"House Third Reading: Given Immediate Effect Roll Call # 275",80,28,0,0,108
456885,301169,2013-09-18,Senate,"Senate Third Reading:  Roll Call # 355",26,9,0,3,38
456885,383005,2013-09-18,Senate,"Senate Third Reading: Roll Call # 355",26,9,0,3,38
456888,221875,2013-01-24,Senate,"Reported Favorably Without Amendment",4,0,0,0,4
456888,359697,2014-04-24,Senate,"Senate Third Reading: Passed Roll Call # 196",36,2,0,0,38
456888,363459,2014-05-08,House,"Reported With Recommendation With Substitute  H-1",7,3,0,0,10
456888,370104,2014-06-05,House,"House Third Reading: Given Immediate Effect Roll Call # 351",80,28,0,0,108
456888,370695,2014-06-10,Senate,"Senate Third Reading:  Roll Call # 395",35,2,0,1,38
456888,382924,2014-06-10,Senate,"Senate Third Reading: Roll Call # 395",35,2,0,1,38
456891,226160,2013-02-05,Senate,"Reported Favorably Without Amendment",4,1,0,0,5
456891,231940,2013-02-14,Senate,"Senate Third Reading: Passed Roll Call # 23",26,9,0,2,37
456891,242578,2013-02-20,House,"Reported With Recommendation Without Amendment",13,0,0,0,13
456891,243307,2013-03-07,House,"House Third Reading: Given Immediate Effect Roll Call # 23",56,52,0,0,108
456891,247742,2013-03-12,Senate,"Senate Third Reading: House Amendment(s) Concurred In Roll Call # 44",26,8,0,3,37
456903,221884,2013-01-24,Senate,"Reported Favorably Without Amendment",4,0,0,0,4
456903,223549,2013-01-29,Senate,"Senate Third Reading: Passed Roll Call # 3",37,0,0,0,37
456903,227838,2013-02-06,House,"Reported With Recommendation With Amendment(s)",7,1,0,0,8
456903,241118,2013-02-27,Senate,"Senate Third Reading: House Amendment(s) Concurred In Roll Call # 29",36,0,0,1,37
456903,241981,2013-02-19,House,"House Third Reading: Given Immediate Effect Roll Call # 7",106,3,0,0,109
456905,221890,2013-01-24,Senate,"Reported Favorably Without Amendment",4,0,0,0,4
456905,230863,2013-02-13,Senate,"Senate Third Reading: Passed Roll Call # 22",35,0,0,2,37
456905,263807,2013-04-11,House,"Reported With Recommendation Without Amendment",11,0,0,0,11
456905,272400,2013-04-25,House,"House Third Reading: Passed Roll Call # 94",108,0,0,0,108
456905,274922,2013-05-01,Senate,"Senate Third Reading:  Roll Call # 149",37,0,0,0,37
456905,382897,2013-05-01,Senate,"Senate Third Reading: Roll Call # 149",37,0,0,0,37
456916,243888,2013-03-07,Senate,"Reported Favorably Without Amendment",3,0,0,0,3
456916,268774,2013-04-18,Senate,"Senate Third Reading: Passed Roll Call # 84",35,1,0,1,37
456916,303979,2013-11-05,House,"Reported With Recommendation Without Amendment",12,0,0,0,12
456916,304506,2013-11-14,House,"House Third Reading: Passed Roll Call # 429",106,4,0,0,110
456916,304507,2013-11-14,House,"House Third Reading: Passed Roll Call # 431",103,7,0,0,110
456916,305022,2013-12-05,Senate,"Senate Third Reading: House Amendment(s) Concurred In Roll Call # 558",35,1,0,2,38
456919,243884,2013-03-07,Senate,"Reported Favorably Without Amendment",3,0,0,0,3
456919,268951,2013-04-18,Senate,"Senate Third Reading: Passed Roll Call # 83",35,1,0,1,37
456919,304017,2013-11-05,House,"Reported With Recommendation Without Amendment",12,0,0,0,12
456919,304468,2013-11-14,House,"House Third Reading: Passed Roll Call # 428",95,15,0,0,110
456921,243365,2013-03-07,Senate,"Reported Favorably With Substitute S-1",3,0,0,0,3
456921,268647,2013-04-18,Senate,"Senate Third Reading: Passed Roll Call # 82",35,1,0,1,37
456921,304018,2013-11-05,House,"Reported With Recommendation With Substitute H-1",12,0,0,0,12
456921,304502,2013-11-14,House,"House Third Reading: Passed Roll Call # 427",106,4,0,0,110
456921,305012,2013-12-05,Senate,"Senate Third Reading:  Roll Call # 557",35,1,0,2,38
456921,382656,2013-12-05,Senate,"Senate Third Reading: Roll Call # 557",35,1,0,2,38
456925,243383,2013-03-07,Senate,"Reported Favorably With Substitute S-1",3,0,0,0,3
456925,268748,2013-04-18,Senate,"Senate Third Reading: Passed Roll Call # 81",35,1,1,0,37
456925,303999,2013-11-05,House,"Reported With Recommendation With Substitute H-1",12,0,0,0,12
456925,304499,2013-11-14,House,"House Third Reading: Passed Roll Call # 426",106,4,0,0,110
456925,305016,2013-12-05,Senate,"Senate Third Reading:  Roll Call # 556",35,1,0,2,38
456925,382635,2013-12-05,Senate,"Senate Third Reading: Roll Call # 556",35,1,0,2,38
456927,243385,2013-03-07,Senate,"Reported Favorably With Substitute S-1",3,0,0,0,3
456927,268789,2013-04-18,Senate,"Senate Third Reading: Passed Roll Call # 80",35,1,1,0,37
456927,303967,2013-11-05,House,"Reported With Recommendation With Substitute H-1",12,0,0,0,12
456927,304492,2013-11-14,House,"House Third Reading: Passed Roll Call # 425",105,5,0,0,110
456927,305013,2013-12-05,Senate,"Senate Third Reading:  Roll Call # 555",35,1,0,2,38
456927,382660,2013-12-05,Senate,"Senate Third Reading: Roll Call # 555",35,1,0,2,38
456936,248866,2013-03-13,Senate,"Reported Favorably Without Amendment",4,0,0,0,4
456936,251948,2013-03-20,Senate,"Senate Third Reading: Passed Roll Call # 58",37,0,0,0,37
456936,305118,2013-12-10,House,"Reported With Recommendation Without Amendment",15,0,0,0,15
456936,312844,2014-01-28,House,"House Third Reading: Given Immediate Effect Roll Call # 19",108,0,0,0,108
456938,242679,2013-03-06,Senate,"Reported Favorably With Recommendation For Referral To Committee On Judiciary",7,0,0,0,7
456938,248680,2013-03-13,Senate,"Reported Favorably Without Amendment",4,0,0,0,4
456938,251882,2013-03-20,Senate,"Senate Third Reading: Passed Roll Call # 57",37,0,0,0,37
456938,305105,2013-12-10,House,"Reported With Recommendation Without Amendment",15,0,0,0,15
456938,312691,2014-01-28,House,"House Third Reading: Given Immediate Effect Roll Call # 18",108,0,0,0,108
456943,241853,2013-02-26,Senate,"Reported Favorably Without Amendment",6,0,0,0,6
456943,274895,2013-05-01,Senate,"Senate Third Reading: Passed Roll Call # 150",36,1,0,0,37
456943,339807,2014-03-11,House,"Reported With Recommendation With Amendment(s)",12,2,0,0,14
456949,271086,2013-04-23,Senate,"Reported Favorably With Substitute S-1",7,0,0,0,7
456949,276914,2013-05-07,Senate,"Senate Third Reading: Passed Roll Call # 158",37,0,0,0,37
456949,281937,2013-05-21,House,"Reported With Recommendation Without Amendment",12,1,0,0,13
456949,288106,2013-06-11,House,"House Third Reading: Given Immediate Effect Roll Call # 212",101,7,0,0,108
456949,288483,2013-06-12,Senate,"Senate Third Reading:  Roll Call # 247",37,0,0,1,38
456949,383051,2013-06-12,Senate,"Senate Third Reading: Roll Call # 247",37,0,0,1,38
456954,261890,2013-04-09,Senate,"Reported Favorably Without Amendment",5,1,0,0,6
456954,275721,2013-05-02,Senate,"Senate Third Reading: Passed Roll Call # 155",35,0,0,2,37
456954,302819,2013-09-25,House,"Reported With Recommendation Without Amendment",14,0,0,0,14
456954,303222,2013-10-03,House,"House Third Reading: Given Immediate Effect Roll Call # 312",102,6,0,0,108
456963,303994,2013-11-05,Senate,"Reported Favorably With Substitute S-2",5,2,0,0,7
456963,304320,2013-11-12,Senate,"Senate Third Reading: Passed Roll Call # 510",36,2,0,0,38
456965,303998,2013-11-05,Senate,"Reported Favorably With Substitute S-2",3,0,0,0,3
456965,304342,2013-11-12,Senate,"Senate Third Reading: Passed Roll Call # 509",36,2,0,0,38
456969,271138,2013-04-23,Senate,"Reported Favorably Without Amendment",6,0,0,0,6
456969,290308,2013-06-20,Senate,"Senate Third Reading: Passed Roll Call # 324",38,0,0,0,38
456969,369702,2014-06-03,House,"Reported With Recommendation With Substitute  H-1",9,0,0,0,9
456969,370986,2014-06-11,House,"House Third Reading: Given Immediate Effect Roll Call # 405",110,0,0,0,110
456969,370987,2014-06-11,Senate,"Senate Third Reading:  Roll Call # 459",38,0,0,0,38
456969,382906,2014-06-11,Senate,"Senate Third Reading: Roll Call # 459",38,0,0,0,38
456972,230257,2013-02-12,Senate,"Reported Favorably Without Amendment",5,0,0,0,5
456972,242156,2013-02-20,Senate,"Senate Third Reading: Passed Roll Call # 26",36,0,0,1,37
456972,242879,2013-03-06,House,"Reported With Recommendation Without Amendment",8,0,0,0,8
456972,252072,2013-03-20,House,"House Third Reading: Given Immediate Effect Roll Call # 49",109,1,0,0,110
456980,230306,2013-02-12,Senate,"Reported Favorably Without Amendment",5,0,0,0,5
456980,242686,2013-02-14,Senate,"Senate Third Reading: Passed Roll Call # 24",35,0,0,2,37
456980,275231,2013-05-01,House,"Reported With Recommendation Without Amendment",8,0,0,0,8
456980,279429,2013-05-14,House,"House Third Reading: Given Immediate Effect Roll Call # 125",107,0,0,0,107
457002,224552,2013-01-31,Senate,"Reported Favorably With Substitute S-1",4,0,0,0,4
457002,226825,2013-02-05,Senate,"Senate Third Reading: Passed Roll Call # 9",35,1,0,1,37
457002,278103,2013-05-09,House,"Reported With Recommendation With Substitute H-1",12,0,0,0,12
457002,339334,2013-05-09,House,"Reported With Recommendation With Substitute  H-1",12,0,0,0,12
457005,224573,2013-01-31,Senate,"Reported Favorably With Substitute S-1",4,0,0,0,4
457005,226833,2013-02-05,Senate,"Senate Third Reading: Passed Roll Call # 8",35,1,0,1,37
457005,278067,2013-05-09,House,"Reported With Recommendation With Substitute H-1",12,0,0,0,12
457005,339037,2013-05-09,House,"Reported With Recommendation With Substitute  H-1",12,0,0,0,12
457007,366326,2014-05-21,Senate,"Reported Favorably With Substitute S-1",7,0,0,0,7
457007,370099,2014-06-05,Senate,"Senate Third Reading: Passed Roll Call # 388",37,0,0,1,38
457018,268862,2013-04-18,Senate,"Reported Favorably With Substitute S-1",6,1,0,0,7
457018,304389,2013-11-13,Senate,"Senate Third Reading: Passed Roll Call # 526",20,18,0,0,38
465335,279350,2013-05-14,House,"Reported With Recommendation Without Amendment",15,0,0,0,15
465335,282650,2013-05-22,House,"House Third Reading: Given Immediate Effect Roll Call # 163",108,0,0,0,108
465335,332121,2014-02-27,Senate,"Senate Third Reading: Given Immediate Effect Roll Call # 57",36,0,0,2,38
465378,231804,2013-02-13,House,"Reported With Recommendation Without Amendment",15,0,0,0,15
465378,263037,2013-04-10,House,"House Third Reading: Given Immediate Effect Roll Call # 73",108,1,0,0,109
465378,288508,2013-06-12,Senate,"Senate Third Reading: Given Immediate Effect Roll Call # 251",37,0,0,1,38
465378,288509,2013-06-12,House,"House Third Reading:  Roll Call # 220",107,1,0,0,108
465378,382641,2013-06-12,House,"House Third Reading: Roll Call # 220",107,1,0,0,108
465387,231796,2013-02-13,House,"Reported With Recommendation Without Amendment",15,0,0,0,15
465387,262705,2013-04-10,House,"House Third Reading: Given Immediate Effect Roll Call # 72",108,1,0,0,109
465387,288506,2013-06-12,Senate,"Senate Third Reading: Given Immediate Effect Roll Call # 250",37,0,0,1,38
465400,277695,2013-05-08,House,"Reported With Recommendation Without Amendment",8,0,0,0,8
465411,231813,2013-02-13,House,"Reported With Recommendation Without Amendment",15,0,0,0,15
465411,262753,2013-04-10,House,"House Third Reading: Given Immediate Effect Roll Call # 71",108,1,0,0,109
465411,288578,2013-06-12,Senate,"Senate Third Reading: Given Immediate Effect Roll Call # 255",37,0,0,1,38
465411,288579,2013-06-12,House,"House Third Reading:  Roll Call # 219",106,2,0,0,108
465411,383131,2013-06-12,House,"House Third Reading: Roll Call # 219",106,2,0,0,108
465423,231811,2013-02-13,House,"Reported With Recommendation Without Amendment",15,0,0,0,15
465423,263111,2013-04-10,House,"House Third Reading: Given Immediate Effect Roll Call # 70",108,1,0,0,109
465435,241721,2013-02-27,House,"Reported With Recommendation Without Amendment",23,0,0,0,23
465435,243818,2013-03-07,House,"House Third Reading: Given Immediate Effect Roll Call # 25",108,1,0,0,109
465435,289876,2013-06-19,Senate,"Reported Favorably With Substitute S-1",3,1,0,0,4
465435,290230,2013-06-20,Senate,"Senate Third Reading: Passed Roll Call # 328",38,0,0,0,38
465435,290231,2013-06-20,House,"House Third Reading:  Roll Call # 264",108,1,0,0,109
465435,290768,2013-06-20,Senate,"Senate Third Reading: Given Immediate Effect Roll Call # 328",38,0,0,0,38
465435,383050,2013-06-20,House,"House Third Reading: Roll Call # 264",108,1,0,0,109
465561,242606,2013-03-06,House,"Reported With Recommendation With Substitute H-1",9,0,0,0,9
465561,251476,2013-03-19,House,"House Third Reading: Given Immediate Effect Roll Call # 36",98,12,0,0,110
465561,270963,2013-04-23,Senate,"Reported Favorably Without Amendment",6,0,0,0,6
465561,280047,2013-05-14,Senate,"Senate Third Reading: Given Immediate Effect Roll Call # 166",38,0,0,0,38
465616,241302,2013-02-21,House,"Reported With Recommendation With Amendment(s)",10,0,0,0,10
465616,242869,2013-03-06,House,"House Third Reading: Given Immediate Effect Roll Call # 21",105,3,0,0,108
465616,304181,2013-11-07,Senate,"Reported Favorably With Substitute S-3",3,0,0,0,3
465616,305015,2013-12-05,Senate,"Senate Third Reading: Given Immediate Effect Roll Call # 559",36,0,0,2,38
465616,305110,2013-12-10,House,"House Third Reading:  Roll Call # 466",109,0,0,0,109
465616,382668,2013-12-10,House,"House Third Reading: Roll Call # 466",109,0,0,0,109
465729,241310,2013-02-21,House,"Reported With Recommendation With Substitute H-1",9,0,0,0,9
465729,242147,2013-03-05,House,"House Third Reading: Given Immediate Effect Roll Call # 19",107,1,0,0,108
465729,248723,2013-03-13,Senate,"Reported Favorably Without Amendment",4,0,0,0,4
465729,271651,2013-04-24,Senate,"Senate Third Reading: Given Immediate Effect Roll Call # 96",36,0,0,1,37
465729,274530,2013-04-30,House,"House Third Reading:  Roll Call # 104",107,1,0,0,108
465729,382921,2013-04-30,House,"House Third Reading: Roll Call # 104",107,1,0,0,108
465743,241311,2013-02-20,House,"Reported With Recommendation Without Amendment",18,0,0,0,18
465743,241312,2013-02-28,House,"House Third Reading: Given Immediate Effect Roll Call # 15",109,1,0,0,110
465743,252384,2013-03-21,Senate,"Reported Favorably Without Amendment",7,0,0,0,7
465743,263835,2013-04-11,Senate,"Senate Third Reading: Given Immediate Effect Roll Call # 76",37,0,0,0,37
465753,241314,2013-02-20,House,"Reported With Recommendation With Substitute H-1",18,0,0,0,18
465753,241315,2013-02-28,House,"House Third Reading: Given Immediate Effect Roll Call # 14",109,1,0,0,110
465753,252496,2013-03-21,Senate,"Reported Favorably Without Amendment",7,0,0,0,7
465753,263575,2013-04-11,Senate,"Senate Third Reading: Given Immediate Effect Roll Call # 75",37,0,0,0,37
465764,241296,2013-02-26,House,"Reported With Recommendation Without Amendment",11,1,0,0,12
465775,241329,2013-02-20,House,"Reported With Recommendation With Substitute H-2",9,0,0,0,9
465775,243611,2013-03-07,House,"House Third Reading: Given Immediate Effect Roll Call # 24",108,1,0,0,109
465775,278170,2013-05-09,Senate,"Reported Favorably Without Amendment",4,0,0,0,4
465775,282227,2013-05-21,Senate,"Senate Third Reading: Given Immediate Effect Roll Call # 200",38,0,0,0,38
465835,226188,2013-02-05,House,"Reported With Recommendation With Substitute H-1",13,0,0,0,13
465835,230924,2013-02-13,House,"House Third Reading: Given Immediate Effect Roll Call # 4",109,0,0,0,109
465835,251492,2013-03-19,Senate,"Reported Favorably Without Amendment",5,0,0,0,5
465835,262184,2013-04-09,Senate,"Senate Third Reading: Given Immediate Effect Roll Call # 71",36,0,0,1,37
465845,305138,2013-12-10,House,"Reported With Recommendation Without Amendment",12,0,0,0,12
465845,305403,2013-12-12,House,"House Third Reading: Given Immediate Effect Roll Call # 508",72,37,0,0,109
465845,334203,2014-03-04,Senate,"Reported Favorably With Substitute S-1",7,0,0,0,7
465845,337332,2014-03-04,Senate,"Reported Favorably With Substitute  S-1",7,0,0,0,7
465870,243101,2013-03-06,House,"Reported With Recommendation Without Amendment",9,0,0,0,9
465870,259899,2013-03-14,House,"House Third Reading: Given Immediate Effect Roll Call # 31",109,1,0,0,110
465870,278257,2013-05-09,Senate,"Reported Favorably Without Amendment",4,0,0,0,4
465870,281879,2013-05-21,Senate,"Senate Third Reading: Given Immediate Effect Roll Call # 199",37,1,0,0,38
465914,279357,2013-05-14,House,"Reported With Recommendation With Substitute H-1",7,2,0,0,9
465914,283361,2013-05-23,House,"House Third Reading: Given Immediate Effect Roll Call # 167",103,4,0,0,107
465914,370619,2014-06-10,Senate,"Reported Favorably Without Amendment",6,0,0,0,6
465914,382264,2014-12-03,Senate,"Senate Third Reading: Given Immediate Effect Roll Call # 690",38,0,0,0,38
465928,241803,2013-02-20,House,"Reported With Recommendation With Substitute H-2",12,0,0,0,12
465928,241804,2013-02-28,House,"House Third Reading: Passed Roll Call # 12",110,0,0,0,110
465928,248885,2013-03-13,Senate,"Reported Favorably Without Amendment",5,0,0,0,5
465928,274935,2013-05-01,Senate,"Senate Third Reading: Given Immediate Effect Roll Call # 151",37,0,0,0,37
466052,248829,2013-03-13,House,"Reported With Recommendation With Substitute H-1",5,0,0,0,5
466052,262855,2013-04-10,House,"House Third Reading: Given Immediate Effect Roll Call # 74",109,0,0,0,109
466110,304391,2013-11-13,House,"Reported With Recommendation With Substitute H-2",11,0,0,0,11
466110,304987,2013-12-04,House,"House Third Reading: Passed Roll Call # 449",109,0,0,0,109
466110,363527,2014-05-08,Senate,"Reported Favorably Without Amendment",3,0,0,0,3
466110,380397,2014-10-02,Senate,"Senate Third Reading: Given Immediate Effect Roll Call # 609",36,0,2,0,38
466110,380398,2014-10-02,Senate,"Senate Third Reading: Passed Roll Call # 610",38,0,0,0,38
466110,380399,2014-10-02,House,"House Third Reading:  Roll Call # 552",107,0,0,0,107
466110,383099,2014-10-02,House,"House Third Reading: Roll Call # 552",107,0,0,0,107
466198,277096,2013-05-07,House,"Reported With Recommendation With Substitute H-3",11,0,0,0,11
466198,338682,2013-05-07,House,"Reported With Recommendation With Substitute  H-3",11,0,0,0,11
467181,231615,2013-02-13,Senate,"Reported Favorably Without Amendment",8,1,0,0,9
467181,241283,2013-02-19,Senate,"Senate Third Reading:  Roll Call # 25",35,1,0,1,37
467181,241284,2013-02-26,House,"Reported With Recommendation Without Amendment",18,0,0,0,18
467241,305390,2013-12-12,Senate,"Reported Favorably With Substitute S-2",4,0,0,0,4
467241,365912,2013-12-12,Senate,"Reported Favorably With Substitute  S-2",4,0,0,0,4
467241,368240,2014-05-28,Senate,"Senate Third Reading: Passed Roll Call # 323",36,0,0,2,38
467241,369874,2014-06-04,House,"Reported With Recommendation Without Amendment",17,0,0,0,17
467241,371294,2014-06-12,House,"House Third Reading: Passed Roll Call # 445",110,0,0,0,110
467241,380109,2014-09-23,Senate,"Senate Third Reading: House Amendment(s) Concurred In Roll Call # 545",38,0,0,0,38
467273,226536,2013-02-05,Senate,"Reported Favorably With Substitute S-2",7,0,0,0,7
467273,227381,2013-02-06,Senate,"Senate Third Reading: Passed Roll Call # 10",36,0,0,1,37
467273,248870,2013-03-13,House,"Reported With Recommendation Without Amendment",15,0,0,0,15
467273,252101,2013-03-20,House,"House Third Reading: Given Immediate Effect Roll Call # 48",107,3,0,0,110
467303,279610,2013-05-14,Senate,"Reported Favorably Without Amendment",7,0,0,0,7
467303,282664,2013-05-22,Senate,"Senate Third Reading: Passed Roll Call # 204",37,0,0,1,38
467303,288486,2013-06-12,House,"Reported With Recommendation Without Amendment",14,0,0,0,14
467303,305379,2013-12-12,House,"House Third Reading: Given Immediate Effect Roll Call # 534",109,0,0,0,109
467303,305380,2013-12-12,Senate,"Senate Third Reading:  Roll Call # 669",37,0,0,1,38
467303,382642,2013-12-12,Senate,"Senate Third Reading: Roll Call # 669",37,0,0,1,38
467396,249086,2013-03-12,House,"Reported With Recommendation Without Amendment",13,0,0,0,13
467551,240191,2013-02-20,House,"Reported With Recommendation With Substitute H-1",10,0,0,0,10
467551,251900,2013-03-20,House,"House Third Reading: Given Immediate Effect Roll Call # 46",110,0,0,0,110
467551,263485,2013-04-10,Senate,"Reported Favorably Without Amendment",4,0,0,0,4
467551,271724,2013-04-24,Senate,"Senate Third Reading: Given Immediate Effect Roll Call # 97",36,0,0,1,37
467585,241280,2013-02-26,House,"Reported With Recommendation Without Amendment",11,1,0,0,12
470581,224392,2013-01-31,Senate,"Reported Favorably Without Amendment",4,0,0,0,4
470644,275708,2013-05-02,Senate,"Reported Favorably With Substitute S-2",4,0,0,0,4
470644,303071,2013-10-01,Senate,"Senate Third Reading: Passed Roll Call # 380",37,0,0,1,38
470644,383436,2014-12-17,House,"Reported With Recommendation Without Amendment",16,0,0,0,16
470644,383677,2014-12-19,House,"House Third Reading: Given Immediate Effect Roll Call # 796",110,0,0,0,110
470644,383831,2014-12-19,Senate,"Senate Third Reading: House Amendment(s) Concurred In Roll Call # 927",34,4,0,0,38
470674,275676,2013-05-02,Senate,"Reported Favorably With Substitute S-3",4,0,0,0,4
470674,303069,2013-10-01,Senate,"Senate Third Reading: Passed Roll Call # 379",37,0,0,1,38
470674,383338,2014-12-17,House,"Reported With Recommendation With Substitute H-2",16,0,0,0,16
470674,383686,2014-12-19,House,"House Third Reading: Passed Roll Call # 784",102,8,0,0,110
470674,383818,2014-12-19,Senate,"Senate Third Reading: House Amendment(s) Concurred In Roll Call # 931",26,11,1,0,38
470708,271288,2013-04-23,Senate,"Reported Favorably With Substitute S-6",7,0,0,0,7
470708,276846,2013-05-07,Senate,"Senate Third Reading: Passed Roll Call # 159",37,0,0,0,37
470708,281924,2013-05-21,House,"Reported With Recommendation Without Amendment",12,0,0,0,12
470708,288099,2013-06-11,House,"House Third Reading: Given Immediate Effect Roll Call # 213",102,6,0,0,108
470708,288477,2013-06-12,Senate,"Senate Third Reading: House Amendment(s) Concurred In Roll Call # 248",37,0,0,1,38
470737,241151,2013-02-26,Senate,"Reported Favorably With Substitute S-1",5,1,0,0,6
470737,242017,2013-03-05,Senate,"Senate Third Reading: Passed Roll Call # 37",26,11,0,0,37
470737,382555,2014-12-09,House,"Reported With Recommendation Without Amendment",6,0,0,0,6
470737,383429,2014-12-18,House,"House Third Reading: Given Immediate Effect Roll Call # 724",59,50,0,0,109
470768,267908,2013-04-17,Senate,"Reported Favorably With Substitute S-1",3,0,0,0,3
470768,302817,2013-09-25,Senate,"Senate Third Reading: Passed Roll Call # 371",37,0,0,1,38
470768,304979,2013-12-04,House,"Reported With Recommendation Without Amendment",7,3,0,0,10
470799,267529,2013-04-17,Senate,"Reported Favorably With Substitute S-3",3,0,0,0,3
470799,302809,2013-09-25,Senate,"Senate Third Reading: Passed Roll Call # 370",37,0,0,1,38
470799,304960,2013-12-04,House,"Reported With Recommendation With Substitute H-1",7,3,0,0,10
470799,338591,2013-12-04,House,"Reported With Recommendation With Substitute  H-1",7,3,0,0,10
470864,287489,2013-06-06,Senate,"Reported Favorably With Recommendation For Referral To Committee On Judiciary",3,0,0,0,3
470864,303315,2013-10-09,Senate,"Reported Favorably With Substitute S-1",3,0,0,0,3
470864,337493,2013-10-09,Senate,"Reported Favorably With Substitute  S-1",3,0,0,0,3
470864,382542,2014-12-09,Senate,"Senate Third Reading: Passed Roll Call # 733",30,7,0,1,38
470864,383691,2014-12-19,House,"House Third Reading: Passed Roll Call # 805",65,45,0,0,110
471055,303821,2013-10-29,Senate,"Reported Favorably With Substitute S-2",6,0,0,0,6
471055,303992,2013-11-05,Senate,"Senate Third Reading: Passed Roll Call # 487",36,1,0,1,38
471055,304899,2013-12-03,House,"Reported With Recommendation Without Amendment",9,0,0,0,9
471055,305262,2013-12-11,House,"House Third Reading: Given Immediate Effect Roll Call # 482",108,0,0,0,108
471753,288205,2013-06-11,House,"Reported With Recommendation With Substitute H-1",15,0,0,0,15
471753,338628,2013-06-11,House,"Reported With Recommendation With Substitute  H-1",15,0,0,0,15
471753,382676,2014-12-10,House,"House Third Reading: Passed Roll Call # 649",107,1,0,0,108
472551,241266,2013-02-21,House,"Reported With Recommendation With Substitute H-1",9,0,0,0,9
472551,243595,2013-03-07,House,"House Third Reading: Given Immediate Effect Roll Call # 22",108,0,0,0,108
472551,288334,2013-06-11,Senate,"Reported Favorably Without Amendment",5,0,0,0,5
472551,299829,2013-09-12,Senate,"Senate Third Reading: Given Immediate Effect Roll Call # 345",36,0,0,2,38
477452,226388,2013-02-05,Senate,"Reported Favorably With Substitute S-1",7,0,0,0,7
477452,227285,2013-02-06,Senate,"Senate Third Reading: Passed Roll Call # 11",34,2,0,1,37
477452,285150,2013-05-29,House,"Reported With Recommendation Without Amendment",13,0,0,0,13
477452,303654,2013-10-22,House,"House Third Reading: Given Immediate Effect Roll Call # 345",99,9,0,0,108
477452,303768,2013-10-23,Senate,"Senate Third Reading:  Roll Call # 439",38,0,0,0,38
477452,382880,2013-10-23,Senate,"Senate Third Reading: Roll Call # 439",38,0,0,0,38
477474,226386,2013-02-05,Senate,"Reported Favorably With Substitute S-1",7,0,0,0,7
477474,227284,2013-02-06,Senate,"Senate Third Reading: Passed Roll Call # 12",36,0,0,1,37
477474,285189,2013-05-29,House,"Reported With Recommendation Without Amendment",13,0,0,0,13
477474,304953,2013-12-04,House,"Reported With Recommendation With Substitute H-2",15,0,0,0,15
477474,305313,2013-12-11,House,"House Third Reading: Given Immediate Effect Roll Call # 473",102,7,0,0,109
477474,305314,2013-12-11,Senate,"Senate Third Reading:  Roll Call # 601",38,0,0,0,38
477474,383072,2013-12-11,Senate,"Senate Third Reading: Roll Call # 601",38,0,0,0,38
477516,251007,2013-03-19,Senate,"Reported Favorably With Substitute S-4",7,0,0,0,7
477516,262228,2013-04-09,Senate,"Senate Third Reading: Passed Roll Call # 70",35,1,0,1,37
477516,288084,2013-06-11,House,"Reported With Recommendation With Substitute H-1",15,0,0,0,15
477516,338955,2013-06-11,House,"Reported With Recommendation With Substitute  H-1",15,0,0,0,15
477516,378831,2014-08-27,House,"House Third Reading: Given Immediate Effect Roll Call # 448",101,7,0,0,108
477516,379359,2014-09-10,Senate,"Senate Third Reading:  Roll Call # 536",36,2,0,0,38
477516,382914,2014-09-10,Senate,"Senate Third Reading: Roll Call # 536",36,2,0,0,38
477540,380326,2014-10-01,Senate,"Reported Favorably With Substitute S-2",7,0,0,0,7
477540,381520,2014-11-06,Senate,"Senate Third Reading: Passed Roll Call # 648",37,0,0,1,38
477540,382718,2014-12-09,House,"Reported With Recommendation Without Amendment",14,0,0,0,14
477540,383591,2014-12-18,House,"House Third Reading: Passed Roll Call # 721",108,0,0,0,108
477540,383753,2014-12-18,Senate,"Senate Third Reading: Roll Call # 893",38,0,0,0,38
477564,240127,2013-02-27,Senate,"Reported Favorably With Substitute S-1",4,0,0,0,4
477564,242506,2013-03-06,Senate,"Senate Third Reading: Passed Roll Call # 40",37,0,0,0,37
477564,304385,2013-11-13,House,"Reported With Recommendation With Substitute H-1",6,0,0,0,6
477564,305106,2013-12-10,House,"House Third Reading: Given Immediate Effect Roll Call # 469",109,0,0,0,109
477564,305230,2013-12-11,Senate,"Senate Third Reading:  Roll Call # 572",35,0,0,3,38
477564,383006,2013-12-11,Senate,"Senate Third Reading: Roll Call # 572",35,0,0,3,38
477630,231419,2013-02-13,Senate,"Reported Favorably Without Amendment",7,0,0,0,7
477630,242637,2013-02-20,Senate,"Senate Third Reading: Passed Roll Call # 27",35,1,0,1,37
477630,262046,2013-04-09,House,"Reported With Recommendation With Substitute H-2",15,0,0,0,15
477630,274488,2013-04-30,House,"House Third Reading: Given Immediate Effect Roll Call # 105",92,16,0,0,108
477630,276904,2013-05-07,Senate,"Senate Third Reading:  Roll Call # 156",37,0,0,0,37
477630,382922,2013-05-07,Senate,"Senate Third Reading: Roll Call # 156",37,0,0,0,37
477653,305229,2013-12-11,Senate,"Reported Favorably With Substitute S-1",3,0,0,0,3
477653,336801,2013-12-11,Senate,"Reported Favorably With Substitute  S-1",3,0,0,0,3
477717,305020,2013-12-05,Senate,"Senate Third Reading: Passed Roll Call # 561",37,0,0,1,38
477717,305114,2013-12-10,House,"Reported With Recommendation Without Amendment",14,0,0,0,14
477717,305342,2013-12-12,House,"House Third Reading: Passed Roll Call # 497",109,0,0,0,109
477782,281916,2013-05-21,Senate,"Reported Favorably With Substitute S-3",7,0,0,0,7
477804,288418,2013-06-12,Senate,"Reported Favorably With Substitute S-1",4,0,0,0,4
477804,337506,2013-06-12,Senate,"Reported Favorably With Substitute  S-1",4,0,0,0,4
477804,370642,2014-06-10,Senate,"Senate Third Reading: Passed Roll Call # 396",37,0,0,1,38
477804,382855,2014-12-11,House,"Reported With Recommendation Without Amendment",10,0,0,0,10
477804,383597,2014-12-18,House,"House Third Reading: Passed Roll Call # 735",92,17,0,0,109
477827,288449,2013-06-12,Senate,"Reported Favorably Without Amendment",4,0,0,0,4
477827,370643,2014-06-10,Senate,"Senate Third Reading: Passed Roll Call # 397",37,0,0,1,38
477827,382792,2014-12-11,House,"Reported With Recommendation Without Amendment",10,0,0,0,10
477827,383589,2014-12-18,House,"House Third Reading: Passed Roll Call # 737",92,17,0,0,109
477846,288448,2013-06-12,Senate,"Reported Favorably Without Amendment",4,0,0,0,4
477846,370646,2014-06-10,Senate,"Senate Third Reading: Passed Roll Call # 398",37,0,0,1,38
477846,382850,2014-12-11,House,"Reported With Recommendation Without Amendment",10,0,0,0,10
477846,383417,2014-12-18,House,"House Third Reading: Passed Roll Call # 738",92,17,0,0,109
477868,243059,2013-03-06,Senate,"Reported Favorably Without Amendment",7,0,0,0,7
477868,248862,2013-03-13,Senate,"Senate Third Reading: Passed Roll Call # 45",36,0,0,1,37
477868,262646,2013-04-09,House,"Reported With Recommendation Without Amendment",15,0,0,0,15
477868,268981,2013-04-18,House,"House Third Reading: Given Immediate Effect Roll Call # 85",109,0,0,0,109
477931,240177,2013-02-20,House,"Reported With Recommendation With Amendment(s)",10,0,0,0,10
477931,251921,2013-03-20,House,"House Third Reading: Given Immediate Effect Roll Call # 47",110,0,0,0,110
477931,262968,2013-04-10,Senate,"Reported Favorably Without Amendment",4,0,0,0,4
477931,271625,2013-04-24,Senate,"Senate Third Reading: Given Immediate Effect Roll Call # 98",36,0,0,1,37
478013,240194,2013-02-20,House,"Reported With Recommendation With Substitute H-1",9,1,0,0,10
478013,252575,2013-03-21,House,"House Third Reading: Given Immediate Effect Roll Call # 64",109,1,0,0,110
478013,275818,2013-05-01,Senate,"Reported Favorably With Substitute S-1",4,0,0,0,4
478013,281904,2013-05-21,Senate,"Senate Third Reading: Given Immediate Effect Roll Call # 197",38,0,0,0,38
478013,284769,2013-05-28,House,"House Third Reading:  Roll Call # 176",107,1,0,0,108
478013,382997,2013-05-28,House,"House Third Reading: Roll Call # 176",107,1,0,0,108
478031,252056,2013-03-20,House,"Reported With Recommendation Without Amendment",11,5,0,0,16
478031,268677,2013-04-18,House,"House Third Reading: Given Immediate Effect Roll Call # 79",59,48,0,0,107
478054,230460,2013-02-12,House,"Reported With Recommendation Without Amendment",15,0,0,0,15
478054,242573,2013-02-20,House,"House Third Reading: Given Immediate Effect Roll Call # 8",110,0,0,0,110
478054,305115,2013-12-10,Senate,"Reported Favorably Without Amendment",8,0,0,0,8
478054,305364,2013-12-12,Senate,"Senate Third Reading: Given Immediate Effect Roll Call # 626",38,0,0,0,38
478100,241143,2013-02-21,House,"Reported With Recommendation With Amendment(s)",10,0,0,0,10
478100,242214,2013-03-05,House,"House Third Reading: Given Immediate Effect Roll Call # 20",103,5,0,0,108
478100,251586,2013-03-20,Senate,"Reported Favorably Without Amendment",3,0,0,0,3
478100,263018,2013-04-10,Senate,"Senate Third Reading: Given Immediate Effect Roll Call # 72",30,5,0,2,37
478143,242577,2013-03-06,House,"Reported With Recommendation With Substitute H-1",10,4,0,0,14
478143,303416,2013-10-15,House,"House Third Reading: Given Immediate Effect Roll Call # 323",62,44,0,0,106
478143,303906,2013-10-31,Senate,"Reported Favorably Without Amendment",6,1,0,0,7
478210,267555,2013-04-17,House,"Reported With Recommendation With Substitute H-2",6,3,0,0,9
478210,275058,2013-05-01,House,"House Third Reading: Passed Roll Call # 116",77,33,0,0,110
478210,288993,2013-06-13,Senate,"Reported Favorably With Substitute S-1",3,0,0,0,3
478210,336966,2013-06-13,Senate,"Reported Favorably With Substitute  S-1",3,0,0,0,3
478210,346572,2014-03-20,Senate,"Senate Third Reading: Passed Roll Call # 137",25,11,0,2,38
478210,382293,2014-12-03,House,"House Third Reading:  Roll Call # 597",74,35,0,0,109
478210,382564,2014-12-10,Senate,"Senate Third Reading:  Roll Call # 738",26,10,0,2,38
478210,382666,2014-12-03,House,"House Third Reading: Roll Call # 597",74,35,0,0,109
478210,382667,2014-12-10,Senate,"Senate Third Reading: Roll Call # 738",26,10,0,2,38
478339,287342,2013-06-05,House,"Reported With Recommendation With Substitute H-1",18,0,0,0,18
478339,287541,2013-06-06,House,"House Third Reading: Passed Roll Call # 211",105,2,0,0,107
478339,289983,2013-06-19,Senate,"Reported Favorably With Substitute S-1",3,1,0,0,4
478339,289984,2013-06-19,Senate,"Senate Third Reading: Given Immediate Effect Roll Call # 308",37,1,0,0,38
478339,290391,2013-06-20,Senate,"Senate Third Reading: Passed Roll Call # 322",36,1,0,1,38
478339,290392,2013-06-20,House,"House Third Reading:  Roll Call # 262",106,3,0,0,109
478339,383117,2013-06-20,House,"House Third Reading: Roll Call # 262",106,3,0,0,109
478357,241816,2013-02-27,House,"Reported With Recommendation With Substitute H-1",24,3,0,0,27
478357,241817,2013-02-28,House,"House Third Reading: Given Immediate Effect Roll Call # 11",78,31,0,0,109
478380,287297,2013-06-05,House,"Reported With Recommendation With Substitute H-2",15,0,0,0,15
479448,262198,2013-04-09,Senate,"Reported Favorably Without Amendment",7,0,0,0,7
479448,267478,2013-04-17,Senate,"Senate Third Reading: Passed Roll Call # 78",34,0,0,3,37
479448,379916,2014-09-17,House,"Reported With Recommendation With Substitute  H-1",12,0,0,0,12
479448,382415,2014-12-04,House,"House Third Reading: Passed Roll Call # 619",93,16,0,0,109
479448,383825,2014-12-19,Senate,"Senate Third Reading: Roll Call # 940",38,0,0,0,38
479464,285110,2013-05-28,Senate,"Reported Favorably Without Amendment",6,0,0,0,6
479464,288767,2013-06-13,Senate,"Senate Third Reading: Passed Roll Call # 268",37,1,0,0,38
479464,330460,2014-02-26,House,"Reported With Recommendation Without Amendment",14,0,0,0,14
479464,367600,2014-05-27,House,"House Third Reading: Given Immediate Effect Roll Call # 316",98,12,0,0,110
479464,369463,2014-06-02,Senate,"Senate Third Reading:  Roll Call # 326",37,1,0,0,38
479464,383028,2014-06-02,Senate,"Senate Third Reading: Roll Call # 326",37,1,0,0,38
479567,304511,2013-11-14,Senate,"Reported Favorably With Substitute S-1",3,1,0,0,4
479567,305216,2013-12-11,Senate,"Senate Third Reading: Passed Roll Call # 582",27,9,0,2,38
479567,345822,2014-03-19,House,"Reported With Recommendation Without Amendment",11,0,0,0,11
479586,304486,2013-11-14,Senate,"Reported Favorably With Substitute S-1",3,1,0,0,4
479586,305219,2013-12-11,Senate,"Senate Third Reading: Passed Roll Call # 583",27,10,0,1,38
479586,345743,2014-03-19,House,"Reported With Recommendation Without Amendment",12,0,0,0,12
479619,241952,2013-02-26,Senate,"Reported Favorably With Substitute S-1",6,0,0,0,6
479619,243479,2013-03-06,Senate,"Senate Third Reading: Passed Roll Call # 39",37,0,0,0,37
479619,252109,2013-03-20,House,"Reported With Recommendation Without Amendment",18,1,0,0,19
479619,263670,2013-04-11,House,"House Third Reading: Given Immediate Effect Roll Call # 76",100,10,0,0,110
479619,267790,2013-04-17,Senate,"Senate Third Reading:  Roll Call # 79",35,0,0,2,37
479619,270996,2013-04-23,House,"House Third Reading: Senate Amendment(s) Concurred In Roll Call # 89",100,10,0,0,110
479619,382892,2013-04-17,Senate,"Senate Third Reading: Roll Call # 79",35,0,0,2,37
479775,230514,2013-02-12,House,"Reported With Recommendation Without Amendment",9,0,0,0,9
479775,241292,2013-02-21,House,"House Third Reading: Given Immediate Effect Roll Call # 9",109,0,0,0,109
479775,288487,2013-06-12,Senate,"Reported Favorably With Substitute S-1",7,0,0,0,7
479775,290451,2013-06-20,Senate,"Senate Third Reading: Given Immediate Effect Roll Call # 325",38,0,0,0,38
479775,298137,2013-08-27,Senate,"Senate Third Reading: Passed Roll Call # 334",37,0,0,1,38
479775,299324,2013-09-10,House,"House Third Reading:  Roll Call # 269",108,0,0,0,108
479775,382950,2013-09-10,House,"House Third Reading: Roll Call # 269",108,0,0,0,108
479814,303918,2013-10-31,House,"Reported With Recommendation With Substitute H-1",7,1,0,0,8
479814,304283,2013-11-12,House,"House Third Reading: Given Immediate Effect Roll Call # 401",91,19,0,0,110
479814,304924,2013-12-04,Senate,"Reported Favorably Without Amendment",3,0,0,0,3
479854,304122,2013-11-07,House,"Reported With Recommendation With Amendment(s)",10,1,0,0,11
479854,304298,2013-11-12,House,"House Third Reading: Given Immediate Effect Roll Call # 403",94,16,0,0,110
479854,305019,2013-12-05,Senate,"Reported Favorably With Substitute S-2",3,0,0,0,3
479854,337525,2013-12-05,Senate,"Reported Favorably With Substitute  S-2",3,0,0,0,3
479896,263060,2013-04-10,House,"Reported With Recommendation With Substitute H-1",14,0,0,0,14
479896,338906,2013-04-10,House,"Reported With Recommendation With Substitute  H-1",14,0,0,0,14
479896,348633,2014-03-27,House,"House Third Reading: Given Immediate Effect Roll Call # 187",85,23,0,0,108
479896,363037,2014-05-07,Senate,"Reported Favorably With Substitute  S-1",6,0,0,0,6
480020,262706,2013-04-10,House,"Reported With Recommendation With Substitute H-1",6,0,0,0,6
480020,268736,2013-04-18,House,"House Third Reading: Given Immediate Effect Roll Call # 86",109,0,0,0,109
480020,280024,2013-05-15,Senate,"Reported Favorably Without Amendment",4,0,0,0,4
480061,252428,2013-03-21,House,"Reported With Recommendation Without Amendment",10,0,0,0,10
480061,263800,2013-04-11,House,"House Third Reading: Given Immediate Effect Roll Call # 75",88,22,0,0,110
480061,278271,2013-05-09,Senate,"Reported Favorably Without Amendment",4,0,0,0,4
480385,249137,2013-03-13,House,"Reported With Recommendation With Substitute H-1",10,0,0,0,10
480385,268766,2013-04-18,House,"House Third Reading: Given Immediate Effect Roll Call # 78",57,50,0,0,107
480425,378814,2014-08-27,House,"Reported With Recommendation For Referral To Committee On Michigan Competitiveness",14,0,0,0,14
481996,262234,2013-04-09,Senate,"Reported Favorably With Substitute S-1",5,1,0,0,6
481996,336798,2013-04-09,Senate,"Reported Favorably With Substitute  S-1",5,1,0,0,6
482020,231616,2013-02-13,Senate,"Reported Favorably With Substitute S-1",3,0,0,0,3
482020,241166,2013-02-21,Senate,"Senate Third Reading: Passed Roll Call # 28",32,4,0,1,37
482020,283479,2013-05-23,House,"Reported With Recommendation Without Amendment",10,0,0,0,10
482128,243825,2013-03-07,Senate,"Reported Favorably Without Amendment",3,0,0,0,3
482261,301210,2013-09-19,Senate,"Reported Favorably With Substitute S-1",4,0,0,0,4
482261,301211,2013-09-19,Senate,"Senate Third Reading: Passed Roll Call # 368",36,0,0,2,38
482261,302805,2013-09-25,House,"Reported With Recommendation Without Amendment",27,0,0,0,27
482261,302823,2013-09-26,House,"House Third Reading: Given Immediate Effect Roll Call # 305",104,2,0,0,106
482314,241679,2013-02-26,House,"Reported With Recommendation With Substitute H-3",13,0,0,0,13
482314,262780,2013-04-10,House,"House Third Reading: Given Immediate Effect Roll Call # 68",106,3,0,0,109
482342,241225,2013-02-26,House,"Reported With Recommendation Without Amendment",13,0,0,0,13
482342,263083,2013-04-10,House,"House Third Reading: Given Immediate Effect Roll Call # 69",106,3,0,0,109
482590,380126,2014-09-24,House,"Reported With Recommendation With Substitute  H-2",25,1,0,0,26
482590,381662,2014-11-13,House,"House Third Reading: Given Immediate Effect Roll Call # 579",90,17,0,0,107
482619,279574,2013-05-14,House,"Reported With Recommendation With Substitute H-2",14,1,0,0,15
482619,282871,2013-05-22,House,"House Third Reading: Given Immediate Effect Roll Call # 161",97,11,0,0,108
482619,303838,2013-10-29,Senate,"Reported Favorably With Substitute S-1",7,0,0,0,7
482619,304046,2013-11-06,Senate,"Senate Third Reading: Given Immediate Effect Roll Call # 492",37,0,0,1,38
482619,304284,2013-11-12,House,"House Third Reading:  Roll Call # 395",97,13,0,0,110
482619,382979,2013-11-12,House,"House Third Reading: Roll Call # 395",97,13,0,0,110
482645,331492,2014-02-27,House,"Reported With Recommendation With Substitute H-3",6,0,0,0,6
482645,338733,2014-02-27,House,"Reported With Recommendation With Substitute  H-3",6,0,0,0,6
482645,341962,2014-03-13,House,"House Third Reading: Given Immediate Effect Roll Call # 105",81,28,0,0,109
482645,359232,2014-04-23,Senate,"Reported Favorably With Substitute  S-2",3,0,0,0,3
482645,369843,2014-06-04,Senate,"Senate Third Reading: Given Immediate Effect Roll Call # 367",29,8,0,1,38
482645,370555,2014-06-10,House,"House Third Reading:  Roll Call # 368",81,28,0,0,109
482645,382928,2014-06-10,House,"House Third Reading: Roll Call # 368",81,28,0,0,109
482673,304956,2013-12-04,House,"Reported With Recommendation With Substitute H-1",17,0,0,0,17
482673,338797,2013-12-04,House,"Reported With Recommendation With Substitute  H-1",17,0,0,0,17
482701,226682,2013-02-05,House,"Reported With Recommendation Without Amendment",15,0,0,0,15
482701,241260,2013-02-14,House,"House Third Reading: Given Immediate Effect Roll Call # 5",108,1,0,0,109
482701,241261,2013-02-27,Senate,"Reported Favorably Without Amendment",7,0,0,0,7
482701,241262,2013-02-27,Senate,"Senate Third Reading: Given Immediate Effect Roll Call # 31",36,0,0,1,37
486345,287553,2013-06-06,Senate,"Senate Third Reading: Passed Roll Call # 234",31,0,0,7,38
486345,288273,2013-06-11,House,"House Third Reading: Given Immediate Effect Roll Call # 218",105,2,0,0,107
486345,288741,2013-06-13,Senate,"Senate Third Reading:  Roll Call # 262",38,0,0,0,38
486345,382970,2013-06-13,Senate,"Senate Third Reading: Roll Call # 262",38,0,0,0,38
486360,366392,2014-05-21,Senate,"Reported Favorably With Substitute S-1",7,0,0,0,7
486360,370085,2014-06-05,Senate,"Senate Third Reading: Passed Roll Call # 389",36,1,0,1,38
486416,303779,2013-10-24,Senate,"Senate Third Reading: Passed Roll Call # 459",32,4,0,2,38
486416,310868,2014-01-22,House,"Reported With Recommendation Without Amendment",12,1,0,0,13
486416,315502,2014-02-04,House,"House Third Reading: Given Immediate Effect Roll Call # 25",93,17,0,0,110
486472,289512,2013-06-18,Senate,"Reported Favorably With Substitute S-1",7,0,0,0,7
486472,290319,2013-06-20,Senate,"Senate Third Reading: Passed Roll Call # 321",37,0,0,1,38
486472,301171,2013-09-18,House,"Reported With Recommendation Without Amendment",10,0,0,0,10
486492,289765,2013-06-18,Senate,"Reported Favorably Without Amendment",7,0,0,0,7
486492,290240,2013-06-20,Senate,"Senate Third Reading: Passed Roll Call # 320",37,0,0,1,38
486492,301168,2013-09-18,House,"Reported With Recommendation Without Amendment",10,0,0,0,10
486679,278128,2013-05-09,House,"Reported With Recommendation With Substitute H-1",10,0,0,0,10
486679,280423,2013-05-16,House,"House Third Reading: Given Immediate Effect Roll Call # 152",106,0,0,0,106
486679,323851,2014-02-18,Senate,"Reported Favorably Without Amendment",4,0,0,0,4
486679,332106,2014-02-27,Senate,"Senate Third Reading: Given Immediate Effect Roll Call # 56",36,0,0,2,38
486702,242549,2013-03-05,House,"Reported With Recommendation Without Amendment",8,0,0,0,8
486702,260155,2013-03-14,House,"House Third Reading: Given Immediate Effect Roll Call # 27",110,0,0,0,110
486702,281929,2013-05-21,Senate,"Reported Favorably Without Amendment",3,0,0,0,3
486702,284608,2013-05-28,Senate,"Senate Third Reading: Given Immediate Effect Roll Call # 214",32,5,0,1,38
486724,241967,2013-03-05,House,"Reported With Recommendation Without Amendment",8,0,0,0,8
486724,252961,2013-03-14,House,"House Third Reading: Given Immediate Effect Roll Call # 28",110,0,0,0,110
486724,281908,2013-05-21,Senate,"Reported Favorably Without Amendment",3,0,0,0,3
486724,284783,2013-05-28,Senate,"Senate Third Reading: Given Immediate Effect Roll Call # 215",32,5,0,1,38
486747,242663,2013-03-05,House,"Reported With Recommendation With Substitute H-2",8,0,0,0,8
486747,252956,2013-03-14,House,"House Third Reading: Given Immediate Effect Roll Call # 29",110,0,0,0,110
486747,281997,2013-05-21,Senate,"Reported Favorably Without Amendment",3,0,0,0,3
486747,284687,2013-05-28,Senate,"Senate Third Reading: Given Immediate Effect Roll Call # 216",32,5,0,1,38
486747,286902,2013-06-04,House,"House Third Reading:  Roll Call # 185",109,0,0,0,109
486747,382994,2013-06-04,House,"House Third Reading: Roll Call # 185",109,0,0,0,109
486882,242708,2013-03-06,House,"Reported With Recommendation Without Amendment",10,0,0,0,10
486882,252490,2013-03-21,House,"House Third Reading: Given Immediate Effect Roll Call # 65",110,0,0,0,110
486882,271640,2013-04-24,Senate,"Reported Favorably Without Amendment",3,0,0,0,3
486882,281900,2013-05-21,Senate,"Senate Third Reading: Given Immediate Effect Roll Call # 196",37,0,0,1,38
486995,271824,2013-04-24,House,"Reported With Recommendation For Referral To Committee On Michigan Competitiveness",13,0,0,0,13
487087,279787,2013-05-15,House,"Reported With Recommendation With Substitute H-1",10,0,0,0,10
487087,338659,2013-05-15,House,"Reported With Recommendation With Substitute  H-1",10,0,0,0,10
487087,382422,2014-12-04,House,"House Third Reading: Given Immediate Effect Roll Call # 630",109,0,0,0,109
487087,383283,2014-12-17,Senate,"Reported Favorably Without Amendment",4,0,0,0,4
487087,383701,2014-12-18,Senate,"Senate Third Reading: Given Immediate Effect Roll Call # 885",38,0,0,0,38
487087,383702,2014-12-18,House,"House Third Reading: Senate Amendment(s) Concurred In Roll Call # 773",110,0,0,0,110
488070,282901,2013-05-22,Senate,"Reported Favorably With Substitute S-2",5,2,0,0,7
488070,282902,2013-05-22,Senate,"Senate Third Reading: Passed Roll Call # 213",25,12,0,1,38
488070,288158,2013-06-11,House,"Reported With Recommendation With Substitute H-3",6,3,0,0,9
488070,288552,2013-06-12,House,"House Third Reading: Given Immediate Effect Roll Call # 223",66,42,0,0,108
488070,288872,2013-06-13,Senate,"Senate Third Reading:  Roll Call # 261",25,12,1,0,38
488070,383038,2013-06-13,Senate,"Senate Third Reading: Roll Call # 261",25,12,1,0,38
488088,241320,2013-02-21,Senate,"Reported Favorably With Substitute S-1",4,0,0,0,4
488088,241321,2013-02-27,Senate,"Senate Third Reading: Passed Roll Call # 30",36,0,0,1,37
488088,268897,2013-04-18,House,"Reported With Recommendation Without Amendment",9,0,0,0,9
488088,302689,2013-09-19,House,"House Third Reading: Given Immediate Effect Roll Call # 289",101,3,0,0,104
488212,262210,2013-04-09,Senate,"Reported Favorably Without Amendment",5,1,0,0,6
488212,364419,2014-05-14,Senate,"Senate Third Reading: Passed Roll Call # 263",26,11,0,1,38
488212,369901,2014-06-04,House,"Reported With Recommendation Without Amendment",13,0,0,0,13
488212,379205,2014-09-09,House,"House Third Reading: Given Immediate Effect Roll Call # 458",100,10,0,0,110
488212,379352,2014-09-10,Senate,"Senate Third Reading:  Roll Call # 542",34,3,1,0,38
488212,382862,2014-09-10,Senate,"Senate Third Reading: Roll Call # 542",34,3,1,0,38
488232,261834,2013-04-09,Senate,"Reported Favorably Without Amendment",5,2,0,0,7
488253,240315,2013-02-26,Senate,"Reported Favorably Without Amendment",7,0,0,0,7
488253,242812,2013-03-06,Senate,"Senate Third Reading: Passed Roll Call # 38",36,0,0,1,37
488274,241147,2013-02-27,Senate,"Reported Favorably Without Amendment",4,0,0,0,4
488274,290042,2013-06-19,Senate,"Senate Third Reading: Passed Roll Call # 298",37,0,1,0,38
488274,363405,2014-05-08,House,"Reported With Recommendation With Substitute  H-1",10,0,0,0,10
488274,370603,2014-06-10,House,"House Third Reading: Given Immediate Effect Roll Call # 376",98,12,0,0,110
488493,302681,2013-09-19,House,"Reported With Recommendation Without Amendment",10,0,0,0,10
488493,303217,2013-10-03,House,"House Third Reading: Passed Roll Call # 310",107,1,0,0,108
488831,299480,2013-09-11,House,"Reported With Recommendation With Substitute H-3",9,1,0,0,10
488831,339872,2013-09-11,House,"Reported With Recommendation With Substitute  H-3",9,1,0,0,10
488871,299479,2013-09-11,House,"Reported With Recommendation With Substitute H-3",9,2,0,0,11
488871,338617,2013-09-11,House,"Reported With Recommendation With Substitute  H-3",9,2,0,0,11
489988,242604,2013-03-06,Senate,"Reported Favorably With Substitute S-2",7,0,0,0,7
489988,304540,2013-11-14,Senate,"Senate Third Reading: Passed Roll Call # 545",38,0,0,0,38
489988,305294,2013-12-11,House,"Reported With Recommendation With Substitute H-1",17,0,0,0,17
489988,305404,2013-12-12,House,"House Third Reading: Given Immediate Effect Roll Call # 493",107,1,0,0,108
489988,305405,2013-12-12,Senate,"Senate Third Reading:  Roll Call # 664",38,0,0,0,38
489988,382893,2013-12-12,Senate,"Senate Third Reading: Roll Call # 664",38,0,0,0,38
490077,250845,2013-03-19,Senate,"Reported Favorably With Substitute S-1",7,0,0,0,7
490077,262149,2013-04-09,Senate,"Senate Third Reading: Passed Roll Call # 69",36,0,0,1,37
490077,279368,2013-05-14,House,"Reported With Recommendation With Substitute H-2",15,0,0,0,15
490077,282793,2013-05-22,House,"House Third Reading: Given Immediate Effect Roll Call # 162",108,0,0,0,108
490077,285446,2013-05-29,Senate,"Senate Third Reading:  Roll Call # 223",36,0,1,1,38
490077,382955,2013-05-29,Senate,"Senate Third Reading: Roll Call # 223",36,0,1,1,38
490147,309383,2014-01-15,House,"Reported With Recommendation Without Amendment",9,1,0,0,10
490147,310832,2014-01-22,House,"House Third Reading: Given Immediate Effect Roll Call # 7",109,1,0,0,110
490171,309427,2014-01-15,House,"Reported With Recommendation Without Amendment",9,1,0,0,10
490171,310932,2014-01-22,House,"House Third Reading: Given Immediate Effect Roll Call # 6",109,1,0,0,110
490196,288932,2013-06-13,House,"Reported With Recommendation With Substitute H-2",12,0,0,0,12
490196,290116,2013-06-19,House,"House Third Reading: Given Immediate Effect Roll Call # 248",109,0,0,0,109
490196,305104,2013-12-10,Senate,"Reported Favorably Without Amendment",3,1,0,0,4
490196,305341,2013-12-12,Senate,"Senate Third Reading: Given Immediate Effect Roll Call # 627",38,0,0,0,38
490242,381606,2014-11-12,House,"Reported With Recommendation With Substitute  H-5",7,3,0,0,10
490242,382237,2014-12-03,House,"House Third Reading: Passed Roll Call # 606",97,12,0,0,109
490242,382594,2014-12-10,Senate,"Reported Favorably Without Amendment",3,0,0,0,3
490292,279462,2013-05-14,House,"Reported With Recommendation With Substitute H-2",14,0,0,0,14
490292,282790,2013-05-22,House,"House Third Reading: Given Immediate Effect Roll Call # 165",108,1,0,0,109
490292,305222,2013-12-11,Senate,"Reported Favorably With Substitute S-1",7,0,0,0,7
490292,305343,2013-12-12,Senate,"Senate Third Reading: Given Immediate Effect Roll Call # 629",38,0,0,0,38
490292,305344,2013-12-12,House,"House Third Reading:  Roll Call # 526",109,0,0,0,109
490292,383170,2013-12-12,House,"House Third Reading: Roll Call # 526",109,0,0,0,109
494150,245552,2013-03-12,Senate,"Reported Favorably Without Amendment",6,0,0,0,6
494150,248915,2013-03-14,Senate,"Senate Third Reading: Passed Roll Call # 48",37,0,0,0,37
494150,303828,2013-10-29,House,"Reported With Recommendation With Substitute H-3",9,0,0,0,9
494150,304392,2013-11-13,House,"House Third Reading: Given Immediate Effect Roll Call # 411",108,2,0,0,110
494150,304495,2013-11-14,Senate,"Senate Third Reading:  Roll Call # 534",38,0,0,0,38
494150,382911,2013-11-14,Senate,"Senate Third Reading: Roll Call # 534",38,0,0,0,38
494166,245575,2013-03-12,Senate,"Reported Favorably Without Amendment",6,0,0,0,6
494166,248917,2013-03-14,Senate,"Senate Third Reading: Passed Roll Call # 49",37,0,0,0,37
494166,303848,2013-10-29,House,"Reported With Recommendation With Substitute H-1",9,0,0,0,9
494166,304382,2013-11-13,House,"House Third Reading: Given Immediate Effect Roll Call # 412",106,4,0,0,110
494166,304481,2013-11-14,Senate,"Senate Third Reading:  Roll Call # 535",38,0,0,0,38
494166,382902,2013-11-14,Senate,"Senate Third Reading: Roll Call # 535",38,0,0,0,38
494187,262065,2013-04-09,Senate,"Reported Favorably Without Amendment",4,1,0,0,5
494187,287215,2013-06-05,Senate,"Senate Third Reading: Passed Roll Call # 232",25,13,0,0,38
494203,303288,2013-10-08,Senate,"Reported Favorably With Substitute S-2",7,0,0,0,7
494203,303468,2013-10-16,Senate,"Senate Third Reading: Passed Roll Call # 410",38,0,0,0,38
494203,303878,2013-10-30,House,"Reported With Recommendation Without Amendment",11,0,0,0,11
494203,304462,2013-11-14,House,"House Third Reading: Given Immediate Effect Roll Call # 417",110,0,0,0,110
494203,305111,2013-12-10,House,"House Third Reading: Passed Roll Call # 468",109,0,0,0,109
494203,305246,2013-12-11,Senate,"Senate Third Reading: House Amendment(s) Concurred In Roll Call # 573",35,0,0,3,38
494224,280351,2013-05-16,Senate,"Reported Favorably With Substitute S-1",4,0,0,0,4
494224,282594,2013-05-22,Senate,"Senate Third Reading: Passed Roll Call # 207",37,0,0,1,38
494224,287243,2013-06-05,House,"Reported With Recommendation Without Amendment",13,0,0,0,13
494224,287508,2013-06-06,House,"House Third Reading: Given Immediate Effect Roll Call # 205",91,14,0,0,105
494224,288094,2013-06-11,Senate,"Senate Third Reading:  Roll Call # 235",37,0,0,1,38
494224,383057,2013-06-11,Senate,"Senate Third Reading: Roll Call # 235",37,0,0,1,38
494239,283487,2013-05-23,Senate,"Reported Favorably Without Amendment",3,0,0,0,3
494273,242878,2013-03-06,Senate,"Reported Favorably With Substitute S-1",7,0,0,0,7
494273,251622,2013-03-20,Senate,"Senate Third Reading: Passed Roll Call # 59",37,0,0,0,37
494273,266670,2013-04-16,House,"Reported With Recommendation Without Amendment",15,0,0,0,15
494273,272455,2013-04-25,House,"House Third Reading: Passed Roll Call # 98",98,10,0,0,108
494288,242593,2013-03-06,Senate,"Reported Favorably Without Amendment",7,0,0,0,7
494288,251935,2013-03-20,Senate,"Senate Third Reading: Passed Roll Call # 60",37,0,0,0,37
494288,266547,2013-04-16,House,"Reported With Recommendation Without Amendment",15,0,0,0,15
494288,272479,2013-04-25,House,"House Third Reading: Passed Roll Call # 99",97,11,0,0,108
494301,231054,2013-02-13,Senate,"Reported Favorably Without Amendment",5,1,0,0,6
494301,243580,2013-02-26,House,"Reported With Recommendation Without Amendment",16,0,0,0,16
494301,243581,2013-03-05,House,"House Third Reading:  Roll Call # 18",88,20,0,0,108
494301,382696,2013-03-05,House,"House Third Reading: Roll Call # 18",88,20,0,0,108
494510,263511,2013-04-11,House,"Reported With Recommendation With Substitute H-1",19,10,0,0,29
494510,271653,2013-04-24,House,"House Third Reading: Given Immediate Effect Roll Call # 91",58,52,0,0,110
494510,274962,2013-05-01,Senate,"Senate Third Reading: Passed Roll Call # 152",25,12,0,0,37
494510,280076,2013-05-15,House,"House Third Reading:  Roll Call # 129",0,107,0,0,107
494510,284739,2013-05-28,House,"House Third Reading: Conference Report Adopted Roll Call # 178",65,43,0,0,108
494510,285414,2013-05-29,Senate,"Senate Third Reading: Senate Adopted Conference Report With Immediate Effect Roll Call # 222",25,12,0,1,38
494510,383073,2013-05-15,House,"House Third Reading: Roll Call # 129",0,107,0,0,107
494520,301163,2013-09-18,House,"Reported With Recommendation With Substitute H-1",24,0,0,0,24
494520,302687,2013-09-19,House,"House Third Reading: Given Immediate Effect Roll Call # 285",104,0,0,0,104
494520,302688,2013-09-19,House,"House Third Reading: Passed Roll Call # 287",104,0,0,0,104
494520,302841,2013-09-26,Senate,"Reported Favorably With Amendment(s)",15,1,0,0,16
494520,302842,2013-09-26,Senate,"Senate Third Reading: Given Immediate Effect Roll Call # 377",37,0,0,1,38
494520,302843,2013-09-26,House,"House Third Reading: Senate Amendment(s) Concurred In Roll Call # 306",106,0,0,0,106
494574,285128,2013-05-29,House,"Reported With Recommendation With Substitute H-1",13,0,0,0,13
494574,287570,2013-06-06,House,"House Third Reading: Given Immediate Effect Roll Call # 209",100,7,0,0,107
494574,303634,2013-10-22,Senate,"Senate Third Reading: Given Immediate Effect Roll Call # 438",38,0,0,0,38
494574,303663,2013-10-22,House,"House Third Reading:  Roll Call # 344",101,7,0,0,108
494574,383164,2013-10-22,House,"House Third Reading: Roll Call # 344",101,7,0,0,108
494604,382470,2014-12-04,House,"Reported With Recommendation With Substitute  H-4",20,0,0,0,20
494604,382712,2014-12-09,House,"House Third Reading: Passed Roll Call # 644",107,2,0,0,109
494604,383126,2014-12-15,Senate,"Reported Favorably With Substitute  S-1",8,1,0,0,9
494604,383330,2014-12-17,Senate,"Senate Third Reading: Given Immediate Effect Roll Call # 823",36,0,1,1,38
494604,383414,2014-12-18,House,"House Third Reading: Roll Call # 758",108,2,0,0,110
494657,277099,2013-05-07,House,"Reported With Recommendation With Amendment(s)",13,0,0,0,13
494657,279328,2013-05-14,House,"House Third Reading: Given Immediate Effect Roll Call # 127",108,0,0,0,108
494657,304281,2013-11-12,Senate,"Reported Favorably Without Amendment",5,2,0,0,7
494657,304884,2013-12-03,Senate,"Senate Third Reading: Given Immediate Effect Roll Call # 547",26,11,0,1,38
494666,243037,2013-03-06,House,"Reported With Recommendation With Substitute H-2",9,0,0,0,9
494666,251502,2013-03-19,House,"House Third Reading: Given Immediate Effect Roll Call # 37",95,15,0,0,110
494666,271161,2013-04-23,Senate,"Reported Favorably Without Amendment",6,0,0,0,6
494666,279928,2013-05-14,Senate,"Senate Third Reading: Given Immediate Effect Roll Call # 167",38,0,0,0,38
494678,243039,2013-03-06,House,"Reported With Recommendation With Substitute H-2",9,0,0,0,9
494678,251486,2013-03-19,House,"House Third Reading: Given Immediate Effect Roll Call # 38",95,15,0,0,110
494678,270965,2013-04-23,Senate,"Reported Favorably Without Amendment",6,0,0,0,6
494678,280112,2013-05-14,Senate,"Senate Third Reading: Given Immediate Effect Roll Call # 168",38,0,0,0,38
494727,248328,2013-03-13,House,"Reported With Recommendation With Substitute H-2",11,7,0,0,18
494727,338722,2013-03-13,House,"Reported With Recommendation With Substitute  H-2",11,7,0,0,18
495436,270867,2013-04-23,Senate,"Reported Favorably With Substitute S-1",10,6,0,0,16
495436,271585,2013-04-24,Senate,"Senate Third Reading: Passed Roll Call # 112",21,15,0,1,37
495436,279824,2013-05-15,House,"House Third Reading: Passed Roll Call # 131",60,48,0,0,108
495436,280394,2013-05-16,Senate,"Senate Third Reading:  Roll Call # 180",0,38,0,0,38
495436,382796,2013-05-16,Senate,"Senate Third Reading: Roll Call # 180",0,38,0,0,38
495455,273381,2013-04-25,Senate,"Reported Favorably With Substitute S-1",9,1,0,0,10
495455,274319,2013-04-30,Senate,"Senate Third Reading: Passed Roll Call # 148",26,11,0,0,37
495455,279862,2013-05-15,House,"House Third Reading: Passed Roll Call # 132",60,48,0,0,108
495455,280421,2013-05-16,Senate,"Senate Third Reading:  Roll Call # 181",0,38,0,0,38
495455,382831,2013-05-16,Senate,"Senate Third Reading: Roll Call # 181",0,38,0,0,38
495463,271531,2013-04-23,Senate,"Reported Favorably With Substitute S-1",12,2,0,0,14
495463,271984,2013-04-24,Senate,"Senate Third Reading: Passed Roll Call # 93",33,3,0,1,37
495463,280021,2013-05-15,House,"House Third Reading: Passed Roll Call # 133",60,48,0,0,108
495463,280519,2013-05-16,Senate,"Senate Third Reading:  Roll Call # 182",0,38,0,0,38
495463,382821,2013-05-16,Senate,"Senate Third Reading: Roll Call # 182",0,38,0,0,38
495480,271355,2013-04-23,Senate,"Reported Favorably With Substitute S-1",13,2,0,0,15
495480,271592,2013-04-24,Senate,"Senate Third Reading: Passed Roll Call # 95",33,3,0,1,37
495480,280010,2013-05-15,House,"House Third Reading: Passed Roll Call # 134",60,48,0,0,108
495480,280511,2013-05-16,Senate,"Senate Third Reading:  Roll Call # 183",0,38,0,0,38
495480,382803,2013-05-16,Senate,"Senate Third Reading: Roll Call # 183",0,38,0,0,38
495490,272251,2013-04-23,Senate,"Reported Favorably With Substitute S-1",11,5,0,0,16
495490,272252,2013-04-24,Senate,"Senate Third Reading: Passed Roll Call # 89",26,10,0,1,37
495490,279797,2013-05-15,House,"House Third Reading: Passed Roll Call # 135",60,48,0,0,108
495490,280371,2013-05-16,Senate,"Senate Third Reading:  Roll Call # 184",0,38,0,0,38
495490,382678,2013-05-16,Senate,"Senate Third Reading: Roll Call # 184",0,38,0,0,38
495501,271541,2013-04-23,Senate,"Reported Favorably With Substitute S-1",9,5,0,0,14
495501,274220,2013-04-30,Senate,"Senate Third Reading: Passed Roll Call # 136",34,2,0,1,37
495501,280048,2013-05-15,House,"House Third Reading: Passed Roll Call # 136",60,48,0,0,108
495501,280551,2013-05-16,Senate,"Senate Third Reading:  Roll Call # 185",0,38,0,0,38
495501,382840,2013-05-16,Senate,"Senate Third Reading: Roll Call # 185",0,38,0,0,38
495510,271560,2013-04-23,Senate,"Reported Favorably With Substitute S-1",10,5,0,0,15
495510,274269,2013-04-30,Senate,"Senate Third Reading: Passed Roll Call # 137",33,3,0,1,37
495510,279833,2013-05-15,House,"House Third Reading: Passed Roll Call # 137",60,48,0,0,108
495510,280399,2013-05-16,Senate,"Senate Third Reading:  Roll Call # 186",0,38,0,0,38
495510,382830,2013-05-16,Senate,"Senate Third Reading: Roll Call # 186",0,38,0,0,38
495518,271229,2013-04-23,Senate,"Reported Favorably With Substitute S-1",11,5,0,0,16
495518,274229,2013-04-30,Senate,"Senate Third Reading: Passed Roll Call # 147",26,11,0,0,37
495518,280094,2013-05-15,House,"House Third Reading: Passed Roll Call # 138",60,48,0,0,108
495518,280338,2013-05-16,Senate,"Senate Third Reading:  Roll Call # 187",0,38,0,0,38
495518,382858,2013-05-16,Senate,"Senate Third Reading: Roll Call # 187",0,38,0,0,38
495530,270979,2013-04-23,Senate,"Reported Favorably With Substitute S-1",11,3,0,0,14
495530,274257,2013-04-30,Senate,"Senate Third Reading: Passed Roll Call # 133",25,12,0,0,37
495530,280055,2013-05-15,House,"House Third Reading: Passed Roll Call # 139",60,48,0,0,108
495530,280547,2013-05-16,Senate,"Senate Third Reading:  Roll Call # 188",0,38,0,0,38
495530,382689,2013-05-16,Senate,"Senate Third Reading: Roll Call # 188",0,38,0,0,38
495538,271250,2013-04-23,Senate,"Reported Favorably With Substitute S-1",11,5,0,0,16
495538,273410,2013-04-25,Senate,"Senate Third Reading: Passed Roll Call # 127",21,15,0,1,37
495538,280002,2013-05-15,House,"House Third Reading: Passed Roll Call # 140",61,47,0,0,108
495538,280510,2013-05-16,Senate,"Senate Third Reading:  Roll Call # 189",0,38,0,0,38
495538,382711,2013-05-16,Senate,"Senate Third Reading: Roll Call # 189",0,38,0,0,38
495549,271868,2013-04-24,Senate,"Reported Favorably With Substitute S-1",10,5,0,0,15
495549,274538,2013-04-30,Senate,"Senate Third Reading: Passed Roll Call # 143",23,14,0,0,37
495549,274539,2013-04-30,Senate,"Senate Third Reading: Passed Roll Call # 144",21,16,0,0,37
495549,280028,2013-05-15,House,"House Third Reading: Passed Roll Call # 141",60,48,0,0,108
495549,280523,2013-05-16,Senate,"Senate Third Reading:  Roll Call # 190",0,38,0,0,38
495549,382670,2013-05-16,Senate,"Senate Third Reading: Roll Call # 190",0,38,0,0,38
495560,271525,2013-04-23,Senate,"Reported Favorably With Substitute S-1",13,2,0,0,15
495560,271970,2013-04-24,Senate,"Senate Third Reading: Passed Roll Call # 91",29,7,0,1,37
495560,279822,2013-05-15,House,"House Third Reading: Passed Roll Call # 142",60,48,0,0,108
495560,280386,2013-05-16,Senate,"Senate Third Reading:  Roll Call # 191",0,38,0,0,38
495560,382648,2013-05-16,Senate,"Senate Third Reading: Roll Call # 191",0,38,0,0,38
495571,270973,2013-04-23,Senate,"Reported Favorably With Substitute S-1",11,5,0,0,16
495571,271676,2013-04-24,Senate,"Senate Third Reading: Passed Roll Call # 101",24,12,0,1,37
495571,280040,2013-05-15,House,"House Third Reading: Passed Roll Call # 143",60,48,0,0,108
495571,280538,2013-05-16,Senate,"Senate Third Reading:  Roll Call # 192",0,38,0,0,38
495571,382657,2013-05-16,Senate,"Senate Third Reading: Roll Call # 192",0,38,0,0,38
495581,271054,2013-04-23,Senate,"Reported Favorably With Substitute S-1",9,5,0,0,14
495581,274443,2013-04-30,Senate,"Senate Third Reading: Passed Roll Call # 135",22,15,0,0,37
495581,280016,2013-05-15,House,"House Third Reading: Passed Roll Call # 144",60,48,0,0,108
495581,280522,2013-05-16,Senate,"Senate Third Reading:  Roll Call # 193",0,38,0,0,38
495581,382807,2013-05-16,Senate,"Senate Third Reading: Roll Call # 193",0,38,0,0,38
495590,280343,2013-05-16,Senate,"Senate Third Reading: Passed Roll Call # 176",20,18,0,0,38
495590,281903,2013-05-21,House,"House Third Reading: Passed Roll Call # 154",59,49,0,0,108
495590,282802,2013-05-22,Senate,"Senate Third Reading:  Roll Call # 203",0,37,0,1,38
495590,382806,2013-05-22,Senate,"Senate Third Reading: Roll Call # 203",0,37,0,1,38
495601,271249,2013-04-23,Senate,"Reported Favorably With Substitute S-1",9,7,0,0,16
495601,273418,2013-04-25,Senate,"Senate Third Reading: Passed Roll Call # 115",21,15,0,1,37
495601,280018,2013-05-15,House,"House Third Reading: Passed Roll Call # 145",60,48,0,0,108
495601,280521,2013-05-16,Senate,"Senate Third Reading:  Roll Call # 194",0,38,0,0,38
495601,382729,2013-05-16,Senate,"Senate Third Reading: Roll Call # 194",0,38,0,0,38
495617,271410,2013-04-23,Senate,"Reported Favorably With Substitute S-1",11,2,0,0,13
495617,271635,2013-04-24,Senate,"Senate Third Reading: Passed Roll Call # 85",32,4,0,1,37
495617,280036,2013-05-15,House,"House Third Reading: Passed Roll Call # 146",60,48,0,0,108
495617,280532,2013-05-16,Senate,"Senate Third Reading:  Roll Call # 195",0,38,0,0,38
495617,382845,2013-05-16,Senate,"Senate Third Reading: Roll Call # 195",0,38,0,0,38
496416,363076,2014-05-07,House,"Reported With Recommendation Without Amendment",11,2,0,0,13
496416,363458,2014-05-08,House,"House Third Reading: Given Immediate Effect Roll Call # 207",92,17,0,0,109
496416,370913,2014-06-11,Senate,"Senate Third Reading: Given Immediate Effect Roll Call # 417",37,1,0,0,38
496416,383687,2014-12-19,House,"House Third Reading: Roll Call # 777",108,2,0,0,110
496416,383805,2014-12-19,Senate,"Senate Third Reading: Roll Call # 915",38,0,0,0,38
498068,299277,2013-09-10,House,"Reported With Recommendation Without Amendment",19,0,0,0,19
498471,242223,2013-03-05,House,"Reported With Recommendation Without Amendment",15,0,0,0,15
498471,252971,2013-03-14,House,"House Third Reading: Given Immediate Effect Roll Call # 26",109,0,0,0,109
498471,267905,2013-04-17,Senate,"Reported Favorably With Substitute S-1",7,0,0,0,7
498471,278137,2013-05-09,Senate,"Senate Third Reading: Given Immediate Effect Roll Call # 161",35,0,0,2,37
498471,279359,2013-05-14,House,"House Third Reading:  Roll Call # 123",106,0,0,0,106
498471,382916,2013-05-14,House,"House Third Reading: Roll Call # 123",106,0,0,0,106
498830,304316,2013-11-12,House,"Reported With Recommendation With Substitute H-1",15,0,0,0,15
498830,304517,2013-11-14,House,"House Third Reading: Passed Roll Call # 437",105,5,0,0,110
499083,303158,2013-10-02,House,"Reported With Recommendation Without Amendment",13,1,0,0,14
499083,303652,2013-10-22,House,"House Third Reading: Given Immediate Effect Roll Call # 346",97,11,0,0,108
499396,243875,2013-03-07,House,"Reported With Recommendation With Amendment(s)",8,0,0,0,8
499396,262573,2013-04-09,House,"House Third Reading: Given Immediate Effect Roll Call # 67",107,2,0,0,109
499396,288495,2013-06-12,Senate,"Reported Favorably Without Amendment",4,0,0,0,4
499484,252589,2013-03-21,House,"House Third Reading: Given Immediate Effect Roll Call # 63",102,8,0,0,110
499484,257590,2013-03-14,House,"Reported With Recommendation Without Amendment",9,0,0,0,9
499484,267527,2013-04-17,Senate,"Reported Favorably Without Amendment",3,0,0,0,3
499484,276900,2013-05-07,Senate,"Senate Third Reading: Given Immediate Effect Roll Call # 157",37,0,0,0,37
507855,241568,2013-02-27,Senate,"Reported Favorably With Recommendation For Referral To Committee On Families, Seniors And Human Services",3,0,0,0,3
507855,365778,2014-05-20,Senate,"Reported Favorably With Substitute  S-2",4,0,0,0,4
507855,370087,2014-06-05,Senate,"Senate Third Reading: Passed Roll Call # 390",37,0,0,1,38
507855,379539,2014-09-10,House,"Reported With Recommendation Without Amendment",7,1,0,0,8
507855,380402,2014-10-02,House,"House Third Reading: Given Immediate Effect Roll Call # 523",107,0,0,0,107
507855,380403,2014-10-02,Senate,"Senate Third Reading:  Roll Call # 621",38,0,0,0,38
507855,383079,2014-10-02,Senate,"Senate Third Reading: Roll Call # 621",38,0,0,0,38
507962,241567,2013-02-27,Senate,"Reported Favorably With Recommendation For Referral To Committee On Families, Seniors And Human Services",3,0,0,0,3
507962,365834,2014-05-20,Senate,"Reported Favorably With Substitute  S-2",4,0,0,0,4
507962,370116,2014-06-05,Senate,"Senate Third Reading: Passed Roll Call # 391",37,0,0,1,38
507962,379419,2014-09-10,House,"Reported With Recommendation Without Amendment",7,1,0,0,8
507962,380330,2014-10-02,House,"House Third Reading: Given Immediate Effect Roll Call # 524",107,0,0,0,107
507962,380331,2014-10-02,Senate,"Senate Third Reading:  Roll Call # 622",38,0,0,0,38
507962,383065,2014-10-02,Senate,"Senate Third Reading: Roll Call # 622",38,0,0,0,38
508315,241569,2013-02-20,House,"Reported With Recommendation Without Amendment",12,0,0,0,12
508315,241570,2013-02-28,House,"House Third Reading: Passed Roll Call # 13",110,0,0,0,110
508353,242632,2013-03-05,House,"Reported With Recommendation For Referral To Committee On Tourism",15,0,0,0,15
508353,278098,2013-05-09,House,"Reported With Recommendation With Substitute H-2",8,0,0,0,8
508353,282870,2013-05-22,House,"House Third Reading: Given Immediate Effect Roll Call # 158",102,6,0,0,108
508353,288603,2013-06-12,Senate,"Reported Favorably With Substitute S-1",5,2,0,0,7
508353,289884,2013-06-19,Senate,"Senate Third Reading: Given Immediate Effect Roll Call # 295",27,11,0,0,38
508353,299830,2013-09-12,House,"House Third Reading:  Roll Call # 273",103,5,0,0,108
508353,383019,2013-09-12,House,"House Third Reading: Roll Call # 273",103,5,0,0,108
508369,278281,2013-05-09,House,"Reported With Recommendation Without Amendment",8,0,0,0,8
508369,280563,2013-05-16,House,"House Third Reading: Given Immediate Effect Roll Call # 151",106,0,0,0,106
508369,304272,2013-11-12,Senate,"Reported Favorably With Substitute S-1",7,0,0,0,7
508369,336997,2013-11-12,Senate,"Reported Favorably With Substitute  S-1",7,0,0,0,7
508456,247866,2013-03-12,House,"Reported With Recommendation With Substitute H-1",11,1,0,0,12
508456,252537,2013-03-21,House,"House Third Reading: Given Immediate Effect Roll Call # 55",109,1,0,0,110
508456,303842,2013-10-29,Senate,"Reported Favorably With Substitute S-1",7,0,0,0,7
508456,304167,2013-11-07,Senate,"Senate Third Reading: Given Immediate Effect Roll Call # 504",38,0,0,0,38
508456,304422,2013-11-13,House,"House Third Reading:  Roll Call # 407",109,1,0,0,110
508456,305366,2013-12-12,Senate,"Senate Third Reading:  Roll Call # 660",38,0,0,0,38
508456,305439,2013-12-12,House,"House Third Reading:  Roll Call # 492",107,1,0,0,108
508456,383152,2013-11-13,House,"House Third Reading: Roll Call # 407",109,1,0,0,110
508456,383153,2013-12-12,House,"House Third Reading: Roll Call # 492",107,1,0,0,108
508456,383154,2013-12-12,Senate,"Senate Third Reading: Roll Call # 660",38,0,0,0,38
508485,242042,2013-03-05,House,"Reported With Recommendation With Substitute H-1",14,1,0,0,15
508485,252376,2013-03-21,House,"House Third Reading: Given Immediate Effect Roll Call # 54",101,8,0,0,109
508500,242388,2013-03-05,House,"Reported With Recommendation Without Amendment",13,1,0,0,14
508500,252404,2013-03-21,House,"House Third Reading: Given Immediate Effect Roll Call # 53",102,7,0,0,109
508530,287247,2013-06-05,House,"Reported With Recommendation With Amendment(s)",17,0,0,0,17
508530,289945,2013-06-19,House,"House Third Reading: Passed Roll Call # 245",109,0,0,0,109
508530,304501,2013-11-14,Senate,"Reported Favorably With Substitute S-2",5,0,0,0,5
508545,305113,2013-12-10,House,"Reported With Recommendation With Substitute H-3",11,0,0,0,11
508545,305339,2013-12-12,House,"House Third Reading: Given Immediate Effect Roll Call # 496",95,14,0,0,109
508545,377089,2014-08-13,Senate,"Reported Favorably With Substitute  S-1",3,1,0,0,4
509080,271858,2013-04-24,Senate,"Reported Favorably Without Amendment",3,0,0,0,3
509080,366421,2014-05-21,Senate,"Senate Third Reading: Passed Roll Call # 311",32,6,0,0,38
509080,383507,2014-12-17,House,"Reported With Recommendation Without Amendment",15,0,0,0,15
509080,383508,2014-12-18,House,"House Third Reading: Given Immediate Effect Roll Call # 750",109,1,0,0,110
509118,279349,2013-05-14,Senate,"Reported Favorably With Substitute S-3",7,0,0,0,7
509118,282000,2013-05-21,Senate,"Senate Third Reading: Passed Roll Call # 201",38,0,0,0,38
509283,305304,2013-12-11,House,"Reported With Recommendation With Substitute H-4",15,0,0,0,15
509283,309225,2014-01-15,House,"House Third Reading: Given Immediate Effect Roll Call # 2",107,0,0,0,107
509283,323756,2014-02-18,Senate,"Reported Favorably Without Amendment",7,0,0,0,7
509283,348158,2014-03-26,Senate,"Senate Third Reading: Given Immediate Effect Roll Call # 141",37,0,0,1,38
509348,279811,2013-05-15,House,"Reported With Recommendation With Substitute H-2",12,0,0,0,12
509348,282844,2013-05-22,House,"House Third Reading: Passed Roll Call # 166",109,0,0,0,109
509348,303220,2013-10-03,Senate,"Reported Favorably With Substitute S-2",7,0,0,0,7
509348,303391,2013-10-15,Senate,"Senate Third Reading: Given Immediate Effect Roll Call # 406",38,0,0,0,38
509348,303644,2013-10-22,House,"House Third Reading:  Roll Call # 338",108,0,0,0,108
509348,383029,2013-10-22,House,"House Third Reading: Roll Call # 338",108,0,0,0,108
509417,267472,2013-04-17,House,"Reported With Recommendation With Substitute H-1",14,0,0,0,14
509417,275677,2013-05-02,House,"House Third Reading: Given Immediate Effect Roll Call # 119",110,0,0,0,110
509417,370587,2014-06-10,Senate,"Reported Favorably Without Amendment",7,0,0,0,7
509417,383299,2014-12-17,Senate,"Senate Third Reading: Given Immediate Effect Roll Call # 837",36,0,1,1,38
509478,272024,2013-04-24,House,"Reported With Recommendation With Substitute H-2",13,0,0,0,13
509478,275786,2013-05-02,House,"House Third Reading: Passed Roll Call # 120",110,0,0,0,110
509478,314058,2014-01-30,Senate,"Reported Favorably Without Amendment",7,0,0,0,7
509478,329234,2014-02-25,Senate,"Senate Third Reading: Given Immediate Effect Roll Call # 51",36,0,0,2,38
509478,331758,2014-02-27,House,"House Third Reading:  Roll Call # 69",108,0,0,0,108
509478,383121,2014-02-27,House,"House Third Reading: Roll Call # 69",108,0,0,0,108
509546,305269,2013-12-11,House,"Reported With Recommendation With Substitute H-4",15,0,0,0,15
509546,309425,2014-01-15,House,"House Third Reading: Given Immediate Effect Roll Call # 3",107,0,0,0,107
509546,323541,2014-02-18,Senate,"Reported Favorably Without Amendment",7,0,0,0,7
509546,348210,2014-03-26,Senate,"Senate Third Reading: Given Immediate Effect Roll Call # 148",37,0,0,1,38
509730,331476,2014-02-27,House,"Reported With Recommendation With Substitute H-2",29,0,0,0,29
509730,335461,2014-03-05,House,"House Third Reading: Given Immediate Effect Roll Call # 85",107,3,0,0,110
509730,346536,2014-03-20,Senate,"Reported Favorably With Substitute  S-1",4,0,0,0,4
509730,346537,2014-03-20,Senate,"Senate Third Reading: Given Immediate Effect Roll Call # 126",36,1,0,1,38
509730,348156,2014-03-26,House,"House Third Reading:  Roll Call # 169",105,4,0,0,109
509730,348452,2014-03-27,Senate,"Senate Third Reading:  Roll Call # 173",23,14,0,1,38
509730,382664,2014-03-26,House,"House Third Reading: Roll Call # 169",105,4,0,0,109
509730,382665,2014-03-27,Senate,"Senate Third Reading: Roll Call # 173",23,14,0,1,38
509848,272058,2013-04-24,House,"Reported With Recommendation With Substitute H-4",13,0,0,0,13
509848,277053,2013-05-07,House,"House Third Reading: Passed Roll Call # 121",107,2,0,0,109
509848,282687,2013-05-22,Senate,"Reported Favorably Without Amendment",4,0,0,0,4
509848,289924,2013-06-19,Senate,"Senate Third Reading: Given Immediate Effect Roll Call # 288",38,0,0,0,38
511264,288867,2013-06-13,House,"Reported With Recommendation With Substitute H-2",11,0,0,0,11
511264,338872,2013-06-13,House,"Reported With Recommendation With Substitute  H-2",11,0,0,0,11
511264,382683,2014-12-10,House,"House Third Reading: Given Immediate Effect Roll Call # 652",75,33,0,0,108
511325,278122,2013-05-09,House,"Reported With Recommendation With Substitute H-2",8,0,0,0,8
511325,282905,2013-05-22,House,"House Third Reading: Given Immediate Effect Roll Call # 159",101,7,0,0,108
511325,288490,2013-06-12,Senate,"Reported Favorably With Substitute S-1",5,2,0,0,7
511325,290014,2013-06-19,Senate,"Senate Third Reading: Given Immediate Effect Roll Call # 296",27,11,0,0,38
511325,299817,2013-09-12,House,"House Third Reading:  Roll Call # 274",101,7,0,0,108
511325,301164,2013-09-18,Senate,"Senate Third Reading:  Roll Call # 358",26,9,0,3,38
511325,383008,2013-09-12,House,"House Third Reading: Roll Call # 274",101,7,0,0,108
511325,383009,2013-09-18,Senate,"Senate Third Reading: Roll Call # 358",26,9,0,3,38
511384,282680,2013-05-22,House,"Reported With Recommendation With Amendment(s)",10,1,0,0,11
511446,382349,2014-12-03,House,"Reported With Recommendation With Substitute  H-2",10,0,0,0,10
511569,262371,2013-04-09,House,"Reported With Recommendation With Substitute H-2",13,0,0,0,13
511569,268768,2013-04-18,House,"House Third Reading: Given Immediate Effect Roll Call # 83",108,0,0,0,108
511569,288133,2013-06-11,Senate,"Reported Favorably With Substitute S-1",6,0,0,0,6
511569,290044,2013-06-19,Senate,"Senate Third Reading: Given Immediate Effect Roll Call # 291",38,0,0,0,38
511569,290519,2013-06-20,House,"House Third Reading:  Roll Call # 252",108,0,0,0,108
511569,383026,2013-06-20,House,"House Third Reading: Roll Call # 252",108,0,0,0,108
511809,241995,2013-03-05,House,"Reported With Recommendation Without Amendment",8,0,0,0,8
511809,252963,2013-03-14,House,"House Third Reading: Given Immediate Effect Roll Call # 30",75,35,0,0,110
511809,283403,2013-05-23,Senate,"Reported Favorably Without Amendment",2,1,0,0,3
511809,290077,2013-06-19,Senate,"Senate Third Reading: Given Immediate Effect Roll Call # 306",26,12,0,0,38
511809,290571,2013-06-20,House,"House Third Reading: Senate Amendment(s) Concurred In Roll Call # 253",75,33,0,0,108
515843,248581,2013-03-13,Senate,"Reported Favorably With Substitute S-1",5,0,0,0,5
515843,248582,2013-03-14,Senate,"Senate Third Reading: Passed Roll Call # 51",32,5,0,0,37
515843,261772,2013-04-09,House,"Reported With Recommendation With Amendment(s)",9,0,0,0,9
515843,268888,2013-04-18,House,"House Third Reading: Given Immediate Effect Roll Call # 84",92,16,0,0,108
515843,273253,2013-04-25,Senate,"Senate Third Reading: House Amendment(s) Concurred In Roll Call # 113",25,11,0,1,37
515883,248879,2013-03-13,Senate,"Reported Favorably Without Amendment",5,0,0,0,5
515883,252113,2013-03-20,Senate,"Senate Third Reading: Passed Roll Call # 56",37,0,0,0,37
515883,267901,2013-04-17,House,"Reported With Recommendation Without Amendment",12,0,0,0,12
515883,274485,2013-04-30,House,"House Third Reading: Passed Roll Call # 106",108,0,0,0,108
515924,381625,2014-11-13,Senate,"Senate Third Reading: Passed Roll Call # 659",37,0,0,1,38
515961,248135,2013-03-13,Senate,"Reported Favorably With Substitute S-1",4,0,0,0,4
515961,275621,2013-05-02,Senate,"Senate Third Reading: Passed Roll Call # 154",33,2,0,2,37
515961,287420,2013-06-05,House,"Reported With Recommendation Without Amendment",10,1,0,0,11
515961,303692,2013-10-22,House,"House Third Reading: Given Immediate Effect Roll Call # 342",103,5,0,0,108
515961,303777,2013-10-24,Senate,"Senate Third Reading: House Amendment(s) Concurred In Roll Call # 450",34,2,0,2,38
515997,279526,2013-05-14,House,"Reported With Recommendation Without Amendment",13,0,0,0,13
515997,282817,2013-05-22,House,"House Third Reading: Given Immediate Effect Roll Call # 160",97,11,0,0,108
516327,303329,2013-10-09,House,"Reported With Recommendation Without Amendment",17,0,0,0,17
516327,303763,2013-10-23,House,"House Third Reading: Given Immediate Effect Roll Call # 353",86,21,0,0,107
516327,304932,2013-12-04,Senate,"Reported Favorably Without Amendment",7,0,0,0,7
516327,305365,2013-12-12,Senate,"Senate Third Reading: Given Immediate Effect Roll Call # 628",33,5,0,0,38
516377,242624,2013-03-06,House,"Reported With Recommendation Without Amendment",9,0,0,0,9
516377,251535,2013-03-19,House,"House Third Reading: Given Immediate Effect Roll Call # 44",99,11,0,0,110
516408,242630,2013-03-06,House,"Reported With Recommendation Without Amendment",9,0,0,0,9
516408,251303,2013-03-19,House,"House Third Reading: Given Immediate Effect Roll Call # 43",100,10,0,0,110
516435,242789,2013-03-06,House,"Reported With Recommendation Without Amendment",9,0,0,0,9
516435,251417,2013-03-19,House,"House Third Reading: Given Immediate Effect Roll Call # 42",99,11,0,0,110
516466,242790,2013-03-06,House,"Reported With Recommendation Without Amendment",9,0,0,0,9
516466,251276,2013-03-19,House,"House Third Reading: Given Immediate Effect Roll Call # 41",93,17,0,0,110
516513,242787,2013-03-06,House,"Reported With Recommendation Without Amendment",9,0,0,0,9
516513,251441,2013-03-19,House,"House Third Reading: Given Immediate Effect Roll Call # 39",94,16,0,0,110
516591,242796,2013-03-06,House,"Reported With Recommendation Without Amendment",9,0,0,0,9
516591,251251,2013-03-19,House,"House Third Reading: Given Immediate Effect Roll Call # 40",95,15,0,0,110
517352,241905,2013-03-05,Senate,"Reported Favorably Without Amendment",7,0,0,0,7
517352,243396,2013-03-07,Senate,"Senate Third Reading:  Roll Call # 43",36,0,0,1,37
517392,241903,2013-03-05,Senate,"Reported Favorably Without Amendment",7,0,0,0,7
517392,243393,2013-03-07,Senate,"Senate Third Reading:  Roll Call # 42",36,0,0,1,37
517506,248318,2013-03-13,Senate,"Reported Favorably With Substitute S-1",5,0,0,0,5
517506,249106,2013-03-14,Senate,"Senate Third Reading: Passed Roll Call # 50",37,0,0,0,37
517506,250864,2013-03-19,House,"Reported With Recommendation Without Amendment",15,0,0,0,15
517506,250865,2013-03-19,House,"House Third Reading: Given Immediate Effect Roll Call # 45",110,0,0,0,110
517545,243422,2013-03-07,Senate,"Reported Favorably With Substitute S-3",3,0,0,0,3
517545,243423,2013-03-07,Senate,"Senate Third Reading: Passed Roll Call # 41",31,5,0,1,37
517545,248663,2013-03-13,House,"Reported With Recommendation With Substitute H-1",22,0,0,0,22
517545,252027,2013-03-20,House,"House Third Reading: Given Immediate Effect Roll Call # 50",107,3,0,0,110
517545,252455,2013-03-21,Senate,"Senate Third Reading:  Roll Call # 63",30,5,0,2,37
517545,382934,2013-03-21,Senate,"Senate Third Reading: Roll Call # 63",30,5,0,2,37
517694,251560,2013-03-19,Senate,"Reported Favorably Without Amendment",5,2,0,0,7
517777,252418,2013-03-21,Senate,"Reported Favorably With Substitute S-1",7,0,0,0,7
517777,302808,2013-09-25,Senate,"Senate Third Reading: Passed Roll Call # 369",34,3,0,1,38
518083,262287,2013-04-09,House,"Reported With Recommendation With Substitute H-1",14,0,0,0,14
518083,268877,2013-04-18,House,"House Third Reading: Given Immediate Effect Roll Call # 80",107,0,0,0,107
518083,288153,2013-06-11,Senate,"Reported Favorably Without Amendment",6,0,0,0,6
518083,290064,2013-06-19,Senate,"Senate Third Reading: Given Immediate Effect Roll Call # 293",38,0,0,0,38
518138,266596,2013-04-16,House,"Reported With Recommendation With Substitute H-1",18,10,0,0,28
518138,271789,2013-04-24,House,"House Third Reading: Given Immediate Effect Roll Call # 92",59,51,0,0,110
518138,274974,2013-05-01,Senate,"Senate Third Reading: Passed Roll Call # 153",26,11,0,0,37
518138,279781,2013-05-15,House,"House Third Reading:  Roll Call # 130",0,107,0,0,107
518138,284664,2013-05-28,House,"House Third Reading: Conference Report Adopted Roll Call # 179",63,46,0,0,109
518138,287050,2013-06-04,Senate,"Senate Third Reading: Senate Adopted Conference Report With Immediate Effect Roll Call # 226",24,14,0,0,38
518138,383064,2013-05-15,House,"House Third Reading: Roll Call # 130",0,107,0,0,107
518179,261844,2013-04-09,House,"Reported With Recommendation With Substitute H-1",13,0,0,0,13
518179,268870,2013-04-18,House,"House Third Reading: Given Immediate Effect Roll Call # 81",108,0,0,0,108
518179,288335,2013-06-11,Senate,"Reported Favorably Without Amendment",6,0,0,0,6
518179,290040,2013-06-19,Senate,"Senate Third Reading: Given Immediate Effect Roll Call # 292",38,0,0,0,38
518355,280235,2013-05-15,House,"Reported With Recommendation Without Amendment",16,0,0,0,16
518355,283393,2013-05-23,House,"House Third Reading: Given Immediate Effect Roll Call # 168",107,0,0,0,107
518355,303099,2013-10-01,Senate,"Reported Favorably Without Amendment",5,0,0,0,5
518355,303295,2013-10-08,Senate,"Senate Third Reading: Given Immediate Effect Roll Call # 392",38,0,0,0,38
518394,368148,2014-05-28,House,"Reported With Recommendation With Substitute  H-2",6,2,0,0,8
518490,247345,2013-03-12,House,"Reported With Recommendation With Substitute H-2",15,0,0,0,15
518490,251381,2013-03-19,Senate,"Senate Third Reading: Given Immediate Effect Roll Call # 54",37,0,0,0,37
518490,253322,2013-03-14,House,"House Third Reading: Given Immediate Effect Roll Call # 32",110,0,0,0,110
519657,275804,2013-05-02,Senate,"Reported Favorably Without Amendment",8,0,0,0,8
519657,278314,2013-05-09,Senate,"Senate Third Reading: Passed Roll Call # 165",35,0,0,2,37
519657,288207,2013-06-11,House,"Reported With Recommendation Without Amendment",16,0,0,0,16
519657,299816,2013-09-12,House,"House Third Reading: Given Immediate Effect Roll Call # 278",108,0,0,0,108
519717,275625,2013-05-02,Senate,"Reported Favorably Without Amendment",8,0,0,0,8
519717,278155,2013-05-09,Senate,"Senate Third Reading: Passed Roll Call # 164",35,0,0,2,37
519717,288218,2013-06-11,House,"Reported With Recommendation Without Amendment",16,0,0,0,16
519717,299787,2013-09-12,House,"House Third Reading: Given Immediate Effect Roll Call # 277",108,0,0,0,108
519780,275616,2013-05-02,Senate,"Reported Favorably Without Amendment",8,0,0,0,8
519780,278142,2013-05-09,Senate,"Senate Third Reading: Passed Roll Call # 163",35,0,0,2,37
519780,288187,2013-06-11,House,"Reported With Recommendation With Substitute H-2",16,0,0,0,16
519780,299801,2013-09-12,House,"House Third Reading: Given Immediate Effect Roll Call # 276",108,0,0,0,108
519780,299864,2013-09-17,Senate,"Senate Third Reading:  Roll Call # 350",36,0,0,2,38
519780,383054,2013-09-17,Senate,"Senate Third Reading: Roll Call # 350",36,0,0,2,38
519843,248768,2013-03-13,Senate,"Reported Favorably Without Amendment",3,0,0,0,3
519843,252059,2013-03-20,Senate,"Senate Third Reading: Passed Roll Call # 61",35,2,0,0,37
519843,283477,2013-05-23,House,"Reported With Recommendation Without Amendment",11,0,0,0,11
519903,250995,2013-03-19,Senate,"Reported Favorably Without Amendment",6,0,0,0,6
519903,287364,2013-06-05,Senate,"Senate Third Reading: Passed Roll Call # 230",38,0,0,0,38
519903,302792,2013-09-24,House,"Reported With Recommendation With Substitute H-1",14,0,0,0,14
519903,303477,2013-10-16,House,"House Third Reading: Given Immediate Effect Roll Call # 328",107,2,0,0,109
519903,303761,2013-10-23,Senate,"Senate Third Reading:  Roll Call # 440",38,0,0,0,38
519903,383053,2013-10-23,Senate,"Senate Third Reading: Roll Call # 440",38,0,0,0,38
520086,303171,2013-10-02,House,"Reported With Recommendation For Referral To Committee On Health Policy",13,0,0,0,13
520086,347611,2014-03-25,House,"Reported With Recommendation With Substitute  H-2",17,0,0,0,17
520086,360756,2014-04-29,House,"House Third Reading: Given Immediate Effect Roll Call # 194",110,0,0,0,110
520086,365019,2014-05-15,Senate,"Reported Favorably With Recommendation For Referral To Committee On Health Policy",5,0,0,0,5
520157,287483,2013-06-06,House,"Reported With Recommendation Without Amendment",9,0,0,0,9
520157,288797,2013-06-13,House,"House Third Reading: Given Immediate Effect Roll Call # 232",107,0,0,0,107
520157,299224,2013-09-10,Senate,"Reported Favorably Without Amendment",3,0,0,0,3
520157,302824,2013-09-26,Senate,"Senate Third Reading: Given Immediate Effect Roll Call # 378",36,1,0,1,38
520157,303762,2013-10-23,House,"House Third Reading: Senate Amendment(s) Concurred In As Amended Roll Call # 348",106,1,0,0,107
520157,304000,2013-11-05,Senate,"Senate Third Reading: House Amendment(s) To Senate Amendment(s) Concurred In Roll Call # 486",36,1,0,1,38
520301,303911,2013-10-31,House,"Reported With Recommendation With Substitute H-1",7,1,0,0,8
520301,304340,2013-11-12,House,"House Third Reading: Given Immediate Effect Roll Call # 402",81,29,0,0,110
520301,304978,2013-12-04,Senate,"Reported Favorably Without Amendment",3,0,0,0,3
520352,303136,2013-10-02,House,"Reported With Recommendation Without Amendment",15,0,0,0,15
520352,303764,2013-10-23,House,"House Third Reading: Passed Roll Call # 349",106,0,0,0,106
520352,304063,2013-11-06,Senate,"Reported Favorably Without Amendment",4,0,0,0,4
520352,305373,2013-12-12,Senate,"Senate Third Reading: Given Immediate Effect Roll Call # 657",37,1,0,0,38
520352,305374,2013-12-12,House,"House Third Reading: Senate Amendment(s) Concurred In Roll Call # 532",109,0,0,0,109
520376,303133,2013-10-02,House,"Reported With Recommendation With Substitute H-2",15,1,0,0,16
520376,303769,2013-10-23,House,"House Third Reading: Passed Roll Call # 350",96,10,0,0,106
520376,304049,2013-11-06,Senate,"Reported Favorably Without Amendment",4,0,0,0,4
520376,305389,2013-12-12,Senate,"Senate Third Reading: Given Immediate Effect Roll Call # 658",27,11,0,0,38
520427,279391,2013-05-14,House,"Reported With Recommendation With Substitute H-3",14,0,0,0,14
520427,287294,2013-06-05,House,"House Third Reading: Given Immediate Effect Roll Call # 194",108,1,0,0,109
520427,302784,2013-09-24,Senate,"Reported Favorably Without Amendment",5,0,0,0,5
520427,303178,2013-10-02,Senate,"Senate Third Reading: Given Immediate Effect Roll Call # 387",37,0,0,1,38
520570,363138,2014-05-07,House,"Reported With Recommendation Without Amendment",12,0,0,0,12
520570,364678,2014-05-14,House,"House Third Reading: Adopted By 2/3 Vote Roll Call # 232",108,1,0,0,109
523482,249241,2013-03-14,Senate,"Reported Favorably With Substitute S-1",5,0,0,0,5
523482,267595,2013-04-17,Senate,"Senate Third Reading: Passed Roll Call # 77",27,7,0,3,37
523642,299327,2013-09-10,House,"Reported With Recommendation Without Amendment",15,0,0,0,15
523687,299322,2013-09-10,House,"Reported With Recommendation Without Amendment",15,0,0,0,15
523793,266658,2013-04-16,House,"Reported With Recommendation With Substitute H-1",11,0,0,0,11
523793,272655,2013-04-25,House,"House Third Reading: Given Immediate Effect Roll Call # 96",107,1,0,0,108
523793,281992,2013-05-21,Senate,"Reported Favorably Without Amendment",6,0,0,0,6
523793,287038,2013-06-04,Senate,"Senate Third Reading: Given Immediate Effect Roll Call # 228",38,0,0,0,38
523819,266667,2013-04-16,House,"Reported With Recommendation With Substitute H-2",12,0,0,0,12
523819,272653,2013-04-25,House,"House Third Reading: Given Immediate Effect Roll Call # 97",107,1,0,0,108
523819,282122,2013-05-21,Senate,"Reported Favorably Without Amendment",6,0,0,0,6
523819,286889,2013-06-04,Senate,"Senate Third Reading: Given Immediate Effect Roll Call # 229",38,0,0,0,38
523878,277546,2013-05-08,House,"Reported With Recommendation With Amendment(s)",6,0,0,0,6
523878,280531,2013-05-16,House,"House Third Reading: Given Immediate Effect Roll Call # 150",92,14,0,0,106
523878,375868,2014-07-16,Senate,"Reported Favorably With Substitute  S-1",3,2,0,0,5
524049,249156,2013-03-14,House,"Reported With Recommendation With Substitute H-2",9,5,0,0,14
524049,252417,2013-03-21,House,"House Third Reading: Passed Roll Call # 66",57,53,0,0,110
524049,305221,2013-12-11,Senate,"Senate Third Reading: Passed Roll Call # 613",20,18,0,0,38
524049,346791,2014-03-20,House,"House Third Reading:  Roll Call # 146",56,0,0,0,56
524049,382686,2014-03-20,House,"House Third Reading: Roll Call # 146",56,54,0,0,110
524705,382450,2014-12-04,Senate,"Reported Favorably With Substitute S-1",6,0,0,0,6
524705,382451,2014-12-04,Senate,"Senate Third Reading: Defeated Roll Call # 723",18,19,1,0,38
524705,382452,2014-12-04,Senate,"Senate Third Reading: Passed Roll Call # 724",22,14,1,1,38
524827,282804,2013-05-22,Senate,"Reported Favorably With Substitute S-1",4,0,0,0,4
524827,288468,2013-06-12,Senate,"Senate Third Reading: Passed Roll Call # 256",36,1,0,1,38
525115,251514,2013-03-19,House,"Reported With Recommendation Without Amendment",14,0,0,0,14
525115,252540,2013-03-21,House,"House Third Reading: Given Immediate Effect Roll Call # 56",109,1,0,0,110
525115,364101,2014-05-13,Senate,"Reported Favorably Without Amendment",6,0,0,0,6
525115,369461,2014-06-02,Senate,"Senate Third Reading: Given Immediate Effect Roll Call # 330",38,0,0,0,38
525155,251533,2013-03-19,House,"Reported With Recommendation Without Amendment",14,0,0,0,14
525155,252604,2013-03-21,House,"House Third Reading: Given Immediate Effect Roll Call # 57",95,15,0,0,110
525155,303277,2013-10-08,Senate,"Reported Favorably With Substitute S-1",4,1,0,0,5
525155,337494,2013-10-08,Senate,"Reported Favorably With Substitute  S-1",4,1,0,0,5
525155,368441,2014-05-28,Senate,"Senate Third Reading: Given Immediate Effect Roll Call # 324",26,10,0,2,38
525155,369677,2014-06-03,House,"House Third Reading:  Roll Call # 332",94,14,0,0,108
525155,382967,2014-06-03,House,"House Third Reading: Roll Call # 332",94,14,0,0,108
525197,251552,2013-03-19,House,"Reported With Recommendation With Substitute H-1",14,0,0,0,14
525197,252612,2013-03-21,House,"House Third Reading: Given Immediate Effect Roll Call # 58",110,0,0,0,110
525197,364076,2014-05-13,Senate,"Reported Favorably With Substitute  S-1",5,1,0,0,6
525197,369474,2014-06-02,Senate,"Senate Third Reading: Passed Roll Call # 331",27,10,1,0,38
525197,369475,2014-06-02,Senate,"Senate Third Reading: Given Immediate Effect Roll Call # 332",29,9,0,0,38
525197,370082,2014-06-05,House,"House Third Reading:  Roll Call # 346",102,6,0,0,108
525197,382663,2014-06-05,House,"House Third Reading: Roll Call # 346",102,6,0,0,108
525237,251577,2013-03-19,House,"Reported With Recommendation Without Amendment",13,0,0,0,13
525237,252617,2013-03-21,House,"House Third Reading: Given Immediate Effect Roll Call # 59",105,5,0,0,110
525237,303401,2013-10-15,Senate,"Reported Favorably With Substitute S-3",6,1,0,0,7
525237,337182,2013-10-15,Senate,"Reported Favorably With Substitute  S-3",6,1,0,0,7
525237,370857,2014-06-11,Senate,"Senate Third Reading: Given Immediate Effect Roll Call # 428",23,15,0,0,38
525237,371339,2014-06-12,House,"House Third Reading:  Roll Call # 435",59,51,0,0,110
525237,382808,2014-06-12,House,"House Third Reading: Roll Call # 435",59,51,0,0,110
525284,251549,2013-03-19,House,"Reported With Recommendation Without Amendment",13,0,0,0,13
525284,252610,2013-03-21,House,"House Third Reading: Given Immediate Effect Roll Call # 60",105,5,0,0,110
525284,303419,2013-10-15,Senate,"Reported Favorably With Substitute S-2",6,1,0,0,7
525284,337411,2013-10-15,Senate,"Reported Favorably With Substitute  S-2",6,1,0,0,7
525284,370976,2014-06-11,Senate,"Senate Third Reading: Given Immediate Effect Roll Call # 427",24,14,0,0,38
525284,371283,2014-06-12,House,"House Third Reading:  Roll Call # 436",59,51,0,0,110
525284,382684,2014-06-12,House,"House Third Reading: Roll Call # 436",59,51,0,0,110
525326,251591,2013-03-19,House,"Reported With Recommendation With Substitute H-1",13,0,0,0,13
525326,252647,2013-03-21,House,"House Third Reading: Given Immediate Effect Roll Call # 61",105,5,0,0,110
525367,263558,2013-04-11,House,"Reported With Recommendation Without Amendment",11,0,0,0,11
525367,268829,2013-04-18,House,"House Third Reading: Given Immediate Effect Roll Call # 82",107,1,0,0,108
525367,282666,2013-05-22,Senate,"Reported Favorably Without Amendment",4,0,0,0,4
525367,303732,2013-10-23,Senate,"Senate Third Reading: Given Immediate Effect Roll Call # 444",37,1,0,0,38
525406,263522,2013-04-11,House,"Reported With Recommendation Without Amendment",11,0,0,0,11
525406,268788,2013-04-18,House,"House Third Reading: Given Immediate Effect Roll Call # 87",108,1,0,0,109
525406,282737,2013-05-22,Senate,"Reported Favorably Without Amendment",4,0,0,0,4
525406,303752,2013-10-23,Senate,"Senate Third Reading: Given Immediate Effect Roll Call # 445",37,1,0,0,38
525438,263567,2013-04-11,House,"Reported With Recommendation Without Amendment",11,0,0,0,11
525438,268863,2013-04-18,House,"House Third Reading: Given Immediate Effect Roll Call # 88",108,1,0,0,109
525438,282879,2013-05-22,Senate,"Reported Favorably With Substitute S-1",4,0,0,0,4
525438,303735,2013-10-23,Senate,"Senate Third Reading: Given Immediate Effect Roll Call # 446",37,1,0,0,38
525438,303823,2013-10-29,House,"House Third Reading:  Roll Call # 354",107,1,0,0,108
525438,303872,2013-10-30,Senate,"Senate Third Reading:  Roll Call # 466",35,0,2,1,38
525438,383041,2013-10-29,House,"House Third Reading: Roll Call # 354",107,1,0,0,108
525438,383042,2013-10-30,Senate,"Senate Third Reading: Roll Call # 466",35,0,2,1,38
526137,247955,2013-03-13,Senate,"Reported Favorably With Substitute S-3",5,0,0,0,5
526137,248906,2013-03-14,Senate,"Senate Third Reading: Passed Roll Call # 52",37,0,0,0,37
526137,251110,2013-03-19,House,"Reported With Recommendation Without Amendment",8,0,0,0,8
526137,251795,2013-03-20,House,"House Third Reading: Given Immediate Effect Roll Call # 51",106,4,0,0,110
526137,252321,2013-03-21,Senate,"Senate Third Reading: House Amendment(s) Concurred In Roll Call # 64",35,0,0,2,37
526518,271716,2013-04-24,House,"Reported With Recommendation With Substitute H-1",6,3,0,0,9
526518,274877,2013-05-01,House,"House Third Reading: Given Immediate Effect Roll Call # 114",78,32,0,0,110
526813,267385,2013-04-16,House,"Reported With Recommendation With Substitute H-1",9,0,0,0,9
526813,272405,2013-04-25,House,"House Third Reading: Given Immediate Effect Roll Call # 103",108,0,0,0,108
526813,305251,2013-12-11,Senate,"Reported Favorably Without Amendment",7,0,0,0,7
526813,305252,2013-12-11,Senate,"Senate Third Reading: Given Immediate Effect Roll Call # 600",37,0,0,1,38
526848,247432,2013-03-12,House,"Reported With Recommendation With Substitute H-1",9,0,0,0,9
526848,252477,2013-03-21,Senate,"Reported Favorably Without Amendment",4,0,0,0,4
526848,252478,2013-03-21,Senate,"Senate Third Reading: Given Immediate Effect Roll Call # 66",33,2,0,2,37
526848,252962,2013-03-14,House,"House Third Reading: Given Immediate Effect Roll Call # 33",90,20,0,0,110
526880,247430,2013-03-12,House,"Reported With Recommendation Without Amendment",9,0,0,0,9
526880,249562,2013-03-14,House,"House Third Reading: Given Immediate Effect Roll Call # 34",107,3,0,0,110
526880,252459,2013-03-21,Senate,"Reported Favorably With Substitute S-1",4,0,0,0,4
526880,252460,2013-03-21,Senate,"Senate Third Reading: Given Immediate Effect Roll Call # 67",34,1,0,2,37
526880,252461,2013-03-21,House,"House Third Reading:  Roll Call # 52",104,5,0,0,109
526880,382938,2013-03-21,House,"House Third Reading: Roll Call # 52",104,5,0,0,109
526914,247429,2013-03-12,House,"Reported With Recommendation With Substitute H-1",9,0,0,0,9
526914,249563,2013-03-14,House,"House Third Reading: Given Immediate Effect Roll Call # 35",88,22,0,0,110
526914,252467,2013-03-21,Senate,"Reported Favorably Without Amendment",4,0,0,0,4
526914,252468,2013-03-21,Senate,"Senate Third Reading: Given Immediate Effect Roll Call # 68",35,0,0,2,37
526952,363217,2014-05-07,House,"Reported With Recommendation Without Amendment",12,0,0,0,12
526952,364428,2014-05-14,House,"House Third Reading: Adopted By 2/3 Vote Roll Call # 233",108,1,0,0,109
527020,266604,2013-04-16,House,"Reported With Recommendation With Substitute H-1",9,0,0,0,9
527020,272553,2013-04-25,House,"House Third Reading: Given Immediate Effect Roll Call # 102",108,0,0,0,108
527020,305266,2013-12-11,Senate,"Reported Favorably Without Amendment",7,0,0,0,7
527020,305267,2013-12-11,Senate,"Senate Third Reading: Given Immediate Effect Roll Call # 599",37,0,0,1,38
527090,266516,2013-04-16,House,"Reported With Recommendation With Substitute H-1",9,0,0,0,9
527090,272438,2013-04-25,House,"House Third Reading: Given Immediate Effect Roll Call # 101",108,0,0,0,108
527090,305253,2013-12-11,Senate,"Reported Favorably Without Amendment",7,0,0,0,7
527090,305254,2013-12-11,Senate,"Senate Third Reading: Given Immediate Effect Roll Call # 598",37,0,0,1,38
527158,266600,2013-04-16,House,"Reported With Recommendation With Substitute H-1",9,0,0,0,9
527158,303471,2013-10-16,House,"House Third Reading: Given Immediate Effect Roll Call # 327",108,0,0,0,108
527158,305290,2013-12-11,Senate,"Reported Favorably Without Amendment",7,0,0,0,7
527158,305291,2013-12-11,Senate,"Senate Third Reading: Given Immediate Effect Roll Call # 597",37,0,0,1,38
527232,266688,2013-04-16,House,"Reported With Recommendation With Substitute H-1",9,0,0,0,9
527232,272835,2013-04-25,House,"House Third Reading: Given Immediate Effect Roll Call # 100",108,0,0,0,108
527232,305279,2013-12-11,Senate,"Reported Favorably Without Amendment",7,0,0,0,7
527232,305280,2013-12-11,Senate,"Senate Third Reading: Given Immediate Effect Roll Call # 596",37,0,0,1,38
527302,251480,2013-03-19,House,"Reported With Recommendation With Substitute H-1",15,0,0,0,15
527302,252502,2013-03-21,House,"House Third Reading: Given Immediate Effect Roll Call # 62",105,5,0,0,110
527302,362784,2014-05-06,Senate,"Reported Favorably With Substitute  S-1",6,0,0,0,6
527302,368457,2014-05-28,Senate,"Senate Third Reading: Given Immediate Effect Roll Call # 325",36,0,0,2,38
527302,369712,2014-06-03,House,"House Third Reading:  Roll Call # 333",102,6,0,0,108
527302,382980,2014-06-03,House,"House Third Reading: Roll Call # 333",102,6,0,0,108
531257,290245,2013-06-19,Senate,"Reported Favorably Without Amendment",3,1,0,0,4
531275,281920,2013-05-21,Senate,"Reported Favorably Without Amendment",6,0,0,0,6
531275,285536,2013-05-29,Senate,"Senate Third Reading: Passed Roll Call # 219",36,0,0,2,38
531275,303978,2013-11-05,House,"Reported With Recommendation Without Amendment",14,0,0,0,14
531275,312829,2014-01-28,House,"House Third Reading: Given Immediate Effect Roll Call # 17",108,0,0,0,108
531290,248995,2013-03-14,Senate,"Reported Favorably Without Amendment",6,0,0,0,6
531290,252138,2013-03-20,Senate,"Senate Third Reading: Passed Roll Call # 62",36,1,0,0,37
531290,282722,2013-05-22,House,"Reported With Recommendation With Substitute H-2",12,2,0,0,14
531290,288126,2013-06-11,House,"House Third Reading: Given Immediate Effect Roll Call # 214",65,43,0,0,108
531290,288502,2013-06-12,Senate,"Senate Third Reading:  Roll Call # 249",36,1,0,1,38
531290,382905,2013-06-12,Senate,"Senate Third Reading: Roll Call # 249",36,1,0,1,38
531306,252600,2013-03-21,Senate,"Reported Favorably With Substitute S-1",6,0,0,0,6
531306,263602,2013-04-11,Senate,"Senate Third Reading: Passed Roll Call # 74",35,2,0,0,37
531306,277737,2013-05-08,House,"Reported With Recommendation With Substitute H-1",13,4,0,0,17
531306,299724,2013-09-12,House,"House Third Reading: Given Immediate Effect Roll Call # 284",77,31,0,0,108
531306,299877,2013-09-18,Senate,"Senate Third Reading:  Roll Call # 356",31,4,0,3,38
531306,382996,2013-09-18,Senate,"Senate Third Reading: Roll Call # 356",31,4,0,3,38
531378,380123,2014-09-23,House,"Reported With Recommendation With Substitute  H-4",8,1,0,0,9
531378,381653,2014-11-13,House,"House Third Reading: Given Immediate Effect Roll Call # 578",68,39,0,0,107
531408,304941,2013-12-04,House,"Reported With Recommendation With Substitute H-2",15,0,0,0,15
531408,338810,2013-12-04,House,"Reported With Recommendation With Substitute  H-2",15,0,0,0,15
531429,285539,2013-05-29,House,"Reported With Recommendation With Substitute H-1",13,0,0,0,13
531429,289899,2013-06-19,House,"House Third Reading: Given Immediate Effect Roll Call # 249",109,0,0,0,109
531442,370472,2014-06-10,House,"Reported With Recommendation With Substitute  H-1",15,0,0,0,15
531442,379151,2014-09-09,House,"House Third Reading: Passed Roll Call # 453",109,0,0,0,109
531442,380242,2014-10-01,Senate,"Reported Favorably Without Amendment",7,0,0,0,7
531442,383241,2014-12-16,Senate,"Senate Third Reading: Given Immediate Effect Roll Call # 790",37,0,0,1,38
531633,272065,2013-04-24,House,"Reported With Recommendation With Substitute H-3",13,0,0,0,13
531633,277131,2013-05-07,House,"House Third Reading: Passed Roll Call # 122",107,2,0,0,109
531633,282755,2013-05-22,Senate,"Reported Favorably Without Amendment",4,0,0,0,4
531633,289908,2013-06-19,Senate,"Senate Third Reading: Given Immediate Effect Roll Call # 289",38,0,0,0,38
531633,290285,2013-06-20,House,"House Third Reading: Senate Amendment(s) Concurred In Roll Call # 254",107,2,0,0,109
532461,285308,2013-05-29,Senate,"Reported Favorably Without Amendment",6,0,0,0,6
532461,288728,2013-06-13,Senate,"Senate Third Reading: Passed Roll Call # 271",38,0,0,0,38
532461,319196,2014-02-11,House,"Reported With Recommendation Without Amendment",9,0,0,0,9
532461,323567,2014-02-18,House,"House Third Reading: Given Immediate Effect Roll Call # 54",108,0,0,0,108
532478,251516,2013-03-19,Senate,"Reported Favorably With Substitute S-1",5,0,0,0,5
532478,252567,2013-03-21,Senate,"Senate Third Reading: Passed Roll Call # 65",35,0,0,2,37
532478,286960,2013-06-04,House,"Reported With Recommendation With Substitute H-3",9,0,0,0,9
532478,288896,2013-06-13,House,"House Third Reading: Given Immediate Effect Roll Call # 226",83,23,0,0,106
532478,289734,2013-06-18,Senate,"Senate Third Reading:  Roll Call # 275",38,0,0,0,38
532478,382992,2013-06-18,Senate,"Senate Third Reading: Roll Call # 275",38,0,0,0,38
532683,277505,2013-05-08,House,"Reported With Recommendation Without Amendment",9,0,0,0,9
532683,382429,2014-12-04,House,"House Third Reading: Passed Roll Call # 621",85,24,0,0,109
532683,382601,2014-12-10,Senate,"Reported Favorably Without Amendment",3,0,0,0,3
532706,277434,2013-05-08,House,"Reported With Recommendation Without Amendment",9,0,0,0,9
532706,382419,2014-12-04,House,"House Third Reading: Passed Roll Call # 620",87,22,0,0,109
532706,382582,2014-12-10,Senate,"Reported Favorably Without Amendment",3,0,0,0,3
532706,383211,2014-12-16,Senate,"Senate Third Reading: Given Immediate Effect Roll Call # 815",37,0,0,1,38
532732,277550,2013-05-08,House,"Reported With Recommendation Without Amendment",9,0,0,0,9
532732,382405,2014-12-04,House,"House Third Reading: Given Immediate Effect Roll Call # 625",84,25,0,0,109
532732,382458,2014-12-04,House,"House Third Reading: Passed Roll Call # 625",84,25,0,0,109
532732,382569,2014-12-10,Senate,"Reported Favorably Without Amendment",3,0,0,0,3
532758,277475,2013-05-08,House,"Reported With Recommendation Without Amendment",9,0,0,0,9
532758,382418,2014-12-04,House,"House Third Reading: Passed Roll Call # 624",85,24,0,0,109
532758,382578,2014-12-10,Senate,"Reported Favorably Without Amendment",3,0,0,0,3
532758,383229,2014-12-16,Senate,"Senate Third Reading: Given Immediate Effect Roll Call # 814",37,0,0,1,38
532781,277528,2013-05-08,House,"Reported With Recommendation Without Amendment",9,0,0,0,9
532781,382412,2014-12-04,House,"House Third Reading: Passed Roll Call # 623",84,25,0,0,109
532781,382607,2014-12-10,Senate,"Reported Favorably Without Amendment",3,0,0,0,3
532781,383217,2014-12-16,Senate,"Senate Third Reading: Given Immediate Effect Roll Call # 813",37,0,0,1,38
532781,383640,2014-12-17,House,"House Third Reading: Roll Call # 684",80,28,0,0,108
532806,277462,2013-05-08,House,"Reported With Recommendation Without Amendment",9,0,0,0,9
532806,382443,2014-12-04,House,"House Third Reading: Passed Roll Call # 622",85,24,0,0,109
532806,382609,2014-12-10,Senate,"Reported Favorably Without Amendment",3,0,0,0,3
532806,383231,2014-12-16,Senate,"Senate Third Reading: Given Immediate Effect Roll Call # 812",37,0,0,1,38
534076,267618,2013-04-17,Senate,"Reported Favorably Without Amendment",6,1,0,0,7
534076,286892,2013-06-04,Senate,"Senate Third Reading: Passed Roll Call # 227",36,2,0,0,38
534076,347603,2014-03-25,House,"Reported With Recommendation Without Amendment",11,0,0,0,11
534076,369701,2014-06-03,House,"House Third Reading: Given Immediate Effect Roll Call # 341",83,25,0,0,108
534076,369925,2014-06-04,Senate,"Senate Third Reading: House Amendment(s) Concurred In Roll Call # 348",35,2,0,1,38
534084,277004,2013-05-07,House,"Reported With Recommendation With Substitute H-3",12,1,0,0,13
534084,287559,2013-06-06,House,"House Third Reading: Given Immediate Effect Roll Call # 207",87,20,0,0,107
534084,371392,2014-06-12,Senate,"Senate Third Reading: Passed Roll Call # 526",23,14,0,1,38
534084,371393,2014-06-12,House,"House Third Reading: Senate Amendment(s) Concurred In Roll Call # 447",90,20,0,0,110
534098,276964,2013-05-07,House,"Reported With Recommendation With Substitute H-3",11,2,0,0,13
534098,287547,2013-06-06,House,"House Third Reading: Given Immediate Effect Roll Call # 206",81,26,0,0,107
534098,371336,2014-06-12,Senate,"Senate Third Reading: Passed Roll Call # 525",23,14,0,1,38
534098,371337,2014-06-12,House,"House Third Reading: Senate Amendment(s) Concurred In Roll Call # 446",89,21,0,0,110
534111,267899,2013-04-17,House,"Reported With Recommendation Without Amendment",14,0,0,0,14
534111,274284,2013-04-30,House,"House Third Reading: Given Immediate Effect Roll Call # 113",105,4,0,0,109
534111,280427,2013-05-16,Senate,"Reported Favorably Without Amendment",6,0,0,0,6
534111,288118,2013-06-11,Senate,"Senate Third Reading: Given Immediate Effect Roll Call # 241",37,0,0,1,38
534125,267891,2013-04-17,House,"Reported With Recommendation Without Amendment",14,0,0,0,14
534125,274572,2013-04-30,House,"House Third Reading: Given Immediate Effect Roll Call # 112",105,4,0,0,109
534125,280534,2013-05-16,Senate,"Reported Favorably Without Amendment",6,0,0,0,6
534125,288050,2013-06-11,Senate,"Senate Third Reading: Given Immediate Effect Roll Call # 240",37,0,0,1,38
534141,267528,2013-04-17,House,"Reported With Recommendation Without Amendment",14,0,0,0,14
534141,274258,2013-04-30,House,"House Third Reading: Given Immediate Effect Roll Call # 111",105,4,0,0,109
534141,280440,2013-05-16,Senate,"Reported Favorably Without Amendment",6,0,0,0,6
534141,288210,2013-06-11,Senate,"Senate Third Reading: Given Immediate Effect Roll Call # 239",37,0,0,1,38
534141,288935,2013-06-13,House,"House Third Reading: Senate Amendment(s) Concurred In Roll Call # 240",104,3,0,0,107
534153,267567,2013-04-17,House,"Reported With Recommendation Without Amendment",14,0,0,0,14
534153,274497,2013-04-30,House,"House Third Reading: Given Immediate Effect Roll Call # 110",105,4,0,0,109
534153,280345,2013-05-16,Senate,"Reported Favorably Without Amendment",6,0,0,0,6
534153,288082,2013-06-11,Senate,"Senate Third Reading: Given Immediate Effect Roll Call # 238",37,0,0,1,38
534168,267473,2013-04-17,House,"Reported With Recommendation Without Amendment",14,0,0,0,14
534168,274348,2013-04-30,House,"House Third Reading: Given Immediate Effect Roll Call # 109",105,4,0,0,109
534168,280512,2013-05-16,Senate,"Reported Favorably Without Amendment",6,0,0,0,6
534168,288066,2013-06-11,Senate,"Senate Third Reading: Given Immediate Effect Roll Call # 237",37,0,0,1,38
534168,288972,2013-06-13,House,"House Third Reading: Senate Amendment(s) Concurred In Roll Call # 239",104,3,0,0,107
534186,267754,2013-04-17,House,"Reported With Recommendation Without Amendment",14,0,0,0,14
534186,274239,2013-04-30,House,"House Third Reading: Given Immediate Effect Roll Call # 108",105,4,0,0,109
534186,280401,2013-05-16,Senate,"Reported Favorably Without Amendment",6,0,0,0,6
534186,288742,2013-06-13,Senate,"Senate Third Reading: Given Immediate Effect Roll Call # 264",38,0,0,0,38
534186,288969,2013-06-13,House,"House Third Reading:  Roll Call # 242",101,6,0,0,107
534186,382884,2013-06-13,House,"House Third Reading: Roll Call # 242",101,6,0,0,107
534200,267792,2013-04-17,House,"Reported With Recommendation Without Amendment",14,0,0,0,14
534200,274251,2013-04-30,House,"House Third Reading: Given Immediate Effect Roll Call # 107",104,4,0,0,108
534200,280416,2013-05-16,Senate,"Reported Favorably Without Amendment",6,0,0,0,6
534200,288095,2013-06-11,Senate,"Senate Third Reading: Given Immediate Effect Roll Call # 236",37,0,0,1,38
534255,274841,2013-05-01,House,"Reported With Recommendation Without Amendment",16,0,0,0,16
534255,382383,2014-12-04,House,"House Third Reading: Passed Roll Call # 614",95,14,0,0,109
535871,302782,2013-09-24,Senate,"Reported Favorably With Recommendation For Referral To Committee On Education",6,0,0,0,6
535892,252292,2013-03-21,Senate,"Reported Favorably Without Amendment",7,0,0,0,7
535892,303917,2013-10-31,Senate,"Senate Third Reading: Passed Roll Call # 478",33,4,0,1,38
535892,304985,2013-12-04,House,"Reported With Recommendation With Substitute H-2",12,7,0,0,19
535892,338709,2013-12-04,House,"Reported With Recommendation With Substitute  H-2",12,7,0,0,19
535892,383421,2014-12-18,House,"House Third Reading: Given Immediate Effect Roll Call # 717",83,25,0,0,108
535892,383422,2014-12-18,House,"House Third Reading: Passed Roll Call # 719",82,26,0,0,108
535892,383816,2014-12-19,Senate,"Senate Third Reading: Roll Call # 924",31,7,0,0,38
535899,252279,2013-03-21,Senate,"Reported Favorably Without Amendment",7,0,0,0,7
535899,288760,2013-06-13,Senate,"Senate Third Reading: Passed Roll Call # 265",36,2,0,0,38
535899,304977,2013-12-04,House,"Reported With Recommendation With Substitute H-2",10,6,0,0,16
535899,338675,2013-12-04,House,"Reported With Recommendation With Substitute  H-2",10,6,0,0,16
535899,383511,2014-12-18,House,"House Third Reading: Given Immediate Effect Roll Call # 718",83,25,0,0,108
535899,383802,2014-12-19,Senate,"Senate Third Reading: Roll Call # 925",30,7,1,0,38
535908,252294,2013-03-21,Senate,"Reported Favorably Without Amendment",7,0,0,0,7
535908,288827,2013-06-13,Senate,"Senate Third Reading: Passed Roll Call # 266",36,2,0,0,38
535908,304981,2013-12-04,House,"Reported With Recommendation With Substitute H-4",13,6,0,0,19
535908,339450,2013-12-04,House,"Reported With Recommendation With Substitute  H-4",13,6,0,0,19
535908,383665,2014-12-18,House,"House Third Reading: Given Immediate Effect Roll Call # 720",83,25,0,0,108
535908,383829,2014-12-19,Senate,"Senate Third Reading: Roll Call # 926",30,8,0,0,38
535917,252295,2013-03-21,Senate,"Reported Favorably Without Amendment",7,0,0,0,7
535917,288771,2013-06-13,Senate,"Senate Third Reading: Passed Roll Call # 267",37,1,0,0,38
535917,304982,2013-12-04,House,"Reported With Recommendation Without Amendment",13,4,0,0,17
535917,383676,2014-12-19,House,"House Third Reading: Given Immediate Effect Roll Call # 794",79,31,0,0,110
535917,383801,2014-12-19,Senate,"Senate Third Reading: Roll Call # 928",31,7,0,0,38
535925,305124,2013-12-10,Senate,"Reported Favorably With Substitute S-1",7,0,0,0,7
535925,313981,2014-01-30,Senate,"Senate Third Reading: Passed Roll Call # 9",34,3,0,1,38
535942,289023,2013-06-13,Senate,"Reported Favorably With Substitute S-1",3,0,0,0,3
535942,305402,2013-12-12,Senate,"Senate Third Reading: Passed Roll Call # 662",26,12,0,0,38
535942,379364,2014-09-10,House,"Reported With Recommendation With Substitute  H-1",6,3,0,0,9
535942,382337,2014-12-03,House,"House Third Reading: Passed Roll Call # 598",75,34,0,0,109
535942,382620,2014-12-10,Senate,"Senate Third Reading:  Roll Call # 737",26,10,0,2,38
535942,382730,2014-12-10,Senate,"Senate Third Reading: Roll Call # 737",26,10,0,2,38
535950,288975,2013-06-13,Senate,"Reported Favorably With Substitute S-1",3,0,0,0,3
535950,300646,2013-09-18,Senate,"Senate Third Reading: Passed Roll Call # 363",27,9,0,2,38
535950,330568,2014-02-26,House,"Reported With Recommendation Without Amendment",6,0,0,0,6
535950,339779,2014-03-11,House,"House Third Reading: Given Immediate Effect Roll Call # 90",91,19,0,0,110
535958,303148,2013-10-02,Senate,"Reported Favorably With Substitute S-1",7,0,0,0,7
535958,303434,2013-10-15,Senate,"Senate Third Reading: Passed Roll Call # 404",38,0,0,0,38
535958,379156,2014-09-09,House,"Reported With Recommendation Without Amendment",15,0,0,0,15
535958,380121,2014-09-23,House,"House Third Reading: Passed Roll Call # 494",101,7,0,0,108
535963,252324,2013-03-21,Senate,"Reported Favorably Without Amendment",7,0,0,0,7
535995,282638,2013-05-21,House,"Reported With Recommendation Without Amendment",9,0,0,0,9
535995,288829,2013-06-13,House,"House Third Reading: Given Immediate Effect Roll Call # 233",107,0,0,0,107
535995,348610,2014-03-27,Senate,"Reported Favorably With Substitute S-1",7,0,0,0,7
535995,348611,2014-03-27,Senate,"Senate Third Reading: Given Immediate Effect Roll Call # 165",37,0,0,1,38
535995,348612,2014-03-27,House,"House Third Reading:  Roll Call # 177",108,0,0,0,108
535995,383002,2014-03-27,House,"House Third Reading: Roll Call # 177",108,0,0,0,108
536107,268949,2013-04-18,House,"Reported With Recommendation Without Amendment",16,0,0,0,16
536107,271599,2013-04-24,House,"House Third Reading: Given Immediate Effect Roll Call # 93",109,1,0,0,110
536107,275612,2013-05-02,Senate,"Reported Favorably With Substitute S-1",5,0,0,0,5
536107,278127,2013-05-09,Senate,"Senate Third Reading: Given Immediate Effect Roll Call # 162",34,1,0,2,37
536107,279324,2013-05-14,House,"House Third Reading:  Roll Call # 124",106,1,0,0,107
536107,382687,2013-05-14,House,"House Third Reading: Roll Call # 124",106,1,0,0,107
536161,304489,2013-11-14,House,"Reported With Recommendation With Substitute H-4",15,0,0,0,15
536161,305024,2013-12-05,House,"House Third Reading: Given Immediate Effect Roll Call # 461",108,2,0,0,110
536161,335481,2014-03-05,Senate,"Reported Favorably Without Amendment",7,0,0,0,7
536161,348246,2014-03-26,Senate,"Senate Third Reading: Given Immediate Effect Roll Call # 139",36,0,1,1,38
536552,271268,2013-04-23,Senate,"Reported Favorably Without Amendment",7,0,0,0,7
536552,277063,2013-05-07,Senate,"Senate Third Reading: Passed Roll Call # 160",37,0,0,0,37
536552,282438,2013-05-21,House,"Reported With Recommendation Without Amendment",12,0,0,0,12
536572,279877,2013-05-15,House,"Reported With Recommendation Without Amendment",13,0,0,0,13
536590,381539,2014-11-06,Senate,"Reported Favorably With Substitute  S-1",5,1,0,0,6
536590,381758,2014-11-13,Senate,"Senate Third Reading: Passed Roll Call # 658",30,6,1,1,38
536624,313971,2014-01-30,House,"Reported With Recommendation With Substitute H-1",10,0,0,0,10
536624,321207,2014-02-13,House,"House Third Reading: Given Immediate Effect Roll Call # 45",102,8,0,0,110
536624,346633,2014-03-20,Senate,"Reported Favorably With Substitute  S-1",4,0,0,0,4
536624,369652,2014-06-03,Senate,"Senate Third Reading: Given Immediate Effect Roll Call # 345",38,0,0,0,38
536624,370578,2014-06-10,House,"House Third Reading:  Roll Call # 371",102,8,0,0,110
536624,382671,2014-06-10,House,"House Third Reading: Roll Call # 371",102,8,0,0,110
536650,304988,2013-12-04,House,"Reported With Recommendation With Substitute H-2",19,0,0,0,19
536650,338989,2013-12-04,House,"Reported With Recommendation With Substitute  H-2",19,0,0,0,19
536650,381704,2014-11-13,House,"House Third Reading: Given Immediate Effect Roll Call # 574",106,1,0,0,107
536650,382431,2014-12-04,Senate,"Reported Favorably Without Amendment",7,0,0,0,7
536650,383303,2014-12-17,Senate,"Senate Third Reading: Given Immediate Effect Roll Call # 827",37,0,0,1,38
536674,304946,2013-12-04,House,"Reported With Recommendation With Substitute H-5",12,6,0,0,18
536674,339253,2013-12-04,House,"Reported With Recommendation With Substitute  H-5",12,6,0,0,18
536674,381700,2014-11-13,House,"House Third Reading: Given Immediate Effect Roll Call # 575",77,30,0,0,107
536674,382417,2014-12-04,Senate,"Reported Favorably Without Amendment",6,0,0,0,6
536674,383367,2014-12-17,Senate,"Senate Third Reading: Given Immediate Effect Roll Call # 828",28,9,0,1,38
536701,302797,2013-09-24,House,"Reported With Recommendation With Substitute H-1",13,1,0,0,14
536701,304129,2013-11-07,House,"House Third Reading: Given Immediate Effect Roll Call # 384",89,20,0,0,109
536701,335283,2014-03-04,Senate,"Reported Favorably Without Amendment",7,0,0,0,7
536701,346525,2014-03-20,Senate,"Senate Third Reading: Given Immediate Effect Roll Call # 135",34,2,1,1,38
536726,304940,2013-12-04,House,"Reported With Recommendation With Substitute H-3",19,0,0,0,19
536726,339782,2013-12-04,House,"Reported With Recommendation With Substitute  H-3",19,0,0,0,19
536726,381711,2014-11-13,House,"House Third Reading: Given Immediate Effect Roll Call # 573",107,0,0,0,107
536726,382426,2014-12-04,Senate,"Reported Favorably Without Amendment",7,0,0,0,7
536726,383316,2014-12-17,Senate,"Senate Third Reading: Given Immediate Effect Roll Call # 826",37,0,0,1,38
536726,383612,2014-12-18,House,"House Third Reading: Roll Call # 705",108,1,0,0,109
536726,383731,2014-12-18,Senate,"Senate Third Reading: Roll Call # 866",38,0,0,0,38
536752,303060,2013-10-01,House,"Reported With Recommendation With Substitute H-3",11,1,0,0,12
536752,304121,2013-11-07,House,"House Third Reading: Given Immediate Effect Roll Call # 387",58,51,0,0,109
536752,382570,2014-12-10,Senate,"Reported Favorably With Substitute  S-1",6,1,0,0,7
536752,383364,2014-12-17,Senate,"Senate Third Reading: Given Immediate Effect Roll Call # 855",34,3,0,1,38
536752,383440,2014-12-18,House,"House Third Reading: Roll Call # 767",57,53,0,0,110
537210,275595,2013-05-01,Senate,"Reported Favorably Without Amendment",8,0,0,0,8
537210,280172,2013-05-14,Senate,"Senate Third Reading: Passed Roll Call # 169",35,3,0,0,38
537210,288173,2013-06-11,House,"Reported With Recommendation With Substitute H-1",17,0,0,0,17
537210,288882,2013-06-13,House,"House Third Reading: Given Immediate Effect Roll Call # 234",86,21,0,0,107
537210,289713,2013-06-18,Senate,"Senate Third Reading:  Roll Call # 276",34,4,0,0,38
537210,382993,2013-06-18,Senate,"Senate Third Reading: Roll Call # 276",34,4,0,0,38
537223,267837,2013-04-17,Senate,"Reported Favorably Without Amendment",3,0,0,0,3
537223,304413,2013-11-13,Senate,"Senate Third Reading: Passed Roll Call # 514",38,0,0,0,38
537223,313353,2014-01-29,House,"Reported With Recommendation With Amendment(s)",9,0,0,0,9
537249,310994,2014-01-22,House,"Reported With Recommendation Without Amendment",14,5,0,0,19
537249,323569,2014-02-18,House,"House Third Reading: Given Immediate Effect Roll Call # 51",81,27,0,0,108
537249,348523,2014-03-27,Senate,"Reported Favorably Without Amendment",7,0,0,0,7
537277,267882,2013-04-17,Senate,"Reported Favorably With Substitute S-1",3,0,0,0,3
537277,304390,2013-11-13,Senate,"Senate Third Reading: Passed Roll Call # 513",38,0,0,0,38
537277,313643,2014-01-29,House,"Reported With Recommendation With Amendment(s)",9,0,0,0,9
537316,282258,2013-05-21,Senate,"Reported Favorably Without Amendment",4,0,0,0,4
537316,282745,2013-05-22,Senate,"Senate Third Reading: Passed Roll Call # 210",36,1,0,1,38
537316,289786,2013-06-18,House,"Reported With Recommendation Without Amendment",9,0,0,0,9
537332,304959,2013-12-04,House,"Reported With Recommendation With Substitute H-4",8,0,0,0,8
537332,315644,2014-02-04,House,"House Third Reading: Given Immediate Effect Roll Call # 24",109,1,0,0,110
537332,382446,2014-12-04,Senate,"Reported Favorably With Substitute  S-2",4,0,0,0,4
543528,270888,2013-04-23,House,"Reported With Recommendation Without Amendment",15,0,0,0,15
543528,271598,2013-04-24,House,"House Third Reading:  Roll Call # 90",109,0,0,0,109
543528,382637,2013-04-24,House,"House Third Reading: Roll Call # 90",109,0,0,0,109
543536,266573,2013-04-16,Senate,"Reported Favorably Without Amendment",5,2,0,0,7
543536,273303,2013-04-25,Senate,"Senate Third Reading: Passed Roll Call # 121",27,9,0,1,37
543536,275270,2013-05-01,House,"Reported With Recommendation Without Amendment",8,0,0,0,8
543536,275696,2013-05-02,House,"House Third Reading: Given Immediate Effect Roll Call # 118",89,21,0,0,110
543554,266470,2013-04-16,Senate,"Reported Favorably With Substitute S-1",5,2,0,0,7
543554,273250,2013-04-25,Senate,"Senate Third Reading: Passed Roll Call # 120",25,11,0,1,37
543554,274910,2013-05-01,House,"Reported With Recommendation Without Amendment",8,0,0,0,8
543554,275840,2013-05-02,House,"House Third Reading: Given Immediate Effect Roll Call # 117",72,38,0,0,110
543562,279906,2013-05-15,House,"Reported With Recommendation Without Amendment",13,0,0,0,13
543751,303786,2013-10-24,House,"Reported With Recommendation Without Amendment",12,0,0,0,12
543751,304535,2013-11-14,House,"House Third Reading: Given Immediate Effect Roll Call # 420",110,0,0,0,110
544118,303214,2013-10-03,Senate,"Reported Favorably With Recommendation For Referral To Committee On Banking And Financial Institutions",7,0,0,0,7
544118,329056,2014-02-25,Senate,"Reported Favorably With Substitute S-4",7,0,0,0,7
544118,337447,2014-02-25,Senate,"Reported Favorably With Substitute  S-4",7,0,0,0,7
544118,382848,2014-12-11,Senate,"Senate Third Reading: Passed Roll Call # 772",36,1,0,1,38
544118,383584,2014-12-18,House,"House Third Reading: Given Immediate Effect Roll Call # 713",107,2,0,0,109
544118,383699,2014-12-18,Senate,"Senate Third Reading: Roll Call # 894",37,1,0,0,38
544146,288885,2013-06-13,Senate,"Senate Third Reading: Passed Roll Call # 273",32,6,0,0,38
544146,289997,2013-06-19,House,"House Third Reading: Given Immediate Effect Roll Call # 250",102,7,0,0,109
544146,290425,2013-06-20,House,"House Third Reading: Passed Roll Call # 251",102,7,0,0,109
544146,290426,2013-06-20,Senate,"Senate Third Reading: House Amendment(s) Concurred In Roll Call # 323",36,1,0,1,38
544219,288865,2013-06-13,Senate,"Senate Third Reading: Passed Roll Call # 272",32,6,0,0,38
544225,279788,2013-05-15,Senate,"Reported Favorably Without Amendment",4,0,0,0,4
544225,282819,2013-05-22,Senate,"Senate Third Reading: Passed Roll Call # 205",37,0,0,1,38
544319,282759,2013-05-22,House,"Reported With Recommendation Without Amendment",11,0,0,0,11
544319,288967,2013-06-13,House,"House Third Reading: Given Immediate Effect Roll Call # 236",101,6,0,0,107
544366,282786,2013-05-22,House,"Reported With Recommendation With Substitute H-2",10,0,0,0,10
544366,288973,2013-06-13,House,"House Third Reading: Given Immediate Effect Roll Call # 235",101,6,0,0,107
544366,289928,2013-06-19,Senate,"Senate Third Reading: Given Immediate Effect Roll Call # 297",33,4,1,0,38
544449,271011,2013-04-23,House,"Reported With Recommendation Without Amendment",13,0,0,0,13
544449,274858,2013-05-01,House,"House Third Reading: Given Immediate Effect Roll Call # 115",110,0,0,0,110
544449,364057,2014-05-13,Senate,"Reported Favorably Without Amendment",6,0,0,0,6
544449,369681,2014-06-03,Senate,"Senate Third Reading: Given Immediate Effect Roll Call # 342",38,0,0,0,38
544490,268906,2013-04-18,House,"Reported With Recommendation With Substitute H-2",10,0,0,0,10
544490,272396,2013-04-25,House,"House Third Reading: Given Immediate Effect Roll Call # 95",106,2,0,0,108
544490,304154,2013-11-07,Senate,"Reported Favorably With Substitute S-1",3,0,0,0,3
544490,305018,2013-12-05,Senate,"Senate Third Reading: Given Immediate Effect Roll Call # 560",36,0,0,2,38
544490,305123,2013-12-10,House,"House Third Reading:  Roll Call # 467",109,0,0,0,109
544490,382987,2013-12-10,House,"House Third Reading: Roll Call # 467",109,0,0,0,109
544514,287242,2013-06-05,House,"Reported With Recommendation With Substitute H-2",10,1,0,0,11
544514,288536,2013-06-12,House,"House Third Reading: Given Immediate Effect Roll Call # 224",107,0,0,0,107
544514,299221,2013-09-10,Senate,"Reported Favorably Without Amendment",4,0,0,0,4
544514,299876,2013-09-18,Senate,"Senate Third Reading: Given Immediate Effect Roll Call # 360",35,0,0,3,38
544559,317226,2014-02-06,House,"Reported With Recommendation With Substitute H-7",9,0,0,0,9
544559,338608,2014-02-06,House,"Reported With Recommendation With Substitute  H-7",9,0,0,0,9
544559,371330,2014-06-12,House,"House Third Reading: Given Immediate Effect Roll Call # 421",98,12,0,0,110
544559,380247,2014-10-01,Senate,"Reported Favorably Without Amendment",4,0,0,0,4
544805,303296,2013-10-08,Senate,"Reported Favorably With Substitute S-3",5,0,0,0,5
544805,303538,2013-10-17,Senate,"Senate Third Reading: Passed Roll Call # 419",38,0,0,0,38
544805,305306,2013-12-11,House,"Reported With Recommendation Without Amendment",15,1,0,0,16
544805,305383,2013-12-12,House,"House Third Reading: Given Immediate Effect Roll Call # 500",96,13,0,0,109
544814,303280,2013-10-08,Senate,"Reported Favorably With Substitute S-1",3,1,0,0,4
544814,337001,2013-10-08,Senate,"Reported Favorably With Substitute  S-1",3,1,0,0,4
544814,369885,2014-06-04,Senate,"Senate Third Reading: Passed Roll Call # 364",33,3,1,1,38
544814,382463,2014-12-04,House,"Reported With Recommendation With Substitute H-2",7,5,0,0,12
544833,299318,2013-09-10,Senate,"Reported Favorably Without Amendment",4,0,0,0,4
544833,302835,2013-09-26,Senate,"Senate Third Reading: Passed Roll Call # 373",37,0,0,1,38
544877,273247,2013-04-25,Senate,"Reported Favorably Without Amendment",14,0,0,0,14
544898,278346,2013-05-09,Senate,"Reported Favorably Without Amendment",6,0,0,0,6
544898,281939,2013-05-21,Senate,"Senate Third Reading: Passed Roll Call # 198",37,1,0,0,38
544898,305241,2013-12-11,House,"Reported With Recommendation Without Amendment",15,0,0,0,15
544898,305353,2013-12-12,House,"House Third Reading: Passed Roll Call # 499",95,14,0,0,109
544898,305354,2013-12-12,Senate,"Senate Third Reading:  Roll Call # 665",37,1,0,0,38
544898,383081,2013-12-12,Senate,"Senate Third Reading: Roll Call # 665",37,1,0,0,38
544908,303308,2013-10-08,Senate,"Reported Favorably With Substitute S-1",4,0,0,0,4
544908,303469,2013-10-16,Senate,"Senate Third Reading: Passed Roll Call # 407",37,0,0,1,38
544908,382475,2014-12-04,House,"Reported With Recommendation With Substitute  H-1",10,2,0,0,12
544945,277502,2013-05-08,House,"Reported With Recommendation With Substitute H-1",14,0,0,0,14
544945,279999,2013-05-15,House,"House Third Reading: Given Immediate Effect Roll Call # 147",108,0,0,0,108
544945,289494,2013-06-18,Senate,"Reported Favorably With Substitute S-1",6,0,0,0,6
544945,290303,2013-06-20,Senate,"Senate Third Reading: Given Immediate Effect Roll Call # 326",38,0,0,0,38
544945,290304,2013-06-20,House,"House Third Reading:  Roll Call # 263",109,0,0,0,109
544945,383068,2013-06-20,House,"House Third Reading: Roll Call # 263",109,0,0,0,109
544995,382346,2014-12-03,House,"Reported With Recommendation With Substitute  H-2",27,0,0,0,27
544995,382669,2014-12-10,House,"House Third Reading: Given Immediate Effect Roll Call # 657",92,17,0,0,109
544995,383297,2014-12-17,Senate,"Senate Third Reading: Given Immediate Effect Roll Call # 849",31,6,0,1,38
544995,383425,2014-12-18,House,"House Third Reading: Roll Call # 760",93,17,0,0,110
545072,303232,2013-10-03,House,"Reported With Recommendation With Substitute H-2",9,2,0,0,11
545072,338929,2013-10-03,House,"Reported With Recommendation With Substitute  H-2",9,2,0,0,11
545072,371335,2014-06-12,House,"House Third Reading: Given Immediate Effect Roll Call # 424",105,5,0,0,110
545072,380013,2014-09-18,Senate,"Reported Favorably With Substitute  S-2",4,0,0,0,4
545072,380289,2014-10-01,Senate,"Senate Third Reading: Given Immediate Effect Roll Call # 593",36,0,0,2,38
545072,380371,2014-10-02,House,"House Third Reading:  Roll Call # 540",103,4,0,0,107
545072,380372,2014-10-02,Senate,"Senate Third Reading:  Roll Call # 637",38,0,0,0,38
545072,382974,2014-10-02,House,"House Third Reading: Roll Call # 540",103,4,0,0,107
545072,382975,2014-10-02,Senate,"Senate Third Reading: Roll Call # 637",38,0,0,0,38
545121,277720,2013-05-08,House,"Reported With Recommendation With Substitute H-1",14,0,0,0,14
545121,279798,2013-05-15,House,"House Third Reading: Given Immediate Effect Roll Call # 148",108,0,0,0,108
545121,289509,2013-06-18,Senate,"Reported Favorably With Substitute S-1",7,0,0,0,7
545121,290312,2013-06-20,Senate,"Senate Third Reading: Passed Roll Call # 327",38,0,0,0,38
545121,290839,2013-06-20,Senate,"Senate Third Reading: Given Immediate Effect Roll Call # 327",38,0,0,0,38
545121,298138,2013-08-27,Senate,"Senate Third Reading: Passed Roll Call # 335",37,0,0,1,38
545121,299325,2013-09-10,House,"House Third Reading:  Roll Call # 270",107,1,0,0,108
545121,382969,2013-09-10,House,"House Third Reading: Roll Call # 270",107,1,0,0,108
545148,382386,2014-12-04,House,"House Third Reading: Passed Roll Call # 632",56,53,0,0,109
545148,382804,2014-12-11,Senate,"Senate Third Reading: Passed Roll Call # 758",22,13,2,1,38
545148,382805,2014-12-11,House,"House Third Reading: Roll Call # 669",0,106,0,0,106
545148,383675,2014-12-19,House,"House Third Reading: Conference Report Adopted Roll Call # 779",88,22,0,0,110
545148,383797,2014-12-19,Senate,"Senate Third Reading: Senate Adopted Conference Report Roll Call # 920",23,15,0,0,38
546129,302257,2013-09-19,Senate,"Reported Favorably With Substitute S-2",4,0,0,0,4
546129,303789,2013-10-24,Senate,"Senate Third Reading: Passed Roll Call # 453",36,0,0,2,38
546129,304976,2013-12-04,House,"Reported With Recommendation With Substitute H-1",9,2,0,0,11
546129,316144,2014-02-04,House,"House Third Reading: Given Immediate Effect Roll Call # 28",62,48,0,0,110
546129,319996,2014-02-12,Senate,"Senate Third Reading:  Roll Call # 15",28,10,0,0,38
546129,382883,2014-02-12,Senate,"Senate Third Reading: Roll Call # 15",28,10,0,0,38
546137,289859,2013-06-18,Senate,"Reported Favorably Without Amendment",5,0,0,0,5
546137,299860,2013-09-17,Senate,"Senate Third Reading: Passed Roll Call # 354",36,0,0,2,38
546148,302691,2013-09-19,Senate,"Reported Favorably With Substitute S-1",4,0,0,0,4
546148,303788,2013-10-24,Senate,"Senate Third Reading: Passed Roll Call # 451",36,0,0,2,38
546148,304975,2013-12-04,House,"Reported With Recommendation Without Amendment",9,1,0,0,10
546166,382455,2014-12-04,Senate,"Senate Third Reading: Passed Roll Call # 721",37,0,0,1,38
546166,382646,2014-12-09,House,"Reported With Recommendation Without Amendment",14,0,0,0,14
546166,383433,2014-12-18,House,"House Third Reading: Passed Roll Call # 722",109,0,0,0,109
546166,383792,2014-12-18,Senate,"Senate Third Reading: Roll Call # 895",38,0,0,0,38
546202,299582,2013-09-11,House,"Reported With Recommendation With Substitute H-1",8,1,0,0,9
546202,316376,2014-02-05,House,"House Third Reading: Given Immediate Effect Roll Call # 29",101,7,0,0,108
546202,326032,2014-02-20,Senate,"Reported Favorably Without Amendment",4,0,0,0,4
546202,371003,2014-06-11,Senate,"Senate Third Reading: Given Immediate Effect Roll Call # 433",37,1,0,0,38
546202,371394,2014-06-12,House,"House Third Reading: Senate Amendment(s) Concurred In Roll Call # 430",99,11,0,0,110
546237,299467,2013-09-11,House,"Reported With Recommendation Without Amendment",8,1,0,0,9
546237,316506,2014-02-05,House,"House Third Reading: Given Immediate Effect Roll Call # 30",100,8,0,0,108
546237,326077,2014-02-20,Senate,"Reported Favorably Without Amendment",4,0,0,0,4
546237,371114,2014-06-11,Senate,"Senate Third Reading: Given Immediate Effect Roll Call # 434",37,1,0,0,38
546237,371284,2014-06-12,House,"House Third Reading: Senate Amendment(s) Concurred In Roll Call # 432",98,12,0,0,110
546252,303535,2013-10-17,House,"Reported With Recommendation With Amendment(s)",11,0,0,0,11
546252,303896,2013-10-30,House,"House Third Reading: Given Immediate Effect Roll Call # 360",108,0,0,0,108
546252,305249,2013-12-11,Senate,"Reported Favorably Without Amendment",4,0,0,0,4
546252,315484,2014-02-04,Senate,"Senate Third Reading: Given Immediate Effect Roll Call # 11",38,0,0,0,38
546285,277143,2013-05-07,House,"Reported With Recommendation With Substitute H-2",9,6,0,0,15
546285,305030,2013-12-05,House,"House Third Reading: Passed Roll Call # 463",84,26,0,0,110
546285,365797,2014-05-20,Senate,"Reported Favorably With Substitute  S-5",5,2,0,0,7
546314,276952,2013-05-07,House,"Reported With Recommendation With Substitute H-2",9,6,0,0,15
546314,305039,2013-12-05,House,"House Third Reading: Passed Roll Call # 464",85,25,0,0,110
546314,365775,2014-05-20,Senate,"Reported Favorably With Substitute  S-2",5,2,0,0,7
546314,381703,2014-11-13,Senate,"Senate Third Reading: Given Immediate Effect Roll Call # 684",32,4,0,2,38
546338,365773,2014-05-20,House,"Reported With Recommendation For Referral To Committee On Michigan Competitiveness",14,0,0,0,14
546373,279855,2013-05-15,House,"Reported With Recommendation With Amendment(s)",14,1,0,0,15
546373,304483,2013-11-14,House,"House Third Reading: Passed Roll Call # 442",73,37,0,0,110
546373,305228,2013-12-11,Senate,"Senate Third Reading: Passed Roll Call # 593",36,1,0,1,38
546588,289598,2013-06-18,Senate,"Reported Favorably With Substitute S-4",7,1,0,0,8
546588,337376,2013-06-18,Senate,"Reported Favorably With Substitute  S-4",7,1,0,0,8
546588,371387,2014-06-12,Senate,"Senate Third Reading: Passed Roll Call # 500",37,0,1,0,38
546651,279986,2013-05-15,Senate,"Reported Favorably Without Amendment",4,0,0,0,4
546651,282747,2013-05-22,Senate,"Senate Third Reading: Passed Roll Call # 206",37,0,0,1,38
546651,303532,2013-10-17,House,"Reported With Recommendation Without Amendment",10,1,0,0,11
546651,305223,2013-12-11,House,"House Third Reading: Given Immediate Effect Roll Call # 483",57,27,0,0,84
546715,288460,2013-06-12,Senate,"Reported Favorably Without Amendment",7,0,0,0,7
546755,367555,2014-05-27,House,"Reported With Recommendation With Substitute  H-2",14,0,0,0,14
546755,370650,2014-06-10,House,"House Third Reading: Given Immediate Effect Roll Call # 384",105,4,0,0,109
546755,382587,2014-12-09,Senate,"Senate Third Reading: Given Immediate Effect Roll Call # 732",37,0,0,1,38
546755,382680,2014-12-09,House,"House Third Reading: Roll Call # 646",97,12,0,0,109
546783,288995,2013-06-13,Senate,"Reported Favorably With Substitute S-2",6,0,0,0,6
546814,312767,2014-01-28,House,"Reported With Recommendation With Substitute H-4",12,0,0,0,12
546814,338724,2014-01-28,House,"Reported With Recommendation With Substitute  H-4",12,0,0,0,12
546814,363507,2014-05-08,House,"House Third Reading: Given Immediate Effect Roll Call # 218",108,1,0,0,109
546814,367708,2014-05-27,Senate,"Reported Favorably With Substitute  S-1",7,0,0,0,7
546814,369838,2014-06-04,Senate,"Senate Third Reading: Given Immediate Effect Roll Call # 350",36,1,0,1,38
546814,370542,2014-06-10,House,"House Third Reading:  Roll Call # 372",109,1,0,0,110
546814,383098,2014-06-10,House,"House Third Reading: Roll Call # 372",109,1,0,0,110
546826,276977,2013-05-07,House,"Reported With Recommendation With Amendment(s)",13,0,0,0,13
546826,279469,2013-05-14,House,"House Third Reading: Given Immediate Effect Roll Call # 128",108,0,0,0,108
546826,288326,2013-06-11,Senate,"Reported Favorably With Substitute S-1",6,0,0,0,6
546826,290033,2013-06-19,Senate,"Senate Third Reading: Given Immediate Effect Roll Call # 294",38,0,0,0,38
546826,290487,2013-06-20,House,"House Third Reading:  Roll Call # 255",109,0,0,0,109
546826,383036,2013-06-20,House,"House Third Reading: Roll Call # 255",109,0,0,0,109
546853,287240,2013-06-05,House,"Reported With Recommendation With Substitute H-1",16,1,0,0,17
546853,289907,2013-06-19,House,"House Third Reading: Given Immediate Effect Roll Call # 246",99,10,0,0,109
546885,288074,2013-06-11,House,"Reported With Recommendation With Substitute H-2",13,0,0,0,13
546885,305413,2013-12-12,House,"House Third Reading: Given Immediate Effect Roll Call # 506",102,7,0,0,109
546885,345286,2014-03-18,Senate,"Reported Favorably Without Amendment",6,0,0,0,6
546885,383173,2014-12-15,Senate,"Senate Third Reading: Given Immediate Effect Roll Call # 782",32,6,0,0,38
546885,383272,2014-12-17,House,"House Third Reading: Roll Call # 692",102,7,0,0,109
546885,383728,2014-12-18,Senate,"Senate Third Reading: Roll Call # 861",37,0,1,0,38
547123,273304,2013-04-25,Senate,"Senate Third Reading: Adopted By 2/3 Vote Roll Call # 122",25,11,0,1,37
547201,299861,2013-09-17,House,"Reported With Recommendation With Substitute H-2",12,0,0,0,12
547201,302811,2013-09-25,House,"House Third Reading: Given Immediate Effect Roll Call # 296",107,0,0,0,107
547201,303750,2013-10-22,Senate,"Reported Favorably Without Amendment",7,0,0,0,7
547201,304054,2013-11-06,Senate,"Senate Third Reading: Given Immediate Effect Roll Call # 489",37,0,0,1,38
547209,274848,2013-05-01,House,"Reported With Recommendation Without Amendment",14,0,0,0,14
547209,279451,2013-05-14,House,"House Third Reading: Given Immediate Effect Roll Call # 126",108,0,0,0,108
547209,303068,2013-10-01,Senate,"Reported Favorably Without Amendment",7,0,0,0,7
547209,303297,2013-10-08,Senate,"Senate Third Reading: Given Immediate Effect Roll Call # 391",38,0,0,0,38
547248,281933,2013-05-21,House,"Reported With Recommendation Without Amendment",18,0,0,0,18
547248,282860,2013-05-22,House,"House Third Reading: Given Immediate Effect Roll Call # 156",105,2,0,0,107
547248,287292,2013-06-05,Senate,"Reported Favorably With Substitute S-2",9,0,0,0,9
547248,288183,2013-06-05,Senate,"Reported Favorably Without Amendment",9,0,0,0,9
547248,288570,2013-06-12,Senate,"Senate Third Reading: Given Immediate Effect Roll Call # 253",37,0,0,1,38
547287,303084,2013-10-01,House,"Reported With Recommendation With Substitute H-2",11,3,0,0,14
547287,303921,2013-10-31,House,"House Third Reading: Passed Roll Call # 365",98,9,0,0,107
547287,305023,2013-12-05,Senate,"Reported Favorably With Substitute S-3",7,0,0,0,7
547287,305317,2013-12-11,Senate,"Senate Third Reading: Given Immediate Effect Roll Call # 614",38,0,0,0,38
547287,345836,2014-03-19,House,"House Third Reading:  Roll Call # 125",98,12,0,0,110
547287,346549,2014-03-20,Senate,"Senate Third Reading:  Roll Call # 124",30,6,1,1,38
547287,346550,2014-03-20,Senate,"Senate Third Reading:  Roll Call # 125",31,6,0,1,38
547287,382649,2014-03-19,House,"House Third Reading: Roll Call # 125",98,12,0,0,110
547287,382650,2014-03-20,Senate,"Senate Third Reading: Roll Call # 124",30,6,1,1,38
547287,382651,2014-03-20,Senate,"Senate Third Reading: Roll Call # 125",31,6,0,1,38
547298,303102,2013-10-01,House,"Reported With Recommendation With Substitute H-1",12,3,0,0,15
547298,303922,2013-10-31,House,"House Third Reading: Passed Roll Call # 366",99,8,0,0,107
547298,305032,2013-12-05,Senate,"Reported Favorably Without Amendment",7,0,0,0,7
547298,305300,2013-12-11,Senate,"Senate Third Reading: Given Immediate Effect Roll Call # 616",38,0,0,0,38
547344,281952,2013-05-21,House,"Reported With Recommendation With Substitute H-3",18,0,0,0,18
547344,282888,2013-05-22,House,"House Third Reading: Given Immediate Effect Roll Call # 155",105,2,0,0,107
547344,287357,2013-06-05,Senate,"Reported Favorably With Substitute S-2",9,0,0,0,9
547344,288629,2013-06-12,Senate,"Senate Third Reading: Given Immediate Effect Roll Call # 252",37,0,0,1,38
547344,288630,2013-06-12,House,"House Third Reading:  Roll Call # 221",106,2,0,0,108
547344,382920,2013-06-12,House,"House Third Reading: Roll Call # 221",106,2,0,0,108
547475,288436,2013-06-12,Senate,"Reported Favorably Without Amendment",4,0,0,0,4
547475,299522,2013-09-11,Senate,"Senate Third Reading: Passed Roll Call # 342",37,0,0,1,38
547475,299523,2013-09-11,Senate,"Senate Third Reading: Passed Roll Call # 343",37,0,0,1,38
547475,380262,2014-10-01,House,"Reported With Recommendation Without Amendment",7,1,0,0,8
547475,383670,2014-12-19,House,"House Third Reading: Given Immediate Effect Roll Call # 801",95,15,0,0,110
548078,304299,2013-11-12,House,"Reported With Recommendation Without Amendment",15,0,0,0,15
548078,348478,2014-03-27,House,"House Third Reading: Given Immediate Effect Roll Call # 181",108,0,0,0,108
548078,381516,2014-11-06,Senate,"Reported Favorably Without Amendment",7,0,0,0,7
548078,383232,2014-12-16,Senate,"Senate Third Reading: Given Immediate Effect Roll Call # 795",37,0,0,1,38
548094,276871,2013-05-07,House,"Reported With Recommendation With Substitute H-1",10,5,0,0,15
548094,338678,2013-05-07,House,"Reported With Recommendation With Substitute  H-1",10,5,0,0,15
548117,284684,2013-05-28,Senate,"Reported Favorably Without Amendment",6,0,0,0,6
548117,285191,2013-05-29,Senate,"Senate Third Reading: Passed Roll Call # 220",36,0,0,2,38
548117,369879,2014-06-04,House,"Reported With Recommendation With Substitute  H-1",14,0,0,0,14
548117,371007,2014-06-11,House,"House Third Reading: Given Immediate Effect Roll Call # 410",109,1,0,0,110
548117,371397,2014-06-12,Senate,"Senate Third Reading:  Roll Call # 463",36,1,1,0,38
548117,383011,2014-06-12,Senate,"Senate Third Reading: Roll Call # 463",36,1,1,0,38
548171,287417,2013-06-05,House,"Reported With Recommendation With Substitute H-3",13,0,0,0,13
548171,288804,2013-06-13,House,"House Third Reading: Given Immediate Effect Roll Call # 227",107,0,0,0,107
548171,303472,2013-10-16,Senate,"Reported Favorably With Substitute S-1",5,0,0,0,5
548171,303897,2013-10-30,Senate,"Senate Third Reading: Given Immediate Effect Roll Call # 468",36,0,0,2,38
548171,303961,2013-11-05,House,"House Third Reading:  Roll Call # 367",108,0,0,0,108
548171,382959,2013-11-05,House,"House Third Reading: Roll Call # 367",108,0,0,0,108
548356,303466,2013-10-16,House,"Reported With Recommendation With Substitute H-2",15,0,0,0,15
548429,304309,2013-11-12,Senate,"Reported Favorably With Substitute S-1",7,0,0,0,7
548429,304406,2013-11-13,Senate,"Senate Third Reading: Passed Roll Call # 518",38,0,0,0,38
548429,334177,2014-03-04,House,"Reported With Recommendation With Substitute H-1",13,0,0,0,13
548429,338726,2014-03-04,House,"Reported With Recommendation With Substitute  H-1",13,0,0,0,13
548429,341167,2014-03-12,House,"House Third Reading: Given Immediate Effect Roll Call # 94",103,5,0,0,108
548429,342238,2014-03-13,Senate,"Senate Third Reading:  Roll Call # 95",37,0,1,0,38
548429,382875,2014-03-13,Senate,"Senate Third Reading: Roll Call # 95",37,0,1,0,38
548432,288172,2013-06-11,Senate,"Reported Favorably With Substitute S-2",11,4,0,0,15
548432,288881,2013-06-13,Senate,"Senate Third Reading: Passed Roll Call # 269",26,12,0,0,38
548432,299323,2013-09-10,House,"House Third Reading: Given Immediate Effect Roll Call # 271",106,2,0,0,108
548459,278284,2013-05-09,House,"Reported With Recommendation Without Amendment",11,0,0,0,11
548459,280572,2013-05-16,House,"House Third Reading: Given Immediate Effect Roll Call # 153",89,18,0,0,107
548459,288513,2013-06-12,Senate,"Reported Favorably Without Amendment",4,0,0,0,4
548459,302807,2013-09-25,Senate,"Senate Third Reading: Given Immediate Effect Roll Call # 372",36,0,1,1,38
548469,303225,2013-10-03,House,"Reported With Recommendation With Substitute H-1",10,0,0,0,10
548469,303396,2013-10-15,House,"House Third Reading: Given Immediate Effect Roll Call # 325",106,0,0,0,106
548469,305375,2013-12-12,Senate,"Reported Favorably Without Amendment",4,0,0,0,4
548469,305376,2013-12-12,Senate,"Senate Third Reading: Passed Roll Call # 651",38,0,0,0,38
548469,305377,2013-12-12,Senate,"Senate Third Reading: Given Immediate Effect Roll Call # 650",36,0,2,0,38
548469,305440,2013-12-12,Senate,"Senate Third Reading: Passed Roll Call # 650",36,0,2,0,38
548469,305441,2013-12-12,Senate,"Senate Third Reading: Given Immediate Effect Roll Call # 651",38,0,0,0,38
548472,303500,2013-10-17,House,"Reported With Recommendation With Substitute H-2",7,0,0,0,7
548472,304463,2013-11-14,House,"House Third Reading: Given Immediate Effect Roll Call # 419",59,51,0,0,110
548472,334428,2014-03-04,Senate,"Reported Favorably Without Amendment",3,1,0,0,4
548472,380350,2014-10-02,Senate,"Senate Third Reading: Given Immediate Effect Roll Call # 597",23,14,0,1,38
548472,380351,2014-10-02,Senate,"Senate Third Reading: Defeated Roll Call # 603",18,20,0,0,38
548472,380352,2014-10-02,Senate,"Senate Third Reading: Passed Roll Call # 607",21,17,0,0,38
548505,282633,2013-05-22,House,"Reported With Recommendation With Substitute H-1",9,5,0,0,14
548505,339255,2013-05-22,House,"Reported With Recommendation With Substitute  H-1",9,5,0,0,14
548868,363200,2014-05-07,House,"Reported With Recommendation With Substitute  H-6",14,1,0,0,15
548868,363461,2014-05-08,House,"House Third Reading: Given Immediate Effect Roll Call # 215",90,19,0,0,109
548868,366154,2014-05-21,Senate,"Reported Favorably With Substitute S-2",7,0,0,0,7
548868,370873,2014-06-11,Senate,"Senate Third Reading: Defeated Roll Call # 423",18,20,0,0,38
548868,370874,2014-06-11,Senate,"Senate Third Reading: Given Immediate Effect Roll Call # 425",21,15,2,0,38
548868,382748,2014-12-11,House,"House Third Reading: Roll Call # 668",1,106,0,0,107
548868,383672,2014-12-19,House,"House Third Reading: Conference Report Adopted Roll Call # 782",67,43,0,0,110
548868,383823,2014-12-19,Senate,"Senate Third Reading: Senate Adopted Conference Report Roll Call # 936",23,15,0,0,38
548890,288806,2013-06-13,House,"Reported With Recommendation With Substitute H-4",14,0,0,0,14
548890,303204,2013-10-03,House,"House Third Reading: Given Immediate Effect Roll Call # 308",74,33,0,0,107
548890,303736,2013-10-23,Senate,"Reported Favorably Without Amendment",5,0,0,0,5
548890,304060,2013-11-06,Senate,"Senate Third Reading: Defeated Roll Call # 490",15,22,0,1,38
548890,304465,2013-11-14,Senate,"Senate Third Reading: Given Immediate Effect Roll Call # 536",21,17,0,0,38
548938,279310,2013-05-14,House,"Reported With Recommendation With Substitute H-3",14,1,0,0,15
548938,287558,2013-06-06,House,"House Third Reading: Given Immediate Effect Roll Call # 210",100,7,0,0,107
548938,305240,2013-12-11,Senate,"Reported Favorably With Substitute S-1",7,0,0,0,7
548938,305397,2013-12-12,Senate,"Senate Third Reading: Given Immediate Effect Roll Call # 663",36,2,0,0,38
548938,309185,2014-01-15,House,"House Third Reading:  Roll Call # 1",101,6,0,0,107
548938,313271,2014-01-29,Senate,"Senate Third Reading:  Roll Call # 7",21,14,0,3,38
548938,313272,2014-01-29,House,"House Third Reading:  Roll Call # 20",104,6,0,0,110
548938,382894,2014-01-15,House,"House Third Reading: Roll Call # 1",101,6,0,0,107
548938,382895,2014-01-29,Senate,"Senate Third Reading: Roll Call # 7",21,14,0,3,38
548938,382896,2014-01-29,House,"House Third Reading: Roll Call # 20",104,6,0,0,110
549785,281962,2013-05-21,Senate,"Reported Favorably With Recommendation For Referral To Committee On Judiciary",3,0,0,0,3
549868,280346,2013-05-16,Senate,"Reported Favorably With Substitute S-1",4,0,0,0,4
549868,280347,2013-05-16,Senate,"Senate Third Reading: Passed Roll Call # 170",25,13,0,0,38
549868,282656,2013-05-22,House,"Reported With Recommendation Without Amendment",18,3,0,0,21
549868,282657,2013-05-22,House,"House Third Reading: Given Immediate Effect Roll Call # 164",65,44,0,0,109
549896,289858,2013-06-18,Senate,"Reported Favorably Without Amendment",5,0,0,0,5
549896,299718,2013-09-12,Senate,"Senate Third Reading: Passed Roll Call # 346",37,0,0,1,38
549896,303318,2013-10-09,House,"Reported With Recommendation With Substitute H-2",17,0,0,0,17
549896,303497,2013-10-17,House,"House Third Reading: Given Immediate Effect Roll Call # 336",102,6,0,0,108
549896,303640,2013-10-22,Senate,"Senate Third Reading:  Roll Call # 431",37,0,0,1,38
549896,303756,2013-10-23,House,"House Third Reading:  Roll Call # 347",103,4,0,0,107
549896,383044,2013-10-22,Senate,"Senate Third Reading: Roll Call # 431",37,0,0,1,38
549896,383045,2013-10-23,House,"House Third Reading: Roll Call # 347",103,4,0,0,107
549929,303334,2013-10-10,House,"Reported With Recommendation With Substitute H-1",9,0,0,0,9
549929,339217,2013-10-10,House,"Reported With Recommendation With Substitute  H-1",9,0,0,0,9
549929,367725,2014-05-27,House,"House Third Reading: Given Immediate Effect Roll Call # 314",110,0,0,0,110
549929,380285,2014-10-01,Senate,"Reported Favorably Without Amendment",4,0,0,0,4
549929,383216,2014-12-16,Senate,"Senate Third Reading: Given Immediate Effect Roll Call # 804",37,0,0,1,38
549929,383282,2014-12-17,Senate,"Senate Third Reading: Passed Roll Call # 834",37,0,0,1,38
549929,383571,2014-12-18,House,"House Third Reading: Senate Amendment(s) Concurred In Roll Call # 761",110,0,0,0,110
549931,321318,2014-02-13,House,"Reported With Recommendation With Substitute H-3",12,0,0,0,12
549931,330580,2014-02-26,House,"House Third Reading: Given Immediate Effect Roll Call # 66",106,4,0,0,110
549931,365808,2014-05-20,Senate,"Reported Favorably With Substitute  S-1",5,0,0,0,5
549931,380301,2014-10-01,Senate,"Senate Third Reading: Given Immediate Effect Roll Call # 580",34,2,0,2,38
549931,380428,2014-10-02,House,"House Third Reading:  Roll Call # 546",103,4,0,0,107
549931,383167,2014-10-02,House,"House Third Reading: Roll Call # 546",103,4,0,0,107
549935,303895,2013-10-29,Senate,"Reported Favorably With Substitute S-1",7,0,0,0,7
549938,302812,2013-09-25,House,"Reported With Recommendation Without Amendment",4,2,0,0,6
549942,321297,2014-02-13,House,"Reported With Recommendation Without Amendment",12,0,0,0,12
549942,330572,2014-02-26,House,"House Third Reading: Given Immediate Effect Roll Call # 67",106,4,0,0,110
549942,365799,2014-05-20,Senate,"Reported Favorably Without Amendment",5,0,0,0,5
549942,380284,2014-10-01,Senate,"Senate Third Reading: Given Immediate Effect Roll Call # 581",33,3,0,2,38
549948,288763,2013-06-13,House,"Reported With Recommendation Without Amendment",11,0,0,0,11
549948,302685,2013-09-19,House,"House Third Reading: Given Immediate Effect Roll Call # 288",104,0,0,0,104
549948,303184,2013-10-02,Senate,"Reported Favorably Without Amendment",4,0,0,0,4
549948,303387,2013-10-15,Senate,"Senate Third Reading: Given Immediate Effect Roll Call # 403",38,0,0,0,38
549957,321374,2014-02-13,House,"Reported With Recommendation With Substitute H-4",12,0,0,0,12
549957,330567,2014-02-26,House,"House Third Reading: Given Immediate Effect Roll Call # 68",106,4,0,0,110
549957,365800,2014-05-20,Senate,"Reported Favorably With Substitute  S-1",5,0,0,0,5
549957,380258,2014-10-01,Senate,"Senate Third Reading: Given Immediate Effect Roll Call # 582",32,3,1,2,38
549957,380437,2014-10-02,House,"House Third Reading:  Roll Call # 547",103,4,0,0,107
549957,382866,2014-10-02,House,"House Third Reading: Roll Call # 547",103,4,0,0,107
549963,279939,2013-05-15,House,"Reported With Recommendation With Substitute H-1",7,0,0,0,7
549963,286968,2013-06-04,House,"House Third Reading: Given Immediate Effect Roll Call # 186",100,9,0,0,109
549963,335476,2014-03-04,Senate,"Reported Favorably With Substitute S-2",3,0,0,0,3
549963,337300,2014-03-04,Senate,"Reported Favorably With Substitute  S-2",3,0,0,0,3
549963,348602,2014-03-27,Senate,"Senate Third Reading: Given Immediate Effect Roll Call # 168",37,0,0,1,38
549963,348603,2014-03-27,House,"House Third Reading:  Roll Call # 174",98,10,0,0,108
549963,382873,2014-03-27,House,"House Third Reading: Roll Call # 174",98,10,0,0,108
549965,279795,2013-05-15,House,"Reported With Recommendation With Substitute H-1",7,0,0,0,7
549965,287033,2013-06-04,House,"House Third Reading: Given Immediate Effect Roll Call # 188",98,11,0,0,109
549965,335440,2014-03-04,Senate,"Reported Favorably With Substitute S-1",3,0,0,0,3
549965,337191,2014-03-04,Senate,"Reported Favorably With Substitute  S-1",3,0,0,0,3
549965,348470,2014-03-27,Senate,"Senate Third Reading: Given Immediate Effect Roll Call # 160",37,0,0,1,38
549965,348471,2014-03-27,House,"House Third Reading:  Roll Call # 172",97,11,0,0,108
549965,382888,2014-03-27,House,"House Third Reading: Roll Call # 172",97,11,0,0,108
549969,303332,2013-10-10,House,"Reported With Recommendation With Substitute H-2",9,0,0,0,9
549969,338736,2013-10-10,House,"Reported With Recommendation With Substitute  H-2",9,0,0,0,9
549969,367556,2014-05-27,House,"House Third Reading: Given Immediate Effect Roll Call # 315",110,0,0,0,110
549969,380296,2014-10-01,Senate,"Reported Favorably With Substitute  S-1",4,0,0,0,4
549969,383220,2014-12-16,Senate,"Senate Third Reading: Given Immediate Effect Roll Call # 805",37,0,0,1,38
549969,383292,2014-12-17,House,"House Third Reading: Roll Call # 691",109,0,0,0,109
549969,383293,2014-12-17,Senate,"Senate Third Reading: Roll Call # 832",37,0,0,1,38
549976,279932,2013-05-15,House,"Reported With Recommendation With Amendment(s)",9,0,0,0,9
549976,287022,2013-06-04,House,"House Third Reading: Given Immediate Effect Roll Call # 187",103,6,0,0,109
549976,335432,2014-03-04,Senate,"Reported Favorably With Substitute S-1",3,0,0,0,3
549976,337187,2014-03-04,Senate,"Reported Favorably With Substitute  S-1",3,0,0,0,3
549976,348454,2014-03-27,Senate,"Senate Third Reading: Given Immediate Effect Roll Call # 159",37,0,0,1,38
549976,348455,2014-03-27,House,"House Third Reading:  Roll Call # 173",105,3,0,0,108
549976,382874,2014-03-27,House,"House Third Reading: Roll Call # 173",105,3,0,0,108
550002,302810,2013-09-25,House,"Reported With Recommendation Without Amendment",4,2,0,0,6
550002,304538,2013-11-14,House,"House Third Reading: Given Immediate Effect Roll Call # 418",59,51,0,0,110
550002,342142,2014-03-13,Senate,"Reported Favorably Without Amendment",4,1,0,0,5
550171,303150,2013-10-02,House,"Reported With Recommendation Without Amendment",18,0,0,0,18
550171,303316,2013-10-09,House,"House Third Reading: Given Immediate Effect Roll Call # 317",108,0,0,0,108
550171,321077,2014-02-13,Senate,"Reported Favorably Without Amendment",7,0,0,0,7
550171,321078,2014-02-13,Senate,"Reported Favorably With Recommendation For Referral To Committee On Families, Seniors And Human Services",7,0,0,0,7
550171,366446,2014-05-21,Senate,"Senate Third Reading: Given Immediate Effect Roll Call # 307",38,0,0,0,38
550201,284706,2013-05-28,Senate,"Reported Favorably With Substitute S-1",6,0,0,0,6
550201,285618,2013-05-29,Senate,"Senate Third Reading: Passed Roll Call # 221",36,0,0,2,38
550201,305275,2013-12-11,House,"Reported With Recommendation With Substitute H-2",15,0,0,0,15
550201,309205,2014-01-15,House,"House Third Reading: Given Immediate Effect Roll Call # 4",108,0,0,0,108
550201,310505,2014-01-21,Senate,"Senate Third Reading:  Roll Call # 2",36,0,0,2,38
550201,383037,2014-01-21,Senate,"Senate Third Reading: Roll Call # 2",36,0,0,2,38
550251,280492,2013-05-16,Senate,"Reported Favorably Without Amendment",4,0,0,0,4
550251,280493,2013-05-16,Senate,"Senate Third Reading: Passed Roll Call # 178",38,0,0,0,38
550262,282649,2013-05-22,Senate,"Senate Third Reading: Passed Roll Call # 209",37,0,0,1,38
550262,287279,2013-06-05,House,"Reported With Recommendation With Substitute H-1",13,0,0,0,13
550262,288181,2013-06-11,House,"House Third Reading: Given Immediate Effect Roll Call # 217",106,1,0,0,107
550262,288997,2013-06-13,Senate,"Senate Third Reading:  Roll Call # 263",38,0,0,0,38
550262,382958,2013-06-13,Senate,"Senate Third Reading: Roll Call # 263",38,0,0,0,38
550270,280557,2013-05-16,Senate,"Reported Favorably Without Amendment",4,0,0,0,4
550270,280558,2013-05-16,Senate,"Senate Third Reading: Passed Roll Call # 179",36,2,0,0,38
550270,288558,2013-06-12,House,"Reported With Recommendation With Substitute H-1",13,5,0,0,18
550270,299832,2013-09-12,House,"House Third Reading: Given Immediate Effect Roll Call # 283",88,20,0,0,108
550270,299859,2013-09-17,Senate,"Senate Third Reading:  Roll Call # 351",35,1,0,2,38
550270,382983,2013-09-17,Senate,"Senate Third Reading: Roll Call # 351",35,1,0,2,38
550282,282663,2013-05-22,Senate,"Senate Third Reading: Passed Roll Call # 208",37,0,0,1,38
550282,287284,2013-06-05,House,"Reported With Recommendation Without Amendment",12,0,0,0,12
550282,288182,2013-06-11,House,"House Third Reading: Given Immediate Effect Roll Call # 216",106,2,0,0,108
550299,280552,2013-05-16,Senate,"Reported Favorably Without Amendment",4,0,0,0,4
550299,280553,2013-05-16,Senate,"Senate Third Reading: Passed Roll Call # 177",34,4,0,0,38
550299,288563,2013-06-12,House,"Reported With Recommendation With Substitute H-1",12,4,0,0,16
550299,339781,2013-06-12,House,"Reported With Recommendation With Substitute  H-1",12,4,0,0,16
550310,279924,2013-05-15,House,"Reported With Recommendation Without Amendment",16,0,0,0,16
550310,283394,2013-05-23,House,"House Third Reading: Given Immediate Effect Roll Call # 169",107,0,0,0,107
550310,303089,2013-10-01,Senate,"Reported Favorably Without Amendment",5,0,0,0,5
550310,303307,2013-10-08,Senate,"Senate Third Reading: Given Immediate Effect Roll Call # 393",38,0,0,0,38
550317,282912,2013-05-22,Senate,"Reported Favorably Without Amendment",3,0,0,0,3
550524,282679,2013-05-22,House,"Reported With Recommendation With Substitute H-1",7,0,0,0,7
550524,286906,2013-06-04,House,"House Third Reading: Given Immediate Effect Roll Call # 190",97,12,0,0,109
550526,282624,2013-05-22,House,"Reported With Recommendation With Substitute H-1",7,0,0,0,7
550526,287065,2013-06-04,House,"House Third Reading: Given Immediate Effect Roll Call # 191",96,13,0,0,109
550530,281947,2013-05-21,House,"Reported With Recommendation Without Amendment",13,1,0,0,14
550530,285051,2013-05-29,House,"House Third Reading: Given Immediate Effect Roll Call # 181",84,21,0,0,105
550531,282493,2013-05-21,House,"Reported With Recommendation Without Amendment",13,0,0,0,13
550531,285478,2013-05-29,House,"House Third Reading: Given Immediate Effect Roll Call # 182",85,21,0,0,106
550531,362848,2014-05-06,Senate,"Reported Favorably With Substitute  S-1",6,0,0,0,6
550531,369525,2014-06-02,Senate,"Senate Third Reading: Given Immediate Effect Roll Call # 328",38,0,0,0,38
550531,370109,2014-06-05,House,"House Third Reading:  Roll Call # 348",86,22,0,0,108
550531,382865,2014-06-05,House,"House Third Reading: Roll Call # 348",86,22,0,0,108
550533,282783,2013-05-22,House,"Reported With Recommendation With Substitute H-1",7,0,0,0,7
550533,287018,2013-06-04,House,"House Third Reading: Given Immediate Effect Roll Call # 189",99,10,0,0,109
550536,282276,2013-05-21,House,"Reported With Recommendation Without Amendment",9,5,0,0,14
550536,288840,2013-06-13,House,"House Third Reading: Given Immediate Effect Roll Call # 225",60,46,0,0,106
550536,362717,2014-05-06,Senate,"Reported Favorably Without Amendment",6,0,0,0,6
550536,369473,2014-06-02,Senate,"Senate Third Reading: Given Immediate Effect Roll Call # 329",36,2,0,0,38
550540,287383,2013-06-05,House,"Reported With Recommendation Without Amendment",18,0,0,0,18
550540,287384,2013-06-05,House,"House Third Reading: Given Immediate Effect Roll Call # 204",102,7,0,0,109
550540,288776,2013-06-13,Senate,"Reported Favorably With Substitute S-1",4,0,0,0,4
550540,289559,2013-06-18,Senate,"Senate Third Reading: Given Immediate Effect Roll Call # 282",24,14,0,0,38
550540,299271,2013-09-10,House,"House Third Reading:  Roll Call # 268",101,7,0,0,108
550540,382948,2013-09-10,House,"House Third Reading: Roll Call # 268",101,7,0,0,108
550547,282294,2013-05-21,House,"Reported With Recommendation With Substitute H-3",9,0,0,0,9
550547,305006,2013-12-05,House,"House Third Reading: Given Immediate Effect Roll Call # 465",106,3,0,0,109
550547,365817,2014-05-20,Senate,"Reported Favorably With Substitute  S-3",7,0,0,0,7
550547,381734,2014-11-13,Senate,"Senate Third Reading: Given Immediate Effect Roll Call # 685",34,2,0,2,38
550551,282741,2013-05-22,House,"Reported With Recommendation Without Amendment",18,0,0,0,18
550551,287356,2013-06-05,House,"House Third Reading: Given Immediate Effect Roll Call # 200",70,39,0,0,109
550551,288948,2013-06-13,Senate,"Reported Favorably Without Amendment",4,0,0,0,4
550551,289603,2013-06-18,Senate,"Senate Third Reading: Defeated Roll Call # 280",16,22,0,0,38
550551,289604,2013-06-18,Senate,"Senate Third Reading: Given Immediate Effect Roll Call # 285",20,18,0,0,38
550555,287371,2013-06-05,House,"Reported With Recommendation With Substitute H-3",18,0,0,0,18
550555,287372,2013-06-05,House,"House Third Reading: Given Immediate Effect Roll Call # 201",73,36,0,0,109
550555,288747,2013-06-13,Senate,"Reported Favorably Without Amendment",4,0,0,0,4
550555,289498,2013-06-18,Senate,"Senate Third Reading: Given Immediate Effect Roll Call # 279",20,18,0,0,38
550557,281923,2013-05-21,House,"Reported With Recommendation Without Amendment",13,1,0,0,14
550557,285039,2013-05-29,House,"House Third Reading: Given Immediate Effect Roll Call # 180",84,21,0,0,105
550567,282682,2013-05-22,House,"Reported With Recommendation With Substitute H-1",21,0,0,0,21
550567,287260,2013-06-05,House,"House Third Reading: Given Immediate Effect Roll Call # 199",77,32,0,0,109
550567,288737,2013-06-13,Senate,"Reported Favorably With Substitute S-2",4,0,0,0,4
550567,289497,2013-06-18,Senate,"Senate Third Reading: Defeated Roll Call # 286",19,19,0,0,38
550567,289882,2013-06-19,Senate,"Senate Third Reading: Defeated Roll Call # 290",19,18,1,0,38
550567,289883,2013-06-19,Senate,"Senate Third Reading: Given Immediate Effect Roll Call # 307",24,14,0,0,38
550567,299218,2013-09-10,House,"House Third Reading:  Roll Call # 272",72,36,0,0,108
550567,382702,2013-09-10,House,"House Third Reading: Roll Call # 272",72,36,0,0,108
550569,282811,2013-05-22,House,"Reported With Recommendation Without Amendment",17,11,0,0,28
550569,287244,2013-06-05,House,"House Third Reading: Given Immediate Effect Roll Call # 197",58,51,0,0,109
550569,288778,2013-06-13,Senate,"Reported Favorably With Substitute S-1",4,0,0,0,4
550569,289548,2013-06-18,Senate,"Senate Third Reading: Defeated Roll Call # 277",17,21,0,0,38
550569,289549,2013-06-18,Senate,"Senate Third Reading: Given Immediate Effect Roll Call # 284",20,18,0,0,38
550569,299333,2013-09-10,House,"House Third Reading:  Roll Call # 266",58,50,0,0,108
550569,382977,2013-09-10,House,"House Third Reading: Roll Call # 266",58,50,0,0,108
550578,282134,2013-05-21,House,"Reported With Recommendation Without Amendment",13,0,0,0,13
550578,285723,2013-05-29,House,"House Third Reading: Given Immediate Effect Roll Call # 183",85,21,0,0,106
550578,365772,2014-05-20,Senate,"Reported Favorably With Substitute  S-1",4,0,0,0,4
550578,369659,2014-06-03,Senate,"Senate Third Reading: Given Immediate Effect Roll Call # 343",38,0,0,0,38
550578,370055,2014-06-05,House,"House Third Reading:  Roll Call # 349",84,24,0,0,108
550578,382887,2014-06-05,House,"House Third Reading: Roll Call # 349",84,24,0,0,108
550579,282808,2013-05-22,House,"Reported With Recommendation With Substitute H-1",7,0,0,0,7
550579,286976,2013-06-04,House,"House Third Reading: Given Immediate Effect Roll Call # 192",96,13,0,0,109
550584,303825,2013-10-29,House,"Reported With Recommendation Without Amendment",9,1,0,0,10
550584,304374,2013-11-13,House,"House Third Reading: Given Immediate Effect Roll Call # 410",71,39,0,0,110
550584,370634,2014-06-10,Senate,"Reported Favorably Without Amendment",5,1,0,0,6
550584,371073,2014-06-11,Senate,"Senate Third Reading: Given Immediate Effect Roll Call # 449",26,12,0,0,38
550590,287365,2013-06-05,House,"Reported With Recommendation With Substitute H-1",18,0,0,0,18
550590,287366,2013-06-05,House,"House Third Reading: Given Immediate Effect Roll Call # 203",109,0,0,0,109
550590,288897,2013-06-13,Senate,"Reported Favorably With Substitute S-1",4,0,0,0,4
550590,289744,2013-06-18,Senate,"Senate Third Reading: Given Immediate Effect Roll Call # 281",27,11,0,0,38
550590,299332,2013-09-10,House,"House Third Reading:  Roll Call # 267",108,0,0,0,108
550590,382968,2013-09-10,House,"House Third Reading: Roll Call # 267",108,0,0,0,108
550596,282852,2013-05-22,House,"Reported With Recommendation With Substitute H-1",21,0,0,0,21
550596,287235,2013-06-05,House,"House Third Reading: Given Immediate Effect Roll Call # 196",102,7,0,0,109
550596,288790,2013-06-13,Senate,"Reported Favorably Without Amendment",4,0,0,0,4
550596,288791,2013-06-13,Senate,"Senate Third Reading: Given Immediate Effect Roll Call # 274",37,0,0,1,38
550596,290417,2013-06-20,House,"House Third Reading:  Roll Call # 259",102,7,0,0,109
550596,383055,2013-06-20,House,"House Third Reading: Roll Call # 259",102,7,0,0,109
550597,284820,2013-05-28,House,"Reported With Recommendation With Substitute H-1",15,0,0,0,15
550597,287561,2013-06-06,House,"House Third Reading: Given Immediate Effect Roll Call # 208",104,3,0,0,107
550602,282903,2013-05-22,House,"Reported With Recommendation Without Amendment",18,0,0,0,18
550602,287418,2013-06-05,House,"House Third Reading: Given Immediate Effect Roll Call # 198",62,47,0,0,109
550602,288783,2013-06-13,Senate,"Reported Favorably Without Amendment",4,0,0,0,4
550602,289563,2013-06-18,Senate,"Senate Third Reading: Given Immediate Effect Roll Call # 278",20,18,0,0,38
551126,301165,2013-09-18,House,"Reported With Recommendation Without Amendment",12,0,0,0,12
551242,299813,2013-09-12,House,"Reported With Recommendation With Substitute H-1",11,0,0,0,11
551242,302690,2013-09-19,House,"House Third Reading: Given Immediate Effect Roll Call # 293",104,0,0,0,104
551242,304119,2013-11-07,Senate,"Reported Favorably With Substitute S-1",4,0,0,0,4
551242,305211,2013-12-11,Senate,"Senate Third Reading: Passed Roll Call # 577",35,0,1,2,38
551242,305212,2013-12-11,Senate,"Senate Third Reading: Given Immediate Effect Roll Call # 578",36,0,0,2,38
551242,305340,2013-12-12,House,"House Third Reading:  Roll Call # 503",109,0,0,0,109
551242,383084,2013-12-12,House,"House Third Reading: Roll Call # 503",109,0,0,0,109
551250,299737,2013-09-12,House,"Reported With Recommendation With Substitute H-1",11,0,0,0,11
551250,301528,2013-09-19,House,"House Third Reading: Given Immediate Effect Roll Call # 292",103,1,0,0,104
551250,304118,2013-11-07,Senate,"Reported Favorably With Substitute S-1",4,0,0,0,4
551250,305287,2013-12-11,Senate,"Senate Third Reading: Given Immediate Effect Roll Call # 576",36,0,0,2,38
551250,305442,2013-12-12,House,"House Third Reading:  Roll Call # 502",109,0,0,0,109
551250,383085,2013-12-12,House,"House Third Reading: Roll Call # 502",109,0,0,0,109
551259,283495,2013-05-23,House,"Reported With Recommendation With Substitute H-1",9,0,0,0,9
551259,287363,2013-06-05,House,"House Third Reading: Given Immediate Effect Roll Call # 195",88,21,0,0,109
551259,303637,2013-10-22,Senate,"Reported Favorably With Substitute S-3",3,1,0,0,4
551259,303913,2013-10-31,Senate,"Senate Third Reading: Given Immediate Effect Roll Call # 479",29,8,0,1,38
551259,304084,2013-11-06,House,"House Third Reading:  Roll Call # 374",87,22,0,0,109
551259,382961,2013-11-06,House,"House Third Reading: Roll Call # 374",87,22,0,0,109
551279,287416,2013-06-05,House,"Reported With Recommendation Without Amendment",15,0,0,0,15
551292,299759,2013-09-12,House,"Reported With Recommendation With Substitute H-1",11,0,0,0,11
551292,302365,2013-09-19,House,"House Third Reading: Given Immediate Effect Roll Call # 294",104,0,0,0,104
551292,304179,2013-11-07,Senate,"Reported Favorably Without Amendment",4,0,0,0,4
551292,305265,2013-12-11,Senate,"Senate Third Reading: Given Immediate Effect Roll Call # 579",36,0,0,2,38
551314,299814,2013-09-12,House,"Reported With Recommendation With Substitute H-1",11,0,0,0,11
551314,302686,2013-09-19,House,"House Third Reading: Given Immediate Effect Roll Call # 291",104,0,0,0,104
551314,304123,2013-11-07,Senate,"Reported Favorably With Substitute S-1",4,0,0,0,4
551314,305315,2013-12-11,Senate,"Senate Third Reading: Given Immediate Effect Roll Call # 575",35,0,1,2,38
551314,305425,2013-12-12,House,"House Third Reading:  Roll Call # 501",109,0,0,0,109
551314,383082,2013-12-12,House,"House Third Reading: Roll Call # 501",109,0,0,0,109
551335,290108,2013-06-19,House,"Reported With Recommendation Without Amendment",15,0,0,0,15
551335,302781,2013-09-24,House,"House Third Reading: Passed Roll Call # 295",107,0,0,0,107
551335,310344,2014-01-21,Senate,"Reported Favorably Without Amendment",7,0,0,0,7
551335,382777,2014-12-11,Senate,"Senate Third Reading: Given Immediate Effect Roll Call # 761",37,0,0,1,38
551335,383266,2014-12-16,House,"House Third Reading: Roll Call # 679",108,0,0,0,108
551345,277606,2013-05-08,House,"Reported With Recommendation Without Amendment",14,0,0,0,14
551345,280049,2013-05-15,House,"House Third Reading: Given Immediate Effect Roll Call # 149",108,0,0,0,108
551345,285384,2013-05-29,Senate,"Senate Third Reading: Given Immediate Effect Roll Call # 217",36,0,0,2,38
551345,285385,2013-05-29,House,"House Third Reading: Senate Amendment(s) Concurred In Roll Call # 184",106,0,0,0,106
551383,281928,2013-05-21,Senate,"Reported Favorably Without Amendment",7,0,0,0,7
551383,282862,2013-05-22,Senate,"Senate Third Reading: Passed Roll Call # 211",37,0,0,1,38
551383,287291,2013-06-05,House,"Reported With Recommendation Without Amendment",15,0,0,0,15
551383,303757,2013-10-23,House,"House Third Reading: Given Immediate Effect Roll Call # 352",107,0,0,0,107
551383,303778,2013-10-24,Senate,"Senate Third Reading: House Amendment(s) Concurred In Roll Call # 449",36,0,0,2,38
551397,289802,2013-06-18,Senate,"Reported Favorably Without Amendment",4,1,0,0,5
551397,299760,2013-09-12,Senate,"Senate Third Reading: Passed Roll Call # 347",27,10,0,1,38
551397,302787,2013-09-24,House,"Reported With Recommendation Without Amendment",9,0,0,0,9
551397,303221,2013-10-03,House,"House Third Reading: Given Immediate Effect Roll Call # 311",94,14,0,0,108
551531,299334,2013-09-10,House,"Reported With Recommendation Without Amendment",15,0,0,0,15
551556,289478,2013-06-18,Senate,"Reported Favorably With Substitute S-1",5,0,0,0,5
551556,299693,2013-09-12,Senate,"Senate Third Reading: Passed Roll Call # 348",37,0,0,1,38
551579,299335,2013-09-10,House,"Reported With Recommendation Without Amendment",15,0,0,0,15
551868,288554,2013-06-12,House,"Reported With Recommendation With Substitute H-3",9,5,0,0,14
551868,288971,2013-06-13,House,"House Third Reading: Given Immediate Effect Roll Call # 241",76,31,0,0,107
551868,297492,2013-08-14,Senate,"Reported Favorably With Substitute S-7",4,0,0,0,4
551868,298131,2013-08-27,Senate,"Senate Third Reading: Defeated Roll Call # 338",19,18,1,0,38
551868,298132,2013-08-27,Senate,"Senate Third Reading: Passed Roll Call # 339",20,18,0,0,38
551868,298660,2013-09-03,House,"House Third Reading:  Roll Call # 265",75,32,0,0,107
551868,382674,2013-09-03,House,"House Third Reading: Roll Call # 265",75,32,0,0,107
551880,279362,2013-05-14,House,"Reported With Recommendation With Substitute H-1",9,0,0,0,9
551893,282222,2013-05-21,Senate,"Reported Favorably Without Amendment",5,0,0,0,5
551893,285360,2013-05-29,Senate,"Senate Third Reading: Passed Roll Call # 218",35,1,0,2,38
551893,289586,2013-06-18,House,"Reported With Recommendation With Substitute H-1",13,1,0,0,14
551893,299831,2013-09-12,House,"House Third Reading: Given Immediate Effect Roll Call # 279",106,2,0,0,108
551893,299873,2013-09-18,Senate,"Senate Third Reading:  Roll Call # 357",34,1,0,3,38
551893,383058,2013-09-18,Senate,"Senate Third Reading: Roll Call # 357",34,1,0,3,38
551900,303847,2013-10-29,House,"Reported With Recommendation With Substitute H-1",12,0,0,0,12
551900,304527,2013-11-14,House,"House Third Reading: Given Immediate Effect Roll Call # 434",106,4,0,0,110
551900,339941,2014-03-11,Senate,"Reported Favorably With Substitute  S-4",16,0,0,0,16
551900,340870,2014-03-12,Senate,"Senate Third Reading: Given Immediate Effect Roll Call # 92",34,0,1,3,38
551900,340871,2014-03-12,Senate,"Senate Third Reading: Passed Roll Call # 93",35,0,0,3,38
551900,342063,2014-03-13,House,"House Third Reading:  Roll Call # 104",106,3,0,0,109
551900,383133,2014-03-13,House,"House Third Reading: Roll Call # 104",106,3,0,0,109
551908,279409,2013-05-14,House,"Reported With Recommendation With Substitute H-1",9,0,0,0,9
551922,289788,2013-06-18,House,"Reported With Recommendation With Substitute H-2",4,2,0,0,6
551922,290273,2013-06-20,House,"House Third Reading: Given Immediate Effect Roll Call # 258",58,51,0,0,109
551928,287349,2013-06-05,House,"Reported With Recommendation With Amendment(s)",18,0,0,0,18
551928,287350,2013-06-05,House,"House Third Reading: Given Immediate Effect Roll Call # 202",73,36,0,0,109
551928,288779,2013-06-13,Senate,"Reported Favorably Without Amendment",4,0,0,0,4
551928,289562,2013-06-18,Senate,"Senate Third Reading: Given Immediate Effect Roll Call # 283",21,17,0,0,38
551941,303840,2013-10-29,House,"Reported With Recommendation Without Amendment",12,0,0,0,12
551941,304519,2013-11-14,House,"House Third Reading: Given Immediate Effect Roll Call # 433",106,4,0,0,110
551941,339778,2014-03-11,Senate,"Reported Favorably With Substitute  S-1",16,0,0,0,16
551941,341177,2014-03-12,Senate,"Senate Third Reading: Given Immediate Effect Roll Call # 91",35,0,0,3,38
551941,342247,2014-03-13,House,"House Third Reading:  Roll Call # 103",106,3,0,0,109
551941,383127,2014-03-13,House,"House Third Reading: Roll Call # 103",106,3,0,0,109
551949,302682,2013-09-19,Senate,"Reported Favorably With Substitute S-1",4,3,0,0,7
551949,303516,2013-10-17,Senate,"Senate Third Reading: Passed Roll Call # 418",21,17,0,0,38
551955,303820,2013-10-29,House,"Reported With Recommendation Without Amendment",12,0,0,0,12
551955,304464,2013-11-14,House,"House Third Reading: Given Immediate Effect Roll Call # 432",107,3,0,0,110
551955,340070,2014-03-11,Senate,"Reported Favorably With Substitute  S-1",16,0,0,0,16
551955,341202,2014-03-12,Senate,"Senate Third Reading: Given Immediate Effect Roll Call # 90",35,0,0,3,38
551955,342252,2014-03-13,House,"House Third Reading:  Roll Call # 102",106,3,0,0,109
551955,383109,2014-03-13,House,"House Third Reading: Roll Call # 102",106,3,0,0,109
551974,303759,2013-10-23,House,"Reported With Recommendation With Substitute H-2",14,0,0,0,14
551974,303892,2013-10-30,House,"House Third Reading: Passed Roll Call # 362",82,26,0,0,108
551974,304487,2013-11-14,Senate,"Reported Favorably With Substitute S-2",5,0,0,0,5
551974,316647,2014-02-05,Senate,"Senate Third Reading: Given Immediate Effect Roll Call # 13",34,0,0,4,38
551974,316648,2014-02-05,House,"House Third Reading:  Roll Call # 34",81,27,0,0,108
551974,382935,2014-02-05,House,"House Third Reading: Roll Call # 34",81,27,0,0,108
552743,380217,2014-09-30,Senate,"Reported Favorably With Substitute  S-2",14,0,0,0,14
552799,282898,2013-05-22,Senate,"Reported Favorably Without Amendment",4,0,0,0,4
552799,288437,2013-06-12,Senate,"Senate Third Reading: Passed Roll Call # 257",36,1,0,1,38
552883,287346,2013-06-05,House,"Reported With Recommendation With Substitute H-4",13,0,0,0,13
552883,288952,2013-06-13,House,"House Third Reading: Given Immediate Effect Roll Call # 228",106,0,0,0,106
552883,303465,2013-10-16,Senate,"Reported Favorably With Substitute S-1",5,0,0,0,5
552883,303870,2013-10-30,Senate,"Senate Third Reading: Given Immediate Effect Roll Call # 469",36,0,0,2,38
552883,303989,2013-11-05,House,"House Third Reading:  Roll Call # 368",108,0,0,0,108
552883,382972,2013-11-05,House,"House Third Reading: Roll Call # 368",108,0,0,0,108
552910,369961,2014-06-04,House,"Reported With Recommendation Without Amendment",10,1,0,0,11
552946,303926,2013-10-31,House,"Reported With Recommendation With Substitute H-1",8,0,0,0,8
552946,304317,2013-11-12,House,"House Third Reading: Given Immediate Effect Roll Call # 406",102,8,0,0,110
552946,309629,2014-01-16,Senate,"Reported Favorably With Substitute S-1",4,0,0,0,4
552946,311359,2014-01-23,Senate,"Senate Third Reading: Given Immediate Effect Roll Call # 6",38,0,0,0,38
552946,312763,2014-01-28,House,"House Third Reading:  Roll Call # 16",101,7,0,0,108
552946,383047,2014-01-28,House,"House Third Reading: Roll Call # 16",101,7,0,0,108
552955,304470,2013-11-14,House,"Reported With Recommendation With Substitute H-1",12,0,0,0,12
552955,305041,2013-12-05,House,"House Third Reading: Passed Roll Call # 460",109,1,0,0,110
552973,303924,2013-10-31,House,"Reported With Recommendation With Substitute H-1",7,0,0,0,7
552973,304313,2013-11-12,House,"House Third Reading: Given Immediate Effect Roll Call # 405",89,21,0,0,110
552973,309567,2014-01-16,Senate,"Reported Favorably With Substitute S-1",4,0,0,0,4
552973,311345,2014-01-23,Senate,"Senate Third Reading: Given Immediate Effect Roll Call # 5",38,0,0,0,38
552973,312743,2014-01-28,House,"House Third Reading:  Roll Call # 15",86,22,0,0,108
552973,383030,2014-01-28,House,"House Third Reading: Roll Call # 15",86,22,0,0,108
552991,303925,2013-10-31,House,"Reported With Recommendation With Substitute H-1",7,0,0,0,7
552991,304315,2013-11-12,House,"House Third Reading: Given Immediate Effect Roll Call # 404",91,19,0,0,110
552991,309598,2014-01-16,Senate,"Reported Favorably With Substitute S-1",4,0,0,0,4
552991,311407,2014-01-23,Senate,"Senate Third Reading: Given Immediate Effect Roll Call # 4",38,0,0,0,38
552991,312708,2014-01-28,House,"House Third Reading:  Roll Call # 14",86,22,0,0,108
552991,383040,2014-01-28,House,"House Third Reading: Roll Call # 14",86,22,0,0,108
553285,284688,2013-05-28,House,"Reported With Recommendation Without Amendment",16,0,0,0,16
553285,287415,2013-06-05,House,"House Third Reading: Given Immediate Effect Roll Call # 193",109,0,0,0,109
553285,289605,2013-06-18,Senate,"Reported Favorably With Substitute S-1",5,0,0,0,5
553285,299515,2013-09-11,Senate,"Senate Third Reading: Given Immediate Effect Roll Call # 344",37,0,0,1,38
553285,302643,2013-09-19,House,"House Third Reading:  Roll Call # 286",105,0,0,0,105
553285,383043,2013-09-19,House,"House Third Reading: Roll Call # 286",105,0,0,0,105
553326,286940,2013-06-04,House,"Reported With Recommendation With Substitute H-2",13,0,0,0,13
553326,303888,2013-10-30,House,"House Third Reading: Given Immediate Effect Roll Call # 361",90,18,0,0,108
553326,380216,2014-09-30,Senate,"Reported Favorably With Substitute  S-2",8,1,0,0,9
553326,383314,2014-12-17,Senate,"Senate Third Reading: Given Immediate Effect Roll Call # 854",27,10,0,1,38
553326,383437,2014-12-18,House,"House Third Reading: Roll Call # 762",88,22,0,0,110
553339,282098,2013-05-21,House,"Reported With Recommendation Without Amendment",18,0,0,0,18
553339,282701,2013-05-22,House,"House Third Reading: Given Immediate Effect Roll Call # 157",106,2,0,0,108
553339,287302,2013-06-05,Senate,"Reported Favorably Without Amendment",9,0,0,0,9
553339,288593,2013-06-12,Senate,"Senate Third Reading: Given Immediate Effect Roll Call # 254",37,0,0,1,38
553771,301203,2013-09-19,House,"Reported With Recommendation With Substitute H-1",12,0,0,0,12
553771,303397,2013-10-15,House,"House Third Reading: Given Immediate Effect Roll Call # 320",106,0,0,0,106
553771,334158,2014-03-04,Senate,"Reported Favorably Without Amendment",4,0,0,0,4
553771,342259,2014-03-13,Senate,"Senate Third Reading: Given Immediate Effect Roll Call # 103",38,0,0,0,38
553802,282009,2013-05-21,House,"Reported With Recommendation With Substitute H-1",13,0,0,0,13
553802,284695,2013-05-28,House,"House Third Reading: Given Immediate Effect Roll Call # 177",107,1,0,0,108
553802,288349,2013-06-11,Senate,"Reported Favorably With Substitute S-4",6,0,0,0,6
553802,288540,2013-06-12,Senate,"Senate Third Reading: Given Immediate Effect Roll Call # 260",37,0,0,1,38
553802,288541,2013-06-12,House,"House Third Reading:  Roll Call # 222",107,1,0,0,108
553802,382868,2013-06-12,House,"House Third Reading: Roll Call # 222",107,1,0,0,108
553817,284208,2013-05-22,Senate,"Reported Favorably With Substitute S-2",5,2,0,0,7
554774,289535,2013-06-18,Senate,"Reported Favorably With Substitute S-1",8,0,0,0,8
554774,299833,2013-09-12,Senate,"Senate Third Reading: Passed Roll Call # 349",37,0,0,1,38
554774,303964,2013-11-05,House,"Reported With Recommendation With Substitute H-1",15,1,0,0,16
554774,304962,2013-12-04,House,"House Third Reading: Given Immediate Effect Roll Call # 447",106,3,0,0,109
554774,305149,2013-12-10,Senate,"Senate Third Reading:  Roll Call # 571",38,0,0,0,38
554774,383088,2013-12-10,Senate,"Senate Third Reading: Roll Call # 571",38,0,0,0,38
554829,289524,2013-06-18,Senate,"Reported Favorably Without Amendment",7,0,0,0,7
554829,289950,2013-06-19,Senate,"Senate Third Reading: Passed Roll Call # 299",37,0,1,0,38
554829,305247,2013-12-11,House,"Reported With Recommendation With Substitute H-2",15,0,0,0,15
554829,305362,2013-12-12,House,"House Third Reading: Given Immediate Effect Roll Call # 498",108,1,0,0,109
554829,305363,2013-12-12,Senate,"Senate Third Reading:  Roll Call # 666",37,0,1,0,38
554829,383075,2013-12-12,Senate,"Senate Third Reading: Roll Call # 666",37,0,1,0,38
554856,289017,2013-06-13,Senate,"Reported Favorably With Substitute S-3",5,0,0,0,5
554856,289476,2013-06-18,Senate,"Senate Third Reading: Passed Roll Call # 287",38,0,0,0,38
554856,305172,2013-12-10,House,"Reported With Recommendation With Substitute H-4",26,0,0,0,26
554856,305311,2013-12-11,House,"House Third Reading: Given Immediate Effect Roll Call # 475",108,1,0,0,109
554856,305312,2013-12-11,Senate,"Senate Third Reading:  Roll Call # 604",38,0,0,0,38
554856,382870,2013-12-11,Senate,"Senate Third Reading: Roll Call # 604",38,0,0,0,38
554888,303090,2013-10-01,Senate,"Reported Favorably Without Amendment",7,0,0,0,7
554888,303215,2013-10-03,Senate,"Senate Third Reading: Passed Roll Call # 389",37,0,0,1,38
554888,303742,2013-10-23,House,"Reported With Recommendation Without Amendment",17,0,0,0,17
554888,303927,2013-10-31,House,"House Third Reading: Given Immediate Effect Roll Call # 364",103,4,0,0,107
554916,287261,2013-06-05,House,"Reported With Recommendation With Substitute H-3",13,0,0,0,13
554916,288851,2013-06-13,House,"House Third Reading: Given Immediate Effect Roll Call # 231",107,0,0,0,107
554916,303474,2013-10-16,Senate,"Reported Favorably With Substitute S-1",5,0,0,0,5
554916,303877,2013-10-30,Senate,"Senate Third Reading: Given Immediate Effect Roll Call # 474",37,0,0,1,38
554916,304001,2013-11-05,House,"House Third Reading:  Roll Call # 371",108,0,0,0,108
554916,382952,2013-11-05,House,"House Third Reading: Roll Call # 371",108,0,0,0,108
554927,287269,2013-06-05,House,"Reported With Recommendation With Substitute H-1",13,0,0,0,13
554927,288869,2013-06-13,House,"House Third Reading: Given Immediate Effect Roll Call # 229",107,0,0,0,107
554927,303470,2013-10-16,Senate,"Reported Favorably With Substitute S-1",5,0,0,0,5
554927,303885,2013-10-30,Senate,"Senate Third Reading: Given Immediate Effect Roll Call # 470",37,0,0,1,38
554927,304016,2013-11-05,House,"House Third Reading:  Roll Call # 369",108,0,0,0,108
554927,382962,2013-11-05,House,"House Third Reading: Roll Call # 369",108,0,0,0,108
554937,310764,2014-01-22,House,"Reported With Recommendation For Referral To Committee On Judiciary",8,0,0,0,8
554937,317095,2014-02-06,House,"Reported With Recommendation With Substitute H-2",9,0,0,0,9
554937,371359,2014-06-12,House,"House Third Reading: Given Immediate Effect Roll Call # 422",93,17,0,0,110
554937,380249,2014-10-01,Senate,"Reported Favorably Without Amendment",4,0,0,0,4
554947,287369,2013-06-05,House,"Reported With Recommendation With Substitute H-1",13,0,0,0,13
554947,288951,2013-06-13,House,"House Third Reading: Given Immediate Effect Roll Call # 230",107,0,0,0,107
554947,303467,2013-10-16,Senate,"Reported Favorably With Substitute S-1",5,0,0,0,5
554947,303869,2013-10-30,Senate,"Senate Third Reading: Given Immediate Effect Roll Call # 473",37,0,0,1,38
554947,303988,2013-11-05,House,"House Third Reading:  Roll Call # 370",108,0,0,0,108
554947,383607,2013-11-05,House,"House Third Reading: Roll Call # 370",108,0,0,0,108
554992,288862,2013-06-13,House,"Reported With Recommendation Without Amendment",15,0,0,0,15
554992,290069,2013-06-19,House,"House Third Reading: Given Immediate Effect Roll Call # 247",109,0,0,0,109
554992,382565,2014-12-10,Senate,"Reported Favorably With Substitute  S-1",7,0,0,0,7
555281,284625,2013-05-28,Senate,"Reported Favorably With Substitute S-1",5,1,0,0,6
555281,288112,2013-06-11,Senate,"Senate Third Reading: Passed Roll Call # 245",36,1,0,1,38
555281,288802,2013-06-13,House,"Reported With Recommendation With Substitute H-1",7,0,0,0,7
555281,290446,2013-06-20,House,"House Third Reading: Given Immediate Effect Roll Call # 261",59,50,0,0,109
555281,290447,2013-06-20,Senate,"Senate Third Reading:  Roll Call # 331",28,10,0,0,38
555281,383049,2013-06-20,Senate,"Senate Third Reading: Roll Call # 331",28,10,0,0,38
555306,284639,2013-05-28,Senate,"Reported Favorably With Substitute S-1",5,0,0,0,5
555306,288040,2013-06-11,Senate,"Senate Third Reading: Passed Roll Call # 244",37,0,0,1,38
555311,284652,2013-05-28,Senate,"Reported Favorably With Substitute S-1",6,0,0,0,6
555311,288055,2013-06-11,Senate,"Senate Third Reading: Passed Roll Call # 242",37,0,0,1,38
555311,288964,2013-06-13,House,"Reported With Recommendation With Substitute H-1",11,0,0,0,11
555311,290297,2013-06-20,House,"House Third Reading: Given Immediate Effect Roll Call # 260",103,6,0,0,109
555311,290298,2013-06-20,Senate,"Senate Third Reading:  Roll Call # 330",28,10,0,0,38
555311,383066,2013-06-20,Senate,"Senate Third Reading: Roll Call # 330",28,10,0,0,38
555316,303534,2013-10-17,Senate,"Reported Favorably With Substitute S-3",4,0,0,0,4
555316,337175,2013-10-17,Senate,"Reported Favorably With Substitute  S-3",4,0,0,0,4
555327,284650,2013-05-28,Senate,"Reported Favorably Without Amendment",5,0,0,0,5
555327,288064,2013-06-11,Senate,"Senate Third Reading: Passed Roll Call # 243",37,0,0,1,38
555337,303127,2013-10-02,House,"Reported With Recommendation With Substitute H-1",13,0,0,0,13
555337,303322,2013-10-09,House,"House Third Reading: Given Immediate Effect Roll Call # 318",106,2,0,0,108
555337,310389,2014-01-21,Senate,"Reported Favorably With Substitute S-1",7,0,0,0,7
555337,337458,2014-01-21,Senate,"Reported Favorably With Substitute  S-1",7,0,0,0,7
555337,383719,2014-12-18,Senate,"Senate Third Reading: Given Immediate Effect Roll Call # 879",36,0,2,0,38
555337,383720,2014-12-18,House,"House Third Reading: Roll Call # 774",109,1,0,0,110
555501,287326,2013-06-05,Senate,"Reported Favorably With Substitute S-1",4,0,0,0,4
555501,298679,2013-09-03,Senate,"Senate Third Reading: Passed Roll Call # 341",37,0,0,1,38
555501,304085,2013-11-06,House,"Reported With Recommendation Without Amendment",13,0,0,0,13
555501,339971,2014-03-11,House,"House Third Reading: Given Immediate Effect Roll Call # 89",110,0,0,0,110
555506,303219,2013-10-03,Senate,"Reported Favorably Without Amendment",7,0,0,0,7
555506,303480,2013-10-16,Senate,"Senate Third Reading: Passed Roll Call # 411",38,0,0,0,38
555520,287374,2013-06-05,Senate,"Reported Favorably With Substitute S-1",7,0,0,0,7
555520,287375,2013-06-05,Senate,"Senate Third Reading: Passed Roll Call # 233",38,0,0,0,38
555520,303748,2013-10-22,House,"Reported With Recommendation With Substitute H-1",15,0,0,0,15
555520,303876,2013-10-30,House,"House Third Reading: Given Immediate Effect Roll Call # 363",108,0,0,0,108
555520,304164,2013-11-07,Senate,"Senate Third Reading:  Roll Call # 493",36,0,0,2,38
555520,382903,2013-11-07,Senate,"Senate Third Reading: Roll Call # 493",36,0,0,2,38
555533,299712,2013-09-12,House,"Reported With Recommendation With Substitute H-2",10,0,0,0,10
555533,303327,2013-10-09,House,"House Third Reading: Given Immediate Effect Roll Call # 315",98,10,0,0,108
555533,304158,2013-11-07,Senate,"Reported Favorably With Substitute S-1",3,1,0,0,4
555533,305410,2013-12-12,Senate,"Senate Third Reading: Given Immediate Effect Roll Call # 643",35,3,0,0,38
555533,305411,2013-12-12,House,"House Third Reading:  Roll Call # 514",99,10,0,0,109
555533,382630,2013-12-12,House,"House Third Reading: Roll Call # 514",99,10,0,0,109
555541,299761,2013-09-12,House,"Reported With Recommendation With Substitute H-2",10,0,0,0,10
555541,303317,2013-10-09,House,"House Third Reading: Given Immediate Effect Roll Call # 314",98,10,0,0,108
555541,304165,2013-11-07,Senate,"Reported Favorably With Substitute S-1",3,1,0,0,4
555541,305414,2013-12-12,Senate,"Senate Third Reading: Passed Roll Call # 641",35,2,1,0,38
555541,305415,2013-12-12,Senate,"Senate Third Reading: Given Immediate Effect Roll Call # 642",35,3,0,0,38
555541,305416,2013-12-12,House,"House Third Reading:  Roll Call # 513",99,10,0,0,109
555541,382632,2013-12-12,House,"House Third Reading: Roll Call # 513",99,10,0,0,109
555569,303130,2013-10-02,Senate,"Reported Favorably Without Amendment",5,1,0,0,6
555584,303493,2013-10-17,Senate,"Reported Favorably With Substitute S-2",4,0,0,0,4
555584,337526,2013-10-17,Senate,"Reported Favorably With Substitute  S-2",4,0,0,0,4
555590,299739,2013-09-12,House,"Reported With Recommendation With Substitute H-1",10,0,0,0,10
555597,303131,2013-10-02,Senate,"Reported Favorably With Substitute S-3",7,0,0,0,7
555597,337436,2013-10-02,Senate,"Reported Favorably With Substitute  S-3",7,0,0,0,7
555604,304137,2013-11-07,Senate,"Reported Favorably Without Amendment",4,0,0,0,4
555604,304138,2013-11-07,Senate,"Senate Third Reading:  Roll Call # 505",26,12,0,0,38
555604,305443,2013-11-07,Senate,"Senate Third Reading: Adopted Roll Call # 505",26,12,0,0,38
555604,321036,2014-02-13,House,"Reported With Recommendation With Substitute H-1",6,4,0,0,10
555604,338677,2014-02-13,House,"Reported With Recommendation With Substitute  H-1",6,4,0,0,10
555604,346766,2014-03-20,House,"House Third Reading:  Roll Call # 150",77,32,0,0,109
555604,348295,2014-03-26,Senate,"Senate Third Reading:  Roll Call # 154",25,12,0,1,38
555604,382824,2014-03-20,House,"House Third Reading: Roll Call # 150",77,32,0,0,109
555604,382825,2014-03-26,Senate,"Senate Third Reading: Roll Call # 154",25,12,0,1,38
555727,287094,2013-06-04,House,"Reported With Recommendation With Substitute H-1",12,2,0,0,14
555727,288096,2013-06-11,House,"House Third Reading: Given Immediate Effect Roll Call # 215",65,43,0,0,108
555727,304012,2013-11-05,Senate,"Reported Favorably With Substitute S-4",5,2,0,0,7
555727,304273,2013-11-12,Senate,"Senate Third Reading: Given Immediate Effect Roll Call # 508",26,12,0,0,38
555727,304373,2013-11-13,House,"House Third Reading:  Roll Call # 408",65,45,0,0,110
555727,382879,2013-11-13,House,"House Third Reading: Roll Call # 408",65,45,0,0,110
555778,288907,2013-06-13,House,"Reported With Recommendation With Substitute H-1",11,0,0,0,11
555778,288908,2013-06-13,House,"House Third Reading: Given Immediate Effect Roll Call # 237",98,9,0,0,107
555778,289866,2013-06-19,Senate,"Senate Third Reading: Given Immediate Effect Roll Call # 303",35,3,0,0,38
555791,288892,2013-06-13,House,"Reported With Recommendation With Substitute H-2",11,0,0,0,11
555791,288893,2013-06-13,House,"House Third Reading: Given Immediate Effect Roll Call # 238",99,8,0,0,107
555791,290102,2013-06-19,Senate,"Senate Third Reading: Given Immediate Effect Roll Call # 305",35,3,0,0,38
556783,303088,2013-10-01,Senate,"Reported Favorably Without Amendment",7,0,0,0,7
556783,304516,2013-11-14,Senate,"Senate Third Reading: Passed Roll Call # 537",38,0,0,0,38
556783,313280,2014-01-29,House,"Reported With Recommendation With Substitute H-1",10,5,0,0,15
556783,319115,2014-02-11,House,"House Third Reading: Given Immediate Effect Roll Call # 36",82,27,0,0,109
556783,321080,2014-02-13,Senate,"Senate Third Reading:  Roll Call # 22",38,0,0,0,38
556783,383015,2014-02-13,Senate,"Senate Third Reading: Roll Call # 22",38,0,0,0,38
556785,288589,2013-06-12,House,"Reported With Recommendation With Substitute H-1",19,0,0,0,19
556785,299815,2013-09-12,House,"House Third Reading: Given Immediate Effect Roll Call # 281",82,26,0,0,108
556785,302786,2013-09-24,Senate,"Reported Favorably Without Amendment",12,2,0,0,14
556785,303103,2013-10-01,Senate,"Senate Third Reading: Given Immediate Effect Roll Call # 383",23,14,1,0,38
556793,319291,2014-02-11,House,"Reported With Recommendation With Substitute H-1",9,0,0,0,9
556793,323605,2014-02-18,House,"House Third Reading: Given Immediate Effect Roll Call # 53",108,0,0,0,108
556793,358742,2014-04-22,Senate,"Senate Third Reading: Given Immediate Effect Roll Call # 186",38,0,0,0,38
556793,383836,2014-03-19,Senate,"Reported Favorably Without Amendment",5,0,0,0,5
556797,287224,2013-06-05,Senate,"Reported Favorably With Substitute S-2",5,0,0,0,5
556797,288132,2013-06-11,Senate,"Senate Third Reading: Passed Roll Call # 246",24,13,0,1,38
556816,288616,2013-06-12,House,"Reported With Recommendation With Substitute H-1",18,4,0,0,22
556816,299821,2013-09-12,House,"House Third Reading: Given Immediate Effect Roll Call # 280",58,50,0,0,108
556816,302785,2013-09-24,Senate,"Reported Favorably Without Amendment",11,3,0,0,14
556816,303105,2013-10-01,Senate,"Senate Third Reading: Defeated Roll Call # 381",18,19,0,1,38
556816,303106,2013-10-01,Senate,"Senate Third Reading: Given Immediate Effect Roll Call # 382",20,18,0,0,38
556820,301202,2013-09-19,Senate,"Reported Favorably Without Amendment",7,0,0,0,7
556820,302825,2013-09-26,Senate,"Senate Third Reading: Passed Roll Call # 374",33,4,0,1,38
556820,304047,2013-11-06,House,"Reported With Recommendation Without Amendment",14,4,0,0,18
556820,305295,2013-12-11,House,"House Third Reading: Given Immediate Effect Roll Call # 472",87,22,0,0,109
556835,301205,2013-09-19,Senate,"Reported Favorably Without Amendment",7,0,0,0,7
556835,302827,2013-09-26,Senate,"Senate Third Reading: Passed Roll Call # 375",33,4,0,1,38
556835,371085,2014-06-11,House,"Reported With Recommendation With Substitute  H-2",14,2,0,0,16
556835,383611,2014-12-18,House,"House Third Reading: Given Immediate Effect Roll Call # 706",81,28,0,0,109
556835,383754,2014-12-18,Senate,"Senate Third Reading: Roll Call # 863",33,5,0,0,38
556843,304075,2013-11-06,House,"Reported With Recommendation With Substitute H-2",13,0,0,0,13
556843,304526,2013-11-14,House,"House Third Reading: Passed Roll Call # 441",110,0,0,0,110
556843,382793,2014-12-11,Senate,"Senate Third Reading: Passed Roll Call # 760",37,0,0,1,38
556843,383428,2014-12-18,House,"House Third Reading: Roll Call # 759",110,0,0,0,110
556846,304072,2013-11-06,House,"Reported With Recommendation Without Amendment",14,4,0,0,18
556846,304518,2013-11-14,House,"House Third Reading: Given Immediate Effect Roll Call # 430",87,23,0,0,110
556846,305007,2013-12-05,Senate,"Reported Favorably Without Amendment",7,0,0,0,7
556846,305309,2013-12-11,Senate,"Senate Third Reading: Given Immediate Effect Roll Call # 590",31,6,0,1,38
556846,305423,2013-12-12,House,"House Third Reading: Senate Amendment(s) Concurred In Roll Call # 504",86,23,0,0,109
556851,370902,2014-06-11,House,"Reported With Recommendation With Substitute  H-1",14,2,0,0,16
556851,379147,2014-09-09,House,"House Third Reading: Given Immediate Effect Roll Call # 459",83,27,0,0,110
556851,382454,2014-12-04,Senate,"Reported Favorably Without Amendment",7,0,0,0,7
556851,383313,2014-12-17,Senate,"Senate Third Reading: Given Immediate Effect Roll Call # 829",31,6,0,1,38
557054,303213,2013-10-03,House,"Reported With Recommendation Without Amendment",11,0,0,0,11
557054,303388,2013-10-15,House,"House Third Reading: Given Immediate Effect Roll Call # 326",106,0,0,0,106
557054,305400,2013-12-12,Senate,"Reported Favorably Without Amendment",4,0,0,0,4
557054,305401,2013-12-12,Senate,"Senate Third Reading: Given Immediate Effect Roll Call # 652",37,1,0,0,38
557068,303473,2013-10-16,House,"Reported With Recommendation With Substitute H-1",10,0,0,0,10
557068,338582,2013-10-16,House,"Reported With Recommendation With Substitute  H-1",10,0,0,0,10
557579,288974,2013-06-13,Senate,"Reported Favorably With Substitute S-1",4,0,0,0,4
557579,337449,2013-06-13,Senate,"Reported Favorably With Substitute  S-1",4,0,0,0,4
557579,380118,2014-09-23,Senate,"Senate Third Reading: Passed Roll Call # 548",38,0,0,0,38
557583,302684,2013-09-19,Senate,"Reported Favorably With Substitute S-1",6,0,0,0,6
557583,303128,2013-10-02,Senate,"Senate Third Reading: Passed Roll Call # 385",37,0,0,1,38
557583,303982,2013-11-05,House,"Reported With Recommendation With Substitute H-2",9,0,0,0,9
557583,305037,2013-12-05,House,"House Third Reading: Given Immediate Effect Roll Call # 454",110,0,0,0,110
557583,305210,2013-12-11,Senate,"Senate Third Reading:  Roll Call # 574",36,0,0,2,38
557583,383069,2013-12-11,Senate,"Senate Third Reading: Roll Call # 574",36,0,0,2,38
557589,297514,2013-08-14,Senate,"Reported Favorably With Substitute S-2",3,0,0,0,3
557589,301167,2013-09-18,Senate,"Senate Third Reading: Passed Roll Call # 359",35,0,0,3,38
557589,313593,2014-01-29,House,"Reported With Recommendation With Amendment(s)",8,0,0,0,8
557589,367643,2014-05-27,House,"House Third Reading: Given Immediate Effect Roll Call # 328",104,6,0,0,110
557589,369443,2014-06-02,Senate,"Senate Third Reading:  Roll Call # 327",38,0,0,0,38
557589,382973,2014-06-02,Senate,"Senate Third Reading: Roll Call # 327",38,0,0,0,38
557595,289031,2013-06-13,Senate,"Reported Favorably With Substitute S-1",4,0,0,0,4
557595,337448,2013-06-13,Senate,"Reported Favorably With Substitute  S-1",4,0,0,0,4
557595,380117,2014-09-23,Senate,"Senate Third Reading: Passed Roll Call # 549",38,0,0,0,38
557609,313950,2014-01-30,Senate,"Reported Favorably Without Amendment",5,2,0,0,7
557622,288976,2013-06-13,Senate,"Reported Favorably Without Amendment",4,0,0,0,4
557639,304520,2013-11-14,Senate,"Reported Favorably With Substitute S-1",5,1,0,0,6
557648,287368,2013-06-05,Senate,"Reported Favorably Without Amendment",9,0,0,0,9
557663,303165,2013-10-02,House,"Reported With Recommendation Without Amendment",18,0,0,0,18
558138,289519,2013-06-18,Senate,"Reported Favorably Without Amendment",5,2,0,0,7
558138,289942,2013-06-19,Senate,"Senate Third Reading: Passed Roll Call # 301",21,16,1,0,38
558138,382652,2014-12-09,House,"Reported With Recommendation With Substitute  H-1",9,3,0,0,12
558152,289536,2013-06-18,Senate,"Reported Favorably Without Amendment",5,2,0,0,7
558152,289951,2013-06-19,Senate,"Senate Third Reading: Passed Roll Call # 300",21,16,1,0,38
558152,347748,2014-03-25,House,"Reported With Recommendation With Substitute  H-1",8,0,0,0,8
558167,369657,2014-06-03,House,"Reported With Recommendation Without Amendment",15,0,0,0,15
558167,379157,2014-09-09,House,"House Third Reading: Given Immediate Effect Roll Call # 452",109,0,0,0,109
558167,380310,2014-10-01,Senate,"Reported Favorably Without Amendment",7,0,0,0,7
558167,383238,2014-12-16,Senate,"Senate Third Reading: Given Immediate Effect Roll Call # 791",36,0,1,1,38
558167,383667,2014-12-17,House,"House Third Reading: Roll Call # 685",108,0,0,0,108
558178,304983,2013-12-04,House,"Reported With Recommendation With Substitute H-1",15,0,0,0,15
558178,305345,2013-12-12,House,"House Third Reading: Given Immediate Effect Roll Call # 512",109,0,0,0,109
558178,314135,2014-01-30,Senate,"Reported Favorably Without Amendment",7,0,0,0,7
558178,339950,2014-03-11,Senate,"Senate Third Reading: Given Immediate Effect Roll Call # 82",38,0,0,0,38
558181,299948,2013-09-18,House,"Reported With Recommendation With Substitute H-1",13,0,0,0,13
558181,303206,2013-10-03,House,"House Third Reading: Given Immediate Effect Roll Call # 309",107,0,0,0,107
558181,330411,2014-02-26,Senate,"Reported Favorably With Substitute S-1",5,0,0,0,5
558181,337397,2014-02-26,Senate,"Reported Favorably With Substitute  S-1",5,0,0,0,5
558181,342299,2014-03-13,Senate,"Senate Third Reading: Given Immediate Effect Roll Call # 102",38,0,0,0,38
558181,345226,2014-03-18,House,"House Third Reading:  Roll Call # 115",110,0,0,0,110
558181,382939,2014-03-18,House,"House Third Reading: Roll Call # 115",110,0,0,0,110
558186,288894,2013-06-13,House,"Reported With Recommendation With Substitute H-1",10,4,0,0,14
558186,288895,2013-06-13,House,"House Third Reading: Given Immediate Effect Roll Call # 244",58,49,0,0,107
558186,290096,2013-06-19,Senate,"Senate Third Reading: Given Immediate Effect Roll Call # 319",20,18,0,0,38
558186,290645,2013-06-20,House,"House Third Reading:  Roll Call # 257",60,49,0,0,109
558186,383021,2013-06-20,House,"House Third Reading: Roll Call # 257",60,49,0,0,109
558195,304968,2013-12-04,House,"Reported With Recommendation With Substitute H-1",9,2,0,0,11
558195,305272,2013-12-11,House,"House Third Reading: Given Immediate Effect Roll Call # 474",59,50,0,0,109
558195,309216,2014-01-15,Senate,"Reported Favorably Without Amendment",4,0,0,0,4
558195,320725,2014-02-12,Senate,"Senate Third Reading: Given Immediate Effect Roll Call # 18",35,3,0,0,38
558195,321031,2014-02-13,House,"House Third Reading: Senate Amendment(s) Concurred In Roll Call # 47",60,50,0,0,110
558204,288913,2013-06-13,House,"Reported With Recommendation With Substitute H-4",10,4,0,0,14
558204,288914,2013-06-13,House,"House Third Reading: Passed Roll Call # 243",58,49,0,0,107
558204,289867,2013-06-19,Senate,"Senate Third Reading: Given Immediate Effect Roll Call # 316",20,18,0,0,38
558204,290656,2013-06-20,House,"House Third Reading:  Roll Call # 256",58,51,0,0,109
558204,383031,2013-06-20,House,"House Third Reading: Roll Call # 256",58,51,0,0,109
558535,288485,2013-06-12,Senate,"Reported Favorably Without Amendment",7,0,0,0,7
558535,303400,2013-10-15,Senate,"Senate Third Reading: Passed Roll Call # 402",38,0,0,0,38
558535,341998,2014-03-13,House,"Reported With Recommendation Without Amendment",14,0,0,0,14
558535,367551,2014-05-27,House,"House Third Reading: Given Immediate Effect Roll Call # 317",107,3,0,0,110
558544,304541,2013-11-14,Senate,"Reported Favorably With Substitute S-2",3,1,0,0,4
558544,305301,2013-12-11,Senate,"Senate Third Reading: Passed Roll Call # 584",27,10,0,1,38
558544,346013,2014-03-19,House,"Reported With Recommendation With Substitute  H-1",11,0,0,0,11
558544,383700,2014-12-19,House,"House Third Reading: Passed Roll Call # 786",72,38,0,0,110
558544,383810,2014-12-19,Senate,"Senate Third Reading: Roll Call # 923",20,18,0,0,38
558558,297490,2013-08-14,Senate,"Reported Favorably With Substitute S-1",3,2,0,0,5
558558,298139,2013-08-27,Senate,"Senate Third Reading: Defeated Roll Call # 336",9,29,0,0,38
558597,304491,2013-11-14,House,"Reported With Recommendation With Substitute H-2",10,5,0,0,15
558597,305382,2013-12-12,House,"House Third Reading: Given Immediate Effect Roll Call # 507",67,42,0,0,109
558696,303205,2013-10-03,Senate,"Reported Favorably With Substitute S-1",7,0,0,0,7
558696,303402,2013-10-15,Senate,"Senate Third Reading: Passed Roll Call # 405",38,0,0,0,38
558696,324744,2014-02-19,House,"Reported With Recommendation Without Amendment",18,0,0,0,18
558696,382773,2014-12-10,House,"Reported With Recommendation With Substitute  H-1",18,0,0,0,18
558696,383592,2014-12-18,House,"House Third Reading: Given Immediate Effect Roll Call # 729",109,0,0,0,109
558696,383745,2014-12-18,Senate,"Senate Third Reading: Roll Call # 896",37,1,0,0,38
558702,303541,2013-10-17,Senate,"Reported Favorably With Substitute S-1",7,0,0,0,7
558702,304076,2013-11-06,Senate,"Senate Third Reading: Passed Roll Call # 488",37,0,1,0,38
558702,366250,2014-05-21,House,"Reported With Recommendation Without Amendment",13,0,0,0,13
558728,301160,2013-09-18,Senate,"Reported Favorably Without Amendment",3,0,0,0,3
558728,303129,2013-10-02,Senate,"Senate Third Reading: Passed Roll Call # 386",37,0,0,1,38
558728,313650,2014-01-29,House,"Reported With Recommendation With Substitute H-2",13,0,0,0,13
558728,321095,2014-02-13,House,"House Third Reading: Given Immediate Effect Roll Call # 41",101,9,0,0,110
558728,323667,2014-02-18,Senate,"Senate Third Reading:  Roll Call # 28",36,0,1,1,38
558728,383007,2014-02-18,Senate,"Senate Third Reading: Roll Call # 28",36,0,1,1,38
558790,303087,2013-10-01,House,"Reported With Recommendation With Substitute H-1",13,0,0,0,13
558790,303389,2013-10-15,House,"House Third Reading: Given Immediate Effect Roll Call # 321",105,1,0,0,106
558790,304958,2013-12-04,Senate,"Reported Favorably Without Amendment",6,0,0,0,6
558790,305361,2013-12-12,Senate,"Senate Third Reading: Given Immediate Effect Roll Call # 655",38,0,0,0,38
558799,312692,2014-01-28,House,"Reported With Recommendation With Substitute H-2",9,0,0,0,9
558799,316398,2014-02-05,House,"House Third Reading: Given Immediate Effect Roll Call # 31",105,3,0,0,108
558896,345168,2014-03-18,Senate,"Reported Favorably With Substitute  S-2",12,1,0,0,13
558896,348221,2014-03-26,Senate,"Senate Third Reading: Passed Roll Call # 149",35,2,0,1,38
558935,289540,2013-06-18,House,"Reported With Recommendation With Substitute H-4",9,0,0,0,9
558935,302692,2013-09-19,House,"House Third Reading: Given Immediate Effect Roll Call # 290",95,9,0,0,104
558935,383110,2014-12-15,Senate,"Reported Favorably Without Amendment",3,0,0,0,3
558935,383706,2014-12-18,Senate,"Senate Third Reading: Given Immediate Effect Roll Call # 878",28,10,0,0,38
558945,303138,2013-10-02,House,"Reported With Recommendation Without Amendment",13,0,0,0,13
558945,303418,2013-10-15,House,"House Third Reading: Passed Roll Call # 324",106,0,0,0,106
558945,305270,2013-12-11,Senate,"Reported Favorably Without Amendment",7,0,0,0,7
558945,305436,2013-12-12,Senate,"Senate Third Reading: Given Immediate Effect Roll Call # 647",38,0,0,0,38
559320,305108,2013-12-10,Senate,"Reported Favorably Without Amendment",3,0,0,0,3
559320,305220,2013-12-11,Senate,"Senate Third Reading: Passed Roll Call # 591",35,1,1,1,38
559320,325854,2014-02-20,House,"Reported With Recommendation Without Amendment",12,0,0,0,12
559320,335843,2014-03-05,House,"House Third Reading: Given Immediate Effect Roll Call # 75",108,2,0,0,110
559331,303278,2013-10-08,Senate,"Reported Favorably With Substitute S-1",7,0,0,0,7
559331,303641,2013-10-22,Senate,"Senate Third Reading: Passed By 2/3 Vote Roll Call # 434",35,3,0,0,38
559353,303294,2013-10-08,Senate,"Reported Favorably With Substitute S-1",7,0,0,0,7
559353,303648,2013-10-22,Senate,"Senate Third Reading: Passed Roll Call # 433",35,3,0,0,38
559360,303306,2013-10-08,Senate,"Reported Favorably With Substitute S-1",7,0,0,0,7
559360,303658,2013-10-22,Senate,"Senate Third Reading: Passed Roll Call # 432",35,3,0,0,38
559360,303868,2013-10-30,House,"Reported With Recommendation Without Amendment",9,0,0,0,9
559360,305029,2013-12-05,House,"House Third Reading: Given Immediate Effect Roll Call # 452",101,9,0,0,110
559389,302795,2013-09-24,House,"Reported With Recommendation Without Amendment",13,0,0,0,13
559593,303333,2013-10-10,House,"Reported With Recommendation Without Amendment",9,0,0,0,9
559704,303780,2013-10-24,Senate,"Reported Favorably Without Amendment",5,0,0,0,5
559704,303879,2013-10-30,Senate,"Senate Third Reading: Passed Roll Call # 477",27,10,0,1,38
559704,305156,2013-12-10,House,"Reported With Recommendation Without Amendment",7,2,0,0,9
559704,305419,2013-12-12,House,"House Third Reading: Given Immediate Effect Roll Call # 495",76,33,0,0,109
559704,305420,2013-12-12,Senate,"Senate Third Reading:  Roll Call # 659",33,5,0,0,38
559704,305421,2013-12-12,House,"House Third Reading:  Roll Call # 533",77,32,0,0,109
559704,383160,2013-12-12,Senate,"Senate Third Reading: Roll Call # 659",33,5,0,0,38
559704,383161,2013-12-12,House,"House Third Reading: Roll Call # 533",77,32,0,0,109
559713,304536,2013-11-14,Senate,"Reported Favorably With Substitute S-1",4,0,0,0,4
559713,304537,2013-11-14,Senate,"Senate Third Reading: Given Immediate Effect Roll Call # 528",38,0,0,0,38
559713,305129,2013-12-10,House,"Reported With Recommendation Without Amendment",9,0,0,0,9
559713,305242,2013-12-11,House,"House Third Reading: Given Immediate Effect Roll Call # 490",108,0,0,0,108
559718,304529,2013-11-14,Senate,"Reported Favorably Without Amendment",4,0,0,0,4
559718,304530,2013-11-14,Senate,"Senate Third Reading: Given Immediate Effect Roll Call # 527",37,1,0,0,38
559718,305169,2013-12-10,House,"Reported With Recommendation Without Amendment",8,0,0,0,8
559718,305310,2013-12-11,House,"House Third Reading: Given Immediate Effect Roll Call # 489",106,2,0,0,108
559720,303782,2013-10-24,Senate,"Reported Favorably Without Amendment",5,0,0,0,5
559720,303881,2013-10-30,Senate,"Senate Third Reading: Passed Roll Call # 476",27,10,0,1,38
559720,305162,2013-12-10,House,"Reported With Recommendation Without Amendment",7,2,0,0,9
559720,305381,2013-12-12,House,"House Third Reading: Given Immediate Effect Roll Call # 494",76,32,0,0,108
559724,314166,2014-01-30,Senate,"Reported Favorably Without Amendment",5,0,0,0,5
559724,320868,2014-02-12,Senate,"Senate Third Reading: Passed Roll Call # 19",38,0,0,0,38
559724,347868,2014-03-25,House,"Reported With Recommendation Without Amendment",17,0,0,0,17
559724,366318,2014-05-21,House,"House Third Reading: Given Immediate Effect Roll Call # 266",107,1,0,0,108
559732,303642,2013-10-22,Senate,"Reported Favorably With Substitute S-1",5,1,0,0,6
559732,359292,2014-04-23,Senate,"Senate Third Reading: Passed Roll Call # 187",26,12,0,0,38
559732,369721,2014-06-03,House,"Reported With Recommendation With Amendment(s)",6,3,0,0,9
559732,371068,2014-06-11,House,"House Third Reading: Given Immediate Effect Roll Call # 409",60,50,0,0,110
559732,371340,2014-06-12,Senate,"Senate Third Reading: House Amendment(s) Concurred In Roll Call # 464",26,11,0,1,38
559737,364098,2014-05-13,House,"Reported With Recommendation Without Amendment",8,1,0,0,9
559737,370576,2014-06-10,House,"House Third Reading: Given Immediate Effect Roll Call # 377",69,41,0,0,110
559737,381591,2014-11-12,Senate,"Reported Favorably With Substitute  S-1",4,2,0,0,6
559737,383757,2014-12-18,Senate,"Senate Third Reading: Given Immediate Effect Roll Call # 870",25,13,0,0,38
559737,383758,2014-12-18,House,"House Third Reading: Roll Call # 769",72,38,0,0,110
559742,303504,2013-10-17,House,"Reported With Recommendation Without Amendment",12,0,0,0,12
559744,371059,2014-06-11,House,"Reported With Recommendation With Substitute  H-1",14,0,0,0,14
559744,379158,2014-09-09,House,"House Third Reading: Given Immediate Effect Roll Call # 454",110,0,0,0,110
559744,382449,2014-12-04,Senate,"Reported Favorably Without Amendment",6,0,0,0,6
559744,383384,2014-12-17,Senate,"Senate Third Reading: Given Immediate Effect Roll Call # 824",31,4,2,1,38
559744,383459,2014-12-18,House,"House Third Reading: Roll Call # 708",109,0,0,0,109
559745,324694,2014-02-19,House,"Reported With Recommendation With Substitute H-1",9,0,0,0,9
559745,331631,2014-02-27,House,"House Third Reading: Given Immediate Effect Roll Call # 71",107,1,0,0,108
559745,382149,2014-12-02,Senate,"Reported Favorably Without Amendment",3,0,0,0,3
559747,303063,2013-10-01,House,"Reported With Recommendation With Amendment(s)",13,0,0,0,13
559747,303422,2013-10-15,House,"House Third Reading: Given Immediate Effect Roll Call # 322",106,0,0,0,106
559747,304926,2013-12-04,Senate,"Reported Favorably Without Amendment",6,0,0,0,6
559747,309415,2014-01-15,Senate,"Senate Third Reading: Given Immediate Effect Roll Call # 1",36,1,0,1,38
559750,303773,2013-10-23,House,"Reported With Recommendation With Substitute H-3",9,0,0,0,9
559752,303505,2013-10-17,House,"Reported With Recommendation With Substitute H-1",12,0,0,0,12
559752,338859,2013-10-17,House,"Reported With Recommendation With Substitute  H-1",12,0,0,0,12
559756,304896,2013-12-03,House,"Reported With Recommendation With Substitute H-2",16,0,0,0,16
559756,305238,2013-12-11,House,"House Third Reading: Given Immediate Effect Roll Call # 486",105,3,0,0,108
559756,347864,2014-03-25,Senate,"Reported Favorably With Substitute  S-1",8,0,0,0,8
559756,348715,2014-03-27,Senate,"Senate Third Reading: Given Immediate Effect Roll Call # 162",37,0,0,1,38
559756,348716,2014-03-27,House,"House Third Reading:  Roll Call # 171",106,2,0,0,108
559756,382889,2014-03-27,House,"House Third Reading: Roll Call # 171",106,2,0,0,108
559760,303758,2013-10-23,House,"Reported With Recommendation With Substitute H-3",9,0,0,0,9
559760,304112,2013-11-07,House,"House Third Reading: Given Immediate Effect Roll Call # 380",108,1,0,0,109
559760,305043,2013-12-05,Senate,"Senate Third Reading: Given Immediate Effect Roll Call # 562",35,2,0,1,38
559772,303320,2013-10-09,House,"Reported With Recommendation With Substitute H-2",9,1,0,0,10
559772,303653,2013-10-22,House,"House Third Reading: Given Immediate Effect Roll Call # 343",100,8,0,0,108
559772,304931,2013-12-04,Senate,"Reported Favorably Without Amendment",4,0,0,0,4
559772,305255,2013-12-11,Senate,"Senate Third Reading: Given Immediate Effect Roll Call # 587",36,0,1,1,38
559774,303765,2013-10-23,House,"Reported With Recommendation With Substitute H-3",9,0,0,0,9
559774,304128,2013-11-07,House,"House Third Reading: Given Immediate Effect Roll Call # 381",108,1,0,0,109
559774,305038,2013-12-05,Senate,"Senate Third Reading: Given Immediate Effect Roll Call # 563",35,2,0,1,38
559783,315557,2014-02-04,House,"Reported With Recommendation With Substitute H-2",18,0,0,0,18
559783,321316,2014-02-13,House,"House Third Reading: Given Immediate Effect Roll Call # 42",85,25,0,0,110
559783,335472,2014-03-05,Senate,"Reported Favorably With Substitute S-1",6,3,0,0,9
559783,337269,2014-03-05,Senate,"Reported Favorably With Substitute  S-1",6,3,0,0,9
559783,345799,2014-03-19,Senate,"Senate Third Reading: Given Immediate Effect Roll Call # 114",25,13,0,0,38
559783,346789,2014-03-20,House,"House Third Reading:  Roll Call # 133",82,28,0,0,110
559783,383116,2014-03-20,House,"House Third Reading: Roll Call # 133",82,28,0,0,110
559784,304396,2013-11-13,House,"Reported With Recommendation Without Amendment",10,1,0,0,11
559784,304933,2013-12-04,House,"House Third Reading: Passed Roll Call # 450",107,2,0,0,109
559784,363558,2014-05-08,Senate,"Reported Favorably Without Amendment",3,0,0,0,3
559784,380349,2014-10-02,Senate,"Senate Third Reading: Given Immediate Effect Roll Call # 611",38,0,0,0,38
559786,303824,2013-10-29,House,"Reported With Recommendation With Substitute H-2",8,0,0,0,8
559786,304327,2013-11-12,House,"House Third Reading: Given Immediate Effect Roll Call # 394",109,1,0,0,110
559787,367758,2014-05-27,House,"Reported With Recommendation With Substitute  H-3",11,0,0,0,11
559787,370111,2014-06-05,House,"House Third Reading: Given Immediate Effect Roll Call # 367",106,2,0,0,108
559787,380096,2014-09-23,Senate,"Reported Favorably With Substitute  S-2",6,0,0,0,6
559787,382571,2014-12-09,Senate,"Senate Third Reading: Given Immediate Effect Roll Call # 734",33,4,0,1,38
559787,382769,2014-12-11,House,"House Third Reading: Roll Call # 664",105,2,0,0,107
562313,303866,2013-10-30,House,"Reported With Recommendation With Substitute H-2",9,0,0,0,9
562313,304405,2013-11-13,House,"House Third Reading: Passed Roll Call # 413",110,0,0,0,110
562313,305014,2013-12-05,Senate,"Reported Favorably Without Amendment",3,0,0,0,3
562313,329249,2014-02-25,Senate,"Senate Third Reading: Given Immediate Effect Roll Call # 50",36,0,0,2,38
562314,303891,2013-10-30,House,"Reported With Recommendation Without Amendment",10,1,0,0,11
562314,304970,2013-12-04,House,"House Third Reading: Passed Roll Call # 446",100,9,0,0,109
562314,309222,2014-01-15,Senate,"Reported Favorably With Substitute S-1",4,0,0,0,4
562314,337340,2014-01-15,Senate,"Reported Favorably With Substitute  S-1",4,0,0,0,4
562314,370723,2014-06-10,Senate,"Senate Third Reading: Given Immediate Effect Roll Call # 399",36,1,0,1,38
562314,370880,2014-06-11,House,"House Third Reading:  Roll Call # 388",95,15,0,0,110
562314,382963,2014-06-11,House,"House Third Reading: Roll Call # 388",95,15,0,0,110
562324,303894,2013-10-30,House,"Reported With Recommendation Without Amendment",9,1,0,0,10
562324,304291,2013-11-12,House,"House Third Reading: Given Immediate Effect Roll Call # 399",109,1,0,0,110
562324,314138,2014-01-30,Senate,"Reported Favorably With Substitute S-1",4,0,0,0,4
562324,337450,2014-01-30,Senate,"Reported Favorably With Substitute  S-1",4,0,0,0,4
562324,348742,2014-03-27,Senate,"Senate Third Reading: Given Immediate Effect Roll Call # 157",37,0,0,1,38
562324,348743,2014-03-27,House,"House Third Reading:  Roll Call # 176",107,1,0,0,108
562324,382890,2014-03-27,House,"House Third Reading: Roll Call # 176",107,1,0,0,108
562327,303867,2013-10-30,House,"Reported With Recommendation With Substitute H-1",9,1,0,0,10
562327,304314,2013-11-12,House,"House Third Reading: Given Immediate Effect Roll Call # 400",109,1,0,0,110
562327,314162,2014-01-30,Senate,"Reported Favorably With Substitute S-1",4,0,0,0,4
562327,337452,2014-01-30,Senate,"Reported Favorably With Substitute  S-1",4,0,0,0,4
562327,348628,2014-03-27,Senate,"Senate Third Reading: Given Immediate Effect Roll Call # 158",37,0,0,1,38
562327,348629,2014-03-27,House,"House Third Reading:  Roll Call # 175",107,1,0,0,108
562327,382872,2014-03-27,House,"House Third Reading: Roll Call # 175",107,1,0,0,108
562329,364079,2014-05-13,House,"Reported With Recommendation With Substitute  H-1",13,0,0,0,13
562331,303890,2013-10-30,House,"Reported With Recommendation Without Amendment",10,1,0,0,11
562331,304971,2013-12-04,House,"House Third Reading: Passed Roll Call # 445",101,8,0,0,109
562331,309310,2014-01-15,Senate,"Reported Favorably With Substitute S-1",4,0,0,0,4
562331,337451,2014-01-15,Senate,"Reported Favorably With Substitute  S-1",4,0,0,0,4
562331,370713,2014-06-10,Senate,"Senate Third Reading: Given Immediate Effect Roll Call # 405",36,1,0,1,38
562331,371129,2014-06-11,House,"House Third Reading:  Roll Call # 387",95,14,0,0,109
562331,382988,2014-06-11,House,"House Third Reading: Roll Call # 387",95,14,0,0,109
562332,302806,2013-09-25,House,"Reported With Recommendation For Referral To Committee On Appropriations",13,0,0,0,13
562334,379835,2014-09-11,House,"Reported With Recommendation Without Amendment",9,0,0,0,9
562334,379983,2014-09-18,House,"House Third Reading: Given Immediate Effect Roll Call # 481",105,3,0,0,108
562334,380306,2014-10-01,Senate,"Reported Favorably Without Amendment",4,0,0,0,4
562334,380307,2014-10-01,Senate,"Senate Third Reading: Given Immediate Effect Roll Call # 596",36,0,0,2,38
562936,297509,2013-08-14,Senate,"Reported Favorably Without Amendment",3,2,0,0,5
562941,297511,2013-08-14,Senate,"Reported Favorably Without Amendment",3,2,0,0,5
563245,360755,2014-04-29,House,"Reported With Recommendation With Substitute  H-2",15,0,0,0,15
563245,362718,2014-05-06,House,"House Third Reading: Given Immediate Effect Roll Call # 195",110,0,0,0,110
563245,381533,2014-11-06,Senate,"Reported Favorably With Substitute  S-1",7,0,0,0,7
563245,383237,2014-12-16,Senate,"Senate Third Reading: Given Immediate Effect Roll Call # 796",37,0,0,1,38
563245,383666,2014-12-17,House,"House Third Reading: Roll Call # 686",108,0,0,0,108
563247,303784,2013-10-24,House,"Reported With Recommendation Without Amendment",12,0,0,0,12
563247,304534,2013-11-14,House,"House Third Reading: Given Immediate Effect Roll Call # 421",102,8,0,0,110
563249,303887,2013-10-30,House,"Reported With Recommendation Without Amendment",14,0,0,0,14
563249,304312,2013-11-12,House,"House Third Reading: Given Immediate Effect Roll Call # 398",109,1,0,0,110
563249,382432,2014-12-04,Senate,"Reported Favorably With Substitute  S-1",7,0,0,0,7
563249,383268,2014-12-17,Senate,"Senate Third Reading: Given Immediate Effect Roll Call # 821",37,0,0,1,38
563249,383475,2014-12-18,House,"House Third Reading: Roll Call # 710",109,0,0,0,109
563250,303875,2013-10-30,House,"Reported With Recommendation Without Amendment",14,0,0,0,14
563250,304345,2013-11-12,House,"House Third Reading: Given Immediate Effect Roll Call # 397",109,1,0,0,110
563250,382440,2014-12-04,Senate,"Reported Favorably With Substitute  S-1",7,0,0,0,7
563250,383323,2014-12-17,Senate,"Senate Third Reading: Given Immediate Effect Roll Call # 820",37,0,0,1,38
563250,383624,2014-12-18,House,"House Third Reading: Roll Call # 709",109,0,0,0,109
564001,299862,2013-09-17,House,"Reported With Recommendation With Substitute H-1",17,0,0,0,17
564001,302815,2013-09-25,House,"House Third Reading: Given Immediate Effect Roll Call # 297",107,0,0,0,107
564001,303476,2013-10-16,Senate,"Reported Favorably Without Amendment",7,0,0,0,7
564001,303865,2013-10-30,Senate,"Senate Third Reading: Given Immediate Effect Roll Call # 467",36,0,1,1,38
564003,303650,2013-10-22,House,"Reported With Recommendation Without Amendment",15,0,0,0,15
564003,348637,2014-03-27,House,"House Third Reading: Given Immediate Effect Roll Call # 178",108,0,0,0,108
564003,380311,2014-10-01,Senate,"Reported Favorably Without Amendment",7,0,0,0,7
564003,383226,2014-12-16,Senate,"Senate Third Reading: Given Immediate Effect Roll Call # 792",37,0,0,1,38
564005,302813,2013-09-25,House,"Reported With Recommendation With Substitute H-4",6,0,0,0,6
564005,338592,2013-09-25,House,"Reported With Recommendation With Substitute  H-4",6,0,0,0,6
564005,382387,2014-12-04,House,"House Third Reading: Given Immediate Effect Roll Call # 616",60,49,0,0,109
564007,301166,2013-09-18,House,"Reported With Recommendation Without Amendment",11,0,0,0,11
564007,302820,2013-09-25,House,"House Third Reading: Given Immediate Effect Roll Call # 298",107,0,0,0,107
564007,303328,2013-10-09,Senate,"Reported Favorably Without Amendment",3,0,0,0,3
564007,303743,2013-10-23,Senate,"Senate Third Reading: Given Immediate Effect Roll Call # 443",38,0,0,0,38
564010,302814,2013-09-25,House,"Reported With Recommendation With Substitute H-4",6,2,0,0,8
564010,338968,2013-09-25,House,"Reported With Recommendation With Substitute  H-4",6,2,0,0,8
564010,382377,2014-12-04,House,"House Third Reading: Given Immediate Effect Roll Call # 617",59,50,0,0,109
564130,336608,2014-03-06,House,"Reported With Recommendation With Substitute H-1",10,0,0,0,10
564180,304087,2013-11-06,Senate,"Reported Favorably Without Amendment",7,0,0,0,7
564180,304531,2013-11-14,Senate,"Senate Third Reading: Passed Roll Call # 539",38,0,0,0,38
564180,319458,2014-02-11,House,"Reported With Recommendation Without Amendment",9,0,0,0,9
564180,323750,2014-02-18,House,"House Third Reading: Given Immediate Effect Roll Call # 55",108,0,0,0,108
564190,303797,2013-10-24,House,"Reported With Recommendation With Substitute H-2",12,0,0,0,12
564190,304155,2013-11-07,House,"House Third Reading: Given Immediate Effect Roll Call # 393",107,2,0,0,109
564190,323537,2014-02-18,Senate,"Reported Favorably With Substitute S-1",4,0,0,0,4
564190,337081,2014-02-18,Senate,"Reported Favorably With Substitute  S-1",4,0,0,0,4
564208,301155,2013-09-18,House,"Reported With Recommendation With Substitute H-4",17,0,0,0,17
564208,302834,2013-09-26,House,"House Third Reading: Given Immediate Effect Roll Call # 299",102,4,0,0,106
564208,303494,2013-10-17,Senate,"Reported Favorably With Substitute S-1",4,0,0,0,4
564208,303495,2013-10-17,Senate,"Senate Third Reading: Given Immediate Effect Roll Call # 425",35,3,0,0,38
564208,303639,2013-10-22,House,"House Third Reading:  Roll Call # 339",102,6,0,0,108
564208,383001,2013-10-22,House,"House Third Reading: Roll Call # 339",102,6,0,0,108
564210,301158,2013-09-18,House,"Reported With Recommendation With Substitute H-2",17,0,0,0,17
564210,302836,2013-09-26,House,"House Third Reading: Given Immediate Effect Roll Call # 301",103,3,0,0,106
564210,303498,2013-10-17,Senate,"Reported Favorably Without Amendment",4,0,0,0,4
564210,303499,2013-10-17,Senate,"Senate Third Reading: Given Immediate Effect Roll Call # 427",35,3,0,0,38
564212,303845,2013-10-29,House,"Reported With Recommendation Without Amendment",12,0,0,0,12
564212,304305,2013-11-12,House,"House Third Reading: Given Immediate Effect Roll Call # 396",96,14,0,0,110
564212,314061,2014-01-30,Senate,"Reported Favorably Without Amendment",5,0,0,0,5
564212,341154,2014-03-12,Senate,"Senate Third Reading: Given Immediate Effect Roll Call # 87",35,0,0,3,38
564217,301161,2013-09-18,House,"Reported With Recommendation Without Amendment",16,0,0,0,16
564217,302839,2013-09-26,House,"House Third Reading: Given Immediate Effect Roll Call # 304",103,3,0,0,106
564217,303543,2013-10-17,Senate,"Reported Favorably Without Amendment",4,0,0,0,4
564217,303544,2013-10-17,Senate,"Senate Third Reading: Given Immediate Effect Roll Call # 430",35,3,0,0,38
564219,303832,2013-10-29,House,"Reported With Recommendation With Substitute H-1",15,0,0,0,15
564219,339767,2013-10-29,House,"Reported With Recommendation With Substitute  H-1",15,0,0,0,15
564219,348646,2014-03-27,House,"House Third Reading: Given Immediate Effect Roll Call # 179",108,0,0,0,108
564219,381511,2014-11-06,Senate,"Reported Favorably Without Amendment",7,0,0,0,7
564219,383218,2014-12-16,Senate,"Senate Third Reading: Given Immediate Effect Roll Call # 797",37,0,0,1,38
564221,301157,2013-09-18,House,"Reported With Recommendation Without Amendment",17,0,0,0,17
564221,302838,2013-09-26,House,"House Third Reading: Given Immediate Effect Roll Call # 303",103,3,0,0,106
564221,303536,2013-10-17,Senate,"Reported Favorably With Substitute S-1",4,0,0,0,4
564221,303537,2013-10-17,Senate,"Senate Third Reading: Given Immediate Effect Roll Call # 429",35,3,0,0,38
564221,303700,2013-10-22,House,"House Third Reading:  Roll Call # 341",105,3,0,0,108
564221,383000,2013-10-22,House,"House Third Reading: Roll Call # 341",105,3,0,0,108
564226,299539,2013-09-11,House,"Reported With Recommendation With Substitute H-1",27,0,0,0,27
564226,299790,2013-09-12,House,"House Third Reading: Given Immediate Effect Roll Call # 282",108,0,0,0,108
564226,302794,2013-09-24,Senate,"Reported Favorably Without Amendment",14,0,0,0,14
564226,303073,2013-10-01,Senate,"Senate Third Reading: Given Immediate Effect Roll Call # 384",38,0,0,0,38
564235,301162,2013-09-18,House,"Reported With Recommendation With Substitute H-3",17,0,0,0,17
564235,302840,2013-09-26,House,"House Third Reading: Given Immediate Effect Roll Call # 300",103,3,0,0,106
564235,303501,2013-10-17,Senate,"Reported Favorably Without Amendment",4,0,0,0,4
564235,303502,2013-10-17,Senate,"Senate Third Reading: Given Immediate Effect Roll Call # 426",34,4,0,0,38
564247,299875,2013-09-18,House,"Reported With Recommendation Without Amendment",12,4,0,0,16
564247,302837,2013-09-26,House,"House Third Reading: Given Immediate Effect Roll Call # 302",82,24,0,0,106
564247,303526,2013-10-17,Senate,"Reported Favorably With Substitute S-1",4,0,0,0,4
564247,303527,2013-10-17,Senate,"Senate Third Reading: Given Immediate Effect Roll Call # 428",28,10,0,0,38
564247,303745,2013-10-22,House,"House Third Reading:  Roll Call # 340",83,25,0,0,108
564247,383004,2013-10-22,House,"House Third Reading: Roll Call # 340",83,25,0,0,108
564251,303483,2013-10-16,House,"Reported With Recommendation With Substitute H-1",16,0,0,0,16
564251,303844,2013-10-29,House,"House Third Reading: Given Immediate Effect Roll Call # 355",105,3,0,0,108
564251,336761,2014-03-06,Senate,"Reported Favorably Without Amendment",4,2,0,0,6
564251,370638,2014-06-10,House,"House Third Reading: Passed Roll Call # 378",105,5,0,0,110
564251,371413,2014-06-12,Senate,"Senate Third Reading: Given Immediate Effect Roll Call # 507",34,4,0,0,38
564415,300840,2013-09-18,House,"Reported With Recommendation Without Amendment",27,0,0,0,27
564415,303207,2013-10-01,Senate,"Reported Favorably Without Amendment",16,0,0,0,16
564417,303059,2013-10-01,Senate,"Reported Favorably Without Amendment",7,0,0,0,7
564417,303285,2013-10-08,Senate,"Senate Third Reading: Passed Roll Call # 390",38,0,0,0,38
564417,366400,2014-05-21,House,"Reported With Recommendation Without Amendment",14,0,0,0,14
564417,379973,2014-09-18,House,"House Third Reading: Given Immediate Effect Roll Call # 479",107,1,0,0,108
564418,305391,2013-12-12,Senate,"Reported Favorably With Substitute S-1",4,0,0,0,4
564418,336698,2014-03-06,Senate,"Senate Third Reading: Passed Roll Call # 79",38,0,0,0,38
564418,348512,2014-03-27,House,"Reported With Recommendation With Substitute  H-2",12,0,0,0,12
564418,367699,2014-05-27,House,"House Third Reading: Given Immediate Effect Roll Call # 318",110,0,0,0,110
564418,368344,2014-05-28,Senate,"Senate Third Reading:  Roll Call # 317",35,0,0,3,38
564418,383077,2014-05-28,Senate,"Senate Third Reading: Roll Call # 317",35,0,0,3,38
564427,303309,2013-10-08,House,"Reported With Recommendation With Substitute H-2",14,2,0,0,16
564427,323616,2014-02-18,House,"House Third Reading: Passed Roll Call # 49",105,3,0,0,108
564427,358605,2014-04-22,Senate,"Reported Favorably Without Amendment",9,0,0,0,9
564427,359727,2014-04-24,Senate,"Senate Third Reading: Given Immediate Effect Roll Call # 199",38,0,0,0,38
564430,299863,2013-09-17,House,"Reported With Recommendation Without Amendment",16,0,0,0,16
564435,336705,2014-03-06,House,"Reported With Recommendation With Substitute H-2",10,1,0,0,11
564435,338632,2014-03-06,House,"Reported With Recommendation With Substitute  H-2",10,1,0,0,11
564435,340986,2014-03-12,House,"House Third Reading: Passed Roll Call # 100",106,2,0,0,108
564435,363433,2014-05-08,Senate,"Reported Favorably With Substitute S--1",7,0,0,0,7
564435,363598,2014-05-08,Senate,"Reported Favorably With Substitute S-1",7,0,0,0,7
564435,369933,2014-06-04,Senate,"Senate Third Reading: Given Immediate Effect Roll Call # 374",22,14,1,1,38
564435,370469,2014-06-10,House,"House Third Reading:  Roll Call # 374",108,2,0,0,110
564435,383018,2014-06-10,House,"House Third Reading: Roll Call # 374",108,2,0,0,110
564437,303134,2013-10-02,Senate,"Reported Favorably With Substitute S-3",4,0,0,0,4
564437,303326,2013-10-09,Senate,"Senate Third Reading: Passed Roll Call # 401",35,0,0,3,38
564437,303475,2013-10-16,House,"Reported With Recommendation Without Amendment",10,1,0,0,11
564437,303739,2013-10-23,House,"House Third Reading: Given Immediate Effect Roll Call # 351",106,1,0,0,107
564448,303292,2013-10-08,Senate,"Reported Favorably Without Amendment",7,0,0,0,7
564448,303478,2013-10-16,Senate,"Senate Third Reading: Passed Roll Call # 409",25,12,0,1,38
564448,304082,2013-11-06,House,"Reported With Recommendation With Substitute H-2",13,4,0,0,17
564448,316196,2014-02-04,House,"House Third Reading: Passed Roll Call # 23",57,53,0,0,110
564448,316476,2014-02-05,Senate,"Senate Third Reading:  Roll Call # 12",25,9,0,4,38
564448,383122,2014-02-05,Senate,"Senate Third Reading: Roll Call # 12",25,9,0,4,38
564496,303407,2013-10-15,Senate,"Reported Favorably Without Amendment",7,0,0,0,7
564496,303771,2013-10-23,Senate,"Senate Third Reading: Passed Roll Call # 448",38,0,0,0,38
564498,303408,2013-10-15,Senate,"Reported Favorably Without Amendment",6,1,0,0,7
564498,364065,2014-05-13,Senate,"Senate Third Reading: Passed Roll Call # 258",22,16,0,0,38
564498,370616,2014-06-10,House,"Reported With Recommendation Without Amendment",8,6,0,0,14
564498,371399,2014-06-12,House,"House Third Reading: Given Immediate Effect Roll Call # 434",61,49,0,0,110
564500,303403,2013-10-15,Senate,"Reported Favorably Without Amendment",6,1,0,0,7
564500,364122,2014-05-13,Senate,"Senate Third Reading: Passed Roll Call # 257",24,14,0,0,38
564500,370527,2014-06-10,House,"Reported With Recommendation Without Amendment",8,6,0,0,14
564500,371304,2014-06-12,House,"House Third Reading: Given Immediate Effect Roll Call # 433",57,53,0,0,110
564501,303310,2013-10-08,Senate,"Reported Favorably Without Amendment",4,0,0,0,4
564501,303503,2013-10-17,Senate,"Senate Third Reading: Passed Roll Call # 421",38,0,0,0,38
564501,364555,2014-05-14,House,"Reported With Recommendation With Substitute  H-1",15,0,0,0,15
564501,366596,2014-05-22,House,"House Third Reading: Given Immediate Effect Roll Call # 284",105,5,0,0,110
564501,368465,2014-05-28,Senate,"Senate Third Reading:  Roll Call # 320",35,0,0,3,38
564501,382999,2014-05-28,Senate,"Senate Third Reading: Roll Call # 320",35,0,0,3,38
564502,303432,2013-10-15,Senate,"Reported Favorably With Substitute S-1",7,0,0,0,7
564502,303754,2013-10-23,Senate,"Senate Third Reading: Passed Roll Call # 447",38,0,0,0,38
564502,364427,2014-05-14,House,"Reported With Recommendation With Substitute  H-1",15,0,0,0,15
564502,366515,2014-05-22,House,"House Third Reading: Given Immediate Effect Roll Call # 285",104,6,0,0,110
564502,371371,2014-06-12,Senate,"Senate Third Reading:  Roll Call # 478",37,0,0,1,38
564502,382960,2014-06-12,Senate,"Senate Third Reading: Roll Call # 478",37,0,0,1,38
564504,380196,2014-09-30,Senate,"Reported Favorably With Substitute  S-2",8,0,0,0,8
564504,380295,2014-10-01,Senate,"Senate Third Reading: Passed Roll Call # 594",28,8,0,2,38
564505,303281,2013-10-08,Senate,"Reported Favorably Without Amendment",5,0,0,0,5
564505,303508,2013-10-17,Senate,"Senate Third Reading: Passed Roll Call # 422",38,0,0,0,38
564507,303279,2013-10-08,Senate,"Reported Favorably Without Amendment",4,0,0,0,4
564507,303507,2013-10-17,Senate,"Senate Third Reading: Passed Roll Call # 420",38,0,0,0,38
564507,364651,2014-05-14,House,"Reported With Recommendation With Substitute  H-1",15,0,0,0,15
564507,366594,2014-05-22,House,"House Third Reading: Given Immediate Effect Roll Call # 283",106,4,0,0,110
564507,368462,2014-05-28,Senate,"Senate Third Reading:  Roll Call # 319",35,0,0,3,38
564507,382984,2014-05-28,Senate,"Senate Third Reading: Roll Call # 319",35,0,0,3,38
564533,301212,2013-09-19,Senate,"Reported Favorably Without Amendment",4,0,0,0,4
564533,301213,2013-09-19,Senate,"Senate Third Reading: Passed Roll Call # 364",27,9,0,2,38
564533,303324,2013-10-09,House,"Reported With Recommendation With Substitute H-2",11,3,0,0,14
564533,303514,2013-10-17,House,"House Third Reading: Given Immediate Effect Roll Call # 334",82,26,0,0,108
564533,303738,2013-10-23,Senate,"Senate Third Reading:  Roll Call # 441",28,10,0,0,38
564533,383063,2013-10-23,Senate,"Senate Third Reading: Roll Call # 441",28,10,0,0,38
564534,303393,2013-10-15,House,"Reported With Recommendation With Substitute H-1",9,6,0,0,15
564534,303880,2013-10-30,House,"House Third Reading: Given Immediate Effect Roll Call # 357",58,50,0,0,108
564538,304048,2013-11-06,Senate,"Reported Favorably With Substitute S-1",7,0,0,0,7
564538,304488,2013-11-14,Senate,"Senate Third Reading: Passed Roll Call # 540",38,0,0,0,38
564539,303209,2013-10-03,House,"Reported With Recommendation Without Amendment",11,0,0,0,11
564539,303518,2013-10-17,House,"House Third Reading: Given Immediate Effect Roll Call # 332",107,0,0,0,107
564539,304409,2013-11-13,Senate,"Reported Favorably With Substitute S-1",4,0,0,0,4
564539,305398,2013-12-12,Senate,"Senate Third Reading: Given Immediate Effect Roll Call # 621",37,0,0,1,38
564539,305399,2013-12-12,House,"House Third Reading:  Roll Call # 517",109,0,0,0,109
564539,383157,2013-12-12,House,"House Third Reading: Roll Call # 517",109,0,0,0,109
564540,303413,2013-10-15,House,"Reported With Recommendation With Substitute H-1",9,6,0,0,15
564540,303873,2013-10-30,House,"House Third Reading: Given Immediate Effect Roll Call # 356",58,50,0,0,108
564542,301466,2013-09-19,Senate,"Reported Favorably Without Amendment",4,0,0,0,4
564542,301467,2013-09-19,Senate,"Senate Third Reading: Passed Roll Call # 365",27,9,0,2,38
564542,303325,2013-10-09,House,"Reported With Recommendation With Substitute H-1",11,1,0,0,12
564542,303517,2013-10-17,House,"House Third Reading: Given Immediate Effect Roll Call # 335",81,27,0,0,108
564542,303741,2013-10-23,Senate,"Senate Third Reading:  Roll Call # 442",28,10,0,0,38
564542,383059,2013-10-23,Senate,"Senate Third Reading: Roll Call # 442",28,10,0,0,38
564543,303218,2013-10-03,Senate,"Reported Favorably Without Amendment",4,0,0,0,4
564543,303482,2013-10-16,Senate,"Senate Third Reading: Passed Roll Call # 412",38,0,0,0,38
564543,383389,2014-12-17,House,"Reported With Recommendation Without Amendment",16,0,0,0,16
564543,383469,2014-12-18,House,"House Third Reading: Given Immediate Effect Roll Call # 743",109,0,0,0,109
564544,303208,2013-10-03,House,"Reported With Recommendation Without Amendment",11,0,0,0,11
564544,303523,2013-10-17,House,"House Third Reading: Given Immediate Effect Roll Call # 329",107,0,0,0,107
564544,304420,2013-11-13,Senate,"Reported Favorably With Substitute S-1",4,0,0,0,4
564544,305417,2013-12-12,Senate,"Senate Third Reading: Given Immediate Effect Roll Call # 619",37,0,0,1,38
564544,305418,2013-12-12,House,"House Third Reading:  Roll Call # 515",109,0,0,0,109
564544,382647,2013-12-12,House,"House Third Reading: Roll Call # 515",109,0,0,0,109
564548,303223,2013-10-03,House,"Reported With Recommendation Without Amendment",11,0,0,0,11
564548,303515,2013-10-17,House,"House Third Reading: Given Immediate Effect Roll Call # 330",107,0,0,0,107
564548,304407,2013-11-13,Senate,"Reported Favorably With Substitute S-1",4,0,0,0,4
564548,305359,2013-12-12,Senate,"Senate Third Reading: Given Immediate Effect Roll Call # 622",37,0,0,1,38
564548,305360,2013-12-12,House,"House Third Reading:  Roll Call # 518",109,0,0,0,109
564548,382871,2013-12-12,House,"House Third Reading: Roll Call # 518",109,0,0,0,109
564550,303224,2013-10-03,House,"Reported With Recommendation Without Amendment",11,0,0,0,11
564550,303513,2013-10-17,House,"House Third Reading: Given Immediate Effect Roll Call # 331",107,0,0,0,107
564550,304415,2013-11-13,Senate,"Reported Favorably With Substitute S-1",4,0,0,0,4
564550,305387,2013-12-12,Senate,"Senate Third Reading: Given Immediate Effect Roll Call # 620",37,0,0,1,38
564550,305388,2013-12-12,House,"House Third Reading:  Roll Call # 516",109,0,0,0,109
564550,382861,2013-12-12,House,"House Third Reading: Roll Call # 516",109,0,0,0,109
564729,380220,2014-09-30,Senate,"Reported Favorably With Substitute  S-1",4,0,0,0,4
564730,380225,2014-09-30,Senate,"Reported Favorably With Substitute  S-1",4,0,0,0,4
564731,379943,2014-09-17,Senate,"Reported Favorably With Substitute  S-2",8,0,0,0,8
564731,380565,2014-10-22,Senate,"Senate Third Reading: Passed Roll Call # 639",36,0,0,2,38
564731,382710,2014-12-09,House,"Reported With Recommendation Without Amendment",19,0,0,0,19
564731,383418,2014-12-18,House,"House Third Reading: Given Immediate Effect Roll Call # 723",109,0,0,0,109
564738,303835,2013-10-29,Senate,"Reported Favorably With Substitute S-3",6,1,0,0,7
564738,304184,2013-11-07,Senate,"Senate Third Reading: Passed Roll Call # 499",34,3,1,0,38
564738,334179,2014-03-04,House,"Reported With Recommendation With Substitute H-6",12,0,0,0,12
564738,341241,2014-03-12,House,"House Third Reading: Given Immediate Effect Roll Call # 96",103,5,0,0,108
564738,342148,2014-03-13,Senate,"Senate Third Reading:  Roll Call # 97",37,1,0,0,38
564738,382891,2014-03-13,Senate,"Senate Third Reading: Roll Call # 97",37,1,0,0,38
564740,303290,2013-10-08,Senate,"Reported Favorably With Substitute S-1",4,1,0,0,5
564740,303522,2013-10-17,Senate,"Senate Third Reading: Passed Roll Call # 423",26,12,0,0,38
564740,364718,2014-05-14,House,"Reported With Recommendation Without Amendment",15,0,0,0,15
564740,367593,2014-05-27,House,"House Third Reading: Given Immediate Effect Roll Call # 299",94,16,0,0,110
564742,303837,2013-10-29,Senate,"Reported Favorably With Substitute S-1",7,0,0,0,7
564742,304114,2013-11-07,Senate,"Senate Third Reading: Passed Roll Call # 501",38,0,0,0,38
564742,334494,2014-03-04,House,"Reported With Recommendation With Substitute H-2",13,0,0,0,13
564742,340842,2014-03-12,House,"House Third Reading: Given Immediate Effect Roll Call # 98",107,1,0,0,108
564742,342015,2014-03-13,Senate,"Senate Third Reading:  Roll Call # 99",38,0,0,0,38
564742,383168,2014-03-13,Senate,"Senate Third Reading: Roll Call # 99",38,0,0,0,38
564747,380204,2014-09-30,Senate,"Reported Favorably With Substitute  S-2",4,0,0,0,4
564748,303839,2013-10-29,Senate,"Reported Favorably With Substitute S-1",7,0,0,0,7
564748,304116,2013-11-07,Senate,"Senate Third Reading: Passed Roll Call # 500",38,0,0,0,38
564748,334527,2014-03-04,House,"Reported With Recommendation With Substitute H-2",12,0,0,0,12
564748,339021,2014-03-04,House,"Reported With Recommendation With Substitute  H-2",12,0,0,0,12
564748,340836,2014-03-12,House,"House Third Reading: Given Immediate Effect Roll Call # 97",107,1,0,0,108
564748,342020,2014-03-13,Senate,"Senate Third Reading:  Roll Call # 98",38,0,0,0,38
564748,382867,2014-03-13,Senate,"Senate Third Reading: Roll Call # 98",38,0,0,0,38
564750,380203,2014-09-30,Senate,"Reported Favorably With Substitute  S-1",4,0,0,0,4
564752,303830,2013-10-29,Senate,"Reported Favorably With Substitute S-2",7,0,0,0,7
564752,304169,2013-11-07,Senate,"Senate Third Reading: Passed Roll Call # 498",37,0,1,0,38
564752,334883,2014-03-04,House,"Reported With Recommendation With Substitute H-1",13,0,0,0,13
564752,338672,2014-03-04,House,"Reported With Recommendation With Substitute  H-1",13,0,0,0,13
564752,341038,2014-03-12,House,"House Third Reading: Given Immediate Effect Roll Call # 95",108,0,0,0,108
564752,342189,2014-03-13,Senate,"Senate Third Reading:  Roll Call # 96",38,0,0,0,38
564752,382881,2014-03-13,Senate,"Senate Third Reading: Roll Call # 96",38,0,0,0,38
564754,304412,2013-11-13,Senate,"Reported Favorably Without Amendment",3,2,0,0,5
564754,304937,2013-12-04,Senate,"Senate Third Reading: Passed Roll Call # 553",22,14,0,2,38
564761,364089,2014-05-13,House,"Reported With Recommendation Without Amendment",13,0,0,0,13
564761,366329,2014-05-21,House,"House Third Reading: Given Immediate Effect Roll Call # 269",107,0,0,0,107
564761,381536,2014-11-06,Senate,"Reported Favorably Without Amendment",7,0,0,0,7
564761,383236,2014-12-16,Senate,"Senate Third Reading: Given Immediate Effect Roll Call # 798",37,0,0,1,38
564768,331621,2014-02-27,House,"Reported With Recommendation With Substitute H-1",29,0,0,0,29
564768,338734,2014-02-27,House,"Reported With Recommendation With Substitute  H-1",29,0,0,0,29
564776,302818,2013-09-25,House,"Reported With Recommendation With Substitute H-3",6,2,0,0,8
564776,339317,2013-09-25,House,"Reported With Recommendation With Substitute  H-3",6,2,0,0,8
564776,382444,2014-12-04,House,"House Third Reading: Given Immediate Effect Roll Call # 618",59,50,0,0,109
564894,303770,2013-10-23,House,"Reported With Recommendation With Substitute H-3",17,1,0,0,18
564894,303986,2013-11-05,House,"House Third Reading: Given Immediate Effect Roll Call # 372",108,0,0,0,108
564894,305116,2013-12-10,Senate,"Reported Favorably With Substitute S-2",4,0,0,0,4
564894,305432,2013-12-12,Senate,"Senate Third Reading: Given Immediate Effect Roll Call # 639",38,0,0,0,38
564894,305433,2013-12-12,House,"House Third Reading:  Roll Call # 530",108,1,0,0,109
564894,383086,2013-12-12,House,"House Third Reading: Roll Call # 530",108,1,0,0,109
564900,303104,2013-10-01,House,"Reported With Recommendation With Substitute H-2",7,1,0,0,8
564900,303321,2013-10-09,House,"House Third Reading: Given Immediate Effect Roll Call # 316",77,31,0,0,108
564900,303829,2013-10-29,Senate,"Reported Favorably With Substitute S-1",5,0,0,0,5
564900,305351,2013-12-12,Senate,"Senate Third Reading: Given Immediate Effect Roll Call # 631",25,13,0,0,38
564900,305352,2013-12-12,House,"House Third Reading:  Roll Call # 519",79,30,0,0,109
564900,382869,2013-12-12,House,"House Third Reading: Roll Call # 519",79,30,0,0,109
564942,304287,2013-11-12,Senate,"Reported Favorably With Substitute S-1",3,0,0,0,3
564942,337429,2013-11-12,Senate,"Reported Favorably With Substitute  S-1",3,0,0,0,3
564943,303919,2013-10-31,Senate,"Reported Favorably Without Amendment",7,0,0,0,7
564944,304285,2013-11-12,Senate,"Reported Favorably With Substitute S-1",3,0,0,0,3
564944,326291,2014-02-20,Senate,"Senate Third Reading: Passed Roll Call # 38",38,0,0,0,38
564944,369891,2014-06-04,House,"Reported With Recommendation With Substitute  H-1",9,0,0,0,9
564944,382312,2014-12-03,House,"House Third Reading: Given Immediate Effect Roll Call # 600",100,9,0,0,109
564944,382556,2014-12-09,Senate,"Senate Third Reading:  Roll Call # 727",37,0,0,1,38
564944,382727,2014-12-09,Senate,"Senate Third Reading: Roll Call # 727",37,0,0,1,38
564946,304280,2013-11-12,Senate,"Reported Favorably With Substitute S-1",3,0,0,0,3
564946,337445,2013-11-12,Senate,"Reported Favorably With Substitute  S-1",3,0,0,0,3
564948,304347,2013-11-12,Senate,"Reported Favorably Without Amendment",3,0,0,0,3
564948,326143,2014-02-20,Senate,"Senate Third Reading: Passed Roll Call # 43",38,0,0,0,38
564948,369929,2014-06-04,House,"Reported With Recommendation With Substitute  H-1",9,0,0,0,9
564948,382260,2014-12-03,House,"House Third Reading: Given Immediate Effect Roll Call # 604",109,0,0,0,109
564948,382544,2014-12-09,Senate,"Senate Third Reading:  Roll Call # 730",37,0,0,1,38
564948,382688,2014-12-09,Senate,"Senate Third Reading: Roll Call # 730",37,0,0,1,38
564949,304288,2013-11-12,Senate,"Reported Favorably With Substitute S-1",3,0,0,0,3
564949,337446,2013-11-12,Senate,"Reported Favorably With Substitute  S-1",3,0,0,0,3
564951,303822,2013-10-29,Senate,"Reported Favorably With Recommendation For Referral To Committee On Judiciary",4,0,0,0,4
564954,304289,2013-11-12,Senate,"Reported Favorably With Substitute S-3",3,0,0,0,3
564954,326286,2014-02-20,Senate,"Senate Third Reading: Passed Roll Call # 44",38,0,0,0,38
564954,369921,2014-06-04,House,"Reported With Recommendation With Substitute  H-1",9,0,0,0,9
564954,382287,2014-12-03,House,"House Third Reading: Given Immediate Effect Roll Call # 605",109,0,0,0,109
564954,382583,2014-12-09,Senate,"Senate Third Reading:  Roll Call # 731",37,0,0,1,38
564954,382677,2014-12-09,Senate,"Senate Third Reading: Roll Call # 731",37,0,0,1,38
564958,304274,2013-11-12,Senate,"Reported Favorably Without Amendment",3,0,0,0,3
564958,326284,2014-02-20,Senate,"Senate Third Reading: Passed Roll Call # 39",38,0,0,0,38
564958,369975,2014-06-04,House,"Reported With Recommendation With Substitute  H-1",9,0,0,0,9
564958,382336,2014-12-03,House,"House Third Reading: Given Immediate Effect Roll Call # 602",109,0,0,0,109
564958,382567,2014-12-09,Senate,"Senate Third Reading:  Roll Call # 728",37,0,0,1,38
564958,382643,2014-12-09,Senate,"Senate Third Reading: Roll Call # 728",37,0,0,1,38
564964,304482,2013-11-14,Senate,"Reported Favorably With Substitute S-1",7,0,0,0,7
564964,304934,2013-12-04,Senate,"Senate Third Reading: Passed Roll Call # 552",36,0,0,2,38
564964,341338,2014-03-12,House,"Reported With Recommendation With Substitute  H-1",14,0,0,0,14
564967,304286,2013-11-12,Senate,"Reported Favorably Without Amendment",3,0,0,0,3
564967,326172,2014-02-20,Senate,"Senate Third Reading: Passed Roll Call # 41",38,0,0,0,38
564967,369866,2014-06-04,House,"Reported With Recommendation With Substitute H-1",9,0,0,0,9
564969,304349,2013-11-12,Senate,"Reported Favorably With Substitute S-1",3,0,0,0,3
564969,326231,2014-02-20,Senate,"Senate Third Reading: Passed Roll Call # 42",38,0,0,0,38
564969,369855,2014-06-04,House,"Reported With Recommendation With Substitute  H-1",9,0,0,0,9
564969,382775,2014-12-11,House,"House Third Reading: Given Immediate Effect Roll Call # 666",104,3,0,0,107
564969,383115,2014-12-15,Senate,"Senate Third Reading: Roll Call # 781",38,0,0,0,38
564973,304282,2013-11-12,Senate,"Reported Favorably With Substitute S-1",3,0,0,0,3
564973,326274,2014-02-20,Senate,"Senate Third Reading: Passed Roll Call # 37",38,0,0,0,38
564973,369973,2014-06-04,House,"Reported With Recommendation With Substitute  H-1",9,0,0,0,9
564973,382326,2014-12-03,House,"House Third Reading: Given Immediate Effect Roll Call # 599",106,3,0,0,109
564973,382560,2014-12-09,Senate,"Senate Third Reading:  Roll Call # 726",37,0,0,1,38
564973,382746,2014-12-09,Senate,"Senate Third Reading: Roll Call # 726",37,0,0,1,38
564974,304276,2013-11-12,Senate,"Reported Favorably Without Amendment",3,0,0,0,3
564974,326074,2014-02-20,Senate,"Senate Third Reading: Passed Roll Call # 40",38,0,0,0,38
564974,369894,2014-06-04,House,"Reported With Recommendation With Substitute  H-1",9,0,0,0,9
564974,382286,2014-12-03,House,"House Third Reading: Given Immediate Effect Roll Call # 603",109,0,0,0,109
564974,382549,2014-12-09,Senate,"Senate Third Reading:  Roll Call # 729",37,0,0,1,38
564974,382708,2014-12-09,Senate,"Senate Third Reading: Roll Call # 729",37,0,0,1,38
564975,344988,2014-03-18,House,"Reported With Recommendation With Substitute  H-4",13,0,0,0,13
564975,363483,2014-05-08,House,"House Third Reading: Given Immediate Effect Roll Call # 217",94,15,0,0,109
564975,371292,2014-06-12,Senate,"Senate Third Reading: Given Immediate Effect Roll Call # 501",38,0,0,0,38
567872,304469,2013-11-14,Senate,"Reported Favorably With Substitute S-1",7,0,0,0,7
567872,305209,2013-12-11,Senate,"Senate Third Reading: Passed Roll Call # 580",36,0,0,2,38
567872,364540,2014-05-14,House,"Reported With Recommendation With Substitute  H-5",15,0,0,0,15
567872,370586,2014-06-10,House,"House Third Reading: Given Immediate Effect Roll Call # 386",70,39,0,0,109
567872,370940,2014-06-11,Senate,"Senate Third Reading:  Roll Call # 460",38,0,0,0,38
567872,383035,2014-06-11,Senate,"Senate Third Reading: Roll Call # 460",38,0,0,0,38
567874,303542,2013-10-17,Senate,"Reported Favorably Without Amendment",6,0,0,0,6
567874,303834,2013-10-29,Senate,"Senate Third Reading: Passed Roll Call # 463",35,1,0,2,38
567874,310909,2014-01-22,House,"Reported With Recommendation With Substitute H-1",15,0,0,0,15
567874,315629,2014-02-04,House,"House Third Reading: Given Immediate Effect Roll Call # 26",98,12,0,0,110
567874,319959,2014-02-12,Senate,"Senate Third Reading:  Roll Call # 16",37,1,0,0,38
567874,383020,2014-02-12,Senate,"Senate Third Reading: Roll Call # 16",37,1,0,0,38
567875,321063,2014-02-13,Senate,"Reported Favorably With Substitute S-2",4,0,0,0,4
567875,326015,2014-02-20,Senate,"Senate Third Reading: Passed Roll Call # 45",38,0,0,0,38
567875,369903,2014-06-04,House,"Reported With Recommendation Without Amendment",10,0,0,0,10
567875,371324,2014-06-12,House,"House Third Reading: Given Immediate Effect Roll Call # 411",107,0,0,0,107
567876,303302,2013-10-08,Senate,"Reported Favorably With Recommendation For Referral To Committee On Judiciary",5,0,0,0,5
567881,303166,2013-10-02,Senate,"Reported Favorably With Substitute S-1",9,0,0,0,9
567881,303304,2013-10-08,Senate,"Senate Third Reading: Passed Roll Call # 400",38,0,0,0,38
567881,303831,2013-10-29,House,"Reported With Recommendation With Substitute H-1",18,0,0,0,18
567881,304131,2013-11-07,House,"House Third Reading: Given Immediate Effect Roll Call # 386",109,0,0,0,109
567881,304370,2013-11-13,Senate,"Senate Third Reading:  Roll Call # 512",38,0,0,0,38
567881,382901,2013-11-13,Senate,"Senate Third Reading: Roll Call # 512",38,0,0,0,38
567882,303167,2013-10-02,Senate,"Reported Favorably Without Amendment",8,0,0,0,8
567882,303305,2013-10-08,Senate,"Senate Third Reading: Passed Roll Call # 399",37,1,0,0,38
567882,303833,2013-10-29,House,"Reported With Recommendation Without Amendment",18,0,0,0,18
567882,304174,2013-11-07,House,"House Third Reading: Given Immediate Effect Roll Call # 385",109,0,0,0,109
567882,304371,2013-11-13,Senate,"Senate Third Reading: House Amendment(s) Concurred In Roll Call # 511",37,1,0,0,38
567898,304020,2013-11-05,House,"Reported With Recommendation With Substitute H-3",9,0,0,0,9
567898,304375,2013-11-13,House,"House Third Reading: Given Immediate Effect Roll Call # 414",110,0,0,0,110
567898,315520,2014-02-04,Senate,"Reported Favorably Without Amendment",6,0,0,0,6
567898,323577,2014-02-18,Senate,"Senate Third Reading: Given Immediate Effect Roll Call # 33",37,0,0,1,38
567898,324690,2014-02-19,House,"House Third Reading: Senate Amendment(s) Concurred In Roll Call # 56",110,0,0,0,110
567902,320336,2014-02-12,House,"Reported With Recommendation With Substitute H-2",12,3,0,0,15
567902,339528,2014-02-12,House,"Reported With Recommendation With Substitute  H-2",12,3,0,0,15
567902,369679,2014-06-03,House,"House Third Reading: Given Immediate Effect Roll Call # 334",85,24,0,0,109
567902,380207,2014-09-30,Senate,"Reported Favorably Without Amendment",5,1,0,0,6
567902,382445,2014-12-04,Senate,"Senate Third Reading: Given Immediate Effect Roll Call # 708",30,6,0,2,38
567910,303303,2013-10-08,House,"Reported With Recommendation Without Amendment",14,0,0,0,14
567910,303319,2013-10-09,House,"House Third Reading: Given Immediate Effect Roll Call # 319",108,0,0,0,108
567910,304376,2013-11-13,Senate,"Reported Favorably Without Amendment",4,0,0,0,4
567910,304891,2013-12-03,Senate,"Senate Third Reading: Given Immediate Effect Roll Call # 548",37,0,0,1,38
567914,303792,2013-10-24,House,"Reported With Recommendation Without Amendment",12,0,0,0,12
567948,303406,2013-10-15,Senate,"Reported Favorably Without Amendment",7,0,0,0,7
567948,303774,2013-10-24,Senate,"Senate Third Reading: Passed Roll Call # 454",36,0,0,2,38
567948,340875,2014-03-12,House,"Reported With Recommendation Without Amendment",12,0,0,0,12
567948,348294,2014-03-26,House,"House Third Reading: Given Immediate Effect Roll Call # 162",109,0,0,0,109
567950,303415,2013-10-15,Senate,"Reported Favorably Without Amendment",7,0,0,0,7
567950,303790,2013-10-24,Senate,"Senate Third Reading: Passed Roll Call # 458",36,0,0,2,38
567950,340830,2014-03-12,House,"Reported With Recommendation Without Amendment",12,0,0,0,12
567950,348257,2014-03-26,House,"House Third Reading: Given Immediate Effect Roll Call # 165",108,1,0,0,109
567952,303201,2013-10-03,Senate,"Reported Favorably Without Amendment",6,0,0,0,6
567952,303284,2013-10-08,Senate,"Senate Third Reading: Passed Roll Call # 398",38,0,0,0,38
567952,305120,2013-12-10,House,"Reported With Recommendation Without Amendment",10,1,0,0,11
567952,305261,2013-12-11,House,"House Third Reading: Given Immediate Effect Roll Call # 480",108,1,0,0,109
567954,303412,2013-10-15,Senate,"Reported Favorably With Substitute S-1",7,0,0,0,7
567954,303785,2013-10-24,Senate,"Senate Third Reading: Passed Roll Call # 456",36,0,0,2,38
567954,341214,2014-03-12,House,"Reported With Recommendation Without Amendment",12,0,0,0,12
567954,348279,2014-03-26,House,"House Third Reading: Given Immediate Effect Roll Call # 164",109,0,0,0,109
567957,303202,2013-10-03,Senate,"Reported Favorably Without Amendment",5,1,0,0,6
567957,303289,2013-10-08,Senate,"Senate Third Reading: Passed Roll Call # 396",38,0,0,0,38
567957,305119,2013-12-10,House,"Reported With Recommendation With Substitute H-1",10,1,0,0,11
567957,330990,2013-12-11,House,"House Third Reading: Given Immediate Effect Roll Call # 478",108,1,0,0,109
567957,330991,2013-12-11,Senate,"Senate Third Reading:  Roll Call # 608",38,0,0,0,38
567957,383096,2013-12-11,Senate,"Senate Third Reading: Roll Call # 608",38,0,0,0,38
567959,303787,2013-10-24,Senate,"Reported Favorably With Substitute S-1",6,0,0,0,6
567959,303920,2013-10-31,Senate,"Senate Third Reading: Passed Roll Call # 480",36,1,0,1,38
567959,316370,2014-02-05,House,"Reported With Recommendation Without Amendment",13,3,0,0,16
567959,323733,2014-02-18,House,"House Third Reading: Given Immediate Effect Roll Call # 50",87,21,0,0,108
567961,303200,2013-10-03,Senate,"Reported Favorably Without Amendment",6,0,0,0,6
567961,303287,2013-10-08,Senate,"Senate Third Reading: Passed Roll Call # 394",38,0,0,0,38
567961,305107,2013-12-10,House,"Reported With Recommendation With Substitute H-1",10,1,0,0,11
567961,305217,2013-12-11,House,"House Third Reading: Given Immediate Effect Roll Call # 476",108,1,0,0,109
567961,305218,2013-12-11,Senate,"Senate Third Reading:  Roll Call # 605",38,0,0,0,38
567961,383089,2013-12-11,Senate,"Senate Third Reading: Roll Call # 605",38,0,0,0,38
567963,303409,2013-10-15,Senate,"Reported Favorably Without Amendment",7,0,0,0,7
567963,303776,2013-10-24,Senate,"Senate Third Reading: Passed Roll Call # 455",36,0,0,2,38
567963,340895,2014-03-12,House,"Reported With Recommendation Without Amendment",12,0,0,0,12
567963,348283,2014-03-26,House,"House Third Reading: Given Immediate Effect Roll Call # 163",109,0,0,0,109
567965,303429,2013-10-15,Senate,"Reported Favorably Without Amendment",7,0,0,0,7
567965,303781,2013-10-24,Senate,"Senate Third Reading: Passed Roll Call # 457",36,0,0,2,38
567968,303211,2013-10-03,Senate,"Reported Favorably Without Amendment",5,1,0,0,6
567968,303293,2013-10-08,Senate,"Senate Third Reading: Passed Roll Call # 395",38,0,0,0,38
567968,305150,2013-12-10,House,"Reported With Recommendation With Substitute H-1",10,1,0,0,11
567968,305302,2013-12-11,House,"House Third Reading: Given Immediate Effect Roll Call # 477",108,1,0,0,109
567968,305303,2013-12-11,Senate,"Senate Third Reading:  Roll Call # 606",38,0,0,0,38
567968,383083,2013-12-11,Senate,"Senate Third Reading: Roll Call # 606",38,0,0,0,38
567970,303203,2013-10-03,Senate,"Reported Favorably Without Amendment",6,0,0,0,6
567970,303282,2013-10-08,Senate,"Senate Third Reading: Passed Roll Call # 397",37,1,0,0,38
567970,305152,2013-12-10,House,"Reported With Recommendation Without Amendment",10,1,0,0,11
567970,305244,2013-12-11,House,"House Third Reading: Given Immediate Effect Roll Call # 479",107,1,0,0,108
567972,303819,2013-10-29,House,"Reported With Recommendation Without Amendment",15,0,0,0,15
567974,303301,2013-10-08,Senate,"Reported Favorably With Substitute S-1",4,0,0,0,4
567974,303484,2013-10-16,Senate,"Senate Third Reading: Passed Roll Call # 408",37,0,0,1,38
567974,360771,2014-04-29,House,"Reported With Recommendation Without Amendment",9,0,0,0,9
567974,364073,2014-05-13,House,"House Third Reading: Given Immediate Effect Roll Call # 227",110,0,0,0,110
567976,305224,2013-12-11,Senate,"Reported Favorably With Substitute S-1",5,2,0,0,7
567976,337433,2013-12-11,Senate,"Reported Favorably With Substitute  S-1",5,2,0,0,7
567986,302832,2013-09-26,House,"Reported With Recommendation With Substitute H-3",11,5,0,0,16
567986,302833,2013-09-26,House,"House Third Reading:  Roll Call # 307",85,21,0,0,106
567986,382981,2013-09-26,House,"House Third Reading: Roll Call # 307",85,21,0,0,106
567991,305237,2013-12-11,Senate,"Reported Favorably Without Amendment",7,0,0,0,7
568050,304957,2013-12-04,Senate,"Reported Favorably With Substitute S-2",4,0,0,0,4
568050,305239,2013-12-11,Senate,"Senate Third Reading: Passed Roll Call # 586",37,0,0,1,38
568050,321206,2014-02-13,House,"Reported With Recommendation With Substitute H-1",27,0,0,0,27
568050,325232,2014-02-19,House,"House Third Reading: Given Immediate Effect Roll Call # 59",110,0,0,0,110
568050,326349,2014-02-20,Senate,"Senate Third Reading:  Roll Call # 49",37,0,1,0,38
568050,382898,2014-02-20,Senate,"Senate Third Reading: Roll Call # 49",37,0,1,0,38
568051,304961,2013-12-04,Senate,"Reported Favorably Without Amendment",4,0,0,0,4
568051,305297,2013-12-11,Senate,"Senate Third Reading: Passed Roll Call # 585",37,0,0,1,38
568051,320962,2014-02-13,House,"Reported With Recommendation Without Amendment",27,0,0,0,27
568051,324820,2014-02-19,House,"House Third Reading: Given Immediate Effect Roll Call # 58",110,0,0,0,110
568052,303299,2013-10-08,Senate,"Reported Favorably With Substitute S-2",7,0,0,0,7
568052,303636,2013-10-22,Senate,"Senate Third Reading: Passed Roll Call # 436",35,3,0,0,38
568053,303298,2013-10-08,Senate,"Reported Favorably With Substitute S-1",7,0,0,0,7
568053,303635,2013-10-22,Senate,"Senate Third Reading: Passed Roll Call # 437",35,3,0,0,38
568053,303882,2013-10-30,House,"Reported With Recommendation Without Amendment",9,0,0,0,9
568053,305036,2013-12-05,House,"House Third Reading: Given Immediate Effect Roll Call # 453",100,10,0,0,110
568054,303300,2013-10-08,Senate,"Reported Favorably With Substitute S-1",7,0,0,0,7
568054,303649,2013-10-22,Senate,"Senate Third Reading: Passed Roll Call # 435",38,0,0,0,38
568066,303884,2013-10-30,House,"Reported With Recommendation With Substitute H-1",14,0,0,0,14
568066,304178,2013-11-07,House,"House Third Reading: Given Immediate Effect Roll Call # 378",108,1,0,0,109
568066,310361,2014-01-21,Senate,"Reported Favorably Without Amendment",7,0,0,0,7
568066,321020,2014-02-13,Senate,"Senate Third Reading: Given Immediate Effect Roll Call # 27",38,0,0,0,38
568071,304053,2013-11-06,House,"Reported With Recommendation With Substitute H-1",13,2,0,0,15
568071,304395,2013-11-13,House,"House Third Reading: Given Immediate Effect Roll Call # 415",86,24,0,0,110
568071,304969,2013-12-04,Senate,"Reported Favorably Without Amendment",7,0,0,0,7
568071,305033,2013-12-05,Senate,"Senate Third Reading: Given Immediate Effect Roll Call # 567",27,9,0,2,38
568071,305034,2013-12-05,Senate,"Senate Third Reading: Passed Roll Call # 568",26,10,0,2,38
568076,303772,2013-10-23,House,"Reported With Recommendation With Substitute H-1",15,0,0,0,15
568076,304159,2013-11-07,House,"House Third Reading: Given Immediate Effect Roll Call # 375",109,0,0,0,109
568076,310486,2014-01-21,Senate,"Reported Favorably Without Amendment",7,0,0,0,7
568076,321014,2014-02-13,Senate,"Senate Third Reading: Given Immediate Effect Roll Call # 23",38,0,0,0,38
568078,303889,2013-10-30,House,"Reported With Recommendation With Substitute H-1",14,0,0,0,14
568078,304183,2013-11-07,House,"House Third Reading: Given Immediate Effect Roll Call # 376",108,1,0,0,109
568078,310379,2014-01-21,Senate,"Reported Favorably With Substitute S-1",7,0,0,0,7
568078,321049,2014-02-13,Senate,"Senate Third Reading: Given Immediate Effect Roll Call # 24",38,0,0,0,38
568078,323752,2014-02-18,House,"House Third Reading:  Roll Call # 48",107,1,0,0,108
568078,382945,2014-02-18,House,"House Third Reading: Roll Call # 48",107,1,0,0,108
568081,304411,2013-11-13,House,"Reported With Recommendation With Substitute H-2",11,0,0,0,11
568081,304942,2013-12-04,House,"House Third Reading: Passed Roll Call # 443",109,0,0,0,109
568081,380309,2014-10-01,Senate,"Reported Favorably With Substitute  S-2",4,0,0,0,4
568081,380386,2014-10-02,Senate,"Senate Third Reading: Given Immediate Effect Roll Call # 615",38,0,0,0,38
568081,380387,2014-10-02,House,"House Third Reading:  Roll Call # 554",107,0,0,0,107
568081,383067,2014-10-02,House,"House Third Reading: Roll Call # 554",107,0,0,0,107
568082,303737,2013-10-23,House,"Reported With Recommendation With Substitute H-1",15,0,0,0,15
568082,304151,2013-11-07,House,"House Third Reading: Given Immediate Effect Roll Call # 377",108,1,0,0,109
568082,310398,2014-01-21,Senate,"Reported Favorably Without Amendment",7,0,0,0,7
568082,321097,2014-02-13,Senate,"Senate Third Reading: Passed Roll Call # 25",37,0,1,0,38
568082,321098,2014-02-13,Senate,"Senate Third Reading: Given Immediate Effect Roll Call # 26",38,0,0,0,38
568085,303767,2013-10-23,House,"Reported With Recommendation With Substitute H-2",9,0,0,0,9
568085,304141,2013-11-07,House,"House Third Reading: Given Immediate Effect Roll Call # 383",108,1,0,0,109
568085,305028,2013-12-05,Senate,"Senate Third Reading: Given Immediate Effect Roll Call # 565",37,0,0,1,38
568086,303760,2013-10-23,House,"Reported With Recommendation With Substitute H-3",9,0,0,0,9
568086,304113,2013-11-07,House,"House Third Reading: Given Immediate Effect Roll Call # 382",106,3,0,0,109
568086,305042,2013-12-05,Senate,"Senate Third Reading: Given Immediate Effect Roll Call # 564",33,2,2,1,38
568087,303747,2013-10-23,House,"Reported With Recommendation With Substitute H-3",9,0,0,0,9
568265,321089,2014-02-13,Senate,"Reported Favorably With Substitute S-1",4,0,0,0,4
568265,325864,2014-02-20,Senate,"Senate Third Reading: Passed Roll Call # 46",36,2,0,0,38
568265,369857,2014-06-04,House,"Reported With Recommendation With Substitute  H-1",9,1,0,0,10
568278,303910,2013-10-31,Senate,"Reported Favorably With Substitute S-1",7,0,0,0,7
568278,304308,2013-11-12,Senate,"Senate Third Reading: Passed Roll Call # 506",38,0,0,0,38
568278,348203,2014-03-26,House,"Reported With Recommendation With Substitute H-4",14,0,0,0,14
568278,362792,2014-05-06,House,"House Third Reading: Given Immediate Effect Roll Call # 200",110,0,0,0,110
568278,363474,2014-05-08,Senate,"Senate Third Reading:  Roll Call # 248",38,0,0,0,38
568278,382936,2014-05-08,Senate,"Senate Third Reading: Roll Call # 248",38,0,0,0,38
568281,321106,2014-02-13,Senate,"Reported Favorably With Substitute S-1",4,0,0,0,4
568281,325970,2014-02-20,Senate,"Senate Third Reading: Passed Roll Call # 47",37,1,0,0,38
568372,316284,2014-02-05,House,"Reported With Recommendation With Substitute H-1",8,0,0,0,8
568372,339737,2014-02-05,House,"Reported With Recommendation With Substitute  H-1",8,0,0,0,8
568387,380159,2014-09-24,House,"Reported With Recommendation With Substitute  H-2",13,0,0,0,13
568387,381521,2014-11-06,House,"House Third Reading: Given Immediate Effect Roll Call # 562",106,0,0,0,106
568387,382846,2014-12-11,Senate,"Reported Favorably Without Amendment",5,0,0,0,5
568387,383694,2014-12-18,Senate,"Senate Third Reading: Given Immediate Effect Roll Call # 875",38,0,0,0,38
568389,304421,2013-11-13,House,"Reported With Recommendation Without Amendment",11,0,0,0,11
568389,304922,2013-12-04,House,"House Third Reading: Passed Roll Call # 444",109,0,0,0,109
568389,380315,2014-10-01,Senate,"Reported Favorably With Substitute  S-1",4,0,0,0,4
568389,380393,2014-10-02,Senate,"Senate Third Reading: Given Immediate Effect Roll Call # 616",38,0,0,0,38
568389,380394,2014-10-02,House,"House Third Reading:  Roll Call # 559",107,0,0,0,107
568389,383070,2014-10-02,House,"House Third Reading: Roll Call # 559",107,0,0,0,107
568392,380163,2014-09-24,House,"Reported With Recommendation With Substitute  H-1",13,0,0,0,13
568392,381517,2014-11-06,House,"House Third Reading: Given Immediate Effect Roll Call # 563",106,0,0,0,106
568392,382774,2014-12-11,Senate,"Reported Favorably With Substitute  S-1",5,0,0,0,5
568392,383695,2014-12-18,Senate,"Senate Third Reading: Given Immediate Effect Roll Call # 876",38,0,0,0,38
568392,383696,2014-12-18,House,"House Third Reading: Roll Call # 768",110,0,0,0,110
568394,310958,2014-01-22,House,"Reported With Recommendation Without Amendment",10,0,0,0,10
568394,320381,2014-02-12,House,"House Third Reading: Given Immediate Effect Roll Call # 38",109,0,0,0,109
568394,365766,2014-05-20,Senate,"Reported Favorably Without Amendment",4,0,0,0,4
568394,380391,2014-10-02,Senate,"Senate Third Reading: Given Immediate Effect Roll Call # 613",38,0,0,0,38
568394,380392,2014-10-02,House,"House Third Reading:  Roll Call # 553",107,0,0,0,107
568394,383060,2014-10-02,House,"House Third Reading: Roll Call # 553",107,0,0,0,107
568396,303545,2013-10-17,House,"Reported With Recommendation Without Amendment",11,0,0,0,11
568396,303893,2013-10-30,House,"House Third Reading: Given Immediate Effect Roll Call # 359",108,0,0,0,108
568396,304187,2013-11-07,Senate,"Reported Favorably Without Amendment",4,0,0,0,4
568396,305434,2013-12-12,Senate,"Senate Third Reading: Given Immediate Effect Roll Call # 633",38,0,0,0,38
568396,305435,2013-12-12,House,"House Third Reading:  Roll Call # 520",109,0,0,0,109
568396,382864,2013-12-12,House,"House Third Reading: Roll Call # 520",109,0,0,0,109
568399,303496,2013-10-17,House,"Reported With Recommendation Without Amendment",11,0,0,0,11
568399,303862,2013-10-30,House,"House Third Reading: Given Immediate Effect Roll Call # 358",108,0,0,0,108
568399,304132,2013-11-07,Senate,"Reported Favorably Without Amendment",4,0,0,0,4
568399,305370,2013-12-12,Senate,"Senate Third Reading: Given Immediate Effect Roll Call # 632",37,0,1,0,38
568399,305371,2013-12-12,House,"House Third Reading:  Roll Call # 525",109,0,0,0,109
568399,383155,2013-12-12,House,"House Third Reading: Roll Call # 525",109,0,0,0,109
568435,303775,2013-10-24,Senate,"Reported Favorably With Substitute S-1",6,0,0,0,6
568435,303909,2013-10-31,Senate,"Senate Third Reading: Passed Roll Call # 481",31,6,0,1,38
568440,303907,2013-10-31,Senate,"Reported Favorably With Substitute S-1",6,0,0,0,6
568440,304117,2013-11-07,Senate,"Senate Third Reading: Passed Roll Call # 496",38,0,0,0,38
568440,329262,2014-02-25,House,"Reported With Recommendation With Substitute H-3",14,0,0,0,14
568440,339071,2014-02-25,House,"Reported With Recommendation With Substitute  H-3",14,0,0,0,14
568440,345374,2014-03-18,House,"House Third Reading: Given Immediate Effect Roll Call # 118",109,1,0,0,110
568440,346597,2014-03-20,Senate,"Senate Third Reading:  Roll Call # 122",37,0,0,1,38
568440,383097,2014-03-20,Senate,"Senate Third Reading: Roll Call # 122",37,0,0,1,38
568443,303908,2013-10-31,Senate,"Reported Favorably With Substitute S-1",5,0,0,0,5
568443,304125,2013-11-07,Senate,"Senate Third Reading: Passed Roll Call # 494",38,0,0,0,38
568443,329027,2014-02-25,House,"Reported With Recommendation With Substitute H-2",14,0,0,0,14
568443,338618,2014-02-25,House,"Reported With Recommendation With Substitute  H-2",14,0,0,0,14
568443,344996,2014-03-18,House,"House Third Reading: Given Immediate Effect Roll Call # 116",110,0,0,0,110
568443,346649,2014-03-20,Senate,"Senate Third Reading:  Roll Call # 120",37,0,0,1,38
568443,383074,2014-03-20,Senate,"Senate Third Reading: Roll Call # 120",37,0,0,1,38
568449,304086,2013-11-06,House,"Reported With Recommendation Without Amendment",13,0,0,0,13
568451,303915,2013-10-31,Senate,"Reported Favorably With Substitute S-1",5,0,0,0,5
568451,304126,2013-11-07,Senate,"Senate Third Reading: Passed Roll Call # 495",38,0,0,0,38
568451,329042,2014-02-25,House,"Reported With Recommendation With Substitute H-2",14,0,0,0,14
568451,339386,2014-02-25,House,"Reported With Recommendation With Substitute  H-2",14,0,0,0,14
568451,345082,2014-03-18,House,"House Third Reading: Given Immediate Effect Roll Call # 117",110,0,0,0,110
568451,346579,2014-03-20,Senate,"Senate Third Reading:  Roll Call # 121",37,0,0,1,38
568451,383091,2014-03-20,Senate,"Senate Third Reading: Roll Call # 121",37,0,0,1,38
568459,303914,2013-10-31,Senate,"Reported Favorably With Substitute S-2",6,0,0,0,6
568459,304127,2013-11-07,Senate,"Senate Third Reading: Passed Roll Call # 497",38,0,0,0,38
568459,329002,2014-02-25,House,"Reported With Recommendation With Substitute H-3",15,0,0,0,15
568459,339402,2014-02-25,House,"Reported With Recommendation With Substitute  H-3",15,0,0,0,15
568459,345136,2014-03-18,House,"House Third Reading: Given Immediate Effect Roll Call # 119",110,0,0,0,110
568459,346599,2014-03-20,Senate,"Senate Third Reading:  Roll Call # 123",37,0,0,1,38
568459,383078,2014-03-20,Senate,"Senate Third Reading: Roll Call # 123",37,0,0,1,38
568462,305112,2013-12-10,Senate,"Reported Favorably With Substitute S-2",3,0,0,0,3
568462,305245,2013-12-11,Senate,"Senate Third Reading: Passed Roll Call # 592",37,0,0,1,38
568462,321470,2014-02-13,House,"Reported With Recommendation Without Amendment",11,0,0,0,11
568462,364457,2014-05-14,House,"House Third Reading: Given Immediate Effect Roll Call # 234",109,0,0,0,109
568464,310825,2014-01-22,Senate,"Reported Favorably With Substitute S-1",4,0,0,0,4
568464,337490,2014-01-22,Senate,"Reported Favorably With Substitute  S-1",4,0,0,0,4
568469,310808,2014-01-22,Senate,"Reported Favorably With Substitute S-1",4,0,0,0,4
568469,336832,2014-01-22,Senate,"Reported Favorably With Substitute  S-1",4,0,0,0,4
568507,304335,2013-11-12,House,"Reported With Recommendation With Substitute H-1",14,0,0,0,14
568507,304522,2013-11-14,House,"House Third Reading: Passed Roll Call # 435",105,5,0,0,110
568507,305367,2013-12-12,Senate,"Reported Favorably Without Amendment",4,0,0,0,4
568507,305368,2013-12-12,Senate,"Senate Third Reading: Given Immediate Effect Roll Call # 653",37,1,0,0,38
568511,324681,2014-02-19,House,"Reported With Recommendation With Substitute H-2",9,0,0,0,9
568511,331648,2014-02-27,House,"House Third Reading: Given Immediate Effect Roll Call # 72",108,0,0,0,108
568511,370641,2014-06-10,Senate,"Reported Favorably Without Amendment",3,0,0,0,3
568511,371051,2014-06-11,Senate,"Senate Third Reading: Given Immediate Effect Roll Call # 443",38,0,0,0,38
568516,370054,2014-06-05,House,"Reported With Recommendation With Substitute  H-3",12,0,0,0,12
568516,378789,2014-08-27,House,"House Third Reading: Given Immediate Effect Roll Call # 449",103,5,0,0,108
568516,383132,2014-12-15,Senate,"Reported Favorably Without Amendment",4,0,0,0,4
568516,383766,2014-12-18,Senate,"Senate Third Reading: Given Immediate Effect Roll Call # 877",36,2,0,0,38
568520,303210,2013-10-03,House,"Reported With Recommendation Without Amendment",11,0,0,0,11
568520,303521,2013-10-17,House,"House Third Reading: Given Immediate Effect Roll Call # 333",107,0,0,0,107
568520,304521,2013-11-14,Senate,"Reported Favorably With Substitute S-3",4,0,0,0,4
568520,305393,2013-12-12,Senate,"Senate Third Reading: Given Immediate Effect Roll Call # 623",38,0,0,0,38
568520,305394,2013-12-12,House,"House Third Reading:  Roll Call # 521",109,0,0,0,109
568520,383151,2013-12-12,House,"House Third Reading: Roll Call # 521",109,0,0,0,109
568524,303753,2013-10-23,House,"Reported With Recommendation With Substitute H-1",15,0,0,0,15
568524,304171,2013-11-07,House,"House Third Reading: Given Immediate Effect Roll Call # 379",108,1,0,0,109
568524,305307,2013-12-11,Senate,"Reported Favorably Without Amendment",7,0,0,0,7
568524,305422,2013-12-12,Senate,"Senate Third Reading: Given Immediate Effect Roll Call # 648",38,0,0,0,38
568530,303212,2013-10-03,House,"Reported With Recommendation Without Amendment",11,0,0,0,11
568530,303525,2013-10-17,House,"House Third Reading: Given Immediate Effect Roll Call # 337",108,0,0,0,108
568530,304523,2013-11-14,Senate,"Reported Favorably With Substitute S-1",4,0,0,0,4
568530,305385,2013-12-12,Senate,"Senate Third Reading: Given Immediate Effect Roll Call # 624",37,0,1,0,38
568530,305386,2013-12-12,House,"House Third Reading:  Roll Call # 522",109,0,0,0,109
568530,383158,2013-12-12,House,"House Third Reading: Roll Call # 522",109,0,0,0,109
568568,315486,2014-02-04,Senate,"Reported Favorably With Substitute S-1",4,0,0,0,4
568568,323696,2014-02-18,Senate,"Senate Third Reading: Passed Roll Call # 30",37,0,0,1,38
568568,366462,2014-05-21,House,"Reported With Recommendation With Substitute  H-1",11,0,0,0,11
568568,380281,2014-10-01,House,"House Third Reading: Given Immediate Effect Roll Call # 509",108,1,0,0,109
568568,380369,2014-10-02,Senate,"Senate Third Reading:  Roll Call # 625",38,0,0,0,38
568568,383092,2014-10-02,Senate,"Senate Third Reading: Roll Call # 625",38,0,0,0,38
568570,319151,2014-02-11,Senate,"Reported Favorably Without Amendment",4,0,0,0,4
568570,348168,2014-03-26,Senate,"Senate Third Reading: Passed Roll Call # 146",37,0,0,1,38
568570,366366,2014-05-21,House,"Reported With Recommendation With Substitute  H-1",10,0,0,0,10
568570,380239,2014-10-01,House,"House Third Reading: Given Immediate Effect Roll Call # 514",101,8,0,0,109
568570,380328,2014-10-02,Senate,"Senate Third Reading:  Roll Call # 629",38,0,0,0,38
568570,382691,2014-10-02,Senate,"Senate Third Reading: Roll Call # 629",38,0,0,0,38
568571,305017,2013-12-05,Senate,"Reported Favorably With Substitute S-1",4,0,0,0,4
568571,305355,2013-12-12,Senate,"Senate Third Reading: Passed Roll Call # 645",38,0,0,0,38
568572,315475,2014-02-04,Senate,"Reported Favorably With Substitute S-2",4,0,0,0,4
568572,323761,2014-02-18,Senate,"Senate Third Reading: Passed Roll Call # 29",37,0,0,1,38
568573,303509,2013-10-17,Senate,"Reported Favorably With Substitute S-1",4,0,0,0,4
568573,303836,2013-10-29,Senate,"Senate Third Reading: Passed Roll Call # 461",36,0,0,2,38
568573,345792,2014-03-19,House,"Reported With Recommendation Without Amendment",10,0,0,0,10
568573,369719,2014-06-03,House,"House Third Reading: Given Immediate Effect Roll Call # 335",108,1,0,0,109
568575,315495,2014-02-04,Senate,"Reported Favorably With Substitute S-3",4,0,0,0,4
568575,337171,2014-02-04,Senate,"Reported Favorably With Substitute  S-3",4,0,0,0,4
568575,348143,2014-03-26,Senate,"Senate Third Reading: Passed Roll Call # 144",37,0,0,1,38
568575,380316,2014-10-01,House,"Reported With Recommendation With Substitute  H-1",10,1,0,0,11
568575,380400,2014-10-02,House,"House Third Reading: Given Immediate Effect Roll Call # 526",107,0,0,0,107
568575,380401,2014-10-02,Senate,"Senate Third Reading:  Roll Call # 624",38,0,0,0,38
568575,383071,2014-10-02,Senate,"Senate Third Reading: Roll Call # 624",38,0,0,0,38
568576,303506,2013-10-17,Senate,"Reported Favorably Without Amendment",4,0,0,0,4
568576,303841,2013-10-29,Senate,"Senate Third Reading: Passed Roll Call # 460",36,0,0,2,38
568576,313600,2014-01-29,House,"Reported With Recommendation Without Amendment",7,0,0,0,7
568576,319215,2014-02-11,House,"House Third Reading: Given Immediate Effect Roll Call # 37",109,0,0,0,109
568583,319116,2014-02-11,Senate,"Reported Favorably Without Amendment",4,0,0,0,4
568583,348222,2014-03-26,Senate,"Senate Third Reading: Passed Roll Call # 145",37,0,0,1,38
568583,366283,2014-05-21,House,"Reported With Recommendation With Substitute  H-1",10,0,0,0,10
568583,380314,2014-10-01,House,"House Third Reading: Given Immediate Effect Roll Call # 513",109,0,0,0,109
568583,380390,2014-10-02,Senate,"Senate Third Reading:  Roll Call # 628",38,0,0,0,38
568583,383103,2014-10-02,Senate,"Senate Third Reading: Roll Call # 628",38,0,0,0,38
568585,380305,2014-10-01,Senate,"Reported Favorably With Substitute  S-2",4,0,0,0,4
568585,380384,2014-10-02,Senate,"Senate Third Reading: Passed Roll Call # 634",38,0,0,0,38
568585,381609,2014-11-12,House,"Reported With Recommendation With Substitute H-1",10,0,0,0,10
568585,382732,2014-12-09,House,"House Third Reading: Given Immediate Effect Roll Call # 647",97,12,0,0,109
568585,383269,2014-12-17,Senate,"Senate Third Reading: Roll Call # 833",37,0,0,1,38
568585,383484,2014-12-18,House,"House Third Reading: Roll Call # 766",96,14,0,0,110
568586,361851,2014-05-01,House,"Reported With Recommendation With Amendment(s)",6,1,0,0,7
568589,305045,2013-12-05,Senate,"Reported Favorably Without Amendment",4,0,0,0,4
568589,305406,2013-12-12,Senate,"Senate Third Reading: Passed Roll Call # 646",38,0,0,0,38
568590,303512,2013-10-17,Senate,"Reported Favorably With Substitute S-1",4,0,0,0,4
568590,303816,2013-10-29,Senate,"Senate Third Reading: Passed Roll Call # 462",36,0,0,2,38
568590,345895,2014-03-19,House,"Reported With Recommendation Without Amendment",10,0,0,0,10
568590,369685,2014-06-03,House,"House Third Reading: Given Immediate Effect Roll Call # 337",108,1,0,0,109
568590,369892,2014-06-04,Senate,"Senate Third Reading:  Roll Call # 349",37,0,0,1,38
568590,383156,2014-06-04,Senate,"Senate Third Reading: Roll Call # 349",37,0,0,1,38
568591,315682,2014-02-04,Senate,"Reported Favorably Without Amendment",4,0,0,0,4
568591,323640,2014-02-18,Senate,"Senate Third Reading: Passed Roll Call # 31",37,0,0,1,38
568591,366268,2014-05-21,House,"Reported With Recommendation With Substitute  H-1",11,0,0,0,11
568591,380287,2014-10-01,House,"House Third Reading: Given Immediate Effect Roll Call # 511",109,0,0,0,109
568591,380370,2014-10-02,Senate,"Senate Third Reading:  Roll Call # 626",38,0,0,0,38
568591,383062,2014-10-02,Senate,"Senate Third Reading: Roll Call # 626",38,0,0,0,38
568593,303746,2013-10-23,House,"Reported With Recommendation Without Amendment",11,0,0,0,11
568593,304191,2013-11-07,House,"House Third Reading: Given Immediate Effect Roll Call # 389",109,0,0,0,109
568593,304398,2013-11-13,Senate,"Reported Favorably Without Amendment",4,0,0,0,4
568593,305346,2013-12-12,Senate,"Senate Third Reading: Given Immediate Effect Roll Call # 634",38,0,0,0,38
568593,305347,2013-12-12,House,"House Third Reading: Senate Amendment(s) Concurred In Roll Call # 523",109,0,0,0,109
568595,303744,2013-10-23,House,"Reported With Recommendation Without Amendment",11,0,0,0,11
568595,304134,2013-11-07,House,"House Third Reading: Passed Roll Call # 390",109,0,0,0,109
568595,304394,2013-11-13,Senate,"Reported Favorably Without Amendment",4,0,0,0,4
568595,305437,2013-12-12,Senate,"Senate Third Reading: Given Immediate Effect Roll Call # 635",38,0,0,0,38
568595,305438,2013-12-12,House,"House Third Reading: Senate Amendment(s) Concurred In Roll Call # 524",109,0,0,0,109
568596,303755,2013-10-23,House,"Reported With Recommendation Without Amendment",11,0,0,0,11
568596,304156,2013-11-07,House,"House Third Reading: Passed Roll Call # 392",109,0,0,0,109
568596,304384,2013-11-13,Senate,"Reported Favorably Without Amendment",4,0,0,0,4
568596,305408,2013-12-12,Senate,"Senate Third Reading: Given Immediate Effect Roll Call # 637",38,0,0,0,38
568596,305409,2013-12-12,House,"House Third Reading: Senate Amendment(s) Concurred In Roll Call # 529",109,0,0,0,109
568598,319303,2014-02-11,Senate,"Reported Favorably Without Amendment",4,0,0,0,4
568598,348289,2014-03-26,Senate,"Senate Third Reading: Passed Roll Call # 147",37,0,0,1,38
568599,315498,2014-02-04,Senate,"Reported Favorably Without Amendment",4,0,0,0,4
568599,323558,2014-02-18,Senate,"Senate Third Reading: Passed Roll Call # 32",37,0,0,1,38
568599,366406,2014-05-21,House,"Reported With Recommendation With Substitute  H-1",11,0,0,0,11
568599,380313,2014-10-01,House,"House Third Reading: Given Immediate Effect Roll Call # 512",109,0,0,0,109
568599,380389,2014-10-02,Senate,"Senate Third Reading:  Roll Call # 627",38,0,0,0,38
568599,383118,2014-10-02,Senate,"Senate Third Reading: Roll Call # 627",38,0,0,0,38
568600,303749,2013-10-23,House,"Reported With Recommendation Without Amendment",11,0,0,0,11
568600,304144,2013-11-07,House,"House Third Reading: Passed Roll Call # 391",109,0,0,0,109
568600,304410,2013-11-13,Senate,"Reported Favorably Without Amendment",4,0,0,0,4
568600,305427,2013-12-12,Senate,"Senate Third Reading: Given Immediate Effect Roll Call # 636",38,0,0,0,38
568600,305428,2013-12-12,House,"House Third Reading: Senate Amendment(s) Concurred In Roll Call # 528",109,0,0,0,109
568601,367612,2014-05-27,Senate,"Reported Favorably With Substitute  S-1",4,0,0,0,4
568601,370072,2014-06-05,Senate,"Senate Third Reading: Passed Roll Call # 393",37,0,0,1,38
568601,379407,2014-09-10,House,"Reported With Recommendation With Substitute  H-2",8,1,0,0,9
568601,380343,2014-10-02,House,"House Third Reading: Given Immediate Effect Roll Call # 525",106,1,0,0,107
568601,380344,2014-10-02,Senate,"Senate Third Reading:  Roll Call # 630",38,0,0,0,38
568601,382631,2014-10-02,Senate,"Senate Third Reading: Roll Call # 630",38,0,0,0,38
568602,367679,2014-05-27,Senate,"Reported Favorably Without Amendment",3,0,0,0,3
568602,370077,2014-06-05,Senate,"Senate Third Reading: Passed Roll Call # 392",37,0,0,1,38
568603,305035,2013-12-05,Senate,"Reported Favorably Without Amendment",4,0,0,0,4
568603,305424,2013-12-12,Senate,"Senate Third Reading: Passed Roll Call # 644",38,0,0,0,38
568603,366187,2014-05-21,House,"Reported With Recommendation With Substitute  H-1",8,1,0,0,9
568603,380297,2014-10-01,House,"House Third Reading: Given Immediate Effect Roll Call # 510",108,1,0,0,109
568603,380377,2014-10-02,Senate,"Senate Third Reading:  Roll Call # 623",38,0,0,0,38
568603,383080,2014-10-02,Senate,"Senate Third Reading: Roll Call # 623",38,0,0,0,38
568604,303751,2013-10-23,House,"Reported With Recommendation With Amendment(s)",11,0,0,0,11
568604,304115,2013-11-07,House,"House Third Reading: Given Immediate Effect Roll Call # 388",109,0,0,0,109
568604,304386,2013-11-13,Senate,"Reported Favorably Without Amendment",4,0,0,0,4
568604,305349,2013-12-12,Senate,"Senate Third Reading: Given Immediate Effect Roll Call # 638",38,0,0,0,38
568604,305350,2013-12-12,House,"House Third Reading: Senate Amendment(s) Concurred In Roll Call # 527",109,0,0,0,109
568800,303519,2013-10-17,Senate,"Reported Favorably With Substitute S-2",4,0,0,0,4
568800,337441,2013-10-17,Senate,"Reported Favorably With Substitute  S-2",4,0,0,0,4
568801,303520,2013-10-17,Senate,"Reported Favorably With Substitute S-1",4,0,0,0,4
568801,337413,2013-10-17,Senate,"Reported Favorably With Substitute  S-1",4,0,0,0,4
568805,310885,2014-01-22,House,"Reported With Recommendation For Referral To Committee On Judiciary",8,0,0,0,8
568805,316963,2014-02-06,House,"Reported With Recommendation With Substitute H-2",10,0,0,0,10
568805,339622,2014-02-06,House,"Reported With Recommendation With Substitute  H-2",10,0,0,0,10
568805,371416,2014-06-12,House,"House Third Reading: Given Immediate Effect Roll Call # 423",89,21,0,0,110
568805,380321,2014-10-01,Senate,"Reported Favorably Without Amendment",4,0,0,0,4
568806,310779,2014-01-22,House,"Reported With Recommendation For Referral To Committee On Judiciary",8,0,0,0,8
568806,317118,2014-02-06,House,"Reported With Recommendation With Substitute H-1",10,0,0,0,10
568806,339475,2014-02-06,House,"Reported With Recommendation With Substitute  H-1",10,0,0,0,10
568806,371390,2014-06-12,House,"House Third Reading: Given Immediate Effect Roll Call # 425",92,18,0,0,110
568806,380269,2014-10-01,Senate,"Reported Favorably Without Amendment",4,0,0,0,4
568807,310761,2014-01-22,House,"Reported With Recommendation For Referral To Committee On Judiciary",8,0,0,0,8
568814,329509,2014-02-25,House,"Reported With Recommendation Without Amendment",15,0,0,0,15
568814,348701,2014-03-27,House,"House Third Reading: Given Immediate Effect Roll Call # 183",108,0,0,0,108
568814,370973,2014-06-11,Senate,"Reported Favorably Without Amendment",6,0,0,0,6
568814,383208,2014-12-16,Senate,"Senate Third Reading: Given Immediate Effect Roll Call # 789",37,0,0,1,38
568815,304890,2013-12-03,House,"Reported With Recommendation With Substitute H-1",10,0,0,0,10
568815,305031,2013-12-05,House,"House Third Reading: Given Immediate Effect Roll Call # 462",110,0,0,0,110
568854,303783,2013-10-24,Senate,"Reported Favorably Without Amendment",6,0,0,0,6
568854,303916,2013-10-31,Senate,"Senate Third Reading: Passed Roll Call # 483",36,1,0,1,38
568854,348286,2014-03-26,House,"Reported With Recommendation Without Amendment",12,0,0,0,12
568854,371133,2014-06-11,House,"House Third Reading: Given Immediate Effect Roll Call # 393",88,22,0,0,110
568854,371298,2014-06-12,Senate,"Senate Third Reading: House Amendment(s) Concurred In Roll Call # 465",36,1,0,1,38
568867,303874,2013-10-30,House,"Reported With Recommendation With Substitute H-1",7,1,0,0,8
568867,304515,2013-11-14,House,"House Third Reading: Passed Roll Call # 422",89,21,0,0,110
568867,309217,2014-01-15,Senate,"Reported Favorably With Substitute S-1",3,0,0,0,3
568867,337514,2014-01-15,Senate,"Reported Favorably With Substitute  S-1",3,0,0,0,3
568867,371110,2014-06-11,Senate,"Senate Third Reading: Given Immediate Effect Roll Call # 429",32,5,1,0,38
568867,371275,2014-06-12,House,"House Third Reading:  Roll Call # 437",98,12,0,0,110
568867,382990,2014-06-12,House,"House Third Reading: Roll Call # 437",98,12,0,0,110
568880,303510,2013-10-17,Senate,"Reported Favorably Without Amendment",4,0,0,0,4
568880,304484,2013-11-14,Senate,"Senate Third Reading: Passed Roll Call # 538",36,2,0,0,38
568880,331534,2014-02-27,House,"Reported With Recommendation With Substitute H-1",8,0,0,0,8
568880,338729,2014-02-27,House,"Reported With Recommendation With Substitute  H-1",8,0,0,0,8
568880,342288,2014-03-13,House,"House Third Reading: Given Immediate Effect Roll Call # 111",103,6,0,0,109
568880,345176,2014-03-18,Senate,"Senate Third Reading:  Roll Call # 105",36,2,0,0,38
568880,382929,2014-03-18,Senate,"Senate Third Reading: Roll Call # 105",36,2,0,0,38
568895,303883,2013-10-30,House,"Reported With Recommendation With Substitute H-1",7,1,0,0,8
568895,304514,2013-11-14,House,"House Third Reading: Passed Roll Call # 423",91,19,0,0,110
568895,309146,2014-01-15,Senate,"Reported Favorably Without Amendment",3,0,0,0,3
568895,370997,2014-06-11,Senate,"Senate Third Reading: Given Immediate Effect Roll Call # 431",32,6,0,0,38
568895,371389,2014-06-12,House,"House Third Reading:  Roll Call # 438",94,16,0,0,110
568895,382957,2014-06-12,House,"House Third Reading: Roll Call # 438",94,16,0,0,110
568909,303886,2013-10-30,House,"Reported With Recommendation With Substitute H-2",7,1,0,0,8
568909,304539,2013-11-14,House,"House Third Reading: Passed Roll Call # 424",91,19,0,0,110
568909,309395,2014-01-15,Senate,"Reported Favorably Without Amendment",3,0,0,0,3
568909,371136,2014-06-11,Senate,"Senate Third Reading: Given Immediate Effect Roll Call # 432",34,4,0,0,38
568909,371303,2014-06-12,House,"House Third Reading:  Roll Call # 439",95,15,0,0,110
568909,382976,2014-06-12,House,"House Third Reading: Roll Call # 439",95,15,0,0,110
568950,326356,2014-02-20,Senate,"Reported Favorably With Substitute S-3",3,0,0,0,3
568950,326357,2014-02-20,Senate,"Senate Third Reading: Passed Roll Call # 36",32,6,0,0,38
568950,331791,2014-02-27,House,"Reported With Recommendation With Substitute H-1",18,10,0,0,28
568950,334163,2014-03-04,House,"House Third Reading: Given Immediate Effect Roll Call # 74",65,44,0,0,109
568950,335490,2014-03-05,Senate,"Senate Third Reading:  Roll Call # 71",0,36,0,2,38
568950,340857,2014-03-12,Senate,"Senate Third Reading: Senate Adopted Conference Report With Immediate Effect Roll Call # 94",30,5,0,3,38
568950,340858,2014-03-12,House,"House Third Reading: Conference Report Adopted Roll Call # 101",106,2,0,0,108
568950,383095,2014-03-05,Senate,"Senate Third Reading: Roll Call # 71",0,36,0,2,38
568977,303740,2013-10-22,Senate,"Reported Favorably Without Amendment",5,0,0,0,5
568977,303826,2013-10-29,Senate,"Senate Third Reading: Passed Roll Call # 464",36,0,0,2,38
569043,303680,2013-10-22,Senate,"Reported Favorably Without Amendment",5,0,0,0,5
569043,303827,2013-10-29,Senate,"Senate Third Reading: Passed Roll Call # 465",36,0,0,2,38
569043,364450,2014-05-14,House,"Reported With Recommendation With Substitute  H-1",14,0,0,0,14
569043,367726,2014-05-27,House,"House Third Reading: Given Immediate Effect Roll Call # 300",104,6,0,0,110
569043,368367,2014-05-28,Senate,"Senate Third Reading:  Roll Call # 318",35,0,0,3,38
569043,382991,2014-05-28,Senate,"Senate Third Reading: Roll Call # 318",35,0,0,3,38
569106,304882,2013-12-03,House,"Reported With Recommendation Without Amendment",11,0,0,0,11
569106,305284,2013-12-11,House,"House Third Reading: Given Immediate Effect Roll Call # 487",108,0,0,0,108
569106,314021,2014-01-30,Senate,"Reported Favorably Without Amendment",7,0,0,0,7
569106,330548,2014-02-26,Senate,"Senate Third Reading: Given Immediate Effect Roll Call # 52",34,0,1,3,38
569107,303815,2013-10-29,House,"Reported With Recommendation Without Amendment",15,0,0,0,15
569107,348757,2014-03-27,House,"House Third Reading: Given Immediate Effect Roll Call # 180",105,3,0,0,108
569107,380268,2014-10-01,Senate,"Reported Favorably Without Amendment",7,0,0,0,7
569107,383224,2014-12-16,Senate,"Senate Third Reading: Given Immediate Effect Roll Call # 793",37,0,0,1,38
569109,344987,2014-03-18,Senate,"Reported Favorably With Substitute  S-2",6,0,0,0,6
569109,348195,2014-03-26,Senate,"Senate Third Reading: Passed Roll Call # 150",37,0,0,1,38
569109,369724,2014-06-03,House,"Reported With Recommendation Without Amendment",7,2,0,0,9
569109,370524,2014-06-10,House,"Reported With Recommendation With Substitute  H-2",8,1,0,0,9
569109,371305,2014-06-12,House,"House Third Reading: Given Immediate Effect Roll Call # 417",109,1,0,0,110
569109,371306,2014-06-12,Senate,"Senate Third Reading:  Roll Call # 493",38,0,0,0,38
569109,382919,2014-06-12,Senate,"Senate Third Reading: Roll Call # 493",38,0,0,0,38
569114,304344,2013-11-12,Senate,"Reported Favorably With Substitute S-1",5,1,0,0,6
569114,304533,2013-11-14,Senate,"Senate Third Reading: Passed Roll Call # 541",31,7,0,0,38
569114,339915,2014-03-11,House,"Reported With Recommendation With Amendment(s)",13,2,0,0,15
569114,364731,2014-05-14,House,"House Third Reading: Given Immediate Effect Roll Call # 235",106,3,0,0,109
569114,364987,2014-05-15,Senate,"Senate Third Reading: House Amendment(s) Concurred In Roll Call # 273",35,3,0,0,38
569116,303817,2013-10-29,House,"Reported With Recommendation Without Amendment",15,0,0,0,15
569116,304414,2013-11-13,House,"House Third Reading: Given Immediate Effect Roll Call # 409",110,0,0,0,110
569116,305257,2013-12-11,Senate,"Reported Favorably Without Amendment",7,0,0,0,7
569116,305372,2013-12-12,Senate,"Senate Third Reading: Given Immediate Effect Roll Call # 640",38,0,0,0,38
569219,313985,2014-01-30,Senate,"Reported Favorably With Substitute S-1",5,0,0,0,5
569219,337501,2014-01-30,Senate,"Reported Favorably With Substitute  S-1",5,0,0,0,5
569219,364709,2014-05-14,Senate,"Senate Third Reading: Passed Roll Call # 265",36,1,0,1,38
569220,303912,2013-10-31,Senate,"Reported Favorably Without Amendment",5,2,0,0,7
569220,304346,2013-11-12,Senate,"Senate Third Reading: Passed Roll Call # 507",35,2,1,0,38
569220,340833,2014-03-12,House,"Reported With Recommendation Without Amendment",14,0,0,0,14
569220,348577,2014-03-27,House,"House Third Reading: Given Immediate Effect Roll Call # 186",106,2,0,0,108
569227,377108,2014-08-13,Senate,"Reported Favorably With Substitute  S-1",8,0,0,0,8
569227,377109,2014-08-13,Senate,"Senate Third Reading: Passed Roll Call # 533",26,7,0,5,38
569227,379972,2014-09-18,House,"Reported With Recommendation With Amendment(s)",21,0,0,0,21
569227,379999,2014-09-18,House,"House Third Reading: Given Immediate Effect Roll Call # 491",78,31,0,0,109
569227,380098,2014-09-23,Senate,"Senate Third Reading: House Amendment(s) Concurred In Roll Call # 543",36,2,0,0,38
569253,303481,2013-10-16,House,"Reported With Recommendation With Amendment(s)",10,0,0,0,10
569257,304973,2013-12-04,House,"Reported With Recommendation Without Amendment",11,0,0,0,11
569294,365029,2014-05-15,Senate,"Reported Favorably With Substitute  S-1",6,0,0,0,6
569294,367587,2014-05-27,Senate,"Senate Third Reading: Passed Roll Call # 314",33,2,1,2,38
569294,381666,2014-11-13,House,"Reported With Recommendation With Substitute H-1*",11,6,0,0,17
569294,383415,2014-12-18,House,"House Third Reading: Given Immediate Effect Roll Call # 714",77,32,0,0,109
569294,383767,2014-12-18,Senate,"Senate Third Reading: Roll Call # 864",37,1,0,0,38
569297,364989,2014-05-15,Senate,"Reported Favorably With Substitute  S-1",7,0,0,0,7
569297,367545,2014-05-27,Senate,"Senate Third Reading: Passed Roll Call # 315",35,1,0,2,38
569297,381672,2014-11-13,House,"Reported With Recommendation Without Amendment",11,6,0,0,17
569297,383596,2014-12-18,House,"House Third Reading: Given Immediate Effect Roll Call # 715",78,31,0,0,109
569316,304381,2013-11-13,House,"Reported With Recommendation Without Amendment",10,1,0,0,11
569343,363569,2014-05-08,House,"Reported With Recommendation With Substitute  H-1",10,0,0,0,10
569343,366532,2014-05-22,House,"House Third Reading: Given Immediate Effect Roll Call # 274",106,4,0,0,110
569343,375883,2014-07-16,Senate,"Reported Favorably With Substitute  S-1",3,0,0,0,3
569343,383709,2014-12-18,Senate,"Senate Third Reading: Given Immediate Effect Roll Call # 868",38,0,0,0,38
569343,383710,2014-12-18,House,"House Third Reading: Roll Call # 770",106,4,0,0,110
569346,361450,2014-04-30,House,"Reported With Recommendation For Referral To Committee On Oversight",9,0,0,0,9
569346,369676,2014-06-03,House,"Reported With Recommendation With Substitute  H-3",7,0,0,0,7
569373,304393,2013-11-13,House,"Reported With Recommendation Without Amendment",15,0,0,0,15
569373,304498,2013-11-14,House,"House Third Reading: Given Immediate Effect Roll Call # 440",110,0,0,0,110
569373,305298,2013-12-11,Senate,"Reported Favorably Without Amendment",7,0,0,0,7
569373,305412,2013-12-12,Senate,"Senate Third Reading: Given Immediate Effect Roll Call # 649",38,0,0,0,38
569376,323827,2014-02-18,Senate,"Reported Favorably Without Amendment",4,0,0,0,4
569376,330919,2014-02-26,Senate,"Senate Third Reading: Passed Roll Call # 53",34,0,0,4,38
569378,303791,2013-10-24,Senate,"Reported Favorably Without Amendment",5,0,0,0,5
569378,303923,2013-10-31,Senate,"Senate Third Reading: Passed Roll Call # 484",36,1,0,1,38
569378,320530,2014-02-12,House,"Reported With Recommendation With Substitute H-1",11,0,0,0,11
569378,330628,2014-02-26,House,"House Third Reading: Given Immediate Effect Roll Call # 64",110,0,0,0,110
569378,331712,2014-02-27,Senate,"Senate Third Reading:  Roll Call # 54",35,1,0,2,38
569378,383093,2014-02-27,Senate,"Senate Third Reading: Roll Call # 54",35,1,0,2,38
569381,381531,2014-11-06,Senate,"Reported Favorably Without Amendment",7,1,0,0,8
569383,303793,2013-10-24,Senate,"Reported Favorably Without Amendment",6,0,0,0,6
569383,303905,2013-10-31,Senate,"Senate Third Reading: Passed Roll Call # 485",36,1,0,1,38
569383,319971,2014-02-12,House,"Reported With Recommendation With Substitute H-1",11,0,0,0,11
569383,330823,2014-02-26,House,"House Third Reading: Given Immediate Effect Roll Call # 65",110,0,0,0,110
569383,332112,2014-02-27,Senate,"Senate Third Reading:  Roll Call # 55",35,1,0,2,38
569383,383090,2014-02-27,Senate,"Senate Third Reading: Roll Call # 55",35,1,0,2,38
569384,303766,2013-10-23,Senate,"Reported Favorably With Substitute S-1",4,0,0,0,4
569384,304062,2013-11-06,Senate,"Senate Third Reading: Passed Roll Call # 491",37,0,0,1,38
569384,314029,2014-01-30,House,"Reported With Recommendation With Amendment(s)",11,0,0,0,11
569384,362681,2014-05-06,House,"House Third Reading: Given Immediate Effect Roll Call # 204",110,0,0,0,110
569384,364616,2014-05-14,Senate,"Senate Third Reading: House Amendment(s) Concurred In Roll Call # 262",37,0,0,1,38
569385,304886,2013-12-03,House,"Reported With Recommendation Without Amendment",9,0,0,0,9
569385,342004,2014-03-13,House,"House Third Reading: Given Immediate Effect Roll Call # 114",107,2,0,0,109
569385,361855,2014-05-01,Senate,"Reported Favorably With Substitute  S-1",3,0,0,0,3
569385,370569,2014-06-10,Senate,"Senate Third Reading: Given Immediate Effect Roll Call # 409",33,4,0,1,38
569385,370915,2014-06-11,House,"House Third Reading:  Roll Call # 391",109,1,0,0,110
569385,382927,2014-06-11,House,"House Third Reading: Roll Call # 391",109,1,0,0,110
569616,304310,2013-11-12,House,"Reported With Recommendation Without Amendment",17,0,0,0,17
569621,304416,2013-11-13,Senate,"Reported Favorably Without Amendment",7,0,0,0,7
569621,371400,2014-06-12,Senate,"Reported Favorably With Substitute S-4",7,0,0,0,7
569621,371401,2014-06-12,Senate,"Senate Third Reading: Passed Roll Call # 516",37,0,0,1,38
569621,375847,2014-07-16,House,"Reported With Recommendation Without Amendment",24,0,0,0,24
569621,379160,2014-09-09,House,"House Third Reading: Given Immediate Effect Roll Call # 456",110,0,0,0,110
569621,379408,2014-09-10,Senate,"Senate Third Reading: House Amendment(s) Concurred In Roll Call # 535",37,0,0,1,38
569627,304318,2013-11-12,House,"Reported With Recommendation Without Amendment",17,0,0,0,17
569631,304923,2013-12-04,Senate,"Reported Favorably With Substitute S-1",7,1,0,0,8
569631,305026,2013-12-05,Senate,"Senate Third Reading: Passed Roll Call # 569",32,3,1,2,38
569631,305027,2013-12-05,Senate,"Senate Third Reading: Passed Roll Call # 570",31,4,1,2,38
569631,305260,2013-12-11,House,"Reported With Recommendation With Amendment(s)",11,3,0,0,14
569631,339791,2014-03-11,House,"House Third Reading: Given Immediate Effect Roll Call # 91",71,39,0,0,110
569631,342056,2014-03-13,Senate,"Senate Third Reading:  Roll Call # 101",33,5,0,0,38
569631,383171,2014-03-13,Senate,"Senate Third Reading: Roll Call # 101",33,5,0,0,38
569665,369913,2014-06-04,House,"Reported With Recommendation With Substitute  H-1",9,1,0,0,10
569665,370062,2014-06-05,House,"House Third Reading: Given Immediate Effect Roll Call # 359",105,3,0,0,108
569665,371123,2014-06-11,Senate,"Senate Third Reading: Given Immediate Effect Roll Call # 436",37,1,0,0,38
569693,336967,2014-03-06,House,"Reported With Recommendation With Substitute H-1",10,0,0,0,10
569693,338708,2014-03-06,House,"Reported With Recommendation With Substitute  H-1",10,0,0,0,10
569693,342155,2014-03-13,House,"House Third Reading: Given Immediate Effect Roll Call # 112",104,5,0,0,109
569693,359231,2014-04-23,Senate,"Reported Favorably Without Amendment",3,0,0,0,3
569693,383222,2014-12-16,Senate,"Senate Third Reading: Given Immediate Effect Roll Call # 802",37,0,0,1,38
569693,383594,2014-12-17,House,"House Third Reading: Senate Amendment(s) Concurred In Roll Call # 688",104,5,0,0,109
569703,336964,2014-03-06,House,"Reported With Recommendation With Substitute H-1",10,0,0,0,10
569703,338577,2014-03-06,House,"Reported With Recommendation With Substitute  H-1",10,0,0,0,10
569703,342035,2014-03-13,House,"House Third Reading: Given Immediate Effect Roll Call # 113",105,4,0,0,109
569703,359313,2014-04-23,Senate,"Reported Favorably Without Amendment",3,0,0,0,3
569713,369909,2014-06-04,House,"Reported With Recommendation With Substitute  H-2",9,1,0,0,10
569713,370088,2014-06-05,House,"House Third Reading: Given Immediate Effect Roll Call # 360",105,3,0,0,108
569713,371145,2014-06-11,Senate,"Senate Third Reading: Given Immediate Effect Roll Call # 437",37,1,0,0,38
569761,304157,2013-11-07,Senate,"Reported Favorably With Substitute S-1",4,0,0,0,4
569761,337141,2013-11-07,Senate,"Reported Favorably With Substitute  S-1",4,0,0,0,4
569761,381528,2014-11-06,Senate,"Senate Third Reading: Passed Roll Call # 643",37,0,0,1,38
569761,382063,2014-12-02,House,"Reported With Recommendation For Referral To Committee On Judiciary",14,0,0,0,14
569762,304311,2013-11-12,Senate,"Reported Favorably With Substitute S-1",6,0,0,0,6
569762,304513,2013-11-14,Senate,"Senate Third Reading: Passed Roll Call # 542",38,0,0,0,38
569762,312756,2014-01-28,House,"Reported With Recommendation With Substitute H-3",12,0,0,0,12
569762,338634,2014-01-28,House,"Reported With Recommendation With Substitute  H-3",12,0,0,0,12
569762,346760,2014-03-20,House,"House Third Reading: Given Immediate Effect Roll Call # 134",110,0,0,0,110
569762,348163,2014-03-26,Senate,"Senate Third Reading:  Roll Call # 155",35,0,0,3,38
569762,382918,2014-03-26,Senate,"Senate Third Reading: Roll Call # 155",35,0,0,3,38
569764,329421,2014-02-25,Senate,"Reported Favorably With Substitute S-2",7,0,0,0,7
569764,337453,2014-02-25,Senate,"Reported Favorably With Substitute  S-2",7,0,0,0,7
569764,382758,2014-12-11,Senate,"Senate Third Reading: Passed Roll Call # 773",37,0,0,1,38
569766,304120,2013-11-07,Senate,"Reported Favorably Without Amendment",4,0,0,0,4
569766,381519,2014-11-06,Senate,"Senate Third Reading: Passed Roll Call # 644",34,0,3,1,38
569766,382081,2014-12-02,House,"Reported With Recommendation For Referral To Committee On Judiciary",14,0,0,0,14
569769,304055,2013-11-06,Senate,"Reported Favorably Without Amendment",7,0,0,0,7
569769,304984,2013-12-04,Senate,"Senate Third Reading: Passed Roll Call # 549",35,0,0,3,38
569769,305109,2013-12-10,House,"Reported With Recommendation Without Amendment",15,0,0,0,15
569769,305235,2013-12-11,House,"House Third Reading: Given Immediate Effect Roll Call # 481",108,1,0,0,109
569770,304124,2013-11-07,Senate,"Reported Favorably Without Amendment",4,0,0,0,4
569770,381525,2014-11-06,Senate,"Senate Third Reading: Passed Roll Call # 645",37,0,0,1,38
569770,382089,2014-12-02,House,"Reported With Recommendation For Referral To Committee On Judiciary",14,0,0,0,14
569804,370570,2014-06-10,House,"Reported With Recommendation With Substitute H-2",11,2,0,0,13
569804,382381,2014-12-04,House,"House Third Reading: Passed Roll Call # 635",83,27,0,0,110
569829,340843,2014-03-12,House,"Reported With Recommendation Without Amendment",17,0,0,0,17
569829,380127,2014-09-24,House,"House Third Reading: Given Immediate Effect Roll Call # 500",97,12,0,0,109
569829,380347,2014-10-02,Senate,"Senate Third Reading: Given Immediate Effect Roll Call # 601",25,12,0,1,38
569909,303846,2013-10-29,Senate,"Reported Favorably With Substitute S-1",5,0,0,0,5
569909,304130,2013-11-07,Senate,"Senate Third Reading: Passed Roll Call # 503",38,0,0,0,38
569911,315471,2014-02-04,Senate,"Reported Favorably With Substitute S-1",13,0,0,0,13
569911,339909,2014-03-11,Senate,"Senate Third Reading: Passed Roll Call # 83",38,0,0,0,38
569911,361290,2014-04-30,House,"Reported With Recommendation Without Amendment",29,0,0,0,29
569911,366430,2014-05-21,House,"House Third Reading: Given Immediate Effect Roll Call # 262",104,6,0,0,110
569912,303860,2013-10-30,Senate,"Reported Favorably With Substitute S-1",3,1,0,0,4
569912,303861,2013-10-30,Senate,"Senate Third Reading: Given Immediate Effect Roll Call # 472",26,11,0,1,38
569913,336708,2014-03-06,Senate,"Reported Favorably With Substitute S-1",5,0,0,0,5
569913,337378,2014-03-06,Senate,"Reported Favorably With Substitute  S-1",5,0,0,0,5
569913,345165,2014-03-18,Senate,"Senate Third Reading: Passed Roll Call # 106",38,0,0,0,38
569913,369862,2014-06-04,House,"Reported With Recommendation Without Amendment",13,0,0,0,13
569913,371349,2014-06-12,House,"House Third Reading: Given Immediate Effect Roll Call # 414",96,14,0,0,110
569914,315487,2014-02-04,Senate,"Reported Favorably With Substitute S-1",13,0,0,0,13
569914,340235,2014-03-11,Senate,"Senate Third Reading: Passed Roll Call # 84",38,0,0,0,38
569914,361403,2014-04-30,House,"Reported With Recommendation Without Amendment",29,0,0,0,29
569914,366458,2014-05-21,House,"House Third Reading: Given Immediate Effect Roll Call # 265",105,5,0,0,110
569914,368196,2014-05-28,Senate,"Senate Third Reading: House Amendment(s) Concurred In Roll Call # 321",36,0,0,2,38
569916,303814,2013-10-29,Senate,"Reported Favorably With Substitute S-1",5,0,0,0,5
569916,304145,2013-11-07,Senate,"Senate Third Reading: Passed Roll Call # 502",38,0,0,0,38
569916,334522,2014-03-04,House,"Reported With Recommendation With Substitute H-1",14,0,0,0,14
569916,339060,2014-03-04,House,"Reported With Recommendation With Substitute  H-1",14,0,0,0,14
569916,340847,2014-03-12,House,"House Third Reading: Given Immediate Effect Roll Call # 99",105,3,0,0,108
569916,341975,2014-03-13,Senate,"Senate Third Reading:  Roll Call # 100",38,0,0,0,38
569916,382863,2014-03-13,Senate,"Senate Third Reading: Roll Call # 100",38,0,0,0,38
569917,303863,2013-10-30,Senate,"Reported Favorably With Substitute S-1",3,1,0,0,4
569917,303864,2013-10-30,Senate,"Senate Third Reading: Given Immediate Effect Roll Call # 471",26,11,0,1,38
569917,304003,2013-11-05,House,"Reported With Recommendation Without Amendment",3,2,0,0,5
569917,304083,2013-11-06,House,"House Third Reading: Given Immediate Effect Roll Call # 373",57,52,0,0,109
569918,363029,2014-05-07,Senate,"Reported Favorably Without Amendment",7,0,0,0,7
569918,364418,2014-05-14,Senate,"Senate Third Reading: Passed Roll Call # 269",37,0,0,1,38
569919,363270,2014-05-07,Senate,"Reported Favorably Without Amendment",7,0,0,0,7
569919,364615,2014-05-14,Senate,"Senate Third Reading: Passed Roll Call # 268",37,0,0,1,38
570042,382847,2014-12-11,Senate,"Senate Third Reading: Passed Roll Call # 765",33,4,0,1,38
570046,304528,2013-11-14,Senate,"Reported Favorably With Substitute S-2",5,0,0,0,5
570046,304980,2013-12-04,Senate,"Senate Third Reading: Passed Roll Call # 554",34,2,0,2,38
570046,347876,2014-03-25,House,"Reported With Recommendation Without Amendment",17,0,0,0,17
570046,366327,2014-05-21,House,"House Third Reading: Passed Roll Call # 261",110,0,0,0,110
570055,304077,2013-11-06,House,"Reported With Recommendation Without Amendment",13,0,0,0,13
570070,305166,2013-12-10,House,"Reported With Recommendation With Substitute H-2",11,0,0,0,11
570070,305384,2013-12-12,House,"House Third Reading: Given Immediate Effect Roll Call # 505",100,9,0,0,109
570070,377081,2014-08-13,Senate,"Reported Favorably With Substitute  S-1",3,1,0,0,4
570071,304939,2013-12-04,House,"Reported With Recommendation With Substitute H-7",11,4,0,0,15
570071,338590,2013-12-04,House,"Reported With Recommendation With Substitute  H-7",11,4,0,0,15
570073,304943,2013-12-04,House,"Reported With Recommendation With Substitute H-3",10,3,0,0,13
570073,338673,2013-12-04,House,"Reported With Recommendation With Substitute  H-3",10,3,0,0,13
570078,304895,2013-12-03,House,"Reported With Recommendation With Substitute H-2",9,0,0,0,9
570078,305392,2013-12-12,House,"House Third Reading: Given Immediate Effect Roll Call # 511",109,0,0,0,109
570078,345094,2014-03-18,Senate,"Reported Favorably Without Amendment",6,0,0,0,6
570078,380421,2014-10-02,Senate,"Senate Third Reading: Given Immediate Effect Roll Call # 598",37,0,0,1,38
570080,304133,2013-11-07,House,"Reported With Recommendation Without Amendment",9,0,0,0,9
570080,304397,2013-11-13,House,"House Third Reading: Given Immediate Effect Roll Call # 416",110,0,0,0,110
570080,305145,2013-12-10,Senate,"Reported Favorably Without Amendment",6,0,0,0,6
570080,305356,2013-12-12,Senate,"Senate Third Reading: Given Immediate Effect Roll Call # 625",38,0,0,0,38
570081,304887,2013-12-03,House,"Reported With Recommendation Without Amendment",11,0,0,0,11
570081,305407,2013-12-12,House,"House Third Reading: Given Immediate Effect Roll Call # 510",109,0,0,0,109
570086,313295,2014-01-29,House,"Reported With Recommendation Without Amendment",8,0,0,0,8
570086,331738,2014-02-27,House,"House Third Reading: Given Immediate Effect Roll Call # 70",66,42,0,0,108
570089,330400,2014-02-26,House,"Reported With Recommendation With Substitute H-2",8,1,0,0,9
570089,338639,2014-02-26,House,"Reported With Recommendation With Substitute  H-2",8,1,0,0,9
570286,382404,2014-12-04,Senate,"Reported Favorably With Substitute  S-2",5,0,0,0,5
570286,382760,2014-12-11,Senate,"Senate Third Reading: Passed Roll Call # 771",21,16,0,1,38
570286,383681,2014-12-19,House,"House Third Reading: Given Immediate Effect Roll Call # 788",83,27,0,0,110
570286,383769,2014-12-19,House,"House Third Reading: Passed Roll Call # 788",83,27,0,0,110
570286,383811,2014-12-19,Senate,"Senate Third Reading: House Amendment(s) Concurred In Roll Call # 919",24,14,0,0,38
570288,304471,2013-11-14,Senate,"Reported Favorably With Substitute S-2",4,0,0,0,4
570288,304472,2013-11-14,Senate,"Senate Third Reading: Given Immediate Effect Roll Call # 533",20,18,0,0,38
570288,305137,2013-12-10,House,"Reported With Recommendation With Amendment(s)",5,4,0,0,9
570288,305256,2013-12-11,House,"House Third Reading: Given Immediate Effect Roll Call # 488",56,52,0,0,108
570288,305369,2013-12-12,Senate,"Senate Third Reading: House Amendment(s) Concurred In Roll Call # 618",23,14,0,1,38
570289,304163,2013-11-07,Senate,"Reported Favorably With Substitute S-3",4,0,0,0,4
570289,304388,2013-11-13,Senate,"Senate Third Reading: Passed Roll Call # 517",22,16,0,0,38
570289,305121,2013-12-10,House,"Reported With Recommendation With Substitute H-1",8,1,0,0,9
570289,305357,2013-12-12,House,"House Third Reading: Given Immediate Effect Roll Call # 509",87,22,0,0,109
570289,305358,2013-12-12,Senate,"Senate Third Reading:  Roll Call # 667",20,18,0,0,38
570289,383076,2013-12-12,Senate,"Senate Third Reading: Roll Call # 667",20,18,0,0,38
570290,382411,2014-12-04,Senate,"Reported Favorably With Substitute  S-2",5,0,0,0,5
570290,382761,2014-12-11,Senate,"Senate Third Reading: Passed Roll Call # 770",21,16,0,1,38
570290,383690,2014-12-19,House,"House Third Reading: Passed Roll Call # 787",83,27,0,0,110
570290,383799,2014-12-19,Senate,"Senate Third Reading: House Amendment(s) Concurred In Roll Call # 918",25,13,0,0,38
570301,304467,2013-11-14,House,"Reported With Recommendation With Substitute H-1",9,1,0,0,10
570301,305010,2013-12-05,House,"House Third Reading: Given Immediate Effect Roll Call # 459",75,35,0,0,110
570301,321205,2014-02-13,Senate,"Reported Favorably With Substitute S-1",4,0,0,0,4
570301,336855,2014-02-13,Senate,"Reported Favorably With Substitute  S-1",4,0,0,0,4
570301,346000,2014-03-19,Senate,"Senate Third Reading: Given Immediate Effect Roll Call # 118",27,11,0,0,38
570301,346658,2014-03-20,House,"House Third Reading:  Roll Call # 130",72,38,0,0,110
570301,382947,2014-03-20,House,"House Third Reading: Roll Call # 130",72,38,0,0,110
570302,380234,2014-09-30,House,"Reported With Recommendation With Substitute  H-2",12,0,0,0,12
570302,381656,2014-11-13,House,"House Third Reading: Given Immediate Effect Roll Call # 582",99,8,0,0,107
570305,341398,2014-03-12,House,"Reported With Recommendation Without Amendment",12,0,0,0,12
570305,346715,2014-03-20,House,"House Third Reading: Given Immediate Effect Roll Call # 138",110,0,0,0,110
570305,348590,2014-03-27,Senate,"Senate Third Reading: Passed Roll Call # 163",36,0,1,1,38
570305,348591,2014-03-27,Senate,"Senate Third Reading: Given Immediate Effect Roll Call # 164",37,0,0,1,38
570306,304496,2013-11-14,House,"Reported With Recommendation With Substitute H-1",10,0,0,0,10
570306,305009,2013-12-05,House,"House Third Reading: Given Immediate Effect Roll Call # 457",102,8,0,0,110
570306,321134,2014-02-13,Senate,"Reported Favorably With Substitute S-2",3,1,0,0,4
570306,337099,2014-02-13,Senate,"Reported Favorably With Substitute  S-2",3,1,0,0,4
570306,345905,2014-03-19,Senate,"Senate Third Reading: Given Immediate Effect Roll Call # 119",26,12,0,0,38
570306,346620,2014-03-20,House,"House Third Reading:  Roll Call # 128",61,49,0,0,110
570306,382944,2014-03-20,House,"House Third Reading: Roll Call # 128",61,49,0,0,110
570307,380235,2014-09-30,House,"Reported With Recommendation With Substitute  H-2",12,0,0,0,12
570307,381646,2014-11-13,House,"House Third Reading: Given Immediate Effect Roll Call # 581",99,8,0,0,107
570308,304480,2013-11-14,House,"Reported With Recommendation With Substitute H-1",9,1,0,0,10
570308,305005,2013-12-05,House,"House Third Reading: Passed Roll Call # 455",104,6,0,0,110
570308,305044,2013-12-05,House,"House Third Reading: Given Immediate Effect Roll Call # 455",104,6,0,0,110
570308,321053,2014-02-13,Senate,"Reported Favorably With Substitute S-2",4,0,0,0,4
570308,336956,2014-02-13,Senate,"Reported Favorably With Substitute  S-2",4,0,0,0,4
570308,345893,2014-03-19,Senate,"Senate Third Reading: Given Immediate Effect Roll Call # 115",28,10,0,0,38
570308,346792,2014-03-20,House,"House Third Reading:  Roll Call # 126",104,6,0,0,110
570308,382943,2014-03-20,House,"House Third Reading: Roll Call # 126",104,6,0,0,110
570309,304473,2013-11-14,House,"Reported With Recommendation With Substitute H-1",7,2,0,0,9
570309,305040,2013-12-05,House,"House Third Reading: Given Immediate Effect Roll Call # 458",67,42,0,0,109
570309,321197,2014-02-13,Senate,"Reported Favorably With Substitute S-1",4,0,0,0,4
570309,337115,2014-02-13,Senate,"Reported Favorably With Substitute  S-1",4,0,0,0,4
570309,345784,2014-03-19,Senate,"Senate Third Reading: Given Immediate Effect Roll Call # 117",24,14,0,0,38
570309,346756,2014-03-20,House,"House Third Reading:  Roll Call # 129",61,48,0,0,109
570309,382946,2014-03-20,House,"House Third Reading: Roll Call # 129",61,48,0,0,109
570310,304479,2013-11-14,House,"Reported With Recommendation With Substitute H-1",9,1,0,0,10
570310,305008,2013-12-05,House,"House Third Reading: Given Immediate Effect Roll Call # 456",102,8,0,0,110
570310,321108,2014-02-13,Senate,"Reported Favorably With Substitute S-1",4,0,0,0,4
570310,336942,2014-02-13,Senate,"Reported Favorably With Substitute  S-1",4,0,0,0,4
570310,345881,2014-03-19,Senate,"Senate Third Reading: Given Immediate Effect Roll Call # 116",27,11,0,0,38
570310,346793,2014-03-20,House,"House Third Reading:  Roll Call # 127",103,7,0,0,110
570310,382941,2014-03-20,House,"House Third Reading: Roll Call # 127",103,7,0,0,110
570528,310989,2014-01-22,House,"Reported With Recommendation With Substitute H-1",19,0,0,0,19
570528,313276,2014-01-29,House,"House Third Reading: Given Immediate Effect Roll Call # 21",108,2,0,0,110
570528,336665,2014-03-06,Senate,"Reported Favorably With Substitute S-2",7,0,0,0,7
570528,337335,2014-03-06,Senate,"Reported Favorably With Substitute  S-2",7,0,0,0,7
570528,370655,2014-06-10,Senate,"Senate Third Reading: Given Immediate Effect Roll Call # 400",37,0,0,1,38
570528,371081,2014-06-11,House,"House Third Reading:  Roll Call # 389",108,2,0,0,110
570528,383052,2014-06-11,House,"House Third Reading: Roll Call # 389",108,2,0,0,110
570538,304343,2013-11-12,House,"Reported With Recommendation Without Amendment",15,0,0,0,15
570538,304532,2013-11-14,House,"House Third Reading: Passed Roll Call # 438",110,0,0,0,110
570538,305281,2013-12-11,Senate,"Reported Favorably Without Amendment",7,0,0,0,7
570538,305282,2013-12-11,Senate,"Senate Third Reading: Passed Roll Call # 594",37,0,0,1,38
570546,310762,2014-01-22,House,"Reported With Recommendation With Substitute H-1",19,0,0,0,19
570546,313288,2014-01-29,House,"House Third Reading: Given Immediate Effect Roll Call # 22",108,2,0,0,110
570546,336600,2014-03-06,Senate,"Reported Favorably With Substitute S-2",7,0,0,0,7
570546,337262,2014-03-06,Senate,"Reported Favorably With Substitute  S-2",7,0,0,0,7
570546,370699,2014-06-10,Senate,"Senate Third Reading: Given Immediate Effect Roll Call # 401",37,0,0,1,38
570546,371113,2014-06-11,House,"House Third Reading:  Roll Call # 390",108,2,0,0,110
570546,383046,2014-06-11,House,"House Third Reading: Roll Call # 390",108,2,0,0,110
570564,304408,2013-11-13,Senate,"Reported Favorably Without Amendment",4,0,0,0,4
570564,304508,2013-11-14,Senate,"Senate Third Reading: Passed Roll Call # 544",38,0,0,0,38
570564,304893,2013-12-03,House,"Reported With Recommendation Without Amendment",15,0,0,0,15
570564,305316,2013-12-11,House,"House Third Reading: Passed Roll Call # 471",109,0,0,0,109
570573,304503,2013-11-14,Senate,"Reported Favorably With Substitute S-1",4,0,0,0,4
570573,304504,2013-11-14,Senate,"Senate Third Reading: Passed Roll Call # 546",38,0,0,0,38
570573,305289,2013-12-11,House,"Reported With Recommendation With Substitute H-1",18,0,0,0,18
570573,305395,2013-12-12,House,"House Third Reading: Given Immediate Effect Roll Call # 491",107,0,0,0,107
570573,305396,2013-12-12,Senate,"Senate Third Reading:  Roll Call # 668",38,0,0,0,38
570573,382899,2013-12-12,Senate,"Senate Third Reading: Roll Call # 668",38,0,0,0,38
570582,304404,2013-11-13,Senate,"Reported Favorably With Substitute S-1",4,0,0,0,4
570582,304505,2013-11-14,Senate,"Senate Third Reading: Passed Roll Call # 543",38,0,0,0,38
570582,304883,2013-12-03,House,"Reported With Recommendation Without Amendment",15,0,0,0,15
570582,305285,2013-12-11,House,"House Third Reading: Passed Roll Call # 470",109,0,0,0,109
570582,305286,2013-12-11,Senate,"Senate Third Reading: House Amendment(s) Concurred In Roll Call # 602",38,0,0,0,38
570591,345002,2014-03-18,Senate,"Reported Favorably With Substitute  S-2",5,0,0,0,5
570591,359389,2014-04-23,Senate,"Senate Third Reading: Passed Roll Call # 188",25,13,0,0,38
570591,366174,2014-05-21,House,"Reported With Recommendation With Substitute  H-1",12,0,0,0,12
570591,381715,2014-05-21,House,"Reported With Recommendation With Substitute H-1",12,0,0,0,12
570591,382071,2014-12-02,House,"House Third Reading: Given Immediate Effect Roll Call # 595",103,6,0,0,109
570591,382410,2014-12-04,Senate,"Senate Third Reading:  Roll Call # 706",27,9,0,2,38
570591,382742,2014-12-04,Senate,"Senate Third Reading: Roll Call # 706",27,9,0,2,38
570750,304339,2013-11-12,House,"Reported With Recommendation Without Amendment",15,0,0,0,15
570750,304524,2013-11-14,House,"House Third Reading: Passed Roll Call # 439",110,0,0,0,110
570750,305213,2013-12-11,Senate,"Reported Favorably Without Amendment",7,0,0,0,7
570750,305214,2013-12-11,Senate,"Senate Third Reading: Passed Roll Call # 595",37,0,0,1,38
570774,329007,2014-02-25,House,"Reported With Recommendation With Substitute H-1",18,0,0,0,18
570774,335650,2014-03-05,House,"House Third Reading: Given Immediate Effect Roll Call # 82",110,0,0,0,110
570774,347726,2014-03-25,Senate,"Reported Favorably Without Amendment",8,0,0,0,8
570774,364533,2014-05-14,Senate,"Senate Third Reading: Given Immediate Effect Roll Call # 264",37,0,0,1,38
570798,304341,2013-11-12,House,"Reported With Recommendation With Substitute H-1",13,0,0,0,13
570798,304925,2013-12-04,House,"House Third Reading: Passed Roll Call # 448",109,0,0,0,109
570798,305248,2013-12-11,Senate,"Senate Third Reading: Passed Roll Call # 588",37,0,0,1,38
570862,304417,2013-11-13,Senate,"Reported Favorably Without Amendment",4,0,0,0,4
570862,304954,2013-12-04,Senate,"Senate Third Reading: Passed Roll Call # 550",36,0,0,2,38
570862,345863,2014-03-19,House,"Reported With Recommendation With Substitute  H-1",13,0,0,0,13
570862,362707,2014-05-06,House,"House Third Reading: Given Immediate Effect Roll Call # 198",110,0,0,0,110
570862,363462,2014-05-08,Senate,"Senate Third Reading:  Roll Call # 249",38,0,0,0,38
570862,383023,2014-05-08,Senate,"Senate Third Reading: Roll Call # 249",38,0,0,0,38
570868,323799,2014-02-18,Senate,"Reported Favorably With Substitute S-2",7,0,0,0,7
570868,336617,2014-03-06,Senate,"Senate Third Reading: Passed Roll Call # 80",38,0,0,0,38
570868,345015,2014-03-18,House,"Reported With Recommendation With Substitute  H-1",13,0,0,0,13
570868,370881,2014-06-11,House,"House Third Reading: Given Immediate Effect Roll Call # 406",94,16,0,0,110
570868,371288,2014-06-12,Senate,"Senate Third Reading:  Roll Call # 508",38,0,0,0,38
570868,382673,2014-06-12,Senate,"Senate Third Reading: Roll Call # 508",38,0,0,0,38
570872,304418,2013-11-13,Senate,"Reported Favorably Without Amendment",4,0,0,0,4
570872,304955,2013-12-04,Senate,"Senate Third Reading: Passed Roll Call # 551",36,0,0,2,38
570872,345750,2014-03-19,House,"Reported With Recommendation With Substitute  H-1",13,0,0,0,13
570872,362824,2014-05-06,House,"House Third Reading: Given Immediate Effect Roll Call # 199",110,0,0,0,110
570872,363420,2014-05-08,Senate,"Senate Third Reading:  Roll Call # 250",38,0,0,0,38
570872,383039,2014-05-08,Senate,"Senate Third Reading: Roll Call # 250",38,0,0,0,38
570879,304338,2013-11-12,House,"Reported With Recommendation Without Amendment",8,0,0,0,8
570879,304525,2013-11-14,House,"House Third Reading: Given Immediate Effect Roll Call # 436",103,7,0,0,110
570879,305429,2013-12-12,Senate,"Reported Favorably With Substitute S-2",4,0,0,0,4
570879,305430,2013-12-12,Senate,"Senate Third Reading: Given Immediate Effect Roll Call # 656",38,0,0,0,38
570879,305431,2013-12-12,House,"House Third Reading:  Roll Call # 531",102,7,0,0,109
570879,382877,2013-12-12,House,"House Third Reading: Roll Call # 531",102,7,0,0,109
570881,323781,2014-02-18,Senate,"Reported Favorably With Substitute S-4",7,0,0,0,7
570881,336706,2014-03-06,Senate,"Senate Third Reading: Passed Roll Call # 81",38,0,0,0,38
570881,345121,2014-03-18,House,"Reported With Recommendation With Substitute  H-2",13,0,0,0,13
570881,370989,2014-06-11,House,"House Third Reading: Given Immediate Effect Roll Call # 407",96,14,0,0,110
570881,371509,2014-06-12,Senate,"Senate Third Reading:  Roll Call # 509",38,0,0,0,38
570881,382685,2014-06-12,Senate,"Senate Third Reading: Roll Call # 509",38,0,0,0,38
570992,321124,2014-02-13,House,"Reported With Recommendation With Substitute H-1",28,0,0,0,28
570992,325148,2014-02-19,House,"House Third Reading: Given Immediate Effect Roll Call # 57",110,0,0,0,110
570992,381532,2014-11-06,Senate,"Reported Favorably Without Amendment",14,0,0,0,14
570992,383311,2014-12-17,Senate,"Senate Third Reading: Given Immediate Effect Roll Call # 838",37,0,0,1,38
570994,382079,2014-12-02,House,"Reported With Recommendation For Referral To Committee On Appropriations",14,0,0,0,14
571003,304881,2013-12-03,Senate,"Reported Favorably With Recommendation For Referral To Committee On Judiciary",4,0,0,0,4
571008,304387,2013-11-13,Senate,"Reported Favorably Without Amendment",4,0,0,0,4
571008,361212,2014-04-30,Senate,"Senate Third Reading: Passed Roll Call # 206",38,0,0,0,38
571008,369880,2014-06-04,House,"Reported With Recommendation With Substitute  H-1",29,0,0,0,29
571008,371395,2014-06-12,House,"House Third Reading: Given Immediate Effect Roll Call # 431",109,1,0,0,110
571008,371396,2014-06-12,Senate,"Senate Third Reading:  Roll Call # 515",37,0,0,1,38
571008,383025,2014-06-12,Senate,"Senate Third Reading: Roll Call # 515",37,0,0,1,38
571013,305258,2013-12-11,Senate,"Reported Favorably Without Amendment",4,0,0,0,4
571013,305378,2013-12-12,Senate,"Senate Third Reading: Passed Roll Call # 654",38,0,0,0,38
571013,366612,2014-05-22,House,"Reported With Recommendation With Amendment(s)",10,0,0,0,10
571013,371300,2014-06-12,House,"House Third Reading: Given Immediate Effect Roll Call # 426",108,2,0,0,110
571013,371301,2014-06-12,Senate,"Senate Third Reading: House Amendment(s) Concurred In Roll Call # 510",38,0,0,0,38
571014,304972,2013-12-04,House,"Reported With Recommendation Without Amendment",15,0,0,0,15
571097,305171,2013-12-10,House,"Reported With Recommendation Without Amendment",15,0,0,0,15
571097,311289,2014-01-23,House,"House Third Reading: Passed Roll Call # 10",107,0,0,0,107
571097,335601,2014-03-05,Senate,"Reported Favorably Without Amendment",7,0,0,0,7
571097,365779,2014-05-20,Senate,"Senate Third Reading: Given Immediate Effect Roll Call # 296",38,0,0,0,38
571106,304952,2013-12-04,Senate,"Reported Favorably Without Amendment",5,0,0,0,5
571106,305025,2013-12-05,Senate,"Senate Third Reading: Passed Roll Call # 566",36,1,0,1,38
571107,305175,2013-12-10,House,"Reported With Recommendation Without Amendment",15,0,0,0,15
571107,311401,2014-01-23,House,"House Third Reading: Passed Roll Call # 12",107,0,0,0,107
571107,335924,2014-03-05,Senate,"Reported Favorably Without Amendment",7,0,0,0,7
571107,365953,2014-05-20,Senate,"Senate Third Reading: Given Immediate Effect Roll Call # 298",38,0,0,0,38
571112,305179,2013-12-10,House,"Reported With Recommendation Without Amendment",15,0,0,0,15
571112,311213,2014-01-23,House,"House Third Reading: Passed Roll Call # 11",107,0,0,0,107
571112,335920,2014-03-05,Senate,"Reported Favorably Without Amendment",7,0,0,0,7
571112,365767,2014-05-20,Senate,"Senate Third Reading: Given Immediate Effect Roll Call # 297",38,0,0,0,38
571115,305176,2013-12-10,House,"Reported With Recommendation Without Amendment",15,0,0,0,15
571115,311412,2014-01-23,House,"House Third Reading: Passed Roll Call # 9",107,0,0,0,107
571115,335402,2014-03-05,Senate,"Reported Favorably Without Amendment",7,0,0,0,7
571115,365900,2014-05-20,Senate,"Senate Third Reading: Given Immediate Effect Roll Call # 295",38,0,0,0,38
571118,305122,2013-12-10,House,"Reported With Recommendation Without Amendment",15,0,0,0,15
571118,311420,2014-01-23,House,"House Third Reading: Passed Roll Call # 13",107,0,0,0,107
571118,335791,2014-03-05,Senate,"Reported Favorably Without Amendment",7,0,0,0,7
571118,365864,2014-05-20,Senate,"Senate Third Reading: Given Immediate Effect Roll Call # 299",38,0,0,0,38
571122,358588,2014-04-22,Senate,"Reported Favorably With Substitute  S-1",4,0,0,0,4
571122,359637,2014-04-24,Senate,"Senate Third Reading: Passed Roll Call # 198",38,0,0,0,38
571122,364944,2014-05-15,House,"Reported With Recommendation Without Amendment",8,0,0,0,8
571122,366528,2014-05-22,House,"House Third Reading: Given Immediate Effect Roll Call # 278",103,7,0,0,110
571123,305103,2013-12-10,House,"Reported With Recommendation Without Amendment",10,0,0,0,10
571192,358529,2014-04-22,Senate,"Reported Favorably With Substitute  S-1",8,0,0,0,8
571192,365776,2014-05-20,Senate,"Senate Third Reading: Passed Roll Call # 300",38,0,0,0,38
571192,369664,2014-06-03,House,"Reported With Recommendation Without Amendment",17,1,0,0,18
571192,370884,2014-06-11,House,"House Third Reading: Given Immediate Effect Roll Call # 399",108,2,0,0,110
571193,319417,2014-02-11,House,"Reported With Recommendation With Substitute H-2",9,0,0,0,9
571193,326245,2014-02-20,House,"House Third Reading: Given Immediate Effect Roll Call # 60",109,0,0,0,109
571193,348474,2014-03-27,Senate,"Reported Favorably With Substitute S-2",7,0,0,0,7
571193,348475,2014-03-27,Senate,"Senate Third Reading: Given Immediate Effect Roll Call # 166",34,3,0,1,38
571193,348476,2014-03-27,House,"House Third Reading:  Roll Call # 170",84,24,0,0,108
571193,383094,2014-03-27,House,"House Third Reading: Roll Call # 170",84,24,0,0,108
571194,358716,2014-04-22,Senate,"Reported Favorably With Substitute  S-1",8,0,0,0,8
571194,365798,2014-05-20,Senate,"Senate Third Reading: Passed Roll Call # 303",38,0,0,0,38
571194,369662,2014-06-03,House,"Reported With Recommendation With Substitute  H-1",18,1,0,0,19
571194,371035,2014-06-11,House,"House Third Reading: Given Immediate Effect Roll Call # 402",106,4,0,0,110
571194,371412,2014-06-12,Senate,"Senate Third Reading:  Roll Call # 468",37,0,0,1,38
571194,382953,2014-06-12,Senate,"Senate Third Reading: Roll Call # 468",37,0,0,1,38
571202,371174,2014-06-11,Senate,"Reported Favorably Without Amendment",6,0,0,0,6
571202,371175,2014-06-11,Senate,"Senate Third Reading: Passed Roll Call # 450",38,0,0,0,38
571202,382141,2014-12-02,House,"Reported With Recommendation Without Amendment",12,1,0,0,13
571202,383671,2014-12-19,House,"House Third Reading: Given Immediate Effect Roll Call # 790",72,38,0,0,110
571204,321305,2014-02-13,House,"Reported With Recommendation Without Amendment",11,0,0,0,11
571204,328974,2014-02-25,House,"House Third Reading: Given Immediate Effect Roll Call # 63",110,0,0,0,110
571204,336999,2014-03-06,Senate,"Reported Favorably Without Amendment",4,0,0,0,4
571204,358556,2014-04-22,Senate,"Senate Third Reading: Given Immediate Effect Roll Call # 185",38,0,0,0,38
571204,363487,2014-05-08,Senate,"Senate Third Reading: Passed Roll Call # 252",38,0,0,0,38
571204,364102,2014-05-13,House,"House Third Reading: Senate Amendment(s) Concurred In Roll Call # 222",110,0,0,0,110
571205,358675,2014-04-22,Senate,"Reported Favorably With Substitute  S-1",8,0,0,0,8
571205,365989,2014-05-20,Senate,"Senate Third Reading: Passed Roll Call # 302",37,0,1,0,38
571205,369693,2014-06-03,House,"Reported With Recommendation With Substitute  H-1",18,1,0,0,19
571205,371115,2014-06-11,House,"House Third Reading: Given Immediate Effect Roll Call # 401",106,4,0,0,110
571205,371281,2014-06-12,Senate,"Senate Third Reading:  Roll Call # 467",37,0,0,1,38
571205,382966,2014-06-12,Senate,"Senate Third Reading: Roll Call # 467",37,0,0,1,38
571211,371071,2014-06-11,Senate,"Reported Favorably Without Amendment",6,0,0,0,6
571211,371072,2014-06-11,Senate,"Senate Third Reading: Passed Roll Call # 452",37,1,0,0,38
571211,382109,2014-12-02,House,"Reported With Recommendation Without Amendment",11,1,0,0,12
571211,383679,2014-12-19,House,"House Third Reading: Given Immediate Effect Roll Call # 792",72,38,0,0,110
571211,383826,2014-12-19,Senate,"Senate Third Reading: Roll Call # 929",36,1,1,0,38
571213,304986,2013-12-04,House,"Reported With Recommendation Without Amendment",10,0,0,0,10
571213,310865,2014-01-22,House,"House Third Reading: Given Immediate Effect Roll Call # 5",109,1,0,0,110
571213,380299,2014-10-01,Senate,"Reported Favorably With Substitute  S-2",4,0,0,0,4
571213,380380,2014-10-02,Senate,"Senate Third Reading: Given Immediate Effect Roll Call # 633",38,0,0,0,38
571213,380381,2014-10-02,House,"House Third Reading:  Roll Call # 557",106,1,0,0,107
571213,383112,2014-10-02,House,"House Third Reading: Roll Call # 557",106,1,0,0,107
571215,315665,2014-02-04,Senate,"Reported Favorably With Substitute S-1",4,0,0,0,4
571215,337096,2014-02-04,Senate,"Reported Favorably With Substitute  S-1",4,0,0,0,4
571215,364997,2014-05-15,Senate,"Senate Third Reading: Passed Roll Call # 275",37,0,1,0,38
571215,380318,2014-10-01,House,"Reported With Recommendation With Substitute  H-1",13,2,0,0,15
571216,326258,2014-02-20,House,"Reported With Recommendation Without Amendment",11,0,0,0,11
571216,334196,2014-03-04,House,"House Third Reading: Given Immediate Effect Roll Call # 73",109,0,0,0,109
571216,380213,2014-09-30,Senate,"Reported Favorably Without Amendment",3,0,0,0,3
571216,383715,2014-12-18,Senate,"Senate Third Reading: Given Immediate Effect Roll Call # 880",37,1,0,0,38
571219,321226,2014-02-13,House,"Reported With Recommendation With Substitute H-1",11,0,0,0,11
571219,325879,2014-02-20,House,"House Third Reading: Given Immediate Effect Roll Call # 62",110,0,0,0,110
571219,336745,2014-03-06,Senate,"Reported Favorably With Substitute S-1",4,0,0,0,4
571219,337395,2014-03-06,Senate,"Reported Favorably With Substitute  S-1",4,0,0,0,4
571219,358751,2014-04-22,Senate,"Senate Third Reading: Given Immediate Effect Roll Call # 184",37,1,0,0,38
571219,363406,2014-05-08,Senate,"Senate Third Reading: Passed Roll Call # 251",36,2,0,0,38
571219,364075,2014-05-13,House,"House Third Reading:  Roll Call # 221",110,0,0,0,110
571219,382925,2014-05-13,House,"House Third Reading: Roll Call # 221",110,0,0,0,110
571223,371163,2014-06-11,Senate,"Reported Favorably With Substitute  S-1",6,0,0,0,6
571223,371164,2014-06-11,Senate,"Senate Third Reading: Passed Roll Call # 451",37,1,0,0,38
571223,382080,2014-12-02,House,"Reported With Recommendation Without Amendment",12,1,0,0,13
571223,383682,2014-12-19,House,"House Third Reading: Given Immediate Effect Roll Call # 791",72,38,0,0,110
571228,310829,2014-01-22,House,"Reported With Recommendation Without Amendment",10,0,0,0,10
571228,315846,2014-02-04,House,"House Third Reading: Given Immediate Effect Roll Call # 27",97,13,0,0,110
571230,304894,2013-12-03,House,"Reported With Recommendation With Substitute H-4",5,0,0,0,5
571230,304974,2013-12-04,House,"House Third Reading: Given Immediate Effect Roll Call # 451",110,0,0,0,110
571230,305208,2013-12-11,Senate,"Senate Third Reading: Given Immediate Effect Roll Call # 589",37,0,0,1,38
571232,358548,2014-04-22,Senate,"Reported Favorably With Substitute  S-1",8,0,0,0,8
571232,365770,2014-05-20,Senate,"Senate Third Reading: Passed Roll Call # 304",38,0,0,0,38
571232,369656,2014-06-03,House,"Reported With Recommendation With Substitute  H-1",18,1,0,0,19
571232,371020,2014-06-11,House,"House Third Reading: Given Immediate Effect Roll Call # 403",106,4,0,0,110
571232,371263,2014-06-12,Senate,"Senate Third Reading:  Roll Call # 469",37,0,0,1,38
571232,382644,2014-06-12,Senate,"Senate Third Reading: Roll Call # 469",37,0,0,1,38
571234,358596,2014-04-22,Senate,"Reported Favorably With Substitute  S-1",8,0,0,0,8
571234,365929,2014-05-20,Senate,"Senate Third Reading: Passed Roll Call # 301",38,0,0,0,38
571234,369703,2014-06-03,House,"Reported With Recommendation With Substitute  H-1",18,1,0,0,19
571234,371100,2014-06-11,House,"House Third Reading: Given Immediate Effect Roll Call # 400",106,4,0,0,110
571234,371440,2014-06-12,Senate,"Senate Third Reading:  Roll Call # 466",37,0,0,1,38
571234,382951,2014-06-12,Senate,"Senate Third Reading: Roll Call # 466",37,0,0,1,38
572105,362713,2014-05-06,Senate,"Reported Favorably With Substitute  S-2",7,0,0,0,7
572105,364059,2014-05-13,Senate,"Senate Third Reading: Passed Roll Call # 260",38,0,0,0,38
572105,370582,2014-06-10,House,"Reported With Recommendation With Amendment(s)",14,0,0,0,14
572105,371328,2014-06-12,House,"House Third Reading: Given Immediate Effect Roll Call # 418",110,0,0,0,110
572105,371329,2014-06-12,Senate,"Senate Third Reading:  Roll Call # 494",38,0,0,0,38
572105,382700,2014-06-12,Senate,"Senate Third Reading: Roll Call # 494",38,0,0,0,38
572200,334159,2014-03-04,Senate,"Reported Favorably With Substitute S-1",7,0,0,0,7
572200,337265,2014-03-04,Senate,"Reported Favorably With Substitute  S-1",7,0,0,0,7
572200,345795,2014-03-19,Senate,"Senate Third Reading: Passed Roll Call # 112",38,0,0,0,38
572200,365777,2014-05-20,House,"Reported With Recommendation Without Amendment",16,0,0,0,16
572200,370468,2014-06-10,House,"House Third Reading: Given Immediate Effect Roll Call # 380",109,0,0,0,109
572200,371332,2014-06-12,Senate,"Senate Third Reading: House Amendment(s) Concurred In Roll Call # 470",37,0,0,1,38
572212,370120,2014-06-05,Senate,"Reported Favorably Without Amendment",4,0,0,0,4
572212,370565,2014-06-10,Senate,"Senate Third Reading: Passed Roll Call # 413",37,0,0,1,38
572212,380412,2014-10-02,House,"Reported With Recommendation Without Amendment",12,0,0,0,12
572212,382331,2014-12-03,House,"House Third Reading: Given Immediate Effect Roll Call # 601",108,1,0,0,109
572217,305274,2013-12-11,Senate,"Reported Favorably Without Amendment",7,0,0,0,7
572217,313523,2014-01-29,Senate,"Senate Third Reading: Passed Roll Call # 8",34,1,0,3,38
572217,330697,2014-02-26,House,"Reported With Recommendation Without Amendment",14,0,0,0,14
572217,336704,2014-03-06,House,"House Third Reading: Given Immediate Effect Roll Call # 86",100,10,0,0,110
572221,305276,2013-12-11,Senate,"Reported Favorably Without Amendment",4,0,0,0,4
572221,311391,2014-01-23,Senate,"Senate Third Reading: Passed Roll Call # 3",38,0,0,0,38
572221,379839,2014-09-11,House,"Reported With Recommendation Without Amendment",10,0,0,0,10
572221,380308,2014-10-01,House,"House Third Reading: Given Immediate Effect Roll Call # 516",109,0,0,0,109
572359,363203,2014-05-07,House,"Reported With Recommendation With Substitute  H-2",9,0,0,0,9
572359,363441,2014-05-08,House,"House Third Reading: Given Immediate Effect Roll Call # 210",108,1,0,0,109
572359,371011,2014-06-11,Senate,"Senate Third Reading: Given Immediate Effect Roll Call # 424",38,0,0,0,38
572359,383678,2014-12-19,House,"House Third Reading: Roll Call # 778",107,3,0,0,110
572359,383819,2014-12-19,Senate,"Senate Third Reading: Roll Call # 916",38,0,0,0,38
572373,368399,2014-05-28,House,"Reported With Recommendation With Substitute  H-2",12,0,0,0,12
572373,370094,2014-06-05,House,"House Third Reading: Given Immediate Effect Roll Call # 364",82,26,0,0,108
572373,371165,2014-06-11,Senate,"Reported Favorably Without Amendment",6,0,0,0,6
572373,371166,2014-06-11,Senate,"Senate Third Reading: Given Immediate Effect Roll Call # 453",32,6,0,0,38
572376,368342,2014-05-28,House,"Reported With Recommendation Without Amendment",13,0,0,0,13
572376,370112,2014-06-05,House,"House Third Reading: Given Immediate Effect Roll Call # 366",83,25,0,0,108
572376,371125,2014-06-11,Senate,"Reported Favorably Without Amendment",6,0,0,0,6
572376,371126,2014-06-11,Senate,"Senate Third Reading: Given Immediate Effect Roll Call # 454",31,7,0,0,38
572428,348196,2014-03-26,House,"Reported With Recommendation For Referral To Committee On Education",26,0,0,0,26
572440,347911,2014-03-25,Senate,"Reported Favorably With Substitute S-1",6,0,0,0,6
572440,364064,2014-05-13,Senate,"Senate Third Reading: Passed Roll Call # 259",38,0,0,0,38
572440,370069,2014-06-05,House,"Reported With Recommendation With Substitute  H-1",14,0,0,0,14
572440,371285,2014-06-12,House,"House Third Reading: Given Immediate Effect Roll Call # 416",109,1,0,0,110
572440,371286,2014-06-12,Senate,"Senate Third Reading:  Roll Call # 495",38,0,0,0,38
572440,383027,2014-06-12,Senate,"Senate Third Reading: Roll Call # 495",38,0,0,0,38
572444,381670,2014-11-13,House,"Reported With Recommendation With Substitute  H-2",12,1,0,0,13
572450,363549,2014-05-08,House,"Reported With Recommendation Without Amendment",6,3,0,0,9
572450,369744,2014-06-03,House,"House Third Reading: Given Immediate Effect Roll Call # 338",62,47,0,0,109
572455,381610,2014-11-12,House,"Reported With Recommendation Without Amendment",26,0,0,0,26
572455,382238,2014-12-03,House,"House Third Reading: Given Immediate Effect Roll Call # 609",106,3,0,0,109
572455,383726,2014-12-18,Senate,"Senate Third Reading: Given Immediate Effect Roll Call # 883",28,10,0,0,38
572455,383727,2014-12-19,House,"House Third Reading: Senate Amendment(s) Concurred In Roll Call # 795",106,4,0,0,110
572459,346640,2014-03-20,Senate,"Reported Favorably With Substitute  S-1",4,0,0,0,4
572459,348269,2014-03-26,Senate,"Senate Third Reading: Passed Roll Call # 151",37,0,0,1,38
572459,363418,2014-05-08,House,"Reported With Recommendation Without Amendment",10,0,0,0,10
572459,366529,2014-05-22,House,"House Third Reading: Given Immediate Effect Roll Call # 275",101,9,0,0,110
572459,367641,2014-05-27,Senate,"Senate Third Reading: House Amendment(s) Concurred In Roll Call # 313",35,0,0,3,38
572935,305296,2013-12-11,House,"Reported With Recommendation Without Amendment",15,0,0,0,15
573062,368228,2014-05-28,House,"Reported With Recommendation Without Amendment",13,0,0,0,13
573062,380345,2014-10-02,House,"House Third Reading: Given Immediate Effect Roll Call # 561",87,20,0,0,107
573062,382423,2014-12-04,Senate,"Reported Favorably With Substitute  S-2",5,2,0,0,7
573062,383345,2014-12-17,Senate,"Senate Third Reading: Given Immediate Effect Roll Call # 845",21,16,0,1,38
573062,383623,2014-12-18,House,"House Third Reading: Roll Call # 763",90,20,0,0,110
573067,315806,2014-02-04,Senate,"Reported Favorably With Substitute S-1",6,0,0,0,6
573067,319984,2014-02-12,Senate,"Senate Third Reading: Passed Roll Call # 17",38,0,0,0,38
573067,339945,2014-03-11,House,"Reported With Recommendation With Substitute  H-1",9,0,0,0,9
573067,346762,2014-03-20,House,"House Third Reading: Given Immediate Effect Roll Call # 137",103,7,0,0,110
573067,348172,2014-03-26,Senate,"Senate Third Reading:  Roll Call # 156",35,0,0,3,38
573067,382932,2014-03-26,Senate,"Senate Third Reading: Roll Call # 156",35,0,0,3,38
573083,305497,2013-12-12,House,"Reported With Recommendation Without Amendment",15,0,0,0,15
573317,305508,2013-12-12,House,"Reported With Recommendation Without Amendment",15,0,0,0,15
573361,347622,2014-03-25,House,"Reported With Recommendation With Amendment(s)",7,0,0,0,7
573361,366214,2014-05-21,House,"House Third Reading: Given Immediate Effect Roll Call # 268",90,17,0,0,107
573366,346566,2014-03-20,House,"Reported With Recommendation Without Amendment",14,0,0,0,14
573366,357642,2014-04-17,House,"House Third Reading: Given Immediate Effect Roll Call # 189",106,1,0,0,107
573366,370974,2014-06-11,Senate,"Reported Favorably Without Amendment",6,0,0,0,6
573366,383215,2014-12-16,Senate,"Senate Third Reading: Given Immediate Effect Roll Call # 803",37,0,0,1,38
573370,317115,2014-02-06,House,"Reported With Recommendation With Substitute H-1",7,0,0,0,7
573370,323734,2014-02-18,House,"House Third Reading: Given Immediate Effect Roll Call # 52",99,9,0,0,108
573370,347898,2014-03-25,Senate,"Reported Favorably With Substitute  S-2",5,0,0,0,5
573370,364939,2014-05-15,Senate,"Senate Third Reading: Given Immediate Effect Roll Call # 274",35,3,0,0,38
573370,366519,2014-05-22,House,"House Third Reading:  Roll Call # 272",101,9,0,0,110
573370,382882,2014-05-22,House,"House Third Reading: Roll Call # 272",101,9,0,0,110
573379,347713,2014-03-25,House,"Reported With Recommendation With Amendment(s)",7,0,0,0,7
573379,366196,2014-05-21,House,"House Third Reading: Given Immediate Effect Roll Call # 267",96,12,0,0,108
573434,313537,2014-01-29,House,"Reported With Recommendation Without Amendment",9,0,0,0,9
573434,340375,2014-03-11,Senate,"Reported Favorably Without Amendment",5,0,0,0,5
573491,348432,2014-03-20,House,"Reported With Recommendation For Referral To Committee On Health Policy",11,0,0,0,11
573492,346070,2014-03-19,House,"Reported With Recommendation With Substitute  H-2",17,0,0,0,17
573492,357631,2014-04-17,House,"House Third Reading: Given Immediate Effect Roll Call # 188",106,1,0,0,107
573492,380551,2014-10-22,Senate,"Reported Favorably Without Amendment",4,0,0,0,4
573492,383285,2014-12-17,Senate,"Senate Third Reading: Given Immediate Effect Roll Call # 819",37,0,0,1,38
573493,375861,2014-07-16,House,"Reported With Recommendation Without Amendment",24,0,0,0,24
573493,382456,2014-12-04,House,"House Third Reading: Passed Roll Call # 636",110,0,0,0,110
573495,380283,2014-10-01,House,"Reported With Recommendation With Substitute  H-1",13,0,0,0,13
573495,381669,2014-11-13,House,"House Third Reading: Given Immediate Effect Roll Call # 583",106,1,0,0,107
573495,383357,2014-12-17,Senate,"Senate Third Reading: Given Immediate Effect Roll Call # 844",34,3,0,1,38
573495,383435,2014-12-18,House,"House Third Reading: Roll Call # 764",109,1,0,0,110
573501,370652,2014-06-10,Senate,"Reported Favorably With Substitute  S-2",5,0,0,0,5
573501,380136,2014-09-24,Senate,"Senate Third Reading: Passed Roll Call # 566",31,7,0,0,38
573501,382772,2014-12-11,House,"Reported With Recommendation Without Amendment",11,2,0,0,13
573501,383432,2014-12-18,House,"House Third Reading: Given Immediate Effect Roll Call # 707",90,19,0,0,109
573501,383711,2014-12-18,Senate,"Senate Third Reading: Roll Call # 865",33,5,0,0,38
573502,313323,2014-01-29,Senate,"Reported Favorably Without Amendment",4,0,0,0,4
573502,316436,2014-02-05,Senate,"Senate Third Reading: Passed Roll Call # 14",32,2,0,4,38
573503,348430,2014-03-20,House,"Reported With Recommendation For Referral To Committee On Health Policy",11,0,0,0,11
573505,382065,2014-12-02,House,"Reported With Recommendation With Substitute  H-3",17,3,0,0,20
573505,382397,2014-12-04,House,"House Third Reading: Given Immediate Effect Roll Call # 631",63,46,0,0,109
573510,348449,2014-03-20,House,"Reported With Recommendation For Referral To Committee On Health Policy",11,0,0,0,11
573513,313302,2014-01-29,House,"Reported With Recommendation Without Amendment",9,0,0,0,9
573513,319498,2014-02-11,House,"House Third Reading: Given Immediate Effect Roll Call # 35",108,1,0,0,109
573513,362674,2014-05-06,Senate,"Reported Favorably Without Amendment",3,0,0,0,3
573513,383814,2014-12-19,Senate,"Senate Third Reading: Passed Roll Call # 911",38,0,0,0,38
573513,383815,2014-12-19,House,"House Third Reading: Roll Call # 800",110,0,0,0,110
580609,346035,2014-03-19,House,"Reported With Recommendation Without Amendment",16,0,0,0,16
580609,360825,2014-04-29,House,"House Third Reading: Given Immediate Effect Roll Call # 192",110,0,0,0,110
580609,363427,2014-05-08,Senate,"Reported Favorably With Substitute  S-1",4,0,0,0,4
580609,382275,2014-12-03,Senate,"Senate Third Reading: Given Immediate Effect Roll Call # 689",36,2,0,0,38
580609,382701,2014-12-09,House,"House Third Reading: Roll Call # 640",109,0,0,0,109
580991,345796,2014-03-19,House,"Reported With Recommendation With Substitute  H-3",12,0,0,0,12
580991,360811,2014-04-29,House,"House Third Reading: Given Immediate Effect Roll Call # 191",65,45,0,0,110
580991,363423,2014-05-08,Senate,"Reported Favorably With Substitute  S-1",4,0,0,0,4
580991,382220,2014-12-03,Senate,"Senate Third Reading: Given Immediate Effect Roll Call # 688",27,11,0,0,38
580991,382704,2014-12-09,House,"House Third Reading: Roll Call # 639",65,44,0,0,109
581368,345778,2014-03-19,House,"Reported With Recommendation With Substitute  H-2",16,0,0,0,16
581368,360663,2014-04-29,House,"House Third Reading: Given Immediate Effect Roll Call # 190",110,0,0,0,110
581368,363493,2014-05-08,Senate,"Reported Favorably With Substitute  S-1",4,0,0,0,4
581368,382221,2014-12-03,Senate,"Senate Third Reading: Given Immediate Effect Roll Call # 687",37,0,0,1,38
581368,382749,2014-12-09,House,"House Third Reading: Roll Call # 638",109,0,0,0,109
587113,313999,2014-01-30,Senate,"Reported Favorably Without Amendment",4,0,0,0,4
587113,314000,2014-01-30,Senate,"Senate Third Reading: Passed Roll Call # 10",35,2,0,1,38
587113,330753,2014-02-26,House,"Reported With Recommendation Without Amendment",14,0,0,0,14
587113,336584,2014-03-06,House,"House Third Reading: Given Immediate Effect Roll Call # 87",100,10,0,0,110
587458,347730,2014-03-25,House,"Reported With Recommendation With Substitute  H-1",14,0,0,0,14
587458,360937,2014-04-29,House,"House Third Reading: Given Immediate Effect Roll Call # 193",110,0,0,0,110
587458,365811,2014-05-20,Senate,"Reported Favorably Without Amendment",4,0,0,0,4
587458,369715,2014-06-03,Senate,"Senate Third Reading: Given Immediate Effect Roll Call # 344",38,0,0,0,38
590001,321227,2014-02-13,House,"Reported With Recommendation With Substitute H-2",6,4,0,0,10
590001,338680,2014-02-13,House,"Reported With Recommendation With Substitute  H-2",6,4,0,0,10
590083,362709,2014-05-06,House,"Reported With Recommendation With Substitute  H-4",9,3,0,0,12
590083,364667,2014-05-14,House,"House Third Reading: Given Immediate Effect Roll Call # 256",96,13,0,0,109
590263,319445,2014-02-11,House,"Reported With Recommendation With Substitute H-1",9,0,0,0,9
590263,326254,2014-02-20,House,"House Third Reading: Given Immediate Effect Roll Call # 61",109,0,0,0,109
590351,362794,2014-05-06,House,"Reported With Recommendation With Substitute  H-4",9,3,0,0,12
590351,364733,2014-05-14,House,"House Third Reading: Given Immediate Effect Roll Call # 255",95,14,0,0,109
598749,336645,2014-03-06,Senate,"Reported Favorably With Substitute S-1",7,0,0,0,7
598749,337312,2014-03-06,Senate,"Reported Favorably With Substitute  S-1",7,0,0,0,7
598749,369856,2014-06-04,Senate,"Senate Third Reading: Passed Roll Call # 365",37,0,0,1,38
598844,380212,2014-09-30,Senate,"Reported Favorably Without Amendment",6,0,0,0,6
598844,380571,2014-10-22,Senate,"Senate Third Reading: Passed Roll Call # 640",36,0,0,2,38
598844,382344,2014-12-03,House,"Reported With Recommendation Without Amendment",15,0,0,0,15
598844,383619,2014-12-17,House,"House Third Reading: Given Immediate Effect Roll Call # 702",108,0,0,0,108
598941,336893,2014-03-06,Senate,"Reported Favorably With Substitute  S-1",7,0,0,0,7
598941,369955,2014-06-04,Senate,"Senate Third Reading: Passed Roll Call # 366",37,0,0,1,38
599287,366380,2014-05-21,House,"Reported With Recommendation With Substitute  H-2",17,0,0,0,17
599287,370056,2014-06-05,House,"House Third Reading: Given Immediate Effect Roll Call # 355",103,5,0,0,108
599287,380574,2014-10-22,Senate,"Reported Favorably Without Amendment",4,0,0,0,4
599287,383169,2014-12-15,Senate,"Senate Third Reading: Given Immediate Effect Roll Call # 783",37,1,0,0,38
599287,383662,2014-12-17,House,"House Third Reading: Senate Amendment(s) Concurred In Roll Call # 689",105,0,0,0,105
600637,348150,2014-03-26,Senate,"Reported Favorably With Substitute  S-1",5,0,0,0,5
600637,362722,2014-05-06,Senate,"Senate Third Reading: Passed Roll Call # 215",38,0,0,0,38
600637,366358,2014-05-21,House,"Reported With Recommendation Without Amendment",13,0,0,0,13
600637,366359,2014-05-21,House,"House Third Reading: Given Immediate Effect Roll Call # 263",110,0,0,0,110
600780,348173,2014-03-26,Senate,"Reported Favorably With Substitute  S-1",5,0,0,0,5
600780,362719,2014-05-06,Senate,"Senate Third Reading: Passed Roll Call # 214",38,0,0,0,38
600780,366354,2014-05-21,House,"Reported With Recommendation Without Amendment",13,0,0,0,13
600780,366355,2014-05-21,House,"House Third Reading: Given Immediate Effect Roll Call # 264",110,0,0,0,110
600960,330743,2014-02-26,House,"Reported With Recommendation Without Amendment",11,0,0,0,11
600960,345775,2014-03-19,House,"House Third Reading: Given Immediate Effect Roll Call # 123",110,0,0,0,110
600960,380292,2014-10-01,Senate,"Reported Favorably Without Amendment",4,0,0,0,4
600960,380374,2014-10-02,Senate,"Senate Third Reading: Given Immediate Effect Roll Call # 620",38,0,0,0,38
600995,345754,2014-03-19,House,"Reported With Recommendation With Substitute  H-1",8,1,0,0,9
600995,379900,2014-09-16,House,"House Third Reading: Given Immediate Effect Roll Call # 463",93,13,0,0,106
600995,380278,2014-10-01,Senate,"Reported Favorably Without Amendment",4,0,0,0,4
600995,380367,2014-10-02,Senate,"Senate Third Reading: Given Immediate Effect Roll Call # 617",37,1,0,0,38
600995,380368,2014-10-02,House,"House Third Reading:  Roll Call # 555",97,10,0,0,107
600995,383123,2014-10-02,House,"House Third Reading: Roll Call # 555",97,10,0,0,107
601031,348349,2014-03-26,House,"Reported With Recommendation With Substitute H-3",7,2,0,0,9
601031,381600,2014-11-12,House,"House Third Reading: Passed Roll Call # 567",77,33,0,0,110
601031,382603,2014-12-10,Senate,"Senate Third Reading: Given Immediate Effect Roll Call # 752",34,2,0,2,38
601031,382809,2014-12-11,House,"House Third Reading: Senate Amendment(s) Concurred In Roll Call # 671",72,34,0,0,106
601179,330765,2014-02-26,House,"Reported With Recommendation Without Amendment",10,1,0,0,11
601179,348548,2014-03-27,House,"House Third Reading: Given Immediate Effect Roll Call # 184",104,4,0,0,108
601215,316441,2014-02-05,House,"Reported With Recommendation With Substitute H-1",9,0,0,0,9
601215,320420,2014-02-12,House,"House Third Reading: Given Immediate Effect Roll Call # 40",107,2,0,0,109
601215,363537,2014-05-08,Senate,"Reported Favorably Without Amendment",3,0,0,0,3
601253,341066,2014-03-12,House,"Reported With Recommendation With Substitute  H-1",8,2,0,0,10
601253,345807,2014-03-19,House,"House Third Reading: Given Immediate Effect Roll Call # 120",108,1,0,0,109
601253,380275,2014-10-01,Senate,"Reported Favorably Without Amendment",4,0,0,0,4
601253,380365,2014-10-02,Senate,"Senate Third Reading: Given Immediate Effect Roll Call # 618",38,0,0,0,38
601291,340865,2014-03-12,House,"Reported With Recommendation With Substitute  H-1",10,1,0,0,11
601291,345816,2014-03-19,House,"House Third Reading: Given Immediate Effect Roll Call # 122",110,0,0,0,110
601291,380272,2014-10-01,Senate,"Reported Favorably Without Amendment",4,0,0,0,4
601291,380357,2014-10-02,Senate,"Senate Third Reading: Given Immediate Effect Roll Call # 619",38,0,0,0,38
601291,380358,2014-10-02,House,"House Third Reading:  Roll Call # 556",103,4,0,0,107
601291,383107,2014-10-02,House,"House Third Reading: Roll Call # 556",103,4,0,0,107
601328,340883,2014-03-12,House,"Reported With Recommendation With Substitute  H-1",10,1,0,0,11
601328,345825,2014-03-19,House,"House Third Reading: Given Immediate Effect Roll Call # 121",108,1,0,0,109
601328,380274,2014-10-01,Senate,"Reported Favorably Without Amendment",4,0,0,0,4
601440,340874,2014-03-12,House,"Reported With Recommendation With Substitute  H-1",10,0,0,0,10
601440,345736,2014-03-19,House,"House Third Reading: Given Immediate Effect Roll Call # 124",110,0,0,0,110
601440,365769,2014-05-20,Senate,"Reported Favorably Without Amendment",4,0,0,0,4
601440,380373,2014-10-02,Senate,"Senate Third Reading: Given Immediate Effect Roll Call # 614",38,0,0,0,38
601514,316475,2014-02-05,House,"Reported With Recommendation With Substitute H-1",9,0,0,0,9
601514,320768,2014-02-12,House,"House Third Reading: Given Immediate Effect Roll Call # 39",109,0,0,0,109
601514,363485,2014-05-08,Senate,"Reported Favorably Without Amendment",3,0,0,0,3
601514,380354,2014-10-02,Senate,"Senate Third Reading: Given Immediate Effect Roll Call # 612",38,0,0,0,38
601546,340890,2014-03-12,House,"Reported With Recommendation With Substitute  H-2",10,0,0,0,10
601546,348613,2014-03-27,House,"House Third Reading: Given Immediate Effect Roll Call # 185",106,2,0,0,108
602340,315649,2014-02-04,House,"Reported With Recommendation With Substitute H-1",17,0,0,0,17
602340,321081,2014-02-13,House,"House Third Reading: Given Immediate Effect Roll Call # 44",69,41,0,0,110
602340,336594,2014-03-05,Senate,"Reported Favorably With Substitute S-1",6,1,0,0,7
602340,337252,2014-03-05,Senate,"Reported Favorably With Substitute  S-1",6,1,0,0,7
602340,345243,2014-03-18,Senate,"Senate Third Reading: Given Immediate Effect Roll Call # 108",26,12,0,0,38
602340,345244,2014-03-18,Senate,"Senate Third Reading: Passed Roll Call # 111",25,13,0,0,38
602340,346788,2014-03-20,House,"House Third Reading:  Roll Call # 131",67,43,0,0,110
602340,383125,2014-03-20,House,"House Third Reading: Roll Call # 131",67,43,0,0,110
602390,361241,2014-04-30,House,"Reported With Recommendation For Referral To Committee On Oversight",10,0,0,0,10
602390,369658,2014-06-03,House,"Reported With Recommendation With Substitute  H-1",7,0,0,0,7
602437,345954,2014-03-19,House,"Reported With Recommendation Without Amendment",13,0,0,0,13
602437,348235,2014-03-26,House,"House Third Reading: Given Immediate Effect Roll Call # 166",109,0,0,0,109
602437,379347,2014-09-10,Senate,"Reported Favorably Without Amendment",4,0,0,0,4
602437,380388,2014-10-02,Senate,"Senate Third Reading: Given Immediate Effect Roll Call # 600",37,0,0,1,38
602486,364071,2014-05-13,House,"Reported With Recommendation Without Amendment",17,0,0,0,17
602486,368125,2014-05-28,House,"House Third Reading: Given Immediate Effect Roll Call # 330",108,0,0,0,108
602486,381518,2014-11-06,Senate,"Reported Favorably Without Amendment",8,0,0,0,8
602486,383228,2014-12-16,Senate,"Senate Third Reading: Given Immediate Effect Roll Call # 807",37,0,0,1,38
602588,361355,2014-04-30,House,"Reported With Recommendation For Referral To Committee On Oversight",10,0,0,0,10
602588,369698,2014-06-03,House,"Reported With Recommendation With Substitute  H-1",7,0,0,0,7
602640,361254,2014-04-30,House,"Reported With Recommendation For Referral To Committee On Oversight",10,0,0,0,10
602640,369716,2014-06-03,House,"Reported With Recommendation With Substitute  H-2",7,0,0,0,7
602834,315545,2014-02-04,House,"Reported With Recommendation With Substitute H-2",18,0,0,0,18
602834,321002,2014-02-13,House,"House Third Reading: Given Immediate Effect Roll Call # 43",93,17,0,0,110
602834,336593,2014-03-05,Senate,"Reported Favorably Without Amendment",8,1,0,0,9
602834,345250,2014-03-18,Senate,"Senate Third Reading: Given Immediate Effect Roll Call # 107",26,12,0,0,38
602834,345251,2014-03-18,Senate,"Senate Third Reading: Passed Roll Call # 110",25,13,0,0,38
602879,346642,2014-03-20,House,"Reported With Recommendation With Substitute H-2",10,0,0,0,10
602879,369700,2014-06-03,House,"House Third Reading: Given Immediate Effect Roll Call # 336",108,1,0,0,109
602879,379954,2014-09-18,Senate,"Reported Favorably Without Amendment",4,0,0,0,4
602930,347789,2014-03-25,House,"Reported With Recommendation Without Amendment",15,0,0,0,15
602930,382703,2014-12-10,House,"House Third Reading: Passed Roll Call # 650",108,0,0,0,108
606984,329384,2014-02-25,House,"Reported With Recommendation Without Amendment",15,0,0,0,15
606984,348694,2014-03-27,House,"House Third Reading: Given Immediate Effect Roll Call # 182",108,0,0,0,108
606984,380290,2014-10-01,Senate,"Reported Favorably Without Amendment",7,0,0,0,7
606984,383209,2014-12-16,Senate,"Senate Third Reading: Given Immediate Effect Roll Call # 794",37,0,0,1,38
607479,361217,2014-04-30,House,"Reported With Recommendation Without Amendment",15,0,0,0,15
607479,364095,2014-05-13,House,"House Third Reading: Given Immediate Effect Roll Call # 223",110,0,0,0,110
607479,370640,2014-06-10,Senate,"Reported Favorably With Substitute  S-1",7,0,0,0,7
607479,371047,2014-06-11,Senate,"Senate Third Reading: Given Immediate Effect Roll Call # 444",38,0,0,0,38
607479,371420,2014-06-12,House,"House Third Reading:  Roll Call # 440",109,1,0,0,110
607479,383048,2014-06-12,House,"House Third Reading: Roll Call # 440",109,1,0,0,110
607503,314004,2014-01-30,House,"Reported With Recommendation Without Amendment",11,0,0,0,11
607503,316389,2014-02-05,House,"House Third Reading: Given Immediate Effect Roll Call # 33",108,0,0,0,108
607503,325892,2014-02-20,Senate,"Reported Favorably Without Amendment",4,0,0,0,4
607503,364472,2014-05-14,Senate,"Senate Third Reading: Given Immediate Effect Roll Call # 266",37,0,0,1,38
607519,325254,2014-02-19,House,"Reported With Recommendation Without Amendment",12,2,0,0,14
607576,314016,2014-01-30,House,"Reported With Recommendation Without Amendment",11,0,0,0,11
607576,316391,2014-02-05,House,"House Third Reading: Given Immediate Effect Roll Call # 32",108,0,0,0,108
607576,326238,2014-02-20,Senate,"Reported Favorably Without Amendment",4,0,0,0,4
607646,324685,2014-02-19,House,"Reported With Recommendation Without Amendment",12,2,0,0,14
607676,324682,2014-02-19,House,"Reported With Recommendation With Substitute H-1",12,2,0,0,14
607676,338958,2014-02-19,House,"Reported With Recommendation With Substitute  H-1",12,2,0,0,14
608572,346652,2014-03-20,House,"Reported With Recommendation Without Amendment",10,0,0,0,10
608572,369907,2014-06-04,House,"House Third Reading: Given Immediate Effect Roll Call # 344",108,0,0,0,108
608595,316340,2014-02-05,Senate,"Reported Favorably Without Amendment",4,0,0,0,4
608595,319991,2014-02-12,Senate,"Senate Third Reading: Passed Roll Call # 20",38,0,0,0,38
608595,357683,2014-04-17,House,"Reported With Recommendation Without Amendment",10,0,0,0,10
608595,364130,2014-05-13,House,"House Third Reading: Given Immediate Effect Roll Call # 225",110,0,0,0,110
608617,335054,2014-03-04,Senate,"Reported Favorably With Substitute S-1",7,0,0,0,7
608617,337336,2014-03-04,Senate,"Reported Favorably With Substitute  S-1",7,0,0,0,7
608617,370966,2014-06-11,Senate,"Senate Third Reading: Passed Roll Call # 426",30,8,0,0,38
608617,381644,2014-11-13,House,"Reported With Recommendation For Referral To Committee On Transportation And Infrastructure",12,0,0,0,12
608617,382477,2014-12-04,House,"Reported With Recommendation With Substitute  H-1",10,1,0,0,11
608640,346517,2014-03-20,House,"Reported With Recommendation Without Amendment",7,0,0,0,7
608640,369846,2014-06-04,House,"House Third Reading: Given Immediate Effect Roll Call # 343",108,0,0,0,108
608661,315582,2014-02-04,House,"Reported With Recommendation With Substitute H-1",17,0,0,0,17
608661,321030,2014-02-13,House,"House Third Reading: Given Immediate Effect Roll Call # 46",99,11,0,0,110
608661,336587,2014-03-05,Senate,"Reported Favorably With Substitute S-1",8,1,0,0,9
608661,337216,2014-03-05,Senate,"Reported Favorably With Substitute  S-1",8,1,0,0,9
608661,345227,2014-03-18,Senate,"Senate Third Reading: Given Immediate Effect Roll Call # 109",25,13,0,0,38
608661,346794,2014-03-20,House,"House Third Reading:  Roll Call # 132",96,14,0,0,110
608661,383120,2014-03-20,House,"House Third Reading: Roll Call # 132",96,14,0,0,110
608687,361205,2014-04-30,House,"Reported With Recommendation With Substitute  H-2",12,0,0,0,12
608687,366527,2014-05-22,House,"House Third Reading: Given Immediate Effect Roll Call # 276",110,0,0,0,110
608687,370617,2014-06-10,Senate,"Reported Favorably With Substitute  S-1",4,0,0,0,4
608687,380335,2014-10-02,Senate,"Senate Third Reading: Given Immediate Effect Roll Call # 599",37,0,0,1,38
608687,380336,2014-10-02,House,"House Third Reading:  Roll Call # 550",107,0,0,0,107
608687,383105,2014-10-02,House,"House Third Reading: Roll Call # 550",107,0,0,0,107
608731,316399,2014-02-05,Senate,"Reported Favorably Without Amendment",4,0,0,0,4
608731,320758,2014-02-12,Senate,"Senate Third Reading: Passed Roll Call # 21",38,0,0,0,38
608754,346589,2014-03-20,House,"Reported With Recommendation Without Amendment",10,0,0,0,10
608754,369858,2014-06-04,House,"House Third Reading: Given Immediate Effect Roll Call # 345",108,0,0,0,108
611797,330592,2014-02-26,House,"Reported With Recommendation With Substitute H-3",11,0,0,0,11
611797,336724,2014-03-06,House,"House Third Reading: Given Immediate Effect Roll Call # 88",107,3,0,0,110
611797,345079,2014-03-18,Senate,"Reported Favorably With Substitute  S-1",5,0,0,0,5
611797,359611,2014-04-24,Senate,"Senate Third Reading: Given Immediate Effect Roll Call # 197",38,0,0,0,38
611797,362714,2014-05-06,House,"House Third Reading:  Roll Call # 197",110,0,0,0,110
611797,382917,2014-05-06,House,"House Third Reading: Roll Call # 197",110,0,0,0,110
611836,382384,2014-12-03,House,"Reported With Recommendation Without Amendment",13,0,0,0,13
611880,382738,2014-12-09,House,"Reported With Recommendation Without Amendment",13,2,0,0,15
611922,323873,2014-02-18,Senate,"Reported Favorably With Substitute S-1",7,0,0,0,7
611922,337035,2014-02-18,Senate,"Reported Favorably With Substitute  S-1",7,0,0,0,7
611922,371008,2014-06-11,Senate,"Senate Third Reading: Passed Roll Call # 416",37,1,0,0,38
613145,323819,2014-02-18,Senate,"Reported Favorably Without Amendment",5,2,0,0,7
613197,323901,2014-02-18,Senate,"Reported Favorably Without Amendment",7,0,0,0,7
613249,370073,2014-06-05,Senate,"Reported Favorably Without Amendment",3,0,0,0,3
613249,377080,2014-08-13,Senate,"Senate Third Reading: Passed Roll Call # 529",22,11,0,5,38
613249,382557,2014-12-09,House,"Reported With Recommendation Without Amendment",7,0,0,0,7
613249,383549,2014-12-18,House,"House Third Reading: Given Immediate Effect Roll Call # 725",76,33,0,0,109
613300,320929,2014-02-13,Senate,"Reported Favorably Without Amendment",4,0,0,0,4
613300,325977,2014-02-20,Senate,"Senate Third Reading: Passed Roll Call # 48",38,0,0,0,38
613300,369869,2014-06-04,House,"Reported With Recommendation With Amendment(s)",10,0,0,0,10
613300,371403,2014-06-12,House,"House Third Reading: Given Immediate Effect Roll Call # 412",110,0,0,0,110
613300,371404,2014-06-12,Senate,"Senate Third Reading: House Amendment(s) Concurred In Roll Call # 496",38,0,0,0,38
614570,334657,2014-03-04,House,"Reported With Recommendation With Substitute H-1",19,1,0,0,20
614570,338586,2014-03-04,House,"Reported With Recommendation With Substitute  H-1",19,1,0,0,20
614570,340877,2014-03-12,House,"House Third Reading: Given Immediate Effect Roll Call # 92",102,6,0,0,108
614570,345752,2014-03-19,Senate,"Reported Favorably Without Amendment",8,0,0,0,8
614570,348581,2014-03-27,Senate,"Senate Third Reading: Given Immediate Effect Roll Call # 161",37,0,0,1,38
614725,334582,2014-03-04,House,"Reported With Recommendation With Substitute H-1",13,0,0,0,13
614725,338953,2014-03-04,House,"Reported With Recommendation With Substitute  H-1",13,0,0,0,13
614725,363411,2014-05-08,House,"House Third Reading: Given Immediate Effect Roll Call # 219",108,1,0,0,109
614725,367812,2014-05-27,Senate,"Reported Favorably Without Amendment",7,0,0,0,7
614725,369870,2014-06-04,Senate,"Senate Third Reading: Given Immediate Effect Roll Call # 351",36,1,0,1,38
614725,370604,2014-06-10,House,"House Third Reading:  Roll Call # 373",109,1,0,0,110
614725,370990,2014-06-11,Senate,"Senate Third Reading:  Roll Call # 458",37,1,0,0,38
614725,383100,2014-06-10,House,"House Third Reading: Roll Call # 373",109,1,0,0,110
614725,383101,2014-06-11,Senate,"Senate Third Reading: Roll Call # 458",37,1,0,0,38
617850,360678,2014-04-29,Senate,"Reported Favorably With Substitute  S-1",11,0,0,0,11
617850,362793,2014-05-06,Senate,"Senate Third Reading: Passed Roll Call # 217",27,11,0,0,38
617850,364425,2014-05-14,House,"House Third Reading: Passed Roll Call # 254",108,0,0,0,108
617850,365832,2014-05-20,Senate,"Senate Third Reading:  Roll Call # 294",0,37,0,1,38
617850,382672,2014-05-20,Senate,"Senate Third Reading: Roll Call # 294",0,37,0,1,38
617856,360878,2014-04-29,Senate,"Reported Favorably With Substitute  S-1",13,0,0,0,13
617856,363460,2014-05-08,Senate,"Senate Third Reading: Passed Roll Call # 256",28,9,0,1,38
617856,364558,2014-05-14,House,"House Third Reading: Passed Roll Call # 241",109,0,0,0,109
617856,366001,2014-05-20,Senate,"Senate Third Reading:  Roll Call # 281",0,38,0,0,38
617856,382801,2014-05-20,Senate,"Senate Third Reading: Roll Call # 281",0,38,0,0,38
617866,360684,2014-04-29,Senate,"Reported Favorably With Substitute  S-1",13,0,0,0,13
617866,360685,2014-04-29,Senate,"Senate Third Reading: Passed Roll Call # 202",36,2,0,0,38
617866,364559,2014-05-14,House,"House Third Reading: Passed Roll Call # 247",109,0,0,0,109
617866,366004,2014-05-20,Senate,"Senate Third Reading:  Roll Call # 287",0,36,1,1,38
617866,382835,2014-05-20,Senate,"Senate Third Reading: Roll Call # 287",0,36,1,1,38
617875,380218,2014-09-30,Senate,"Senate Third Reading: Passed Roll Call # 579",38,0,0,0,38
617875,381594,2014-11-12,House,"Reported With Recommendation With Substitute  H-1",27,0,0,0,27
617875,381633,2014-11-13,House,"House Third Reading: Passed Roll Call # 577",92,15,0,0,107
617875,381634,2014-11-13,Senate,"Senate Third Reading:  Roll Call # 667",35,1,1,1,38
617875,383056,2014-11-13,Senate,"Senate Third Reading: Roll Call # 667",35,1,1,1,38
617884,360666,2014-04-29,Senate,"Reported Favorably With Substitute  S-1",12,0,0,0,12
617884,363486,2014-05-08,Senate,"Senate Third Reading: Passed Roll Call # 247",28,10,0,0,38
617884,364677,2014-05-14,House,"House Third Reading: Passed Roll Call # 242",109,0,0,0,109
617884,365771,2014-05-20,Senate,"Senate Third Reading:  Roll Call # 282",0,37,1,0,38
617884,382778,2014-05-20,Senate,"Senate Third Reading: Roll Call # 282",0,37,1,0,38
617896,334275,2014-03-04,Senate,"Reported Favorably Without Amendment",7,0,0,0,7
617896,341951,2014-03-13,Senate,"Senate Third Reading: Passed Roll Call # 104",38,0,0,0,38
617896,364100,2014-05-13,House,"Reported With Recommendation Without Amendment",8,0,0,0,8
617896,366514,2014-05-22,House,"House Third Reading: Given Immediate Effect Roll Call # 279",102,8,0,0,110
617906,360674,2014-04-29,Senate,"Reported Favorably With Substitute  S-1",11,0,0,0,11
617906,363510,2014-05-08,Senate,"Senate Third Reading: Passed Roll Call # 231",25,13,0,0,38
617906,364674,2014-05-14,House,"House Third Reading: Passed Roll Call # 246",109,0,0,0,109
617906,365790,2014-05-20,Senate,"Senate Third Reading:  Roll Call # 286",0,37,0,1,38
617906,382694,2014-05-20,Senate,"Senate Third Reading: Roll Call # 286",0,37,0,1,38
617918,360836,2014-04-29,Senate,"Reported Favorably With Substitute  S-1",10,1,0,0,11
617918,362833,2014-05-06,Senate,"Senate Third Reading: Passed Roll Call # 222",23,15,0,0,38
617918,364523,2014-05-14,House,"House Third Reading: Passed Roll Call # 245",109,0,0,0,109
617918,365942,2014-05-20,Senate,"Senate Third Reading:  Roll Call # 285",0,38,0,0,38
617918,382645,2014-05-20,Senate,"Senate Third Reading: Roll Call # 285",0,38,0,0,38
617926,360680,2014-04-29,Senate,"Reported Favorably With Substitute  S-1",11,4,0,0,15
617926,363464,2014-05-08,Senate,"Senate Third Reading: Passed Roll Call # 246",26,12,0,0,38
617926,364456,2014-05-14,House,"House Third Reading: Passed Roll Call # 252",108,0,0,0,108
617926,365787,2014-05-20,Senate,"Senate Third Reading:  Roll Call # 292",0,37,0,1,38
617926,382783,2014-05-20,Senate,"Senate Third Reading: Roll Call # 292",0,37,0,1,38
617935,335475,2014-03-05,Senate,"Reported Favorably Without Amendment",9,0,0,0,9
617947,339776,2014-03-11,Senate,"Reported Favorably With Substitute  S-1",16,0,0,0,16
617947,341014,2014-03-12,Senate,"Senate Third Reading: Passed Roll Call # 89",33,2,0,3,38
617947,348226,2014-03-26,House,"Reported With Recommendation Without Amendment",28,0,0,0,28
617947,348227,2014-03-26,House,"House Third Reading: Given Immediate Effect Roll Call # 168",106,3,0,0,109
617947,348575,2014-03-27,Senate,"Senate Third Reading: House Amendment(s) Concurred In Roll Call # 183",36,1,0,1,38
617958,360911,2014-04-29,Senate,"Reported Favorably With Substitute  S-1",13,0,0,0,13
617958,360912,2014-04-29,Senate,"Senate Third Reading: Passed Roll Call # 203",37,1,0,0,38
617958,364736,2014-05-14,House,"House Third Reading: Passed Roll Call # 249",108,0,0,0,108
617958,365813,2014-05-20,Senate,"Senate Third Reading:  Roll Call # 289",0,37,0,1,38
617958,382836,2014-05-20,Senate,"Senate Third Reading: Roll Call # 289",0,37,0,1,38
617967,382829,2014-12-11,Senate,"Senate Third Reading: Passed Roll Call # 778",30,7,0,1,38
617977,342241,2014-03-13,Senate,"Reported Favorably Without Amendment",5,0,0,0,5
617977,348313,2014-03-26,Senate,"Senate Third Reading: Passed Roll Call # 140",37,0,0,1,38
617977,370964,2014-06-11,House,"Reported With Recommendation Without Amendment",15,0,0,0,15
617977,379159,2014-09-09,House,"House Third Reading: Given Immediate Effect Roll Call # 455",97,13,0,0,110
617990,360676,2014-04-29,Senate,"Reported Favorably With Substitute  S-1",14,0,0,0,14
617990,361258,2014-04-30,Senate,"Senate Third Reading: Passed Roll Call # 213",34,4,0,0,38
617990,364520,2014-05-14,House,"House Third Reading: Passed Roll Call # 251",108,0,0,0,108
617990,365949,2014-05-20,Senate,"Senate Third Reading:  Roll Call # 291",0,37,0,1,38
617990,382675,2014-05-20,Senate,"Senate Third Reading: Roll Call # 291",0,37,0,1,38
618000,360787,2014-04-29,Senate,"Reported Favorably With Substitute  S-1",11,0,0,0,11
618000,362700,2014-05-06,Senate,"Senate Third Reading: Passed Roll Call # 219",25,13,0,0,38
618000,364475,2014-05-14,House,"House Third Reading: Passed Roll Call # 239",109,0,0,0,109
618000,365764,2014-05-20,Senate,"Senate Third Reading:  Roll Call # 279",0,38,0,0,38
618000,382695,2014-05-20,Senate,"Senate Third Reading: Roll Call # 279",0,38,0,0,38
618009,360855,2014-04-29,Senate,"Reported Favorably With Substitute  S-1",13,0,0,0,13
618009,360856,2014-04-29,Senate,"Senate Third Reading: Passed Roll Call # 204",38,0,0,0,38
618009,364668,2014-05-14,House,"House Third Reading: Passed Roll Call # 253",108,0,0,0,108
618009,365782,2014-05-20,Senate,"Senate Third Reading:  Roll Call # 293",0,37,0,1,38
618009,382765,2014-05-20,Senate,"Senate Third Reading: Roll Call # 293",0,37,0,1,38
618020,360871,2014-04-29,Senate,"Reported Favorably With Substitute  S-1",11,0,0,0,11
618020,361189,2014-04-30,Senate,"Senate Third Reading: Passed Roll Call # 210",37,0,0,1,38
618020,364416,2014-05-14,House,"House Third Reading: Passed Roll Call # 250",108,0,0,0,108
618020,365810,2014-05-20,Senate,"Senate Third Reading:  Roll Call # 290",0,37,0,1,38
618020,382745,2014-05-20,Senate,"Senate Third Reading: Roll Call # 290",0,37,0,1,38
618029,360858,2014-04-29,Senate,"Reported Favorably With Substitute  S-1",10,4,0,0,14
618029,363447,2014-05-08,Senate,"Senate Third Reading: Passed Roll Call # 239",26,12,0,0,38
618029,364426,2014-05-14,House,"House Third Reading: Passed Roll Call # 244",108,1,0,0,109
618029,365780,2014-05-20,Senate,"Senate Third Reading:  Roll Call # 284",0,38,0,0,38
618029,382728,2014-05-20,Senate,"Senate Third Reading: Roll Call # 284",0,38,0,0,38
618060,360931,2014-04-29,Senate,"Reported Favorably With Substitute  S-1",15,0,0,0,15
618060,361214,2014-04-30,Senate,"Senate Third Reading: Passed Roll Call # 207",38,0,0,0,38
618060,364446,2014-05-14,House,"House Third Reading: Passed Roll Call # 243",109,0,0,0,109
618060,365792,2014-05-20,Senate,"Senate Third Reading:  Roll Call # 283",0,38,0,0,38
618060,382705,2014-05-20,Senate,"Senate Third Reading: Roll Call # 283",0,38,0,0,38
618070,320752,2014-02-12,House,"Reported With Recommendation Without Amendment",10,0,0,0,10
618081,360892,2014-04-29,Senate,"Reported Favorably With Substitute  S-1",13,0,0,0,13
618081,360893,2014-04-29,Senate,"Senate Third Reading: Passed Roll Call # 201",38,0,0,0,38
618081,364685,2014-05-14,House,"House Third Reading: Passed Roll Call # 238",109,0,0,0,109
618081,365791,2014-05-20,Senate,"Senate Third Reading:  Roll Call # 278",0,38,0,0,38
618081,382826,2014-05-20,Senate,"Senate Third Reading: Roll Call # 278",0,38,0,0,38
618090,360901,2014-04-29,Senate,"Reported Favorably With Substitute  S-1",13,0,0,0,13
618090,360902,2014-04-29,Senate,"Senate Third Reading: Passed Roll Call # 205",38,0,0,0,38
618090,364710,2014-05-14,House,"House Third Reading: Passed Roll Call # 248",108,0,0,0,108
618090,365781,2014-05-20,Senate,"Senate Third Reading:  Roll Call # 288",0,37,0,1,38
618090,382706,2014-05-20,Senate,"Senate Third Reading: Roll Call # 288",0,37,0,1,38
618098,361223,2014-04-29,Senate,"Reported Favorably With Substitute  S-1",13,1,0,0,14
618098,362834,2014-05-06,Senate,"Senate Third Reading: Passed Roll Call # 225",32,5,0,1,38
618098,364512,2014-05-14,House,"House Third Reading: Passed Roll Call # 240",109,0,0,0,109
618098,365785,2014-05-20,Senate,"Senate Third Reading:  Roll Call # 280",0,38,0,0,38
618098,382833,2014-05-20,Senate,"Senate Third Reading: Roll Call # 280",0,38,0,0,38
618204,379913,2014-09-17,House,"Reported With Recommendation For Referral To Committee On Michigan Competitiveness",15,0,0,0,15
618234,359325,2014-04-23,House,"Reported With Recommendation With Substitute  H-1",19,0,0,0,19
618234,362777,2014-05-06,House,"House Third Reading: Given Immediate Effect Roll Call # 205",92,17,0,0,109
618234,364529,2014-05-14,Senate,"Senate Third Reading: Passed Roll Call # 270",26,11,0,1,38
618234,364978,2014-05-15,House,"House Third Reading:  Roll Call # 257",0,109,0,0,109
618234,371326,2014-06-12,House,"House Third Reading: Conference Report Adopted Roll Call # 413",100,10,0,0,110
618234,371327,2014-06-12,Senate,"Senate Third Reading: Senate Adopted Conference Report With Immediate Effect Roll Call # 492",24,12,2,0,38
618234,382912,2014-05-15,House,"House Third Reading: Roll Call # 257",0,109,0,0,109
618276,359433,2014-04-23,House,"Reported With Recommendation With Substitute  H-1",19,0,0,0,19
618276,363463,2014-05-08,House,"House Third Reading: Given Immediate Effect Roll Call # 216",97,12,0,0,109
618276,364453,2014-05-14,Senate,"Senate Third Reading: Passed Roll Call # 271",27,9,1,1,38
618276,364910,2014-05-15,House,"House Third Reading:  Roll Call # 258",0,109,0,0,109
618276,371091,2014-06-11,House,"House Third Reading: Conference Report Adopted Roll Call # 408",60,50,0,0,110
618276,371092,2014-06-11,Senate,"Senate Third Reading: Senate Adopted Conference Report With Immediate Effect Roll Call # 430",21,17,0,0,38
618276,382904,2014-05-15,House,"House Third Reading: Roll Call # 258",0,109,0,0,109
619053,326085,2014-02-20,Senate,"Reported Favorably With Substitute S-1",3,0,0,0,3
619053,334154,2014-03-04,Senate,"Senate Third Reading: Passed By 3/4 Vote Roll Call # 59",31,7,0,0,38
619053,382751,2014-12-11,House,"Reported With Recommendation With Amendment(s)",10,1,0,0,11
619161,364551,2014-05-14,House,"Reported With Recommendation With Substitute  H-1",9,6,0,0,15
619161,366598,2014-05-22,House,"House Third Reading: Given Immediate Effect Roll Call # 281",60,50,0,0,110
619161,383732,2014-12-18,Senate,"Senate Third Reading: Given Immediate Effect Roll Call # 886",26,12,0,0,38
619161,383733,2014-12-18,House,"House Third Reading: Senate Amendment(s) Concurred In Roll Call # 775",70,40,0,0,110
619190,364509,2014-05-14,House,"Reported With Recommendation With Substitute  H-3",14,0,0,0,14
619190,366579,2014-05-22,House,"House Third Reading: Given Immediate Effect Roll Call # 282",81,29,0,0,110
619190,383794,2014-12-18,Senate,"Senate Third Reading: Given Immediate Effect Roll Call # 887",26,12,0,0,38
619715,342019,2014-03-13,Senate,"Reported Favorably With Substitute  S-1",5,0,0,0,5
619715,348287,2014-03-26,Senate,"Senate Third Reading: Passed Roll Call # 143",36,1,0,1,38
619715,381614,2014-11-12,House,"Reported With Recommendation With Substitute  H-1",12,1,0,0,13
619715,383673,2014-12-19,House,"House Third Reading: Given Immediate Effect Roll Call # 804",93,17,0,0,110
619715,383824,2014-12-19,Senate,"Senate Third Reading: Roll Call # 937",37,1,0,0,38
619775,342253,2014-03-13,Senate,"Reported Favorably Without Amendment",5,0,0,0,5
619775,348153,2014-03-26,Senate,"Senate Third Reading: Passed Roll Call # 142",36,1,0,1,38
619775,381595,2014-11-12,House,"Reported With Recommendation With Substitute  H-1",12,1,0,0,13
619775,383683,2014-12-19,House,"House Third Reading: Given Immediate Effect Roll Call # 793",94,16,0,0,110
619775,383834,2014-12-19,Senate,"Senate Third Reading: Roll Call # 930",37,1,0,0,38
619832,361831,2014-05-01,Senate,"Reported Favorably With Substitute  S-1",3,0,0,0,3
619832,366452,2014-05-21,Senate,"Senate Third Reading: Passed Roll Call # 305",36,0,2,0,38
619832,366453,2014-05-21,Senate,"Senate Third Reading: Passed Roll Call # 306",38,0,0,0,38
619943,331806,2014-02-27,House,"Reported With Recommendation With Amendment(s)",7,0,0,0,7
619943,342272,2014-03-13,House,"House Third Reading: Given Immediate Effect Roll Call # 107",89,20,0,0,109
619943,359220,2014-04-23,Senate,"Reported Favorably With Substitute  S-1",3,0,0,0,3
619943,369939,2014-06-04,Senate,"Senate Third Reading: Given Immediate Effect Roll Call # 368",29,8,0,1,38
619943,370471,2014-06-10,House,"House Third Reading:  Roll Call # 369",88,21,0,0,109
619943,382908,2014-06-10,House,"House Third Reading: Roll Call # 369",88,21,0,0,109
619969,331829,2014-02-27,House,"Reported With Recommendation With Substitute H-1",6,0,0,0,6
619969,339621,2014-02-27,House,"Reported With Recommendation With Substitute  H-1",6,0,0,0,6
619969,342141,2014-03-13,House,"House Third Reading: Given Immediate Effect Roll Call # 109",82,27,0,0,109
619969,359233,2014-04-23,Senate,"Reported Favorably With Substitute  S-1",3,0,0,0,3
619992,331498,2014-02-27,House,"Reported With Recommendation Without Amendment",7,0,0,0,7
619992,342112,2014-03-13,House,"House Third Reading: Given Immediate Effect Roll Call # 106",88,21,0,0,109
620021,331808,2014-02-27,House,"Reported With Recommendation Without Amendment",6,1,0,0,7
620072,331488,2014-02-27,House,"Reported With Recommendation Without Amendment",7,0,0,0,7
620072,342138,2014-03-13,House,"House Third Reading: Given Immediate Effect Roll Call # 110",89,20,0,0,109
620072,359367,2014-04-23,Senate,"Reported Favorably With Substitute  S-1",3,0,0,0,3
620072,369876,2014-06-04,Senate,"Senate Third Reading: Given Immediate Effect Roll Call # 369",29,8,0,1,38
620072,370513,2014-06-10,House,"House Third Reading:  Roll Call # 370",88,21,0,0,109
620072,382909,2014-06-10,House,"House Third Reading: Roll Call # 370",88,21,0,0,109
620141,331605,2014-02-27,House,"Reported With Recommendation Without Amendment",7,0,0,0,7
620141,342048,2014-03-13,House,"House Third Reading: Given Immediate Effect Roll Call # 108",87,22,0,0,109
622307,348238,2014-03-26,Senate,"Reported Favorably With Substitute  S-1",3,0,0,0,3
622307,370705,2014-06-10,Senate,"Senate Third Reading: Passed Roll Call # 407",24,13,0,1,38
622307,382476,2014-12-04,House,"Reported With Recommendation With Substitute  H-2",7,3,0,0,10
622307,383812,2014-12-19,Senate,"Senate Third Reading: Roll Call # 942",26,12,0,0,38
622307,383813,2014-12-19,House,"House Third Reading: Given Immediate Effect Roll Call # 806",84,26,0,0,110
622341,366027,2014-05-20,Senate,"Reported Favorably With Substitute  S-1",4,0,0,0,4
622341,366330,2014-05-21,Senate,"Senate Third Reading: Passed Roll Call # 310",38,0,0,0,38
622341,382144,2014-12-02,House,"Reported With Recommendation With Substitute  H-1",7,0,0,0,7
622341,383339,2014-12-17,Senate,"Senate Third Reading: Roll Call # 856",35,0,2,1,38
622341,383595,2014-12-17,House,"House Third Reading: Given Immediate Effect Roll Call # 699",108,0,0,0,108
622394,357618,2014-04-17,House,"Reported With Recommendation With Substitute  H-1",7,0,0,0,7
622394,363535,2014-05-08,House,"House Third Reading: Given Immediate Effect Roll Call # 220",105,4,0,0,109
622394,370602,2014-06-10,Senate,"Senate Third Reading: Given Immediate Effect Roll Call # 410",37,0,0,1,38
622415,380206,2014-09-30,Senate,"Reported Favorably Without Amendment",13,0,0,0,13
622452,339901,2014-03-11,House,"Reported With Recommendation With Substitute  H-1",18,0,0,0,18
622452,346765,2014-03-20,House,"House Third Reading: Passed Roll Call # 136",110,0,0,0,110
622452,362825,2014-05-06,Senate,"Reported Favorably Without Amendment",6,0,0,0,6
622452,370665,2014-06-10,Senate,"Senate Third Reading: Given Immediate Effect Roll Call # 402",37,0,0,1,38
622488,348304,2014-03-26,Senate,"Reported Favorably Without Amendment",4,0,0,0,4
622488,370592,2014-06-10,Senate,"Senate Third Reading: Passed Roll Call # 408",27,10,0,1,38
622488,382459,2014-12-04,House,"Reported With Recommendation Without Amendment",8,2,0,0,10
622488,383688,2014-12-19,House,"House Third Reading: Given Immediate Effect Roll Call # 807",85,25,0,0,110
623018,367687,2014-05-27,Senate,"Reported Favorably With Substitute  S-1",6,0,0,0,6
623018,369844,2014-06-04,Senate,"Senate Third Reading: Passed Roll Call # 363",37,0,0,1,38
623018,382076,2014-12-02,House,"Reported With Recommendation Without Amendment",9,0,0,0,9
623018,383627,2014-12-18,House,"House Third Reading: Given Immediate Effect Roll Call # 747",103,6,0,0,109
623018,383749,2014-12-18,Senate,"Senate Third Reading: House Amendment(s) Concurred In Roll Call # 898",38,0,0,0,38
623028,367572,2014-05-27,Senate,"Reported Favorably With Substitute  S-3",6,0,0,0,6
623028,369878,2014-06-04,Senate,"Senate Third Reading: Passed Roll Call # 359",37,0,0,1,38
623028,382113,2014-12-02,House,"Reported With Recommendation Without Amendment",7,0,0,0,7
623028,383453,2014-12-18,House,"House Third Reading: Given Immediate Effect Roll Call # 745",105,4,0,0,109
623028,383770,2014-12-18,Senate,"Senate Third Reading: Roll Call # 897",38,0,0,0,38
623040,367736,2014-05-27,Senate,"Reported Favorably With Substitute  S-1",6,0,0,0,6
623040,369839,2014-06-04,Senate,"Senate Third Reading: Passed Roll Call # 360",37,0,0,1,38
623040,382129,2014-12-02,House,"Reported With Recommendation Without Amendment",9,0,0,0,9
623040,383626,2014-12-18,House,"House Third Reading: Given Immediate Effect Roll Call # 746",100,9,0,0,109
623064,332155,2014-02-25,House,"Reported With Recommendation Without Amendment",9,0,0,0,9
623074,367569,2014-05-27,Senate,"Reported Favorably With Substitute  S-1",6,0,0,0,6
623074,369886,2014-06-04,Senate,"Senate Third Reading: Passed Roll Call # 362",37,0,0,1,38
623074,382117,2014-12-02,House,"Reported With Recommendation Without Amendment",9,0,0,0,9
623074,383279,2014-12-17,House,"House Third Reading: Given Immediate Effect Roll Call # 701",104,4,0,0,108
623086,332156,2014-02-25,House,"Reported With Recommendation Without Amendment",9,0,0,0,9
623113,367720,2014-05-27,Senate,"Reported Favorably With Substitute  S-1",6,0,0,0,6
623113,369845,2014-06-04,Senate,"Senate Third Reading: Passed Roll Call # 361",37,0,0,1,38
623113,382122,2014-12-02,House,"Reported With Recommendation With Substitute  H-1",9,0,0,0,9
623113,383614,2014-12-17,House,"House Third Reading: Given Immediate Effect Roll Call # 700",104,0,0,0,104
623113,383771,2014-12-18,Senate,"Senate Third Reading: Roll Call # 905",38,0,0,0,38
623170,335751,2014-03-05,House,"Reported With Recommendation Without Amendment",14,0,0,0,14
623170,341275,2014-03-12,House,"House Third Reading: Given Immediate Effect Roll Call # 93",107,1,0,0,108
623257,364724,2014-05-14,House,"Reported With Recommendation With Substitute  H-3",9,0,0,0,9
623257,379895,2014-09-16,House,"House Third Reading: Passed Roll Call # 461",104,2,0,0,106
623257,382428,2014-12-04,Senate,"Reported Favorably Without Amendment",4,0,0,0,4
623284,364422,2014-05-14,House,"Reported With Recommendation Without Amendment",9,0,0,0,9
623284,379897,2014-09-16,House,"House Third Reading: Passed Roll Call # 462",96,10,0,0,106
623284,382421,2014-12-04,Senate,"Reported Favorably Without Amendment",3,0,0,0,3
623284,383800,2014-12-19,Senate,"Senate Third Reading: Given Immediate Effect Roll Call # 912",38,0,0,0,38
624103,334162,2014-03-04,Senate,"Reported Favorably Without Amendment",3,1,0,0,4
624103,335747,2014-03-05,Senate,"Senate Third Reading: Passed Roll Call # 73",36,0,0,2,38
624103,345209,2014-03-18,House,"Reported With Recommendation Without Amendment",17,0,0,0,17
624103,346713,2014-03-20,House,"House Third Reading: Given Immediate Effect Roll Call # 140",110,0,0,0,110
624109,334268,2014-03-04,House,"Reported With Recommendation Without Amendment",17,0,0,0,17
624109,335635,2014-03-05,House,"House Third Reading: Given Immediate Effect Roll Call # 79",110,0,0,0,110
624109,345004,2014-03-18,Senate,"Reported Favorably Without Amendment",12,1,0,0,13
624109,346542,2014-03-20,Senate,"Senate Third Reading: Given Immediate Effect Roll Call # 130",37,0,0,1,38
624118,334732,2014-03-04,Senate,"Reported Favorably Without Amendment",3,1,0,0,4
624118,335413,2014-03-05,Senate,"Senate Third Reading: Passed Roll Call # 72",36,0,0,2,38
624118,344990,2014-03-18,House,"Reported With Recommendation Without Amendment",17,0,0,0,17
624118,346748,2014-03-20,House,"House Third Reading: Given Immediate Effect Roll Call # 139",110,0,0,0,110
624129,334727,2014-03-04,House,"Reported With Recommendation Without Amendment",17,0,0,0,17
624129,336045,2014-03-05,House,"House Third Reading: Given Immediate Effect Roll Call # 84",110,0,0,0,110
624129,345169,2014-03-18,Senate,"Reported Favorably Without Amendment",12,1,0,0,13
624129,346612,2014-03-20,Senate,"Senate Third Reading: Given Immediate Effect Roll Call # 133",37,0,0,1,38
624149,334846,2014-03-04,House,"Reported With Recommendation Without Amendment",17,0,0,0,17
624149,335451,2014-03-05,House,"House Third Reading: Given Immediate Effect Roll Call # 83",110,0,0,0,110
624149,345180,2014-03-18,Senate,"Reported Favorably Without Amendment",12,1,0,0,13
624149,346628,2014-03-20,Senate,"Senate Third Reading: Given Immediate Effect Roll Call # 134",37,0,0,1,38
624168,334157,2014-03-04,Senate,"Reported Favorably Without Amendment",3,1,0,0,4
624168,335465,2014-03-05,Senate,"Senate Third Reading: Passed Roll Call # 75",37,0,0,1,38
624168,345127,2014-03-18,House,"Reported With Recommendation Without Amendment",17,0,0,0,17
624168,346728,2014-03-20,House,"House Third Reading: Given Immediate Effect Roll Call # 142",110,0,0,0,110
624177,334155,2014-03-04,Senate,"Reported Favorably Without Amendment",3,1,0,0,4
624177,335439,2014-03-05,Senate,"Senate Third Reading: Passed Roll Call # 78",38,0,0,0,38
624177,345225,2014-03-18,House,"Reported With Recommendation Without Amendment",17,0,0,0,17
624177,346759,2014-03-20,House,"House Third Reading: Given Immediate Effect Roll Call # 145",110,0,0,0,110
624186,365018,2014-05-15,Senate,"Senate Third Reading: Passed Roll Call # 276",38,0,0,0,38
624186,369697,2014-06-03,House,"Reported With Recommendation Without Amendment",9,3,0,0,12
624199,334796,2014-03-04,House,"Reported With Recommendation Without Amendment",17,0,0,0,17
624199,335447,2014-03-05,House,"House Third Reading: Given Immediate Effect Roll Call # 77",110,0,0,0,110
624199,345158,2014-03-18,Senate,"Reported Favorably Without Amendment",12,1,0,0,13
624199,346602,2014-03-20,Senate,"Senate Third Reading: Given Immediate Effect Roll Call # 128",37,0,0,1,38
624208,334794,2014-03-04,House,"Reported With Recommendation Without Amendment",17,0,0,0,17
624208,335445,2014-03-05,House,"House Third Reading: Given Immediate Effect Roll Call # 78",110,0,0,0,110
624208,345157,2014-03-18,Senate,"Reported Favorably Without Amendment",12,1,0,0,13
624208,346588,2014-03-20,Senate,"Senate Third Reading: Given Immediate Effect Roll Call # 129",37,0,0,1,38
624217,334752,2014-03-04,House,"Reported With Recommendation Without Amendment",17,0,0,0,17
624217,335430,2014-03-05,House,"House Third Reading: Given Immediate Effect Roll Call # 81",110,0,0,0,110
624217,345156,2014-03-18,Senate,"Reported Favorably Without Amendment",12,1,0,0,13
624217,346601,2014-03-20,Senate,"Senate Third Reading: Given Immediate Effect Roll Call # 132",37,0,0,1,38
624237,334167,2014-03-04,Senate,"Reported Favorably Without Amendment",3,1,0,0,4
624237,335491,2014-03-05,Senate,"Senate Third Reading: Passed Roll Call # 76",37,0,0,1,38
624237,345181,2014-03-18,House,"Reported With Recommendation Without Amendment",17,0,0,0,17
624237,346712,2014-03-20,House,"House Third Reading: Given Immediate Effect Roll Call # 143",110,0,0,0,110
624248,334221,2014-03-04,Senate,"Reported Favorably Without Amendment",3,1,0,0,4
624248,335541,2014-03-05,Senate,"Senate Third Reading: Passed Roll Call # 77",37,0,1,0,38
624248,344998,2014-03-18,House,"Reported With Recommendation Without Amendment",17,0,0,0,17
624248,346699,2014-03-20,House,"House Third Reading: Given Immediate Effect Roll Call # 144",110,0,0,0,110
624257,334270,2014-03-04,House,"Reported With Recommendation Without Amendment",17,0,0,0,17
624257,335637,2014-03-05,House,"House Third Reading: Given Immediate Effect Roll Call # 80",110,0,0,0,110
624257,345018,2014-03-18,Senate,"Reported Favorably Without Amendment",12,1,0,0,13
624257,346560,2014-03-20,Senate,"Senate Third Reading: Given Immediate Effect Roll Call # 131",37,0,0,1,38
624267,334169,2014-03-04,Senate,"Reported Favorably With Substitute S-1",3,1,0,0,4
624267,335483,2014-03-05,Senate,"Senate Third Reading: Passed Roll Call # 74",36,0,0,2,38
624267,345102,2014-03-18,House,"Reported With Recommendation Without Amendment",17,0,0,0,17
624267,346727,2014-03-20,House,"House Third Reading: Given Immediate Effect Roll Call # 141",110,0,0,0,110
624277,334202,2014-03-04,House,"Reported With Recommendation Without Amendment",17,0,0,0,17
624277,335513,2014-03-05,House,"House Third Reading: Given Immediate Effect Roll Call # 76",110,0,0,0,110
624277,345087,2014-03-18,Senate,"Reported Favorably Without Amendment",12,1,0,0,13
624277,346591,2014-03-20,Senate,"Senate Third Reading: Given Immediate Effect Roll Call # 127",37,0,0,1,38
627005,331838,2014-02-27,Senate,"Reported Favorably Without Amendment",7,0,0,0,7
627005,334160,2014-03-04,Senate,"Senate Third Reading: Passed Roll Call # 63",36,2,0,0,38
627005,345964,2014-03-19,House,"Reported With Recommendation With Substitute  H-1",13,0,0,0,13
627005,347849,2014-03-25,House,"House Third Reading: Given Immediate Effect Roll Call # 154",108,1,0,0,109
627005,348552,2014-03-27,Senate,"Senate Third Reading:  Roll Call # 177",35,2,0,1,38
627005,382926,2014-03-27,Senate,"Senate Third Reading: Roll Call # 177",35,2,0,1,38
627030,331539,2014-02-27,Senate,"Reported Favorably Without Amendment",7,0,0,0,7
627030,334152,2014-03-04,Senate,"Senate Third Reading: Passed Roll Call # 61",36,2,0,0,38
627030,345920,2014-03-19,House,"Reported With Recommendation With Substitute  H-1",13,0,0,0,13
627030,347649,2014-03-25,House,"House Third Reading: Given Immediate Effect Roll Call # 152",107,2,0,0,109
627030,348559,2014-03-27,Senate,"Senate Third Reading:  Roll Call # 174",34,2,1,1,38
627030,348560,2014-03-27,Senate,"Senate Third Reading:  Roll Call # 175",35,2,0,1,38
627030,382930,2014-03-27,Senate,"Senate Third Reading: Roll Call # 174",34,2,1,1,38
627030,382931,2014-03-27,Senate,"Senate Third Reading: Roll Call # 175",35,2,0,1,38
627043,331535,2014-02-27,Senate,"Reported Favorably Without Amendment",7,0,0,0,7
627043,334153,2014-03-04,Senate,"Senate Third Reading: Passed Roll Call # 70",36,2,0,0,38
627043,345900,2014-03-19,House,"Reported With Recommendation With Substitute  H-1",13,0,0,0,13
627043,347705,2014-03-25,House,"House Third Reading: Given Immediate Effect Roll Call # 161",105,4,0,0,109
627043,348606,2014-03-27,Senate,"Senate Third Reading:  Roll Call # 182",35,2,0,1,38
627043,382956,2014-03-27,Senate,"Senate Third Reading: Roll Call # 182",35,2,0,1,38
627057,331566,2014-02-27,Senate,"Reported Favorably Without Amendment",7,0,0,0,7
627057,334339,2014-03-04,Senate,"Senate Third Reading: Passed Roll Call # 66",36,2,0,0,38
627057,345732,2014-03-19,House,"Reported With Recommendation With Substitute  H-1",15,0,0,0,15
627057,347767,2014-03-25,House,"House Third Reading: Given Immediate Effect Roll Call # 157",108,1,0,0,109
627057,348684,2014-03-27,Senate,"Senate Third Reading:  Roll Call # 178",35,2,0,1,38
627057,383013,2014-03-27,Senate,"Senate Third Reading: Roll Call # 178",35,2,0,1,38
627080,364114,2014-05-13,House,"Reported With Recommendation With Substitute  H-1",8,0,0,0,8
627080,367571,2014-05-27,House,"House Third Reading: Given Immediate Effect Roll Call # 325",110,0,0,0,110
627106,331529,2014-02-27,Senate,"Reported Favorably Without Amendment",7,0,0,0,7
627106,334606,2014-03-04,Senate,"Senate Third Reading: Passed Roll Call # 67",36,2,0,0,38
627106,345811,2014-03-19,House,"Reported With Recommendation With Substitute  H-1",15,0,0,0,15
627106,347595,2014-03-25,House,"House Third Reading: Given Immediate Effect Roll Call # 158",109,0,0,0,109
627106,348499,2014-03-27,Senate,"Senate Third Reading:  Roll Call # 179",35,2,0,1,38
627106,382937,2014-03-27,Senate,"Senate Third Reading: Roll Call # 179",35,2,0,1,38
627118,331525,2014-02-27,Senate,"Reported Favorably Without Amendment",7,0,0,0,7
627118,334593,2014-03-04,Senate,"Senate Third Reading: Passed Roll Call # 64",36,2,0,0,38
627118,345808,2014-03-19,House,"Reported With Recommendation Without Amendment",15,0,0,0,15
627118,347732,2014-03-25,House,"House Third Reading: Given Immediate Effect Roll Call # 156",108,1,0,0,109
627146,331601,2014-02-27,Senate,"Reported Favorably Without Amendment",7,0,0,0,7
627146,334280,2014-03-04,Senate,"Senate Third Reading: Passed Roll Call # 62",36,2,0,0,38
627146,345883,2014-03-19,House,"Reported With Recommendation With Substitute  H-1",9,0,0,0,9
627146,347751,2014-03-25,House,"House Third Reading: Given Immediate Effect Roll Call # 153",104,5,0,0,109
627146,348680,2014-03-27,Senate,"Senate Third Reading:  Roll Call # 176",35,2,0,1,38
627146,382885,2014-03-27,Senate,"Senate Third Reading: Roll Call # 176",35,2,0,1,38
627170,331891,2014-02-27,Senate,"Reported Favorably Without Amendment",7,0,0,0,7
627170,334330,2014-03-04,Senate,"Senate Third Reading: Passed Roll Call # 68",36,2,0,0,38
627170,346050,2014-03-19,House,"Reported With Recommendation With Substitute  H-1",15,0,0,0,15
627170,347652,2014-03-25,House,"House Third Reading: Given Immediate Effect Roll Call # 159",109,0,0,0,109
627170,348563,2014-03-27,Senate,"Senate Third Reading:  Roll Call # 180",35,2,0,1,38
627170,382949,2014-03-27,Senate,"Senate Third Reading: Roll Call # 180",35,2,0,1,38
627195,335429,2014-03-05,Senate,"Reported Favorably Without Amendment",7,0,0,0,7
627195,340985,2014-03-12,Senate,"Senate Third Reading: Passed Roll Call # 88",35,0,0,3,38
627195,346635,2014-03-20,House,"Reported With Recommendation Without Amendment",14,0,0,0,14
627195,348154,2014-03-26,House,"House Third Reading: Given Immediate Effect Roll Call # 167",107,2,0,0,109
627222,331886,2014-02-27,Senate,"Reported Favorably Without Amendment",7,0,0,0,7
627222,334656,2014-03-04,Senate,"Senate Third Reading: Passed Roll Call # 65",36,2,0,0,38
627222,345783,2014-03-19,House,"Reported With Recommendation Without Amendment",10,0,0,0,10
627222,347878,2014-03-25,House,"House Third Reading: Given Immediate Effect Roll Call # 155",106,3,0,0,109
627268,331900,2014-02-27,Senate,"Reported Favorably Without Amendment",7,0,0,0,7
627268,334156,2014-03-04,Senate,"Senate Third Reading: Passed Roll Call # 69",36,2,0,0,38
627268,345861,2014-03-19,House,"Reported With Recommendation With Substitute  H-1",13,0,0,0,13
627268,347798,2014-03-25,House,"House Third Reading: Given Immediate Effect Roll Call # 160",105,4,0,0,109
627268,348703,2014-03-27,Senate,"Senate Third Reading:  Roll Call # 181",35,2,0,1,38
627268,382954,2014-03-27,Senate,"Senate Third Reading: Roll Call # 181",35,2,0,1,38
627506,345741,2014-03-19,Senate,"Reported Favorably Without Amendment",5,0,0,0,5
627506,364478,2014-05-14,Senate,"Senate Third Reading: Passed Roll Call # 272",37,0,0,1,38
627506,369893,2014-06-04,House,"Reported With Recommendation Without Amendment",15,0,0,0,15
627506,371314,2014-06-12,House,"House Third Reading: Given Immediate Effect Roll Call # 415",110,0,0,0,110
627506,371315,2014-06-12,Senate,"Senate Third Reading: House Amendment(s) Concurred In Roll Call # 497",38,0,0,0,38
628173,363129,2014-05-07,Senate,"Reported Favorably With Substitute  S-2",7,0,0,0,7
628173,370064,2014-06-05,Senate,"Senate Third Reading: Passed Roll Call # 394",37,0,0,1,38
628173,380257,2014-10-01,House,"Reported With Recommendation With Substitute  H-2",13,0,0,0,13
628562,369926,2014-06-04,House,"Reported With Recommendation With Substitute  H-1",9,1,0,0,10
628562,370098,2014-06-05,House,"House Third Reading: Given Immediate Effect Roll Call # 361",105,3,0,0,108
628562,370927,2014-06-11,Senate,"Senate Third Reading: Given Immediate Effect Roll Call # 438",37,1,0,0,38
628578,380416,2014-10-02,House,"Reported With Recommendation With Substitute  H-1",7,0,0,0,7
628599,380406,2014-10-02,House,"Reported With Recommendation With Substitute  H-1",7,0,0,0,7
628617,380413,2014-10-02,House,"Reported With Recommendation With Substitute  H-1",6,0,0,0,6
628678,380429,2014-10-02,House,"Reported With Recommendation With Substitute  H-1",6,0,0,0,6
628696,380426,2014-10-02,House,"Reported With Recommendation With Substitute  H-1",7,0,0,0,7
629656,359264,2014-04-23,Senate,"Reported Favorably With Substitute  S-1",3,0,0,0,3
629656,359761,2014-04-24,Senate,"Senate Third Reading: Passed Roll Call # 194",36,2,0,0,38
629656,363414,2014-05-08,House,"Reported With Recommendation Without Amendment",7,2,0,0,9
629656,370106,2014-06-05,House,"House Third Reading: Given Immediate Effect Roll Call # 352",87,21,0,0,108
629878,347620,2014-03-25,House,"Reported With Recommendation Without Amendment",17,0,0,0,17
629878,364673,2014-05-14,House,"House Third Reading: Given Immediate Effect Roll Call # 237",109,0,0,0,109
629878,377114,2014-08-13,Senate,"Reported Favorably Without Amendment",8,0,0,0,8
629984,347606,2014-03-25,House,"Reported With Recommendation With Substitute  H-1",17,0,0,0,17
629984,364670,2014-05-14,House,"House Third Reading: Given Immediate Effect Roll Call # 236",109,0,0,0,109
629984,377100,2014-08-13,Senate,"Reported Favorably With Substitute  S-2",8,0,0,0,8
630063,347794,2014-03-25,House,"Reported With Recommendation Without Amendment",17,0,0,0,17
630063,364436,2014-05-14,House,"House Third Reading: Given Immediate Effect Roll Call # 229",109,0,0,0,109
630063,377119,2014-08-13,Senate,"Reported Favorably Without Amendment",8,0,0,0,8
632952,364086,2014-05-13,Senate,"Reported Favorably Without Amendment",6,0,0,0,6
632952,366188,2014-05-21,Senate,"Senate Third Reading: Passed Roll Call # 309",38,0,0,0,38
632952,370593,2014-06-10,House,"Reported With Recommendation With Amendment(s)",14,0,0,0,14
632952,371364,2014-06-12,House,"House Third Reading: Given Immediate Effect Roll Call # 420",103,7,0,0,110
632952,371365,2014-06-12,Senate,"Senate Third Reading: House Amendment(s) Concurred In Roll Call # 498",38,0,0,0,38
632961,363480,2014-05-08,Senate,"Reported Favorably Without Amendment",3,0,0,0,3
632961,381637,2014-11-13,Senate,"Senate Third Reading: Passed Roll Call # 669",25,10,1,2,38
632961,381638,2014-11-13,Senate,"Senate Third Reading: Passed Roll Call # 672",26,10,0,2,38
632971,363571,2014-05-08,Senate,"Reported Favorably Without Amendment",3,0,0,0,3
632971,381652,2014-11-13,Senate,"Senate Third Reading: Passed Roll Call # 670",26,10,0,2,38
632994,364643,2014-05-14,Senate,"Reported Favorably With Substitute  S-1",4,0,0,0,4
632994,369872,2014-06-04,Senate,"Senate Third Reading: Passed Roll Call # 354",37,0,0,1,38
632994,381671,2014-11-13,House,"Reported With Recommendation With Amendment(s)",8,0,0,0,8
632994,382661,2014-12-10,House,"House Third Reading: Given Immediate Effect Roll Call # 661",97,13,0,0,110
632994,383114,2014-12-15,Senate,"Senate Third Reading: House Amendment(s) Concurred In Roll Call # 780",38,0,0,0,38
633006,363475,2014-05-08,Senate,"Reported Favorably With Substitute  S-1",4,0,0,0,4
633006,381629,2014-11-13,Senate,"Senate Third Reading: Passed Roll Call # 671",25,11,0,2,38
633041,363473,2014-05-08,Senate,"Reported Favorably Without Amendment",4,0,0,0,4
633041,381721,2014-11-13,Senate,"Senate Third Reading: Passed Roll Call # 673",25,11,0,2,38
633063,371386,2014-06-11,Senate,"Senate Third Reading: Passed Roll Call # 415",37,1,0,0,38
633063,383685,2014-12-19,House,"House Third Reading: Passed Roll Call # 785",78,32,0,0,110
633063,383798,2014-12-19,Senate,"Senate Third Reading: Roll Call # 917",23,15,0,0,38
633173,364921,2014-05-15,House,"Reported With Recommendation With Substitute  H-2",6,0,0,0,6
633173,369694,2014-06-03,House,"House Third Reading: Given Immediate Effect Roll Call # 339",108,1,0,0,109
633189,346546,2014-03-20,House,"Reported With Recommendation With Substitute  H-3",7,4,0,0,11
633189,346682,2014-03-20,House,"House Third Reading: Given Immediate Effect Roll Call # 151",62,47,0,0,109
633189,382843,2014-12-11,Senate,"Senate Third Reading: Given Immediate Effect Roll Call # 763",26,11,0,1,38
633241,364908,2014-05-15,House,"Reported With Recommendation With Substitute  H-3",6,0,0,0,6
633241,369751,2014-06-03,House,"House Third Reading: Given Immediate Effect Roll Call # 340",101,8,0,0,109
633241,379832,2014-09-11,Senate,"Reported Favorably With Substitute  S-2",4,0,0,0,4
633241,380319,2014-10-01,Senate,"Senate Third Reading: Given Immediate Effect Roll Call # 591",35,0,1,2,38
633241,380431,2014-10-02,House,"House Third Reading:  Roll Call # 548",104,3,0,0,107
633241,382940,2014-10-02,House,"House Third Reading: Roll Call # 548",104,3,0,0,107
633265,347698,2014-03-25,House,"Reported With Recommendation Without Amendment",16,0,0,0,16
633265,364591,2014-05-14,House,"House Third Reading: Given Immediate Effect Roll Call # 230",93,16,0,0,109
633265,377088,2014-08-13,Senate,"Reported Favorably With Substitute  S-1",8,0,0,0,8
633265,383806,2014-12-19,Senate,"Senate Third Reading: Given Immediate Effect Roll Call # 933",38,0,0,0,38
633265,383807,2014-12-19,House,"House Third Reading: Roll Call # 811",94,16,0,0,110
633746,370122,2014-06-05,Senate,"Reported Favorably Without Amendment",4,2,0,0,6
633746,370694,2014-06-10,Senate,"Senate Third Reading: Passed Roll Call # 412",27,10,0,1,38
633841,379467,2014-09-10,House,"Reported With Recommendation With Substitute  H-1",19,0,0,0,19
633841,380007,2014-09-18,House,"House Third Reading: Given Immediate Effect Roll Call # 486",102,7,0,0,109
633841,382844,2014-12-11,Senate,"Reported Favorably With Substitute  S-1",4,1,0,0,5
633931,379475,2014-09-10,House,"Reported With Recommendation With Substitute  H-1",18,0,0,0,18
633931,379996,2014-09-18,House,"House Third Reading: Given Immediate Effect Roll Call # 485",102,6,0,0,108
633931,382823,2014-12-11,Senate,"Reported Favorably With Substitute  S-1",4,1,0,0,5
634418,347685,2014-03-25,Senate,"Reported Favorably Without Amendment",8,0,0,0,8
634418,348477,2014-03-27,Senate,"Senate Third Reading: Passed Roll Call # 169",37,0,0,1,38
634418,369714,2014-06-03,House,"Reported With Recommendation With Substitute  H-1",19,0,0,0,19
634418,370882,2014-06-11,House,"House Third Reading: Given Immediate Effect Roll Call # 404",108,2,0,0,110
634418,371442,2014-06-12,Senate,"Senate Third Reading:  Roll Call # 471",37,0,0,1,38
634418,383034,2014-06-12,Senate,"Senate Third Reading: Roll Call # 471",37,0,0,1,38
634437,370115,2014-06-05,House,"Reported With Recommendation With Substitute  H-4",12,0,0,0,12
634437,379161,2014-09-09,House,"House Third Reading: Given Immediate Effect Roll Call # 451",104,5,0,0,109
634437,382436,2014-12-04,Senate,"Reported Favorably Without Amendment",6,0,0,0,6
634437,383697,2014-12-18,Senate,"Senate Third Reading: Given Immediate Effect Roll Call # 873",38,0,0,0,38
634473,369867,2014-06-04,House,"Reported With Recommendation With Substitute  H-2",19,0,0,0,19
634473,371367,2014-06-12,House,"House Third Reading: Given Immediate Effect Roll Call # 429",108,2,0,0,110
634473,382324,2014-12-03,Senate,"Reported Favorably Without Amendment",6,0,0,0,6
634473,383230,2014-12-16,Senate,"Senate Third Reading: Given Immediate Effect Roll Call # 811",36,0,1,1,38
634494,339823,2014-03-11,House,"Reported With Recommendation Without Amendment",13,2,0,0,15
634494,346743,2014-03-20,House,"House Third Reading: Given Immediate Effect Roll Call # 135",103,7,0,0,110
634494,362680,2014-05-06,Senate,"Reported Favorably With Substitute  S-1",5,0,0,0,5
634494,364679,2014-05-14,Senate,"Senate Third Reading: Given Immediate Effect Roll Call # 267",35,2,0,1,38
634494,365027,2014-05-15,House,"House Third Reading:  Roll Call # 259",102,7,0,0,109
634494,382982,2014-05-15,House,"House Third Reading: Roll Call # 259",102,7,0,0,109
634529,380197,2014-09-30,Senate,"Reported Favorably Without Amendment",6,0,0,0,6
634529,380245,2014-10-01,Senate,"Senate Third Reading: Passed Roll Call # 588",36,0,0,2,38
634529,382741,2014-12-10,House,"Reported With Recommendation Without Amendment",17,0,0,0,17
634529,383441,2014-12-18,House,"House Third Reading: Given Immediate Effect Roll Call # 730",103,6,0,0,109
636199,361736,2014-05-01,Senate,"Reported Favorably With Substitute  S-2",3,0,0,0,3
636199,369863,2014-06-04,Senate,"Senate Third Reading: Passed Roll Call # 373",37,0,0,1,38
636203,340956,2014-03-12,House,"Reported With Recommendation Without Amendment",12,1,0,0,13
636205,347746,2014-03-25,Senate,"Reported Favorably Without Amendment",6,0,0,0,6
636205,348267,2014-03-26,Senate,"Senate Third Reading: Passed Roll Call # 152",37,0,0,1,38
636205,360659,2014-04-29,House,"Reported With Recommendation Without Amendment",14,0,0,0,14
636205,364103,2014-05-13,House,"House Third Reading: Given Immediate Effect Roll Call # 226",105,5,0,0,110
636207,379846,2014-09-11,Senate,"Reported Favorably With Substitute  S-2",4,0,0,0,4
636207,380097,2014-09-23,Senate,"Senate Third Reading: Passed Roll Call # 546",38,0,0,0,38
636207,380340,2014-10-02,House,"Reported With Recommendation Without Amendment",10,0,0,0,10
636207,380341,2014-10-02,House,"House Third Reading: Given Immediate Effect Roll Call # 545",107,0,0,0,107
636208,370701,2014-06-10,Senate,"Senate Third Reading: Passed Roll Call # 406",37,0,0,1,38
636208,380133,2014-09-24,House,"Reported With Recommendation Without Amendment",9,0,0,0,9
636208,380382,2014-10-02,House,"House Third Reading: Given Immediate Effect Roll Call # 530",107,0,0,0,107
636208,380383,2014-10-02,Senate,"Senate Third Reading:  Roll Call # 631",38,0,0,0,38
636208,383016,2014-10-02,Senate,"Senate Third Reading: Roll Call # 631",38,0,0,0,38
636209,366233,2014-05-21,Senate,"Reported Favorably With Substitute  S-2",4,0,0,0,4
636209,369854,2014-06-04,Senate,"Senate Third Reading: Passed Roll Call # 380",36,0,0,2,38
636209,379833,2014-09-11,House,"Reported With Recommendation Without Amendment",11,0,0,0,11
636209,380128,2014-09-24,House,"House Third Reading: Given Immediate Effect Roll Call # 504",108,0,0,0,108
636210,361725,2014-05-01,Senate,"Reported Favorably Without Amendment",3,0,0,0,3
636210,369842,2014-06-04,Senate,"Senate Third Reading: Passed Roll Call # 372",37,0,0,1,38
636211,340950,2014-03-12,House,"Reported With Recommendation Without Amendment",12,1,0,0,13
636214,361717,2014-05-01,Senate,"Reported Favorably Without Amendment",3,0,0,0,3
636214,369860,2014-06-04,Senate,"Senate Third Reading: Passed Roll Call # 371",37,0,0,1,38
636257,357636,2014-04-17,House,"Reported With Recommendation Without Amendment",9,0,0,0,9
636257,362736,2014-05-06,House,"House Third Reading: Given Immediate Effect Roll Call # 202",66,44,0,0,110
636257,368321,2014-05-28,Senate,"Reported Favorably Without Amendment",5,1,0,0,6
636257,370121,2014-06-05,Senate,"Senate Third Reading: Given Immediate Effect Roll Call # 386",25,12,0,1,38
636288,357643,2014-04-17,House,"Reported With Recommendation With Substitute  H-2",8,0,0,0,8
636288,362648,2014-05-06,House,"House Third Reading: Given Immediate Effect Roll Call # 201",68,42,0,0,110
636288,368405,2014-05-28,Senate,"Reported Favorably With Substitute  S-2",5,1,0,0,6
636288,369865,2014-06-04,Senate,"Senate Third Reading: Given Immediate Effect Roll Call # 382",25,11,0,2,38
636288,370512,2014-06-10,House,"House Third Reading:  Roll Call # 375",70,40,0,0,110
636288,383106,2014-06-10,House,"House Third Reading: Roll Call # 375",70,40,0,0,110
636315,364994,2014-05-15,House,"Reported With Recommendation With Amendment(s)",11,0,0,0,11
636315,367636,2014-05-27,House,"House Third Reading: Given Immediate Effect Roll Call # 321",109,1,0,0,110
636315,379831,2014-09-11,Senate,"Reported Favorably With Substitute  S-1",4,0,0,0,4
636315,380148,2014-09-24,Senate,"Senate Third Reading: Given Immediate Effect Roll Call # 567",37,1,0,0,38
636315,380238,2014-10-01,House,"House Third Reading:  Roll Call # 505",107,2,0,0,109
636315,382933,2014-10-01,House,"House Third Reading: Roll Call # 505",107,2,0,0,109
636345,364954,2014-05-15,House,"Reported With Recommendation Without Amendment",11,0,0,0,11
636345,367599,2014-05-27,House,"House Third Reading: Given Immediate Effect Roll Call # 322",110,0,0,0,110
636345,379834,2014-09-11,Senate,"Reported Favorably With Substitute  S-1",4,0,0,0,4
636345,380149,2014-09-24,Senate,"Senate Third Reading: Given Immediate Effect Roll Call # 568",38,0,0,0,38
636345,380236,2014-10-01,House,"House Third Reading:  Roll Call # 506",109,0,0,0,109
636345,382662,2014-10-01,House,"House Third Reading: Roll Call # 506",109,0,0,0,109
636402,365028,2014-05-15,House,"Reported With Recommendation With Amendment(s)",11,0,0,0,11
636402,367583,2014-05-27,House,"House Third Reading: Given Immediate Effect Roll Call # 324",110,0,0,0,110
636402,379843,2014-09-11,Senate,"Reported Favorably With Substitute  S-2",4,0,0,0,4
636402,380144,2014-09-24,Senate,"Senate Third Reading: Given Immediate Effect Roll Call # 569",38,0,0,0,38
636402,380240,2014-10-01,House,"House Third Reading:  Roll Call # 507",109,0,0,0,109
636402,382633,2014-10-01,House,"House Third Reading: Roll Call # 507",109,0,0,0,109
636458,364918,2014-05-15,House,"Reported With Recommendation With Amendment(s)",9,0,0,0,9
636458,367615,2014-05-27,House,"House Third Reading: Given Immediate Effect Roll Call # 323",110,0,0,0,110
636486,357690,2014-04-17,House,"Reported With Recommendation With Substitute  H-1",9,0,0,0,9
636486,362712,2014-05-06,House,"House Third Reading: Given Immediate Effect Roll Call # 203",66,44,0,0,110
636486,368248,2014-05-28,Senate,"Reported Favorably Without Amendment",5,1,0,0,6
636486,370119,2014-06-05,Senate,"Senate Third Reading: Given Immediate Effect Roll Call # 387",26,11,0,1,38
636515,346680,2014-03-20,Senate,"Reported Favorably Without Amendment",4,0,0,0,4
637150,347686,2014-03-25,Senate,"Reported Favorably Without Amendment",6,0,0,0,6
637150,348228,2014-03-26,Senate,"Senate Third Reading: Passed Roll Call # 153",37,0,0,1,38
637150,362670,2014-05-06,House,"Reported With Recommendation Without Amendment",9,0,0,0,9
637150,364974,2014-05-15,House,"House Third Reading: Given Immediate Effect Roll Call # 260",108,1,0,0,109
637160,382073,2014-12-02,House,"Reported With Recommendation With Substitute  H-2",14,0,0,0,14
637160,382514,2014-12-02,House,"Reported With Recommendation With Substitute H-2",14,0,0,0,14
637160,382654,2014-12-10,House,"House Third Reading: Passed Roll Call # 654",97,12,0,0,109
637171,375881,2014-07-16,Senate,"Reported Favorably With Substitute  S-2",3,0,0,0,3
637171,381714,2014-11-13,Senate,"Senate Third Reading: Passed Roll Call # 675",36,0,0,2,38
637195,382388,2014-12-03,House,"Reported With Recommendation Without Amendment",13,0,0,0,13
637195,382740,2014-12-10,House,"House Third Reading: Passed Roll Call # 653",102,7,0,0,109
637245,375871,2014-07-16,Senate,"Reported Favorably With Substitute  S-3",3,0,0,0,3
637245,381642,2014-11-13,Senate,"Senate Third Reading: Passed Roll Call # 674",36,0,0,2,38
637256,358557,2014-04-22,Senate,"Reported Favorably With Amendment(s)",7,0,0,0,7
637272,370623,2014-06-10,Senate,"Reported Favorably Without Amendment",5,2,0,0,7
637272,380438,2014-09-30,House,"Reported With Recommendation Without Amendment",13,0,0,0,13
637318,370559,2014-06-10,Senate,"Reported Favorably Without Amendment",5,2,0,0,7
637483,358696,2014-04-22,Senate,"Reported Favorably With Substitute  S-1",4,0,0,0,4
637483,359361,2014-04-23,Senate,"Senate Third Reading: Passed Roll Call # 190",38,0,0,0,38
637508,362683,2014-05-06,Senate,"Reported Favorably With Substitute  S-1",5,1,0,0,6
637508,369861,2014-06-04,Senate,"Senate Third Reading: Passed Roll Call # 356",31,6,0,1,38
637508,370633,2014-06-10,House,"Reported With Recommendation Without Amendment",8,1,0,0,9
637508,371410,2014-06-12,House,"House Third Reading: Given Immediate Effect Roll Call # 442",67,43,0,0,110
637508,371411,2014-06-12,Senate,"Senate Third Reading:  Roll Call # 521",29,8,0,1,38
637508,382907,2014-06-12,Senate,"Senate Third Reading: Roll Call # 521",29,8,0,1,38
637521,358827,2014-04-22,Senate,"Reported Favorably With Substitute  S-2",4,0,0,0,4
637521,359416,2014-04-23,Senate,"Senate Third Reading: Passed Roll Call # 193",38,0,0,0,38
637521,364915,2014-05-15,House,"Reported With Recommendation With Substitute  H-1",8,0,0,0,8
637521,370932,2014-06-11,House,"House Third Reading: Given Immediate Effect Roll Call # 397",108,2,0,0,110
637521,371309,2014-06-12,Senate,"Senate Third Reading:  Roll Call # 475",37,0,0,1,38
637521,382985,2014-06-12,Senate,"Senate Third Reading: Roll Call # 475",37,0,0,1,38
637535,358785,2014-04-22,Senate,"Reported Favorably With Substitute  S-1",4,0,0,0,4
637535,359395,2014-04-23,Senate,"Senate Third Reading: Passed Roll Call # 192",38,0,0,0,38
637535,364917,2014-05-15,House,"Reported With Recommendation With Substitute  H-1",8,0,0,0,8
637535,370892,2014-06-11,House,"House Third Reading: Given Immediate Effect Roll Call # 396",108,2,0,0,110
637535,371317,2014-06-12,Senate,"Senate Third Reading:  Roll Call # 474",36,0,1,1,38
637535,371318,2014-06-12,Senate,"Senate Third Reading:  Roll Call # 476",37,0,0,1,38
637535,382964,2014-06-12,Senate,"Senate Third Reading: Roll Call # 474",36,0,1,1,38
637535,382965,2014-06-12,Senate,"Senate Third Reading: Roll Call # 476",37,0,0,1,38
637546,358873,2014-04-22,Senate,"Reported Favorably Without Amendment",4,0,0,0,4
637546,359208,2014-04-23,Senate,"Senate Third Reading: Passed Roll Call # 191",38,0,0,0,38
637546,365025,2014-05-15,House,"Reported With Recommendation With Substitute  H-1",8,0,0,0,8
637546,371106,2014-06-11,House,"House Third Reading: Given Immediate Effect Roll Call # 395",108,2,0,0,110
637546,371266,2014-06-12,Senate,"Senate Third Reading:  Roll Call # 473",37,0,0,1,38
637546,382986,2014-06-12,Senate,"Senate Third Reading: Roll Call # 473",37,0,0,1,38
637554,358582,2014-04-22,Senate,"Reported Favorably With Substitute  S-1",4,0,0,0,4
637554,359293,2014-04-23,Senate,"Senate Third Reading: Passed Roll Call # 189",38,0,0,0,38
637554,364909,2014-05-15,House,"Reported With Recommendation With Substitute  H-2",8,0,0,0,8
637554,371042,2014-06-11,House,"House Third Reading: Given Immediate Effect Roll Call # 394",108,2,0,0,110
637554,371418,2014-06-12,Senate,"Senate Third Reading:  Roll Call # 472",37,0,0,1,38
637554,382989,2014-06-12,Senate,"Senate Third Reading: Roll Call # 472",37,0,0,1,38
638816,358591,2014-04-22,Senate,"Reported Favorably With Substitute  S-2",6,0,0,0,6
638816,359607,2014-04-24,Senate,"Senate Third Reading: Passed Roll Call # 200",37,0,1,0,38
638843,361324,2014-04-30,House,"Reported With Recommendation Without Amendment",11,0,0,0,11
638857,364480,2014-05-14,House,"Reported With Recommendation Without Amendment",28,0,0,0,28
638857,366265,2014-05-21,House,"House Third Reading: Given Immediate Effect Roll Call # 270",108,0,0,0,108
638857,371278,2014-06-12,Senate,"Reported Favorably With Substitute  S-2",7,0,0,0,7
638857,371279,2014-06-12,Senate,"Senate Third Reading: Given Immediate Effect Roll Call # 517",37,0,0,1,38
638857,371280,2014-06-12,House,"House Third Reading:  Roll Call # 444",110,0,0,0,110
638857,383024,2014-06-12,House,"House Third Reading: Roll Call # 444",110,0,0,0,110
638867,379926,2014-09-17,House,"Reported With Recommendation With Substitute  H-2",11,0,0,0,11
638867,380150,2014-09-24,House,"House Third Reading: Given Immediate Effect Roll Call # 501",108,1,0,0,109
638867,380557,2014-10-22,Senate,"Reported Favorably Without Amendment",7,0,0,0,7
638867,383139,2014-12-15,Senate,"Senate Third Reading: Given Immediate Effect Roll Call # 784",37,1,0,0,38
638890,379918,2014-09-17,House,"Reported With Recommendation Without Amendment",11,0,0,0,11
638890,380135,2014-09-24,House,"House Third Reading: Given Immediate Effect Roll Call # 502",108,1,0,0,109
638890,380556,2014-10-22,Senate,"Reported Favorably Without Amendment",7,0,0,0,7
638890,383140,2014-12-15,Senate,"Senate Third Reading: Given Immediate Effect Roll Call # 785",36,2,0,0,38
639301,369442,2014-06-02,Senate,"Reported Favorably With Substitute  S-2",8,0,0,0,8
639301,370601,2014-06-10,Senate,"Senate Third Reading: Passed Roll Call # 404",37,0,0,1,38
639301,380233,2014-09-30,House,"Reported With Recommendation Without Amendment",18,0,0,0,18
639301,383535,2014-12-18,House,"House Third Reading: Passed Roll Call # 752",92,18,0,0,110
639359,360895,2014-04-29,Senate,"Reported Favorably Without Amendment",8,0,0,0,8
639359,369859,2014-06-04,Senate,"Senate Third Reading: Passed Roll Call # 370",37,0,0,1,38
639359,380248,2014-09-30,House,"Reported With Recommendation With Substitute  H-1",16,0,0,0,16
639359,382062,2014-12-02,House,"House Third Reading: Given Immediate Effect Roll Call # 596",109,0,0,0,109
639359,382390,2014-12-04,Senate,"Senate Third Reading:  Roll Call # 707",36,0,0,2,38
639359,382722,2014-12-04,Senate,"Senate Third Reading: Roll Call # 707",36,0,0,2,38
639799,379905,2014-09-16,Senate,"Reported Favorably With Substitute  S-3",14,0,0,0,14
639799,380139,2014-09-24,Senate,"Senate Third Reading: Passed Roll Call # 564",38,0,0,0,38
639799,382061,2014-12-02,House,"Reported With Recommendation With Substitute  H-1",13,0,0,0,13
639799,383276,2014-12-17,House,"House Third Reading: Given Immediate Effect Roll Call # 697",108,0,0,0,108
639799,383277,2014-12-17,Senate,"Senate Third Reading: Roll Call # 859",37,0,0,1,38
639808,379906,2014-09-16,Senate,"Reported Favorably With Substitute  S-2",14,0,0,0,14
639808,380152,2014-09-24,Senate,"Senate Third Reading: Passed Roll Call # 565",38,0,0,0,38
639808,382099,2014-12-02,House,"Reported With Recommendation Without Amendment",13,0,0,0,13
639808,383465,2014-12-17,House,"House Third Reading: Given Immediate Effect Roll Call # 698",108,0,0,0,108
639814,379907,2014-09-16,Senate,"Reported Favorably With Substitute  S-2",14,0,0,0,14
639814,380157,2014-09-24,Senate,"Senate Third Reading: Passed Roll Call # 562",38,0,0,0,38
639814,382082,2014-12-02,House,"Reported With Recommendation With Substitute  H-2",13,0,0,0,13
639814,383372,2014-12-17,Senate,"Senate Third Reading: Roll Call # 857",37,0,0,1,38
639814,383663,2014-12-17,House,"House Third Reading: Given Immediate Effect Roll Call # 695",108,0,0,0,108
639823,379919,2014-09-17,House,"Reported With Recommendation With Substitute  H-1",13,0,0,0,13
639823,380169,2014-09-24,House,"House Third Reading: Given Immediate Effect Roll Call # 497",91,17,0,0,108
639823,382558,2014-12-09,Senate,"Reported Favorably Without Amendment",6,0,0,0,6
639832,382098,2014-12-02,Senate,"Reported Favorably Without Amendment",5,3,0,0,8
639846,366309,2014-05-21,Senate,"Reported Favorably Without Amendment",7,0,0,0,7
639846,369914,2014-06-04,Senate,"Senate Third Reading: Passed Roll Call # 375",35,1,1,1,38
639846,380113,2014-09-23,House,"Reported With Recommendation Without Amendment",13,2,0,0,15
639846,380261,2014-10-01,House,"House Third Reading: Given Immediate Effect Roll Call # 521",107,2,0,0,109
639846,380342,2014-10-02,Senate,"Senate Third Reading:  Roll Call # 608",38,0,0,0,38
639846,382978,2014-10-02,Senate,"Senate Third Reading: Roll Call # 608",38,0,0,0,38
639863,359370,2014-04-23,Senate,"Reported Favorably With Substitute  S-1",3,0,0,0,3
639863,359762,2014-04-24,Senate,"Senate Third Reading: Passed Roll Call # 195",36,2,0,0,38
639863,363477,2014-05-08,House,"Reported With Recommendation Without Amendment",7,1,0,0,8
639863,370089,2014-06-05,House,"House Third Reading: Given Immediate Effect Roll Call # 353",87,21,0,0,108
639870,380237,2014-10-01,House,"Reported With Recommendation With Substitute  H-1",13,0,0,0,13
639870,382427,2014-12-04,House,"House Third Reading: Given Immediate Effect Roll Call # 634",110,0,0,0,110
639870,383271,2014-12-17,Senate,"Reported Favorably Without Amendment",4,0,0,0,4
639870,383830,2014-12-19,Senate,"Senate Third Reading: Given Immediate Effect Roll Call # 913",38,0,0,0,38
639876,379908,2014-09-16,Senate,"Reported Favorably With Substitute  S-3",14,0,0,0,14
639876,380168,2014-09-24,Senate,"Senate Third Reading: Passed Roll Call # 563",38,0,0,0,38
639876,382075,2014-12-02,House,"Reported With Recommendation With Substitute  H-1",13,0,0,0,13
639876,383360,2014-12-17,Senate,"Senate Third Reading: Roll Call # 858",37,0,0,1,38
639876,383651,2014-12-17,House,"House Third Reading: Given Immediate Effect Roll Call # 696",108,0,0,0,108
640549,366321,2014-05-21,House,"Reported With Recommendation Without Amendment",14,0,0,0,14
640549,370107,2014-06-05,House,"House Third Reading: Given Immediate Effect Roll Call # 354",108,0,0,0,108
640549,380385,2014-10-02,Senate,"Reported Favorably Without Amendment",7,0,0,0,7
640549,383286,2014-12-17,Senate,"Senate Third Reading: Given Immediate Effect Roll Call # 825",31,4,2,1,38
640549,383424,2014-12-18,House,"House Third Reading: Roll Call # 711",108,0,0,0,108
640588,365788,2014-05-20,House,"Reported With Recommendation With Substitute  H-1",13,2,0,0,15
640623,365768,2014-05-20,House,"Reported With Recommendation With Substitute H-3",13,2,0,0,15
640722,380122,2014-09-23,House,"Reported With Recommendation With Substitute  H-1",15,0,0,0,15
640722,380324,2014-10-02,House,"House Third Reading: Passed Roll Call # 531",92,15,0,0,107
640722,382322,2014-12-03,Senate,"Reported Favorably Without Amendment",7,0,0,0,7
641210,363471,2014-05-08,Senate,"Reported Favorably Without Amendment",3,0,0,0,3
641210,371090,2014-06-11,Senate,"Senate Third Reading: Passed Roll Call # 435",38,0,0,0,38
641210,380320,2014-10-01,House,"Reported With Recommendation With Substitute  H-2",9,0,0,0,9
641210,380378,2014-10-02,House,"House Third Reading: Given Immediate Effect Roll Call # 527",107,0,0,0,107
641210,380379,2014-10-02,Senate,"Senate Third Reading:  Roll Call # 632",38,0,0,0,38
641210,383012,2014-10-02,Senate,"Senate Third Reading: Roll Call # 632",38,0,0,0,38
641463,364585,2014-05-14,House,"Reported With Recommendation Without Amendment",16,0,0,0,16
641463,366523,2014-05-22,House,"House Third Reading: Given Immediate Effect Roll Call # 298",108,1,0,0,109
641463,382585,2014-12-09,Senate,"Reported Favorably Without Amendment",4,0,0,0,4
641463,383281,2014-12-17,Senate,"Senate Third Reading: Given Immediate Effect Roll Call # 847",25,12,0,1,38
641498,364463,2014-05-14,House,"Reported With Recommendation With Substitute  H-1",16,0,0,0,16
641498,366517,2014-05-22,House,"House Third Reading: Given Immediate Effect Roll Call # 297",109,0,0,0,109
641498,382554,2014-12-09,Senate,"Reported Favorably Without Amendment",4,0,0,0,4
641498,383380,2014-12-17,Senate,"Senate Third Reading: Given Immediate Effect Roll Call # 846",27,10,0,1,38
641507,368199,2014-05-28,House,"Reported With Recommendation Without Amendment",15,0,0,0,15
641507,369965,2014-06-04,House,"House Third Reading: Passed Roll Call # 342",108,0,0,0,108
641507,380273,2014-10-01,Senate,"Reported Favorably With Amendment(s)",4,0,0,0,4
641507,380360,2014-10-02,Senate,"Senate Third Reading: Passed Roll Call # 605",38,0,0,0,38
641507,380361,2014-10-02,House,"House Third Reading: Senate Amendment(s) Concurred In Roll Call # 558",107,0,0,0,107
641547,363455,2014-05-08,Senate,"Reported Favorably With Substitute  S-3",3,0,0,0,3
641547,363456,2014-05-08,Senate,"Senate Third Reading: Passed Roll Call # 253",33,5,0,0,38
641547,364519,2014-05-14,House,"Reported With Recommendation Without Amendment",26,0,0,0,26
641547,367747,2014-05-27,House,"House Third Reading: Given Immediate Effect Roll Call # 319",86,24,0,0,110
641594,370608,2014-06-10,Senate,"Reported Favorably With Substitute  S-1",5,2,0,0,7
641594,371287,2014-06-12,Senate,"Senate Third Reading: Passed Roll Call # 513",26,12,0,0,38
641594,382083,2014-12-02,House,"Reported With Recommendation With Substitute  H-2",6,2,0,0,8
641594,383235,2014-12-16,House,"House Third Reading: Given Immediate Effect Roll Call # 680",56,52,0,0,108
641594,383348,2014-12-17,Senate,"Senate Third Reading: Roll Call # 830",26,11,0,1,38
641640,370628,2014-06-10,Senate,"Reported Favorably Without Amendment",5,2,0,0,7
645498,363066,2014-05-07,House,"Reported With Recommendation With Substitute  H-3",12,1,0,0,13
645498,363449,2014-05-08,House,"House Third Reading: Given Immediate Effect Roll Call # 211",104,5,0,0,109
645498,381728,2014-11-13,Senate,"Senate Third Reading: Given Immediate Effect Roll Call # 660",37,0,0,1,38
645500,363131,2014-05-07,House,"Reported With Recommendation With Substitute  H-2",11,0,0,0,11
645500,363491,2014-05-08,House,"House Third Reading: Given Immediate Effect Roll Call # 208",91,18,0,0,109
645505,363216,2014-05-07,House,"Reported With Recommendation With Substitute  H-1",11,1,0,0,12
645505,363540,2014-05-08,House,"House Third Reading: Given Immediate Effect Roll Call # 212",98,11,0,0,109
645505,370893,2014-06-11,Senate,"Senate Third Reading: Defeated Roll Call # 420",16,22,0,0,38
645513,379931,2014-09-17,House,"Reported With Recommendation With Substitute  H-2",9,0,0,0,9
645513,380151,2014-09-24,House,"House Third Reading: Given Immediate Effect Roll Call # 503",108,1,0,0,109
645513,381727,2014-11-13,Senate,"Reported Favorably Without Amendment",3,0,0,0,3
645513,383388,2014-12-17,Senate,"Senate Third Reading: Given Immediate Effect Roll Call # 839",37,0,0,1,38
645520,382747,2014-12-11,House,"House Third Reading: Given Immediate Effect Roll Call # 677",95,11,0,0,106
645522,364912,2014-05-15,House,"Reported With Recommendation Without Amendment",8,0,0,0,8
645522,366522,2014-05-22,House,"House Third Reading: Given Immediate Effect Roll Call # 296",108,1,0,0,109
645522,380202,2014-09-30,Senate,"Reported Favorably Without Amendment",4,0,0,0,4
645522,380333,2014-10-02,Senate,"Senate Third Reading: Given Immediate Effect Roll Call # 636",38,0,0,0,38
645525,360925,2014-04-29,House,"Reported With Recommendation Without Amendment",15,0,0,0,15
645525,362677,2014-05-06,House,"House Third Reading: Given Immediate Effect Roll Call # 196",110,0,0,0,110
645525,381538,2014-11-06,Senate,"Reported Favorably With Substitute  S-1",7,0,0,0,7
645525,383233,2014-12-16,Senate,"Senate Third Reading: Given Immediate Effect Roll Call # 799",37,0,0,1,38
645525,383427,2014-12-18,House,"House Third Reading: Roll Call # 755",110,0,0,0,110
645531,364580,2014-05-14,House,"Reported With Recommendation With Substitute  H-1",10,0,0,0,10
645531,366546,2014-05-22,House,"House Third Reading: Passed Roll Call # 280",110,0,0,0,110
645531,369962,2014-06-04,Senate,"Reported Favorably Without Amendment",4,0,0,0,4
645531,371444,2014-06-12,Senate,"Senate Third Reading: Given Immediate Effect Roll Call # 502",38,0,0,0,38
645536,363056,2014-05-07,House,"Reported With Recommendation With Substitute  H-3",13,0,0,0,13
645536,363445,2014-05-08,House,"House Third Reading: Given Immediate Effect Roll Call # 206",109,0,0,0,109
645536,370844,2014-06-11,Senate,"Senate Third Reading: Given Immediate Effect Roll Call # 418",37,1,0,0,38
645536,383668,2014-12-19,House,"House Third Reading: Roll Call # 783",99,11,0,0,110
645536,383817,2014-12-19,Senate,"Senate Third Reading: Roll Call # 932",37,1,0,0,38
645538,380430,2014-10-02,House,"Reported With Recommendation With Substitute  H-2",7,0,0,0,7
645538,381596,2014-11-12,House,"House Third Reading: Given Immediate Effect Roll Call # 569",106,2,0,0,108
645538,382233,2014-12-03,Senate,"Reported Favorably Without Amendment",3,0,0,0,3
645543,363172,2014-05-07,House,"Reported With Recommendation With Substitute  H-1",12,0,0,0,12
645543,364477,2014-05-14,House,"House Third Reading: Given Immediate Effect Roll Call # 231",109,0,0,0,109
645543,371310,2014-06-12,Senate,"Reported Favorably With Substitute  S-3",7,0,0,0,7
645543,371311,2014-06-12,Senate,"Senate Third Reading: Given Immediate Effect Roll Call # 506",38,0,0,0,38
645543,371312,2014-06-12,House,"House Third Reading:  Roll Call # 441",110,0,0,0,110
645543,382942,2014-06-12,House,"House Third Reading: Roll Call # 441",110,0,0,0,110
645744,371181,2014-06-11,Senate,"Reported Favorably With Substitute  S-1",6,0,0,0,6
645744,379468,2014-09-10,Senate,"Senate Third Reading: Passed Roll Call # 539",38,0,0,0,38
645744,380244,2014-09-30,House,"Reported With Recommendation Without Amendment",15,0,0,0,15
645744,382707,2014-12-10,House,"House Third Reading: Passed Roll Call # 651",108,0,0,0,108
645744,383111,2014-12-15,Senate,"Senate Third Reading: Roll Call # 779",38,0,0,0,38
645746,369948,2014-06-04,Senate,"Reported Favorably With Substitute  S-1",4,0,0,0,4
645749,363570,2014-05-08,Senate,"Reported Favorably With Substitute  S-1",7,0,0,0,7
645749,366455,2014-05-21,Senate,"Senate Third Reading: Passed Roll Call # 308",38,0,0,0,38
645749,369957,2014-06-04,House,"Reported With Recommendation Without Amendment",14,0,0,0,14
645749,371131,2014-06-11,House,"House Third Reading: Given Immediate Effect Roll Call # 398",110,0,0,0,110
645749,371297,2014-06-12,Senate,"Senate Third Reading:  Roll Call # 477",37,0,0,1,38
645749,383017,2014-06-12,Senate,"Senate Third Reading: Roll Call # 477",37,0,0,1,38
645818,366168,2014-05-21,House,"Reported With Recommendation With Substitute  H-1",8,0,0,0,8
645818,380004,2014-09-18,House,"House Third Reading: Given Immediate Effect Roll Call # 475",96,12,0,0,108
645818,380554,2014-10-22,Senate,"Reported Favorably Without Amendment",3,0,0,0,3
645818,382600,2014-12-10,Senate,"Senate Third Reading: Given Immediate Effect Roll Call # 746",36,0,0,2,38
645829,366273,2014-05-21,House,"Reported With Recommendation With Substitute  H-1",8,0,0,0,8
645829,380006,2014-09-18,House,"House Third Reading: Given Immediate Effect Roll Call # 472",96,12,0,0,108
645829,380572,2014-10-22,Senate,"Reported Favorably Without Amendment",3,0,0,0,3
645829,382610,2014-12-10,Senate,"Senate Third Reading: Given Immediate Effect Roll Call # 743",36,0,0,2,38
645832,366226,2014-05-21,House,"Reported With Recommendation With Substitute  H-1",9,0,0,0,9
645832,379928,2014-09-17,House,"House Third Reading: Given Immediate Effect Roll Call # 467",106,2,0,0,108
645832,380553,2014-10-22,Senate,"Reported Favorably Without Amendment",3,0,0,0,3
645832,382626,2014-12-10,Senate,"Senate Third Reading: Given Immediate Effect Roll Call # 749",35,1,0,2,38
645837,366379,2014-05-21,House,"Reported With Recommendation With Substitute  H-1",8,0,0,0,8
645837,380008,2014-09-18,House,"House Third Reading: Given Immediate Effect Roll Call # 476",95,13,0,0,108
645837,380573,2014-10-22,Senate,"Reported Favorably Without Amendment",3,0,0,0,3
645837,382572,2014-12-10,Senate,"Senate Third Reading: Given Immediate Effect Roll Call # 747",36,0,0,2,38
645841,366320,2014-05-21,House,"Reported With Recommendation With Substitute  H-1",8,0,0,0,8
645841,379939,2014-09-17,House,"House Third Reading: Given Immediate Effect Roll Call # 470",104,4,0,0,108
645841,380563,2014-10-22,Senate,"Reported Favorably Without Amendment",3,0,0,0,3
645841,382586,2014-12-10,Senate,"Senate Third Reading: Given Immediate Effect Roll Call # 741",36,0,0,2,38
645849,362646,2014-05-06,House,"Reported With Recommendation With Substitute  H-4",21,0,0,0,21
645849,364081,2014-05-13,House,"House Third Reading: Given Immediate Effect Roll Call # 224",104,6,0,0,110
645849,368469,2014-05-28,Senate,"Reported Favorably With Substitute  S-1",6,0,0,0,6
645849,369875,2014-06-04,Senate,"Senate Third Reading: Given Immediate Effect Roll Call # 355",37,0,0,1,38
645849,370065,2014-06-05,House,"House Third Reading:  Roll Call # 350",104,4,0,0,108
645849,383087,2014-06-05,House,"House Third Reading: Roll Call # 350",104,4,0,0,108
645851,366373,2014-05-21,House,"Reported With Recommendation With Substitute  H-1",8,0,0,0,8
645851,379923,2014-09-17,House,"House Third Reading: Given Immediate Effect Roll Call # 465",106,2,0,0,108
645851,380555,2014-10-22,Senate,"Reported Favorably Without Amendment",3,0,0,0,3
645851,382628,2014-12-10,Senate,"Senate Third Reading: Given Immediate Effect Roll Call # 739",36,0,0,2,38
645858,364641,2014-05-14,House,"Reported With Recommendation With Substitute  H-1",9,0,0,0,9
645858,379935,2014-09-17,House,"House Third Reading: Given Immediate Effect Roll Call # 464",108,0,0,0,108
645858,380559,2014-10-22,Senate,"Reported Favorably Without Amendment",3,0,0,0,3
645858,382593,2014-12-10,Senate,"Senate Third Reading: Given Immediate Effect Roll Call # 748",36,0,0,2,38
645860,377014,2014-05-22,Senate,"Reported Favorably With Substitute  S-2",6,0,0,0,6
645867,366222,2014-05-21,House,"Reported With Recommendation With Substitute  H-1",8,0,0,0,8
645867,379925,2014-09-17,House,"House Third Reading: Given Immediate Effect Roll Call # 466",105,3,0,0,108
645867,380552,2014-10-22,Senate,"Reported Favorably Without Amendment",3,0,0,0,3
645867,382627,2014-12-10,Senate,"Senate Third Reading: Given Immediate Effect Roll Call # 740",36,0,0,2,38
645869,362730,2014-05-06,Senate,"Reported Favorably Without Amendment",7,0,0,0,7
645869,364116,2014-05-13,Senate,"Senate Third Reading: Passed Roll Call # 261",38,0,0,0,38
645869,370590,2014-06-10,House,"Reported With Recommendation Without Amendment",12,1,0,0,13
645869,371356,2014-06-12,House,"House Third Reading: Given Immediate Effect Roll Call # 419",110,0,0,0,110
645869,371357,2014-06-12,Senate,"Senate Third Reading:  Roll Call # 499",38,0,0,0,38
645869,383022,2014-06-12,Senate,"Senate Third Reading: Roll Call # 499",38,0,0,0,38
645871,364640,2014-05-14,Senate,"Reported Favorably Without Amendment",4,0,0,0,4
645871,370674,2014-06-10,Senate,"Senate Third Reading: Passed Roll Call # 403",37,0,0,1,38
645880,366237,2014-05-21,House,"Reported With Recommendation With Substitute  H-1",8,0,0,0,8
645880,379959,2014-09-18,House,"House Third Reading: Given Immediate Effect Roll Call # 471",98,10,0,0,108
645880,380566,2014-10-22,Senate,"Reported Favorably Without Amendment",3,0,0,0,3
645880,382629,2014-12-10,Senate,"Senate Third Reading: Given Immediate Effect Roll Call # 742",36,0,0,2,38
645886,366216,2014-05-21,House,"Reported With Recommendation With Substitute  H-1",8,0,0,0,8
645886,380001,2014-09-18,House,"House Third Reading: Given Immediate Effect Roll Call # 473",96,12,0,0,108
645886,380561,2014-10-22,Senate,"Reported Favorably Without Amendment",3,0,0,0,3
645886,382588,2014-12-10,Senate,"Senate Third Reading: Given Immediate Effect Roll Call # 744",36,0,0,2,38
645895,363063,2014-05-07,House,"Reported With Recommendation With Substitute  H-1",13,1,0,0,14
645895,363454,2014-05-08,House,"House Third Reading: Given Immediate Effect Roll Call # 213",85,24,0,0,109
645895,366199,2014-05-21,Senate,"Reported Favorably With Substitute S-1",7,0,0,0,7
645895,371276,2014-06-12,Senate,"Senate Third Reading: Defeated Roll Call # 524",17,20,0,1,38
645895,377026,2014-05-21,Senate,"Reported Favorably With Substitute  S-1",7,0,0,0,7
645895,381645,2014-11-13,Senate,"Senate Third Reading: Given Immediate Effect Roll Call # 662",23,14,0,1,38
645895,382374,2014-12-04,House,"House Third Reading:  Roll Call # 633",58,51,0,0,109
645895,382636,2014-12-04,House,"House Third Reading: Roll Call # 633",58,51,0,0,109
645895,382857,2014-12-11,Senate,"Senate Third Reading: Roll Call # 759",7,30,0,1,38
645895,383669,2014-12-19,House,"House Third Reading: Conference Report Adopted Roll Call # 780",93,17,0,0,110
645895,383796,2014-12-19,Senate,"Senate Third Reading: Senate Adopted Conference Report Roll Call # 921",23,15,0,0,38
645897,366361,2014-05-21,House,"Reported With Recommendation With Substitute  H-1",8,0,0,0,8
645897,380011,2014-09-18,House,"House Third Reading: Given Immediate Effect Roll Call # 474",96,12,0,0,108
645897,380558,2014-10-22,Senate,"Reported Favorably Without Amendment",3,0,0,0,3
645897,382618,2014-12-10,Senate,"Senate Third Reading: Given Immediate Effect Roll Call # 745",36,0,0,2,38
645942,364663,2014-05-14,House,"Reported With Recommendation Without Amendment",19,0,0,0,19
645942,367681,2014-05-27,House,"House Third Reading: Given Immediate Effect Roll Call # 303",109,1,0,0,110
645942,371122,2014-06-11,Senate,"Reported Favorably Without Amendment",6,0,0,0,6
645942,371291,2014-06-12,Senate,"Senate Third Reading: Given Immediate Effect Roll Call # 481",37,0,0,1,38
645979,370597,2014-06-10,Senate,"Reported Favorably With Substitute  S-1",5,2,0,0,7
645979,370958,2014-06-11,Senate,"Senate Third Reading: Passed Roll Call # 445",25,12,1,0,38
645979,382140,2014-12-02,House,"Reported With Recommendation Without Amendment",16,1,0,0,17
645979,383257,2014-12-16,House,"House Third Reading: Passed Roll Call # 678",68,41,0,0,109
646264,366272,2014-05-21,Senate,"Reported Favorably With Substitute  S-1",7,0,0,0,7
646264,369906,2014-06-04,Senate,"Senate Third Reading: Passed Roll Call # 377",36,0,0,2,38
646264,379152,2014-09-09,House,"Reported With Recommendation Without Amendment",15,0,0,0,15
646264,379988,2014-09-18,House,"House Third Reading: Passed Roll Call # 482",108,0,0,0,108
646274,363435,2014-05-08,Senate,"Reported Favorably With Substitute  S-2",3,0,0,0,3
646274,363436,2014-05-08,Senate,"Senate Third Reading: Passed Roll Call # 254",38,0,0,0,38
646274,364510,2014-05-14,House,"Reported With Recommendation Without Amendment",28,0,0,0,28
646274,367782,2014-05-27,House,"House Third Reading: Given Immediate Effect Roll Call # 320",110,0,0,0,110
646295,366364,2014-05-21,Senate,"Reported Favorably Without Amendment",7,0,0,0,7
646295,369960,2014-06-04,Senate,"Senate Third Reading: Passed Roll Call # 378",36,0,0,2,38
646295,379162,2014-09-09,House,"Reported With Recommendation Without Amendment",15,0,0,0,15
646295,380012,2014-09-18,House,"House Third Reading: Passed Roll Call # 483",108,0,0,0,108
646305,366219,2014-05-21,Senate,"Reported Favorably Without Amendment",7,0,0,0,7
646305,369890,2014-06-04,Senate,"Senate Third Reading: Passed Roll Call # 376",35,0,1,2,38
646305,379153,2014-09-09,House,"Reported With Recommendation Without Amendment",15,0,0,0,15
646305,379992,2014-09-18,House,"House Third Reading: Passed Roll Call # 480",108,0,0,0,108
646323,366243,2014-05-21,Senate,"Reported Favorably Without Amendment",7,0,0,0,7
646323,369920,2014-06-04,Senate,"Senate Third Reading: Passed Roll Call # 379",36,0,0,2,38
646323,379149,2014-09-09,House,"Reported With Recommendation With Amendment(s)",15,0,0,0,15
646323,379986,2014-09-18,House,"House Third Reading: Passed Roll Call # 484",108,0,0,0,108
646323,380116,2014-09-23,Senate,"Senate Third Reading: House Amendment(s) Concurred In Roll Call # 544",38,0,0,0,38
646339,366342,2014-05-21,House,"Reported With Recommendation Without Amendment",13,0,0,0,13
646339,370477,2014-06-10,House,"House Third Reading: Given Immediate Effect Roll Call # 381",109,0,0,0,109
646349,365997,2014-05-20,Senate,"Reported Favorably Without Amendment",4,0,0,0,4
646356,364572,2014-05-14,House,"Reported With Recommendation Without Amendment",19,0,0,0,19
646356,367549,2014-05-27,House,"House Third Reading: Given Immediate Effect Roll Call # 306",109,1,0,0,110
646356,371088,2014-06-11,Senate,"Reported Favorably Without Amendment",6,0,0,0,6
646356,371432,2014-06-12,Senate,"Senate Third Reading: Given Immediate Effect Roll Call # 483",36,0,1,1,38
646363,364573,2014-05-14,House,"Reported With Recommendation Without Amendment",19,0,0,0,19
646363,367635,2014-05-27,House,"House Third Reading: Given Immediate Effect Roll Call # 307",109,1,0,0,110
646363,370961,2014-06-11,Senate,"Reported Favorably Without Amendment",6,0,0,0,6
646363,371343,2014-06-12,Senate,"Senate Third Reading: Given Immediate Effect Roll Call # 484",38,0,0,0,38
646363,371344,2014-06-12,Senate,"Senate Third Reading: Given Immediate Effect Roll Call # 486",38,0,0,0,38
646363,371580,2014-06-12,Senate,"Senate Third Reading: Passed Roll Call # 486",38,0,0,0,38
646369,364511,2014-05-14,House,"Reported With Recommendation Without Amendment",19,0,0,0,19
646369,367763,2014-05-27,House,"House Third Reading: Given Immediate Effect Roll Call # 309",109,1,0,0,110
646369,371038,2014-06-11,Senate,"Reported Favorably Without Amendment",6,0,0,0,6
646369,371409,2014-06-12,Senate,"Senate Third Reading: Given Immediate Effect Roll Call # 487",38,0,0,0,38
646376,364594,2014-05-14,House,"Reported With Recommendation Without Amendment",19,0,0,0,19
646376,367564,2014-05-27,House,"House Third Reading: Given Immediate Effect Roll Call # 304",109,1,0,0,110
646376,371109,2014-06-11,Senate,"Reported Favorably Without Amendment",6,0,0,0,6
646376,371267,2014-06-12,Senate,"Senate Third Reading: Given Immediate Effect Roll Call # 482",37,0,0,1,38
646381,364557,2014-05-14,House,"Reported With Recommendation With Substitute H-1",19,0,0,0,19
646381,364998,2014-05-14,House,"Reported With Recommendation With Substitute  H-1",19,0,0,0,19
646381,367531,2014-05-27,House,"House Third Reading: Given Immediate Effect Roll Call # 312",110,0,0,0,110
646381,371063,2014-06-11,Senate,"Reported Favorably Without Amendment",6,0,0,0,6
646381,371338,2014-06-12,Senate,"Senate Third Reading: Given Immediate Effect Roll Call # 490",38,0,0,0,38
646395,364629,2014-05-14,House,"Reported With Recommendation With Substitute  H-1",19,0,0,0,19
646395,367691,2014-05-27,House,"House Third Reading: Given Immediate Effect Roll Call # 310",107,3,0,0,110
646395,371103,2014-06-11,Senate,"Reported Favorably Without Amendment",6,0,0,0,6
646395,371443,2014-06-12,Senate,"Senate Third Reading: Given Immediate Effect Roll Call # 488",38,0,0,0,38
646402,364583,2014-05-14,House,"Reported With Recommendation Without Amendment",19,0,0,0,19
646402,367527,2014-05-27,House,"House Third Reading: Given Immediate Effect Roll Call # 305",109,1,0,0,110
646402,371657,2014-06-12,Senate,"Reported Favorably Without Amendment",7,0,0,0,7
646411,364612,2014-05-14,House,"Reported With Recommendation Without Amendment",19,0,0,0,19
646411,367533,2014-05-27,House,"House Third Reading: Given Immediate Effect Roll Call # 302",109,1,0,0,110
646411,371066,2014-06-11,Senate,"Reported Favorably Without Amendment",6,0,0,0,6
646411,371346,2014-06-12,Senate,"Senate Third Reading: Given Immediate Effect Roll Call # 480",37,0,0,1,38
646416,364601,2014-05-14,House,"Reported With Recommendation Without Amendment",19,0,0,0,19
646416,367864,2014-05-27,House,"House Third Reading: Given Immediate Effect Roll Call # 308",109,1,0,0,110
646416,371121,2014-06-11,Senate,"Reported Favorably Without Amendment",6,0,0,0,6
646416,371290,2014-06-12,Senate,"Senate Third Reading: Given Immediate Effect Roll Call # 485",36,0,2,0,38
646424,363271,2014-05-07,House,"Reported With Recommendation Without Amendment",13,1,0,0,14
646424,363412,2014-05-08,House,"House Third Reading: Given Immediate Effect Roll Call # 214",84,25,0,0,109
646424,366432,2014-05-21,Senate,"Reported Favorably With Substitute S-1",7,0,0,0,7
646424,371139,2014-06-11,Senate,"Senate Third Reading: Defeated Roll Call # 446",18,19,1,0,38
646424,371140,2014-06-11,Senate,"Senate Third Reading: Given Immediate Effect Roll Call # 447",20,18,0,0,38
646424,383689,2014-12-19,House,"House Third Reading: Roll Call # 781",87,23,0,0,110
646424,383808,2014-12-19,Senate,"Senate Third Reading: Roll Call # 922",25,13,0,0,38
646430,364644,2014-05-14,House,"Reported With Recommendation Without Amendment",19,0,0,0,19
646430,367560,2014-05-27,House,"House Third Reading: Given Immediate Effect Roll Call # 311",109,1,0,0,110
646430,371029,2014-06-11,Senate,"Reported Favorably Without Amendment",6,0,0,0,6
646430,371406,2014-06-12,Senate,"Senate Third Reading: Given Immediate Effect Roll Call # 489",38,0,0,0,38
646436,364604,2014-05-14,House,"Reported With Recommendation Without Amendment",19,0,0,0,19
646436,367630,2014-05-27,House,"House Third Reading: Given Immediate Effect Roll Call # 313",109,1,0,0,110
646436,371180,2014-06-11,Senate,"Reported Favorably Without Amendment",6,0,0,0,6
646436,371348,2014-06-12,Senate,"Senate Third Reading: Given Immediate Effect Roll Call # 491",38,0,0,0,38
646444,364586,2014-05-14,House,"Reported With Recommendation Without Amendment",19,0,0,0,19
646444,367649,2014-05-27,House,"House Third Reading: Given Immediate Effect Roll Call # 301",109,1,0,0,110
646444,370991,2014-06-11,Senate,"Reported Favorably Without Amendment",6,0,0,0,6
646444,371388,2014-06-12,Senate,"Senate Third Reading: Given Immediate Effect Roll Call # 479",37,0,0,1,38
646450,363279,2014-05-07,House,"Reported With Recommendation With Substitute  H-2",10,0,0,0,10
646450,363416,2014-05-08,House,"House Third Reading: Given Immediate Effect Roll Call # 209",91,18,0,0,109
646450,383827,2014-12-19,Senate,"Senate Third Reading: Given Immediate Effect Roll Call # 934",24,14,0,0,38
646450,383828,2014-12-19,House,"House Third Reading: Roll Call # 808",88,22,0,0,110
646668,366163,2014-05-21,House,"Reported With Recommendation Without Amendment",13,0,0,0,13
646668,370588,2014-06-10,House,"House Third Reading: Given Immediate Effect Roll Call # 379",110,0,0,0,110
646677,366375,2014-05-21,House,"Reported With Recommendation Without Amendment",13,0,0,0,13
646677,370508,2014-06-10,House,"House Third Reading: Given Immediate Effect Roll Call # 383",109,0,0,0,109
646688,364669,2014-05-14,House,"Reported With Recommendation Without Amendment",28,0,0,0,28
646688,366261,2014-05-21,House,"House Third Reading: Given Immediate Effect Roll Call # 271",108,0,0,0,108
646715,366461,2014-05-21,House,"Reported With Recommendation Without Amendment",13,0,0,0,13
646715,370581,2014-06-10,House,"House Third Reading: Given Immediate Effect Roll Call # 382",109,0,0,0,109
646841,380252,2014-09-30,House,"Reported With Recommendation With Substitute  H-3",14,0,0,0,14
646841,381632,2014-11-13,House,"House Third Reading: Given Immediate Effect Roll Call # 593",106,0,0,0,106
646841,382576,2014-12-09,Senate,"Reported Favorably With Substitute  S-2",6,0,0,0,6
646841,383703,2014-12-18,Senate,"Senate Third Reading: Given Immediate Effect Roll Call # 874",38,0,0,0,38
646847,366240,2014-05-21,House,"Reported With Recommendation With Substitute  H-1",9,0,0,0,9
646847,379921,2014-09-17,House,"House Third Reading: Given Immediate Effect Roll Call # 468",105,3,0,0,108
646847,380564,2014-10-22,Senate,"Reported Favorably Without Amendment",3,0,0,0,3
646853,366345,2014-05-21,House,"Reported With Recommendation Without Amendment",9,0,0,0,9
646858,366221,2014-05-21,House,"Reported With Recommendation Without Amendment",9,0,0,0,9
646858,379997,2014-09-18,House,"House Third Reading: Given Immediate Effect Roll Call # 477",108,0,0,0,108
646858,380560,2014-10-22,Senate,"Reported Favorably Without Amendment",3,0,0,0,3
646858,383210,2014-12-16,Senate,"Senate Third Reading: Given Immediate Effect Roll Call # 806",37,0,0,1,38
646864,370647,2014-06-10,Senate,"Reported Favorably With Substitute  S-1",7,0,0,0,7
646864,371320,2014-06-12,Senate,"Senate Third Reading: Passed Roll Call # 505",38,0,0,0,38
646864,379829,2014-09-11,House,"Reported With Recommendation Without Amendment",7,1,0,0,8
646864,380110,2014-09-23,House,"House Third Reading: Given Immediate Effect Roll Call # 495",107,1,0,0,108
646887,363525,2014-05-08,Senate,"Reported Favorably Without Amendment",4,0,0,0,4
646887,369937,2014-06-04,Senate,"Senate Third Reading: Passed Roll Call # 353",37,0,0,1,38
646901,363533,2014-05-08,Senate,"Reported Favorably With Substitute  S-1",4,0,0,0,4
646901,369897,2014-06-04,Senate,"Senate Third Reading: Passed Roll Call # 352",37,0,0,1,38
646929,369927,2014-06-04,House,"Reported With Recommendation Without Amendment",29,0,0,0,29
646929,371102,2014-06-11,House,"House Third Reading: Given Immediate Effect Roll Call # 392",110,0,0,0,110
646929,380103,2014-09-23,Senate,"Reported Favorably With Substitute  S-1",15,0,0,0,15
646929,380137,2014-09-24,Senate,"Senate Third Reading: Given Immediate Effect Roll Call # 570",38,0,0,0,38
646929,380279,2014-10-01,House,"House Third Reading:  Roll Call # 508",109,0,0,0,109
646929,382971,2014-10-01,House,"House Third Reading: Roll Call # 508",109,0,0,0,109
646936,364720,2014-05-14,House,"Reported With Recommendation With Substitute  H-1",9,0,0,0,9
646936,379912,2014-09-17,House,"House Third Reading: Passed Roll Call # 469",94,14,0,0,108
646936,380562,2014-10-22,Senate,"Reported Favorably Without Amendment",3,0,0,0,3
646936,382568,2014-12-10,Senate,"Senate Third Reading: Given Immediate Effect Roll Call # 750",36,0,0,2,38
646941,366170,2014-05-21,House,"Reported With Recommendation With Substitute  H-2",9,0,0,0,9
647386,380111,2014-09-23,Senate,"Reported Favorably With Substitute  S-1",15,0,0,0,15
647386,380147,2014-09-24,Senate,"Senate Third Reading: Passed Roll Call # 573",38,0,0,0,38
647386,382077,2014-12-02,House,"Reported With Recommendation Without Amendment",9,0,0,0,9
647386,383680,2014-12-19,House,"House Third Reading: Given Immediate Effect Roll Call # 802",109,1,0,0,110
647436,365814,2014-05-20,House,"Reported With Recommendation Without Amendment",12,0,0,0,12
647436,368260,2014-05-28,House,"House Third Reading: Given Immediate Effect Roll Call # 331",108,0,0,0,108
647436,381529,2014-11-06,Senate,"Reported Favorably With Substitute  S-1",7,0,0,0,7
647436,383214,2014-12-16,Senate,"Senate Third Reading: Given Immediate Effect Roll Call # 800",37,0,0,1,38
647436,383464,2014-12-17,House,"House Third Reading: Roll Call # 687",109,0,0,0,109
647481,380119,2014-09-23,Senate,"Reported Favorably With Substitute  S-1",15,0,0,0,15
647481,380145,2014-09-24,Senate,"Senate Third Reading: Passed Roll Call # 572",38,0,0,0,38
647481,382111,2014-12-02,House,"Reported With Recommendation With Substitute  H-2",9,0,0,0,9
647481,383259,2014-12-16,House,"House Third Reading: Given Immediate Effect Roll Call # 681",108,0,0,0,108
647481,383809,2014-12-19,Senate,"Senate Third Reading: Roll Call # 941",38,0,0,0,38
647504,380411,2014-10-02,House,"Reported With Recommendation With Substitute  H-1",9,0,0,0,9
647655,364647,2014-05-14,Senate,"Reported Favorably With Substitute  S-1",4,0,0,0,4
647655,369932,2014-06-04,Senate,"Senate Third Reading: Passed Roll Call # 358",37,0,0,1,38
647655,381630,2014-11-13,House,"Reported With Recommendation Without Amendment",8,0,0,0,8
647655,382715,2014-12-10,House,"House Third Reading: Given Immediate Effect Roll Call # 663",98,12,0,0,110
647666,364598,2014-05-14,Senate,"Reported Favorably Without Amendment",4,0,0,0,4
647666,369959,2014-06-04,Senate,"Senate Third Reading: Passed Roll Call # 357",37,0,0,1,38
647666,381655,2014-11-13,House,"Reported With Recommendation Without Amendment",8,0,0,0,8
647666,382693,2014-12-10,House,"House Third Reading: Given Immediate Effect Roll Call # 662",96,14,0,0,110
647673,365023,2014-05-15,Senate,"Reported Favorably Without Amendment",7,0,0,0,7
647673,368238,2014-05-28,Senate,"Senate Third Reading: Passed Roll Call # 322",35,1,0,2,38
647673,381698,2014-11-13,House,"Reported With Recommendation Without Amendment",11,6,0,0,17
647673,383602,2014-12-18,House,"House Third Reading: Given Immediate Effect Roll Call # 716",78,30,0,0,108
647937,366336,2014-05-21,House,"Reported With Recommendation Without Amendment",5,0,0,0,5
647937,366607,2014-05-22,House,"House Third Reading: Given Immediate Effect Roll Call # 295",77,33,0,0,110
647937,369728,2014-06-03,Senate,"Reported Favorably Without Amendment",5,0,0,0,5
647937,369729,2014-06-03,Senate,"Senate Third Reading: Given Immediate Effect Roll Call # 338",21,17,0,0,38
647938,366212,2014-05-21,House,"Reported With Recommendation Without Amendment",5,0,0,0,5
647938,366554,2014-05-22,House,"House Third Reading: Given Immediate Effect Roll Call # 292",74,36,0,0,110
647938,369650,2014-06-03,Senate,"Reported Favorably Without Amendment",5,0,0,0,5
647938,369651,2014-06-03,Senate,"Senate Third Reading: Given Immediate Effect Roll Call # 339",21,17,0,0,38
647940,365020,2014-05-15,House,"Reported With Recommendation Without Amendment",8,0,0,0,8
647940,370113,2014-06-05,House,"House Third Reading: Given Immediate Effect Roll Call # 357",106,2,0,0,108
647940,370999,2014-06-11,Senate,"Senate Third Reading: Given Immediate Effect Roll Call # 440",38,0,0,0,38
647943,366194,2014-05-21,House,"Reported With Recommendation With Substitute  H-3",5,0,0,0,5
647943,366613,2014-05-22,House,"House Third Reading: Given Immediate Effect Roll Call # 286",103,7,0,0,110
647943,369710,2014-06-03,Senate,"Reported Favorably Without Amendment",5,0,0,0,5
647943,369711,2014-06-03,Senate,"Senate Third Reading: Given Immediate Effect Roll Call # 333",36,2,0,0,38
647945,380124,2014-09-23,House,"Reported With Recommendation With Substitute  H-1",9,0,0,0,9
647945,380346,2014-10-02,House,"House Third Reading: Given Immediate Effect Roll Call # 533",107,0,0,0,107
647945,382092,2014-12-02,Senate,"Reported Favorably With Substitute  S-1",6,0,0,0,6
647945,383772,2014-12-18,Senate,"Senate Third Reading: Given Immediate Effect Roll Call # 871",38,0,0,0,38
647945,383773,2014-12-18,House,"House Third Reading: Roll Call # 771",110,0,0,0,110
647950,369850,2014-06-04,House,"Reported With Recommendation With Substitute  H-1",9,5,0,0,14
647950,370118,2014-06-05,House,"House Third Reading: Given Immediate Effect Roll Call # 365",77,31,0,0,108
647950,380337,2014-10-02,Senate,"Reported Favorably With Substitute  S-1",7,0,0,0,7
647950,380338,2014-10-02,Senate,"Senate Third Reading: Given Immediate Effect Roll Call # 635",26,12,0,0,38
647950,380339,2014-10-02,House,"House Third Reading:  Roll Call # 560",77,30,0,0,107
647950,383014,2014-10-02,House,"House Third Reading: Roll Call # 560",77,30,0,0,107
647954,366293,2014-05-21,House,"Reported With Recommendation With Substitute  H-2",3,0,0,0,3
647954,366591,2014-05-22,House,"House Third Reading: Given Immediate Effect Roll Call # 288",85,25,0,0,110
647954,369674,2014-06-03,Senate,"Reported Favorably Without Amendment",5,0,0,0,5
647954,369675,2014-06-03,Senate,"Senate Third Reading: Given Immediate Effect Roll Call # 335",24,14,0,0,38
647956,366524,2014-05-22,House,"Reported With Recommendation Without Amendment",6,4,0,0,10
647956,370096,2014-06-05,House,"House Third Reading: Given Immediate Effect Roll Call # 347",57,49,0,0,106
647956,370942,2014-06-11,Senate,"Reported Favorably Without Amendment",5,2,0,0,7
647956,371354,2014-06-12,Senate,"Senate Third Reading: Passed Roll Call # 518",24,13,0,1,38
647964,366230,2014-05-21,House,"Reported With Recommendation With Substitute  H-3",5,0,0,0,5
647964,366513,2014-05-22,House,"House Third Reading: Given Immediate Effect Roll Call # 293",75,35,0,0,110
647964,369669,2014-06-03,Senate,"Reported Favorably Without Amendment",5,0,0,0,5
647964,369670,2014-06-03,Senate,"Senate Third Reading: Given Immediate Effect Roll Call # 340",21,17,0,0,38
647969,381667,2014-11-13,House,"Reported With Recommendation With Substitute  H-2",8,4,0,0,12
647969,382409,2014-12-04,House,"House Third Reading: Given Immediate Effect Roll Call # 610",62,47,0,0,109
647980,364916,2014-05-15,House,"Reported With Recommendation Without Amendment",8,0,0,0,8
647980,370076,2014-06-05,House,"House Third Reading: Given Immediate Effect Roll Call # 356",106,2,0,0,108
647980,370995,2014-06-11,Senate,"Senate Third Reading: Given Immediate Effect Roll Call # 439",38,0,0,0,38
647988,366396,2014-05-21,House,"Reported With Recommendation With Substitute  H-2",5,0,0,0,5
647988,366608,2014-05-22,House,"House Third Reading: Given Immediate Effect Roll Call # 287",105,5,0,0,110
647988,369717,2014-06-03,Senate,"Reported Favorably Without Amendment",5,0,0,0,5
647988,369718,2014-06-03,Senate,"Senate Third Reading: Given Immediate Effect Roll Call # 334",37,1,0,0,38
647989,366244,2014-05-21,House,"Reported With Recommendation With Substitute  H-1",5,0,0,0,5
647989,366518,2014-05-22,House,"House Third Reading: Given Immediate Effect Roll Call # 273",66,44,0,0,110
647993,366251,2014-05-21,House,"Reported With Recommendation Without Amendment",3,0,0,0,3
647993,366510,2014-05-22,House,"House Third Reading: Given Immediate Effect Roll Call # 289",100,10,0,0,110
647993,369734,2014-06-03,Senate,"Reported Favorably Without Amendment",5,0,0,0,5
647993,369735,2014-06-03,Senate,"Senate Third Reading: Given Immediate Effect Roll Call # 336",36,2,0,0,38
647996,364907,2014-05-15,Senate,"Senate Third Reading: Passed Roll Call # 277",24,14,0,0,38
647996,367537,2014-05-27,House,"Reported With Recommendation With Substitute  H-2",3,0,0,0,3
647996,367538,2014-05-27,House,"House Third Reading: Given Immediate Effect Roll Call # 329",76,34,0,0,110
647996,367539,2014-05-27,Senate,"Senate Third Reading:  Roll Call # 316",24,12,0,2,38
647996,383033,2014-05-27,Senate,"Senate Third Reading: Roll Call # 316",24,12,0,2,38
647998,366245,2014-05-21,House,"Reported With Recommendation With Substitute  H-3",5,0,0,0,5
647998,366511,2014-05-22,House,"House Third Reading: Given Immediate Effect Roll Call # 290",105,5,0,0,110
647998,369672,2014-06-03,Senate,"Reported Favorably Without Amendment",5,0,0,0,5
647998,369673,2014-06-03,Senate,"Senate Third Reading: Given Immediate Effect Roll Call # 341",37,1,0,0,38
648001,366228,2014-05-21,House,"Reported With Recommendation Without Amendment",5,0,0,0,5
648001,366583,2014-05-22,House,"House Third Reading: Given Immediate Effect Roll Call # 294",75,35,0,0,110
648433,377115,2014-08-13,Senate,"Reported Favorably With Substitute  S-1",8,0,0,0,8
648433,379382,2014-09-10,Senate,"Senate Third Reading: Passed Roll Call # 541",36,2,0,0,38
648480,366445,2014-05-21,House,"Reported With Recommendation With Substitute  H-2",5,0,0,0,5
648480,366520,2014-05-22,House,"House Third Reading: Given Immediate Effect Roll Call # 291",98,12,0,0,110
648480,369689,2014-06-03,Senate,"Reported Favorably Without Amendment",5,0,0,0,5
648480,369690,2014-06-03,Senate,"Senate Third Reading: Given Immediate Effect Roll Call # 337",37,1,0,0,38
648721,377076,2014-08-13,Senate,"Reported Favorably With Substitute  S-1",8,0,0,0,8
648721,377077,2014-08-13,Senate,"Senate Third Reading: Passed Roll Call # 531",33,0,0,5,38
648739,364569,2014-05-14,House,"House Third Reading:  Roll Call # 228",108,0,0,0,108
648739,382876,2014-05-14,House,"House Third Reading: Roll Call # 228",108,0,0,0,108
648785,366457,2014-05-21,House,"Reported With Recommendation Without Amendment",11,0,0,0,11
648812,380223,2014-09-30,House,"Reported With Recommendation With Substitute  H-1",13,1,0,0,14
648812,380404,2014-10-02,House,"House Third Reading: Given Immediate Effect Roll Call # 537",102,5,0,0,107
648812,382119,2014-12-02,Senate,"Reported Favorably With Substitute  S-1",4,0,0,0,4
648817,370564,2014-06-10,Senate,"Reported Favorably Without Amendment",5,2,0,0,7
648834,370692,2014-06-10,Senate,"Reported Favorably Without Amendment",5,2,0,0,7
648879,381608,2014-11-12,House,"Reported With Recommendation Without Amendment",9,1,0,0,10
648879,382244,2014-12-03,House,"House Third Reading: Passed Roll Call # 607",100,9,0,0,109
648879,383346,2014-12-17,Senate,"Reported Favorably With Substitute  S-1",4,0,0,0,4
648884,366337,2014-05-21,House,"Reported With Recommendation With Substitute  H-1",8,0,0,0,8
648884,380014,2014-09-18,House,"House Third Reading: Given Immediate Effect Roll Call # 478",106,2,0,0,108
648884,380550,2014-10-22,Senate,"Reported Favorably Without Amendment",3,0,0,0,3
648884,382595,2014-12-10,Senate,"Senate Third Reading: Given Immediate Effect Roll Call # 751",35,1,0,2,38
648890,381658,2014-11-13,Senate,"Reported Favorably With Substitute  S-1",4,1,0,0,5
648890,381659,2014-11-13,Senate,"Senate Third Reading: Passed Roll Call # 680",36,0,0,2,38
648890,382543,2014-12-09,House,"Reported With Recommendation Without Amendment",9,0,0,0,9
648890,383494,2014-12-18,House,"House Third Reading: Given Immediate Effect Roll Call # 726",107,2,0,0,109
648890,383724,2014-12-18,Senate,"Senate Third Reading: House Amendment(s) Concurred In Roll Call # 899",38,0,0,0,38
648917,370946,2014-06-11,Senate,"Reported Favorably With Substitute  S-1",6,0,0,0,6
648917,380322,2014-10-01,Senate,"Senate Third Reading: Passed Roll Call # 590",35,1,0,2,38
648917,382108,2014-12-02,House,"Reported With Recommendation Without Amendment",15,0,0,0,15
648917,382810,2014-12-11,House,"House Third Reading: Given Immediate Effect Roll Call # 667",106,1,0,0,107
648958,381712,2014-11-13,Senate,"Reported Favorably Without Amendment",4,1,0,0,5
648958,381713,2014-11-13,Senate,"Senate Third Reading: Passed Roll Call # 681",36,0,0,2,38
648958,382532,2014-12-09,House,"Reported With Recommendation Without Amendment",9,0,0,0,9
649716,377025,2014-05-22,Senate,"Reported Favorably Without Amendment",3,2,0,0,5
649731,367565,2014-05-27,Senate,"Reported Favorably With Substitute  S-1",5,0,0,0,5
649731,369883,2014-06-04,Senate,"Senate Third Reading: Passed Roll Call # 381",28,7,1,2,38
649731,369884,2014-06-04,Senate,"Senate Third Reading: Passed Roll Call # 383",27,9,0,2,38
649731,382078,2014-12-02,House,"Reported With Recommendation Without Amendment",10,2,0,0,12
649731,383554,2014-12-18,House,"House Third Reading: Given Immediate Effect Roll Call # 753",66,44,0,0,110
649731,383555,2014-12-18,House,"House Third Reading: Passed Roll Call # 756",65,45,0,0,110
649731,383820,2014-12-19,Senate,"Senate Third Reading: House Amendment(s) Concurred In Roll Call # 914",26,12,0,0,38
649797,366624,2014-05-22,House,"Reported With Recommendation Without Amendment",10,0,0,0,10
649797,367611,2014-05-27,House,"House Third Reading: Given Immediate Effect Roll Call # 327",110,0,0,0,110
649797,369967,2014-06-04,Senate,"Reported Favorably Without Amendment",4,0,0,0,4
649797,371313,2014-06-12,Senate,"Senate Third Reading: Given Immediate Effect Roll Call # 504",37,0,1,0,38
649820,381607,2014-11-12,House,"Reported With Recommendation Without Amendment",8,2,0,0,10
649820,382302,2014-12-03,House,"House Third Reading: Passed Roll Call # 608",103,6,0,0,109
649820,383274,2014-12-17,Senate,"Reported Favorably Without Amendment",4,0,0,0,4
649830,366530,2014-05-22,House,"Reported With Recommendation Without Amendment",10,0,0,0,10
649830,367660,2014-05-27,House,"House Third Reading: Given Immediate Effect Roll Call # 326",110,0,0,0,110
649830,369956,2014-06-04,Senate,"Reported Favorably Without Amendment",4,0,0,0,4
649830,371331,2014-06-12,Senate,"Senate Third Reading: Given Immediate Effect Roll Call # 503",38,0,0,0,38
649868,370553,2014-06-10,Senate,"Reported Favorably Without Amendment",7,0,0,0,7
649907,370598,2014-06-10,Senate,"Reported Favorably Without Amendment",7,0,0,0,7
649923,370596,2014-06-10,Senate,"Reported Favorably Without Amendment",7,0,0,0,7
649949,370519,2014-06-10,Senate,"Reported Favorably Without Amendment",7,0,0,0,7
650020,370649,2014-06-10,Senate,"Reported Favorably With Substitute  S-2",7,0,0,0,7
650020,371057,2014-06-11,Senate,"Senate Third Reading: Passed Roll Call # 448",38,0,0,0,38
650062,382090,2014-12-02,Senate,"Reported Favorably With Substitute  S-3",10,3,0,0,13
650062,382222,2014-12-03,Senate,"Senate Third Reading: Passed Roll Call # 698",24,14,0,0,38
650062,382764,2014-12-11,House,"Reported With Recommendation Without Amendment",7,4,0,0,11
650067,382105,2014-12-02,Senate,"Reported Favorably Without Amendment",10,3,0,0,13
650067,382248,2014-12-03,Senate,"Senate Third Reading: Passed Roll Call # 700",23,15,0,0,38
650067,382800,2014-12-11,House,"Reported With Recommendation Without Amendment",6,4,0,0,10
650072,382068,2014-12-02,Senate,"Reported Favorably With Substitute  S-2",10,3,0,0,13
650072,382271,2014-12-03,Senate,"Senate Third Reading: Passed Roll Call # 699",24,14,0,0,38
650072,382756,2014-12-11,House,"Reported With Recommendation Without Amendment",6,4,0,0,10
650077,382115,2014-12-02,Senate,"Reported Favorably Without Amendment",10,3,0,0,13
650077,382253,2014-12-03,Senate,"Senate Third Reading: Passed Roll Call # 701",24,14,0,0,38
650077,382820,2014-12-11,House,"Reported With Recommendation Without Amendment",6,4,0,0,10
650095,382091,2014-12-02,Senate,"Reported Favorably With Substitute  S-1",12,1,0,0,13
650095,382256,2014-12-03,Senate,"Senate Third Reading: Passed Roll Call # 702",37,1,0,0,38
650095,382750,2014-12-11,House,"Reported With Recommendation Without Amendment",6,4,0,0,10
650110,382217,2014-12-03,Senate,"Senate Third Reading: Passed Roll Call # 705",22,16,0,0,38
650110,382771,2014-12-11,House,"Reported With Recommendation Without Amendment",6,4,0,0,10
650635,369881,2014-06-04,House,"Reported With Recommendation With Substitute  H-1",5,0,0,0,5
650635,370068,2014-06-05,House,"House Third Reading: Given Immediate Effect Roll Call # 362",104,4,0,0,108
650635,371013,2014-06-11,Senate,"Senate Third Reading: Given Immediate Effect Roll Call # 441",37,1,0,0,38
650651,381628,2014-11-13,House,"Reported With Recommendation Without Amendment",11,0,0,0,11
650651,382389,2014-12-04,House,"House Third Reading: Given Immediate Effect Roll Call # 613",109,0,0,0,109
650726,369448,2014-06-02,Senate,"Reported Favorably Without Amendment",14,0,0,0,14
650726,369665,2014-06-03,Senate,"Senate Third Reading: Passed Roll Call # 347",37,1,0,0,38
650726,375866,2014-07-16,House,"Reported With Recommendation With Amendment(s)",18,0,0,0,18
650726,379150,2014-09-09,House,"House Third Reading: Given Immediate Effect Roll Call # 460",110,0,0,0,110
650726,379496,2014-09-10,Senate,"Senate Third Reading: House Amendment(s) Concurred In Roll Call # 538",37,1,0,0,38
650820,369450,2014-06-02,Senate,"Reported Favorably Without Amendment",14,0,0,0,14
650820,369668,2014-06-03,Senate,"Senate Third Reading: Passed Roll Call # 346",37,1,0,0,38
650820,375862,2014-07-16,House,"Reported With Recommendation With Amendment(s)",17,0,0,0,17
650820,379181,2014-09-09,House,"House Third Reading: Given Immediate Effect Roll Call # 457",109,1,0,0,110
650820,379389,2014-09-10,Senate,"Senate Third Reading: House Amendment(s) Concurred In Roll Call # 537",37,1,0,0,38
650880,369922,2014-06-04,House,"Reported With Recommendation With Substitute  H-1",11,0,0,0,11
650885,369963,2014-06-04,House,"Reported With Recommendation With Substitute  H-1",27,0,0,0,27
650885,371262,2014-06-12,House,"House Third Reading: Given Immediate Effect Roll Call # 427",110,0,0,0,110
650890,382070,2014-12-02,Senate,"Reported Favorably With Substitute  S-1",14,0,0,0,14
650890,382408,2014-12-04,Senate,"Senate Third Reading: Passed Roll Call # 713",37,0,0,1,38
650890,383381,2014-12-17,House,"Reported With Recommendation Without Amendment",20,0,0,0,20
650890,383450,2014-12-18,House,"House Third Reading: Given Immediate Effect Roll Call # 742",108,1,0,0,109
650894,369692,2014-06-03,House,"Reported With Recommendation Without Amendment",9,0,0,0,9
650898,369723,2014-06-03,House,"Reported With Recommendation Without Amendment",8,0,0,0,8
650898,370108,2014-06-05,House,"House Third Reading: Given Immediate Effect Roll Call # 358",104,4,0,0,108
650898,381611,2014-11-12,Senate,"Senate Third Reading: Given Immediate Effect Roll Call # 651",37,0,0,1,38
650898,382121,2014-12-02,House,"House Third Reading: Senate Amendment(s) Concurred In Roll Call # 594",106,3,0,0,109
650903,369871,2014-06-04,House,"Reported With Recommendation Without Amendment",3,0,0,0,3
650903,371351,2014-06-12,House,"House Third Reading:  Roll Call # 443",60,50,0,0,110
650903,382794,2014-06-12,House,"House Third Reading: Roll Call # 443",60,50,0,0,110
650907,369696,2014-06-03,House,"Reported With Recommendation Without Amendment",9,0,0,0,9
650919,380198,2014-09-30,Senate,"Reported Favorably Without Amendment",6,0,0,0,6
650919,380246,2014-10-01,Senate,"Senate Third Reading: Passed Roll Call # 589",36,0,0,2,38
650919,382699,2014-12-10,House,"Reported With Recommendation Without Amendment",17,0,0,0,17
650919,383438,2014-12-18,House,"House Third Reading: Given Immediate Effect Roll Call # 731",104,5,0,0,109
650929,369889,2014-06-04,House,"Reported With Recommendation Without Amendment",6,3,0,0,9
650932,369908,2014-06-04,House,"Reported With Recommendation With Substitute  H-1",11,0,0,0,11
650934,379938,2014-09-17,House,"Reported With Recommendation With Substitute  H-1",18,0,0,0,18
650934,379995,2014-09-18,House,"House Third Reading: Given Immediate Effect Roll Call # 489",106,3,0,0,109
650934,380214,2014-09-30,Senate,"Reported Favorably Without Amendment",6,0,0,0,6
650934,380363,2014-10-02,Senate,"Senate Third Reading: Given Immediate Effect Roll Call # 604",38,0,0,0,38
650934,380364,2014-10-02,House,"House Third Reading:  Roll Call # 549",106,1,0,0,107
650934,383061,2014-10-02,House,"House Third Reading: Roll Call # 549",106,1,0,0,107
651118,369868,2014-06-04,House,"Reported With Recommendation With Substitute  H-1",20,0,0,0,20
651118,370059,2014-06-05,House,"House Third Reading: Given Immediate Effect Roll Call # 363",107,1,0,0,108
651118,370949,2014-06-11,Senate,"Senate Third Reading: Given Immediate Effect Roll Call # 442",38,0,0,0,38
651458,375863,2014-07-16,Senate,"Reported Favorably With Substitute  S-2",3,0,0,0,3
651458,380165,2014-09-24,Senate,"Senate Third Reading: Passed Roll Call # 557",38,0,0,0,38
651458,382465,2014-12-04,House,"Reported With Recommendation Without Amendment",10,0,0,0,10
651458,382853,2014-12-11,House,"House Third Reading: Given Immediate Effect Roll Call # 672",100,6,0,0,106
651463,375870,2014-07-16,Senate,"Reported Favorably With Substitute  S-2",3,0,0,0,3
651463,380166,2014-09-24,Senate,"Senate Third Reading: Passed Roll Call # 559",38,0,0,0,38
651463,382474,2014-12-04,House,"Reported With Recommendation With Substitute  H-1",10,0,0,0,10
651463,382827,2014-12-11,House,"House Third Reading: Given Immediate Effect Roll Call # 674",98,8,0,0,106
651463,383225,2014-12-16,Senate,"Senate Third Reading: Roll Call # 788",37,0,0,1,38
651478,375880,2014-07-16,Senate,"Reported Favorably With Substitute  S-2",3,0,0,0,3
651478,380155,2014-09-24,Senate,"Senate Third Reading: Passed Roll Call # 558",38,0,0,0,38
651478,382469,2014-12-04,House,"Reported With Recommendation With Substitute  H-3",10,0,0,0,10
651478,382849,2014-12-11,House,"House Third Reading: Given Immediate Effect Roll Call # 673",95,11,0,0,106
651478,383207,2014-12-16,Senate,"Senate Third Reading: Roll Call # 787",37,0,0,1,38
651485,375864,2014-07-16,Senate,"Reported Favorably With Substitute  S-2",3,0,0,0,3
651485,380158,2014-09-24,Senate,"Senate Third Reading: Passed Roll Call # 556",38,0,0,0,38
651490,371119,2014-06-11,Senate,"Reported Favorably With Substitute  S-1",6,0,0,0,6
651490,379448,2014-09-10,Senate,"Senate Third Reading: Passed Roll Call # 540",37,0,1,0,38
651490,381590,2014-11-12,House,"Reported With Recommendation Without Amendment",12,0,0,0,12
651495,369972,2014-06-04,Senate,"Reported Favorably With Substitute  S-1",4,0,0,0,4
651495,377120,2014-08-13,Senate,"Senate Third Reading: Passed Roll Call # 528",33,0,0,5,38
651495,379920,2014-09-17,House,"Reported With Recommendation Without Amendment",9,1,0,0,10
651551,369949,2014-06-04,House,"Reported With Recommendation Without Amendment",9,1,0,0,10
651551,370480,2014-06-10,House,"House Third Reading: Given Immediate Effect Roll Call # 385",107,2,0,0,109
651551,380221,2014-09-30,Senate,"Senate Third Reading: Given Immediate Effect Roll Call # 576",36,2,0,0,38
651754,380418,2014-10-02,House,"Reported With Recommendation With Substitute  H-2",10,0,0,0,10
651754,381624,2014-11-13,House,"House Third Reading: Given Immediate Effect Roll Call # 585",103,4,0,0,107
651809,380129,2014-09-24,House,"Reported With Recommendation Without Amendment",12,0,0,0,12
651850,380153,2014-09-24,House,"Reported With Recommendation With Substitute  H-1",14,0,0,0,14
651850,380323,2014-10-02,House,"House Third Reading: Given Immediate Effect Roll Call # 534",104,3,0,0,107
651850,382232,2014-12-03,Senate,"Reported Favorably With Substitute  S-1",6,0,0,0,6
651850,383692,2014-12-18,Senate,"Senate Third Reading: Given Immediate Effect Roll Call # 872",38,0,0,0,38
651850,383693,2014-12-18,House,"House Third Reading: Roll Call # 772",105,5,0,0,110
652208,380288,2014-10-01,Senate,"Reported Favorably With Substitute  S-4",3,0,0,0,3
652208,381597,2014-11-12,Senate,"Senate Third Reading: Passed Roll Call # 652",37,0,0,1,38
652248,380317,2014-10-01,Senate,"Reported Favorably With Substitute  S-2",4,0,0,0,4
652248,381616,2014-11-12,Senate,"Senate Third Reading: Passed Roll Call # 653",37,0,0,1,38
652248,382782,2014-12-10,House,"Reported With Recommendation Without Amendment",27,0,0,0,27
652248,383610,2014-12-18,House,"House Third Reading: Given Immediate Effect Roll Call # 732",109,0,0,0,109
652268,380312,2014-10-01,Senate,"Reported Favorably With Substitute  S-2",3,0,0,0,3
652268,381593,2014-11-12,Senate,"Senate Third Reading: Passed Roll Call # 654",37,0,0,1,38
652268,382763,2014-12-10,House,"Reported With Recommendation Without Amendment",26,0,0,0,26
652268,383430,2014-12-18,House,"House Third Reading: Given Immediate Effect Roll Call # 733",109,0,0,0,109
652455,380138,2014-09-24,House,"Reported With Recommendation Without Amendment",12,0,0,0,12
652473,382094,2014-12-02,Senate,"Reported Favorably Without Amendment",10,3,0,0,13
652473,382259,2014-12-03,Senate,"Senate Third Reading: Passed Roll Call # 703",38,0,0,0,38
652473,382791,2014-12-11,House,"Reported With Recommendation Without Amendment",6,4,0,0,10
652479,379987,2014-09-18,Senate,"Reported Favorably Without Amendment",4,0,0,0,4
652479,380277,2014-10-01,Senate,"Senate Third Reading: Passed Roll Call # 584",36,0,0,2,38
652483,375867,2014-07-16,Senate,"Reported Favorably Without Amendment",3,0,0,0,3
652483,377113,2014-08-13,Senate,"Senate Third Reading: Passed Roll Call # 530",32,1,0,5,38
652483,381661,2014-11-13,House,"Reported With Recommendation With Amendment(s)",11,0,0,0,11
652488,379994,2014-09-18,Senate,"Reported Favorably Without Amendment",4,0,0,0,4
652488,380300,2014-10-01,Senate,"Senate Third Reading: Passed Roll Call # 585",36,0,0,2,38
652489,382072,2014-12-02,Senate,"Reported Favorably With Substitute  S-3",5,0,0,0,5
652489,382413,2014-12-04,Senate,"Senate Third Reading: Passed Roll Call # 714",36,1,0,1,38
652492,379176,2014-09-09,Senate,"Reported Favorably With Substitute  S-1",3,1,0,0,4
652492,380154,2014-09-24,Senate,"Senate Third Reading: Passed Roll Call # 561",28,10,0,0,38
652492,382466,2014-12-04,House,"Reported With Recommendation Without Amendment",7,2,0,0,9
652492,382854,2014-12-11,House,"House Third Reading: Given Immediate Effect Roll Call # 675",71,35,0,0,106
652498,382128,2014-12-02,Senate,"Reported Favorably Without Amendment",5,0,0,0,5
652498,382447,2014-12-04,Senate,"Senate Third Reading: Passed Roll Call # 717",22,15,0,1,38
652500,379993,2014-09-18,Senate,"Reported Favorably With Substitute  S-1",3,0,0,0,3
652500,380255,2014-10-01,Senate,"Senate Third Reading: Passed Roll Call # 592",36,0,0,2,38
652505,380270,2014-10-01,Senate,"Reported Favorably With Substitute  S-1",4,0,0,0,4
652506,380010,2014-09-18,Senate,"Reported Favorably With Substitute  S-1",3,0,0,0,3
652506,380298,2014-10-01,Senate,"Senate Third Reading: Passed Roll Call # 583",35,1,0,2,38
652510,380000,2014-09-18,Senate,"Reported Favorably Without Amendment",4,0,0,0,4
652510,380243,2014-10-01,Senate,"Senate Third Reading: Passed Roll Call # 586",36,0,0,2,38
652513,382066,2014-12-02,Senate,"Reported Favorably With Substitute  S-2",5,0,0,0,5
652513,382403,2014-12-04,Senate,"Senate Third Reading: Passed Roll Call # 715",36,1,0,1,38
652516,377116,2014-08-13,Senate,"Reported Favorably With Substitute  S-1",8,0,0,0,8
652516,377117,2014-08-13,Senate,"Senate Third Reading: Passed Roll Call # 532",31,2,0,5,38
652516,379892,2014-09-16,House,"Reported With Recommendation Without Amendment",17,0,0,0,17
652516,380256,2014-10-01,House,"House Third Reading: Given Immediate Effect Roll Call # 515",109,0,0,0,109
652517,382074,2014-12-02,Senate,"Reported Favorably Without Amendment",5,0,0,0,5
652517,382395,2014-12-04,Senate,"Senate Third Reading: Passed Roll Call # 716",36,1,0,1,38
652523,379890,2014-09-16,House,"Reported With Recommendation With Substitute  H-1",17,0,0,0,17
652523,380005,2014-09-18,House,"House Third Reading: Given Immediate Effect Roll Call # 490",109,0,0,0,109
652523,380209,2014-09-30,Senate,"Reported Favorably Without Amendment",6,0,0,0,6
652523,380264,2014-10-01,Senate,"Senate Third Reading: Given Immediate Effect Roll Call # 587",35,1,0,2,38
652524,380435,2014-10-02,House,"Reported With Recommendation For Referral To Committee On Families, Children, And Seniors",10,0,0,0,10
652526,371439,2014-06-12,House,"Reported With Recommendation With Substitute  H-1",10,6,0,0,16
652528,380433,2014-10-02,House,"Reported With Recommendation For Referral To Committee On Families, Children, And Seniors",10,0,0,0,10
652538,380407,2014-10-02,House,"Reported With Recommendation For Referral To Committee On Families, Children, And Seniors",10,0,0,0,10
652542,380409,2014-10-02,House,"Reported With Recommendation For Referral To Committee On Families, Children, And Seniors",10,0,0,0,10
652549,380423,2014-10-02,House,"Reported With Recommendation For Referral To Committee On Families, Children, And Seniors",10,0,0,0,10
652553,380434,2014-10-02,House,"Reported With Recommendation For Referral To Committee On Families, Children, And Seniors",10,0,0,0,10
652556,380410,2014-10-02,House,"Reported With Recommendation For Referral To Committee On Families, Children, And Seniors",10,0,0,0,10
652558,380414,2014-10-02,House,"Reported With Recommendation For Referral To Committee On Families, Children, And Seniors",10,0,0,0,10
652608,380253,2014-10-01,Senate,"Reported Favorably Without Amendment",4,0,0,0,4
652608,382414,2014-12-04,Senate,"Senate Third Reading: Passed Roll Call # 709",35,1,0,2,38
652609,379174,2014-09-09,Senate,"Reported Favorably With Substitute  S-2",4,0,0,0,4
652609,380108,2014-09-23,Senate,"Senate Third Reading: Passed Roll Call # 552",38,0,0,0,38
652609,380241,2014-10-01,House,"Reported With Recommendation Without Amendment",11,0,0,0,11
652609,380327,2014-10-02,House,"House Third Reading: Given Immediate Effect Roll Call # 529",107,0,0,0,107
652612,380254,2014-10-01,Senate,"Reported Favorably Without Amendment",4,0,0,0,4
652612,382448,2014-12-04,Senate,"Senate Third Reading: Passed Roll Call # 712",35,2,0,1,38
652621,380260,2014-10-01,Senate,"Reported Favorably Without Amendment",4,0,0,0,4
652621,382453,2014-12-04,Senate,"Senate Third Reading: Passed Roll Call # 711",37,0,0,1,38
652634,380250,2014-10-01,Senate,"Reported Favorably Without Amendment",4,0,0,0,4
652634,382433,2014-12-04,Senate,"Senate Third Reading: Passed Roll Call # 710",37,0,0,1,38
652639,380266,2014-10-01,House,"Reported With Recommendation Without Amendment",7,0,0,0,7
652641,380210,2014-09-30,Senate,"Reported Favorably Without Amendment",4,2,0,0,6
652641,382799,2014-12-11,Senate,"Senate Third Reading: Passed Roll Call # 762",27,10,0,1,38
652641,383503,2014-12-17,House,"Reported With Recommendation Without Amendment",8,5,0,0,13
652642,379148,2014-09-09,Senate,"Reported Favorably With Substitute  S-1",4,0,0,0,4
652642,380100,2014-09-23,Senate,"Senate Third Reading: Passed Roll Call # 551",38,0,0,0,38
652642,380265,2014-10-01,House,"Reported With Recommendation Without Amendment",11,0,0,0,11
652642,380348,2014-10-02,House,"House Third Reading: Given Immediate Effect Roll Call # 528",107,0,0,0,107
652684,380417,2014-10-02,House,"Reported With Recommendation With Substitute  H-1",12,0,0,0,12
652684,381729,2014-11-13,House,"House Third Reading: Given Immediate Effect Roll Call # 591",106,0,0,0,106
652684,383150,2014-12-15,Senate,"Reported Favorably Without Amendment",4,0,0,0,4
652684,383351,2014-12-17,Senate,"Senate Third Reading: Given Immediate Effect Roll Call # 852",37,0,0,1,38
652743,380227,2014-09-30,House,"Reported With Recommendation With Substitute  H-2",17,0,0,0,17
652744,379825,2014-09-11,House,"Reported With Recommendation For Referral To Committee On Local Government",10,0,0,0,10
652744,380436,2014-10-02,House,"Reported With Recommendation Without Amendment",12,0,0,0,12
652744,381641,2014-11-13,House,"House Third Reading: Given Immediate Effect Roll Call # 586",106,0,0,0,106
652745,380420,2014-10-02,House,"Reported With Recommendation Without Amendment",11,0,0,0,11
652745,381627,2014-11-13,House,"House Third Reading: Given Immediate Effect Roll Call # 592",104,2,0,0,106
652745,383124,2014-12-15,Senate,"Reported Favorably Without Amendment",4,0,0,0,4
652745,383328,2014-12-17,Senate,"Senate Third Reading: Given Immediate Effect Roll Call # 853",37,0,0,1,38
652749,382541,2014-12-09,House,"Reported With Recommendation Without Amendment",9,0,0,0,9
652749,382856,2014-12-11,House,"House Third Reading: Given Immediate Effect Roll Call # 665",99,8,0,0,107
652749,383791,2014-12-18,Senate,"Senate Third Reading: Given Immediate Effect Roll Call # 891",38,0,0,0,38
652752,380419,2014-10-02,House,"Reported With Recommendation With Substitute  H-1",11,0,0,0,11
652752,381626,2014-11-13,House,"House Third Reading: Given Immediate Effect Roll Call # 590",103,3,0,0,106
652752,383108,2014-12-15,Senate,"Reported Favorably Without Amendment",4,0,0,0,4
652752,383295,2014-12-17,Senate,"Senate Third Reading: Given Immediate Effect Roll Call # 850",35,0,2,1,38
652752,383296,2014-12-17,Senate,"Senate Third Reading: Passed Roll Call # 851",37,0,0,1,38
652759,379845,2014-09-11,House,"Reported With Recommendation For Referral To Committee On Local Government",11,0,0,0,11
652759,380408,2014-10-02,House,"Reported With Recommendation Without Amendment",12,0,0,0,12
652759,381643,2014-11-13,House,"House Third Reading: Given Immediate Effect Roll Call # 589",106,0,0,0,106
652764,379842,2014-09-11,House,"Reported With Recommendation For Referral To Committee On Local Government",10,0,0,0,10
652764,380415,2014-10-02,House,"Reported With Recommendation Without Amendment",12,0,0,0,12
652764,381640,2014-11-13,House,"House Third Reading: Given Immediate Effect Roll Call # 588",106,0,0,0,106
652765,379817,2014-09-11,House,"Reported With Recommendation For Referral To Committee On Local Government",10,0,0,0,10
652765,380425,2014-10-02,House,"Reported With Recommendation Without Amendment",12,0,0,0,12
652765,381726,2014-11-13,House,"House Third Reading: Given Immediate Effect Roll Call # 587",106,0,0,0,106
652772,379914,2014-09-17,House,"Reported With Recommendation Without Amendment",15,0,0,0,15
652772,380132,2014-09-24,House,"House Third Reading: Given Immediate Effect Roll Call # 499",109,0,0,0,109
652772,381524,2014-11-06,Senate,"Reported Favorably Without Amendment",5,0,0,0,5
652772,383708,2014-12-18,Senate,"Senate Third Reading: Given Immediate Effect Roll Call # 869",38,0,0,0,38
654478,379154,2014-09-09,Senate,"Reported Favorably With Substitute  S-1",5,2,0,0,7
654480,379155,2014-09-09,Senate,"Reported Favorably With Substitute  S-1",5,2,0,0,7
654528,380219,2014-09-30,Senate,"Reported Favorably Without Amendment",7,0,0,0,7
654530,377118,2014-08-13,Senate,"Senate Third Reading: Passed Roll Call # 534",30,2,0,6,38
654530,379922,2014-09-17,House,"Reported With Recommendation Without Amendment",12,0,0,0,12
654530,380106,2014-09-23,House,"House Third Reading: Given Immediate Effect Roll Call # 493",107,1,0,0,108
654533,380120,2014-09-23,Senate,"Reported Favorably Without Amendment",15,0,0,0,15
654533,380156,2014-09-24,Senate,"Senate Third Reading: Passed Roll Call # 571",36,2,0,0,38
654533,382768,2014-12-10,House,"Reported With Recommendation With Substitute  H-1",12,0,0,0,12
654533,383423,2014-12-18,House,"House Third Reading: Given Immediate Effect Roll Call # 728",107,2,0,0,109
654533,383777,2014-12-18,Senate,"Senate Third Reading: Roll Call # 900",36,2,0,0,38
654555,380167,2014-09-24,Senate,"Senate Third Reading: Passed Roll Call # 575",37,1,0,0,38
654555,380293,2014-10-01,House,"Reported With Recommendation Without Amendment",24,0,0,0,24
654555,380294,2014-10-01,House,"House Third Reading: Given Immediate Effect Roll Call # 522",107,2,0,0,109
654556,379848,2014-09-11,Senate,"Reported Favorably Without Amendment",4,0,0,0,4
654556,380099,2014-09-23,Senate,"Senate Third Reading: Passed Roll Call # 547",38,0,0,0,38
654556,382375,2014-12-03,House,"Reported With Recommendation With Amendment(s)",27,0,0,0,27
654556,383358,2014-12-17,Senate,"Senate Third Reading: House Amendment(s) Concurred In Roll Call # 831",37,0,0,1,38
654556,383650,2014-12-17,House,"House Third Reading: Given Immediate Effect Roll Call # 693",109,0,0,0,109
654559,379146,2014-09-09,Senate,"Reported Favorably With Substitute  S-2",4,0,0,0,4
654559,380143,2014-09-24,Senate,"Senate Third Reading: Passed Roll Call # 555",38,0,0,0,38
655274,380115,2014-09-23,House,"Reported With Recommendation With Substitute  H-1",15,0,0,0,15
655274,380334,2014-10-02,House,"House Third Reading: Passed Roll Call # 532",105,2,0,0,107
655274,382225,2014-12-03,Senate,"Reported Favorably With Substitute  S-1",7,0,0,0,7
655274,383713,2014-12-18,Senate,"Senate Third Reading: Given Immediate Effect Roll Call # 881",37,0,1,0,38
655274,383714,2014-12-19,House,"House Third Reading: Roll Call # 809",98,12,0,0,110
655276,379898,2014-09-16,House,"Reported With Recommendation Without Amendment",15,0,0,0,15
655276,381663,2014-11-13,House,"House Third Reading: Given Immediate Effect Roll Call # 576",107,0,0,0,107
655276,383223,2014-12-16,Senate,"Senate Third Reading: Given Immediate Effect Roll Call # 801",37,0,0,1,38
655276,383500,2014-12-18,House,"House Third Reading: Roll Call # 757",110,0,0,0,110
655809,381534,2014-11-06,Senate,"Reported Favorably With Substitute  S-1",4,0,0,0,4
655809,381535,2014-11-06,Senate,"Senate Third Reading: Passed Roll Call # 650",37,0,0,1,38
655809,382717,2014-12-09,House,"Reported With Recommendation Without Amendment",14,0,0,0,14
655812,380251,2014-10-01,House,"Reported With Recommendation Without Amendment",5,0,0,0,5
655814,379830,2014-09-11,Senate,"Reported Favorably With Substitute  S-1",4,0,0,0,4
655814,380107,2014-09-23,Senate,"Senate Third Reading: Passed Roll Call # 553",38,0,0,0,38
655814,380276,2014-10-01,House,"Reported With Recommendation Without Amendment",11,0,0,0,11
655814,380366,2014-10-02,House,"House Third Reading: Given Immediate Effect Roll Call # 543",107,0,0,0,107
655819,382785,2014-12-11,Senate,"Senate Third Reading: Defeated Roll Call # 756",10,27,0,1,38
655988,380130,2014-09-24,House,"Reported With Recommendation With Substitute  H-2",17,8,0,0,25
656109,380208,2014-09-30,Senate,"Reported Favorably Without Amendment",4,2,0,0,6
656109,381537,2014-11-06,Senate,"Senate Third Reading: Passed Roll Call # 646",26,11,0,1,38
656109,383265,2014-12-16,House,"Reported With Recommendation With Substitute  H-4",10,5,0,0,15
656109,383426,2014-12-18,House,"House Third Reading: Passed Roll Call # 751",60,50,0,0,110
656109,383783,2014-12-18,Senate,"Senate Third Reading: Roll Call # 903",26,12,0,0,38
656111,379985,2014-09-18,Senate,"Reported Favorably With Substitute  S-1",4,0,0,0,4
656111,380114,2014-09-23,Senate,"Senate Third Reading: Passed Roll Call # 554",38,0,0,0,38
656111,380271,2014-10-01,House,"Reported With Recommendation Without Amendment",11,0,0,0,11
656111,380356,2014-10-02,House,"House Third Reading: Given Immediate Effect Roll Call # 544",107,0,0,0,107
656112,380071,2014-09-18,House,"Reported With Recommendation Without Amendment",24,0,0,0,24
656112,380405,2014-09-30,Senate,"Reported Favorably Without Amendment",6,0,0,0,6
656138,379936,2014-09-17,House,"Reported With Recommendation Without Amendment",9,0,0,0,9
656138,380267,2014-10-01,House,"House Third Reading: Given Immediate Effect Roll Call # 517",109,0,0,0,109
656138,381647,2014-11-13,Senate,"Reported Favorably Without Amendment",3,0,0,0,3
656138,383361,2014-12-17,Senate,"Senate Third Reading: Given Immediate Effect Roll Call # 840",37,0,0,1,38
656140,379937,2014-09-17,House,"Reported With Recommendation Without Amendment",9,0,0,0,9
656140,380286,2014-10-01,House,"House Third Reading: Given Immediate Effect Roll Call # 520",109,0,0,0,109
656140,381657,2014-11-13,Senate,"Reported Favorably Without Amendment",3,0,0,0,3
656140,383337,2014-12-17,Senate,"Senate Third Reading: Given Immediate Effect Roll Call # 842",37,0,0,1,38
656144,379826,2014-09-11,House,"Reported With Recommendation With Substitute  H-1",6,3,0,0,9
656144,379984,2014-09-18,House,"House Third Reading: Given Immediate Effect Roll Call # 487",95,14,0,0,109
656144,380205,2014-09-30,Senate,"Reported Favorably With Substitute  S-2",4,0,0,0,4
656144,380375,2014-10-02,Senate,"Senate Third Reading: Given Immediate Effect Roll Call # 602",37,0,0,1,38
656144,380376,2014-10-02,House,"House Third Reading:  Roll Call # 551",95,12,0,0,107
656144,382860,2014-10-02,House,"House Third Reading: Roll Call # 551",95,12,0,0,107
656148,379940,2014-09-17,House,"Reported With Recommendation Without Amendment",9,0,0,0,9
656148,380280,2014-10-01,House,"House Third Reading: Given Immediate Effect Roll Call # 518",109,0,0,0,109
656148,381719,2014-11-13,Senate,"Reported Favorably Without Amendment",3,0,0,0,3
656148,383270,2014-12-17,Senate,"Senate Third Reading: Given Immediate Effect Roll Call # 841",37,0,0,1,38
656148,383485,2014-12-18,House,"House Third Reading: Roll Call # 765",110,0,0,0,110
656152,379894,2014-09-16,House,"Reported With Recommendation Without Amendment",8,0,0,0,8
656152,380140,2014-09-24,House,"House Third Reading: Given Immediate Effect Roll Call # 496",108,0,0,0,108
656152,382802,2014-12-11,Senate,"Senate Third Reading: Given Immediate Effect Roll Call # 764",37,0,0,1,38
656157,380432,2014-10-02,House,"Reported With Recommendation Without Amendment",7,0,0,0,7
656157,381604,2014-11-12,House,"House Third Reading: Given Immediate Effect Roll Call # 571",102,6,0,0,108
656157,382227,2014-12-03,Senate,"Reported Favorably Without Amendment",3,0,0,0,3
656158,379971,2014-09-18,House,"Reported With Recommendation With Substitute  H-2",22,2,0,0,24
656158,379998,2014-09-18,House,"House Third Reading: Given Immediate Effect Roll Call # 492",88,21,0,0,109
656158,382106,2014-12-02,Senate,"Reported Favorably Without Amendment",12,0,0,0,12
656158,383104,2014-12-15,Senate,"Senate Third Reading: Given Immediate Effect Roll Call # 786",38,0,0,0,38
656161,380427,2014-10-02,House,"Reported With Recommendation Without Amendment",7,0,0,0,7
656161,381605,2014-11-12,House,"House Third Reading: Given Immediate Effect Roll Call # 572",101,7,0,0,108
656161,382228,2014-12-03,Senate,"Reported Favorably Without Amendment",3,0,0,0,3
656167,379941,2014-09-17,House,"Reported With Recommendation Without Amendment",9,0,0,0,9
656167,380302,2014-10-01,House,"House Third Reading: Given Immediate Effect Roll Call # 519",109,0,0,0,109
656167,381697,2014-11-13,Senate,"Reported Favorably Without Amendment",3,0,0,0,3
656167,383355,2014-12-17,Senate,"Senate Third Reading: Given Immediate Effect Roll Call # 843",37,0,0,1,38
656168,380160,2014-09-24,House,"Reported With Recommendation Without Amendment",12,0,0,0,12
656168,381530,2014-11-06,House,"House Third Reading: Given Immediate Effect Roll Call # 564",106,0,0,0,106
656168,382561,2014-12-09,Senate,"Reported Favorably Without Amendment",6,0,0,0,6
656171,380422,2014-10-02,House,"Reported With Recommendation Without Amendment",7,0,0,0,7
656171,381598,2014-11-12,House,"House Third Reading: Given Immediate Effect Roll Call # 570",106,2,0,0,108
656171,382234,2014-12-03,Senate,"Reported Favorably Without Amendment",3,0,0,0,3
656206,380226,2014-09-30,Senate,"Reported Favorably With Substitute  S-1",5,1,0,0,6
656206,381654,2014-11-13,Senate,"Senate Third Reading: Passed Roll Call # 663",30,7,0,1,38
656209,380211,2014-09-30,Senate,"Reported Favorably With Substitute  S-1",5,1,0,0,6
656209,381718,2014-11-13,Senate,"Senate Third Reading: Passed Roll Call # 664",31,5,1,1,38
656212,381648,2014-11-13,Senate,"Senate Third Reading: Passed Roll Call # 682",36,0,0,2,38
656212,382461,2014-12-04,House,"Reported With Recommendation Without Amendment",12,0,0,0,12
656212,383664,2014-12-17,House,"House Third Reading: Given Immediate Effect Roll Call # 703",108,0,0,0,108
656218,380201,2014-09-30,Senate,"Reported Favorably With Substitute  S-1",5,1,0,0,6
656218,381685,2014-11-13,Senate,"Senate Third Reading: Passed Roll Call # 665",30,7,0,1,38
656223,380487,2014-10-01,House,"Reported With Recommendation Without Amendment",9,0,0,0,9
656226,380142,2014-09-24,House,"Reported With Recommendation With Substitute  H-1",10,0,0,0,10
656226,380325,2014-10-02,House,"House Third Reading: Passed Roll Call # 535",107,0,0,0,107
656226,383379,2014-12-17,Senate,"Reported Favorably With Substitute  S-1",7,0,0,0,7
656226,383782,2014-12-18,Senate,"Senate Third Reading: Given Immediate Effect Roll Call # 889",38,0,0,0,38
656229,380161,2014-09-24,House,"Reported With Recommendation Without Amendment",11,0,0,0,11
656229,381527,2014-11-06,House,"House Third Reading: Given Immediate Effect Roll Call # 566",106,0,0,0,106
656229,382838,2014-12-11,Senate,"Reported Favorably Without Amendment",5,0,0,0,5
656229,383221,2014-12-16,Senate,"Senate Third Reading: Given Immediate Effect Roll Call # 817",37,0,0,1,38
656230,379915,2014-09-17,House,"Reported With Recommendation With Substitute  H-1",15,0,0,0,15
656230,380009,2014-09-18,House,"House Third Reading: Given Immediate Effect Roll Call # 488",109,0,0,0,109
656230,380134,2014-09-24,Senate,"Senate Third Reading: Given Immediate Effect Roll Call # 574",37,1,0,0,38
656235,380162,2014-09-24,House,"Reported With Recommendation Without Amendment",11,0,0,0,11
656235,381513,2014-11-06,House,"House Third Reading: Given Immediate Effect Roll Call # 565",106,0,0,0,106
656235,382839,2014-12-11,Senate,"Reported Favorably With Substitute  S-1",5,0,0,0,5
656235,383244,2014-12-16,Senate,"Senate Third Reading: Given Immediate Effect Roll Call # 816",37,0,0,1,38
656235,383660,2014-12-17,House,"House Third Reading: Roll Call # 690",109,0,0,0,109
656280,380224,2014-09-30,Senate,"Reported Favorably Without Amendment",5,1,0,0,6
656280,381526,2014-11-06,Senate,"Senate Third Reading: Passed Roll Call # 642",24,13,0,1,38
656280,382692,2014-12-09,House,"Reported With Recommendation With Substitute  H-1",14,1,0,0,15
656280,383416,2014-12-18,House,"House Third Reading: Given Immediate Effect Roll Call # 727",68,41,0,0,109
656280,383781,2014-12-18,Senate,"Senate Third Reading: Roll Call # 901",24,14,0,0,38
656281,380329,2014-10-02,Senate,"Reported Favorably Without Amendment",4,0,0,0,4
656281,382206,2014-11-13,Senate,"Senate Third Reading: Passed Roll Call # 666",37,0,0,1,38
656281,382370,2014-12-03,House,"Reported With Recommendation Without Amendment",23,2,0,0,25
656281,382834,2014-12-11,House,"House Third Reading: Given Immediate Effect Roll Call # 670",104,2,0,0,106
656284,381523,2014-11-06,Senate,"Reported Favorably With Substitute  S-1",6,0,0,0,6
656285,380303,2014-10-01,Senate,"Reported Favorably With Substitute  S-1",4,0,0,0,4
656285,380304,2014-10-01,Senate,"Senate Third Reading: Passed Roll Call # 595",36,0,0,2,38
656285,382784,2014-12-11,House,"Reported With Recommendation Without Amendment",11,0,0,0,11
656285,383451,2014-12-18,House,"House Third Reading: Given Immediate Effect Roll Call # 739",105,4,0,0,109
656286,380104,2014-09-23,Senate,"Reported Favorably With Substitute  S-1",7,0,0,0,7
656544,380199,2014-09-30,Senate,"Reported Favorably Without Amendment",6,0,0,0,6
656544,380200,2014-09-30,Senate,"Senate Third Reading: Passed Roll Call # 578",37,1,0,0,38
656544,382679,2014-12-10,House,"Reported With Recommendation Without Amendment",18,0,0,0,18
656544,383617,2014-12-18,House,"House Third Reading: Given Immediate Effect Roll Call # 754",108,2,0,0,110
656577,382437,2014-12-04,Senate,"Reported Favorably With Substitute  S-3",6,0,0,0,6
656577,382438,2014-12-04,Senate,"Senate Third Reading: Passed Roll Call # 720",37,0,0,1,38
656585,382407,2014-12-04,Senate,"Senate Third Reading: Defeated Roll Call # 722",11,26,1,0,38
656587,380215,2014-09-30,Senate,"Reported Favorably Without Amendment",15,0,0,0,15
656587,382599,2014-12-10,Senate,"Senate Third Reading: Passed Roll Call # 754",35,0,1,2,38
656631,380424,2014-10-02,House,"Reported With Recommendation Without Amendment",12,0,0,0,12
656631,381599,2014-11-12,House,"House Third Reading: Given Immediate Effect Roll Call # 568",108,0,0,0,108
656631,383102,2014-12-15,Senate,"Reported Favorably Without Amendment",3,0,0,0,3
656631,383795,2014-12-18,Senate,"Senate Third Reading: Given Immediate Effect Roll Call # 882",38,0,0,0,38
656638,379924,2014-09-17,House,"Reported With Recommendation With Substitute  H-1",13,0,0,0,13
656638,380141,2014-09-24,House,"House Third Reading: Given Immediate Effect Roll Call # 498",103,6,0,0,109
656638,380395,2014-10-02,Senate,"Reported Favorably Without Amendment",7,0,0,0,7
656638,380396,2014-10-02,Senate,"Senate Third Reading: Given Immediate Effect Roll Call # 606",37,1,0,0,38
656639,380228,2014-09-30,House,"Reported With Recommendation With Substitute  H-1",17,0,0,0,17
656639,381702,2014-11-13,House,"House Third Reading: Passed Roll Call # 580",106,1,0,0,107
656639,382598,2014-12-10,Senate,"Reported Favorably Without Amendment",9,0,0,0,9
656639,383327,2014-12-17,Senate,"Senate Third Reading: Given Immediate Effect Roll Call # 848",37,0,0,1,38
656718,382814,2014-12-11,Senate,"Senate Third Reading: Defeated Roll Call # 757",8,29,0,1,38
656724,382095,2014-12-02,Senate,"Reported Favorably With Substitute  S-1",10,3,0,0,13
656724,382535,2014-12-09,Senate,"Senate Third Reading: Passed Roll Call # 735",26,11,0,1,38
656733,380146,2014-09-24,House,"Reported With Recommendation With Substitute  H-1",15,0,0,0,15
656733,380332,2014-10-02,House,"House Third Reading: Passed Roll Call # 536",107,0,0,0,107
656733,383704,2014-12-18,Senate,"Reported Favorably With Substitute  S-2",7,0,0,0,7
656733,383705,2014-12-18,Senate,"Senate Third Reading: Given Immediate Effect Roll Call # 890",38,0,0,0,38
656743,382479,2014-12-04,House,"Reported With Recommendation With Substitute  H-1",12,0,0,0,12
656743,382739,2014-12-10,House,"House Third Reading: Given Immediate Effect Roll Call # 659",110,0,0,0,110
657010,380259,2014-10-01,House,"Reported With Recommendation With Substitute  H-1",9,0,0,0,9
657010,381720,2014-11-13,House,"House Third Reading: Given Immediate Effect Roll Call # 584",107,0,0,0,107
657021,381583,2014-11-06,Senate,"Reported Favorably Without Amendment",5,3,0,0,8
657032,382368,2014-12-03,House,"Reported With Recommendation With Substitute  H-1",13,0,0,0,13
657032,382713,2014-12-10,House,"House Third Reading: Given Immediate Effect Roll Call # 655",109,0,0,0,109
657534,380282,2014-10-01,Senate,"Reported Favorably With Substitute  S-1",3,0,0,0,3
657534,381615,2014-11-12,Senate,"Senate Third Reading: Passed Roll Call # 655",37,0,0,1,38
657534,382781,2014-12-10,House,"Reported With Recommendation Without Amendment",26,0,0,0,26
657534,383534,2014-12-18,House,"House Third Reading: Given Immediate Effect Roll Call # 734",105,4,0,0,109
657541,380222,2014-09-30,Senate,"Reported Favorably Without Amendment",4,0,0,0,4
657541,381514,2014-11-06,Senate,"Senate Third Reading: Passed Roll Call # 647",37,0,0,1,38
657541,382478,2014-12-04,House,"Reported With Recommendation With Substitute  H-1",8,4,0,0,12
657541,383434,2014-12-18,House,"House Third Reading: Given Immediate Effect Roll Call # 740",99,10,0,0,109
657541,383750,2014-12-18,Senate,"Senate Third Reading: Roll Call # 902",37,0,1,0,38
657543,381522,2014-11-06,Senate,"Reported Favorably With Substitute  S-1",13,0,0,0,13
657543,381701,2014-11-13,Senate,"Senate Third Reading: Passed Roll Call # 668",35,0,1,2,38
657543,382714,2014-12-10,House,"Reported With Recommendation Without Amendment",26,0,0,0,26
657543,383601,2014-12-18,House,"House Third Reading: Given Immediate Effect Roll Call # 736",103,6,0,0,109
657548,380567,2014-10-22,Senate,"Reported Favorably Without Amendment",7,0,0,0,7
657548,381602,2014-11-12,Senate,"Senate Third Reading: Passed Roll Call # 656",36,0,1,1,38
657548,382406,2014-12-03,House,"Reported With Recommendation Without Amendment",10,0,0,0,10
657548,383239,2014-12-16,House,"House Third Reading: Given Immediate Effect Roll Call # 682",107,1,0,0,108
657554,380229,2014-09-30,House,"Reported With Recommendation Without Amendment",18,0,0,0,18
657554,380353,2014-10-02,House,"House Third Reading: Given Immediate Effect Roll Call # 542",107,0,0,0,107
657554,382103,2014-12-02,Senate,"Reported Favorably With Substitute  S-2",8,0,0,0,8
657554,383774,2014-12-18,Senate,"Senate Third Reading: Given Immediate Effect Roll Call # 867",38,0,0,0,38
657554,383775,2014-12-18,House,"House Third Reading: Roll Call # 776",100,10,0,0,110
657556,380230,2014-09-30,House,"Reported With Recommendation Without Amendment",18,0,0,0,18
657556,380355,2014-10-02,House,"House Third Reading: Given Immediate Effect Roll Call # 541",107,0,0,0,107
657556,382069,2014-12-02,Senate,"Reported Favorably Without Amendment",8,0,0,0,8
657556,383227,2014-12-16,Senate,"Senate Third Reading: Given Immediate Effect Roll Call # 810",37,0,0,1,38
657557,380232,2014-09-30,House,"Reported With Recommendation Without Amendment",17,0,0,0,17
657557,380362,2014-10-02,House,"House Third Reading: Given Immediate Effect Roll Call # 538",107,0,0,0,107
657557,382084,2014-12-02,Senate,"Reported Favorably Without Amendment",8,0,0,0,8
657557,383213,2014-12-16,Senate,"Senate Third Reading: Given Immediate Effect Roll Call # 808",37,0,0,1,38
657569,380231,2014-09-30,House,"Reported With Recommendation Without Amendment",18,0,0,0,18
657569,380359,2014-10-02,House,"House Third Reading: Given Immediate Effect Roll Call # 539",107,0,0,0,107
657569,382067,2014-12-02,Senate,"Reported Favorably Without Amendment",8,0,0,0,8
657569,383234,2014-12-16,Senate,"Senate Third Reading: Given Immediate Effect Roll Call # 809",37,0,0,1,38
657571,382351,2014-12-03,House,"Reported With Recommendation With Substitute  H-2",10,5,0,0,15
657587,382573,2014-12-10,Senate,"Reported Favorably With Substitute  S-1",9,0,0,0,9
657593,380263,2014-10-01,Senate,"Reported Favorably Without Amendment",7,0,0,0,7
657593,380568,2014-10-22,Senate,"Senate Third Reading: Passed Roll Call # 641",36,0,0,2,38
657593,381601,2014-11-12,House,"Reported With Recommendation Without Amendment",12,0,0,0,12
657593,382682,2014-12-09,House,"House Third Reading: Given Immediate Effect Roll Call # 641",109,0,0,0,109
657661,382553,2014-12-09,Senate,"Reported Favorably With Substitute  S-1",4,0,0,0,4
657661,382613,2014-12-10,Senate,"Senate Third Reading: Passed Roll Call # 753",36,0,0,2,38
657669,381515,2014-11-06,Senate,"Reported Favorably With Substitute  S-1",4,0,0,0,4
657669,381665,2014-11-13,Senate,"Senate Third Reading: Passed Roll Call # 676",36,0,0,2,38
657669,382819,2014-12-11,House,"Reported With Recommendation Without Amendment",12,3,0,0,15
657669,383573,2014-12-18,House,"House Third Reading: Given Immediate Effect Roll Call # 741",81,28,0,0,109
657670,380291,2014-10-01,Senate,"Reported Favorably Without Amendment",7,0,0,0,7
657670,381512,2014-11-06,Senate,"Senate Third Reading: Passed Roll Call # 649",37,0,0,1,38
657670,382698,2014-12-09,House,"Reported With Recommendation Without Amendment",15,0,0,0,15
657670,383600,2014-12-17,House,"House Third Reading: Passed Roll Call # 683",108,0,0,0,108
657674,382442,2014-12-04,Senate,"Reported Favorably With Substitute  S-1",4,0,0,0,4
657704,382096,2014-12-02,House,"Reported With Recommendation With Substitute  H-1",12,0,0,0,12
657704,382690,2014-12-09,House,"House Third Reading: Given Immediate Effect Roll Call # 642",109,0,0,0,109
657704,383119,2014-12-15,Senate,"Reported Favorably Without Amendment",5,0,0,0,5
657704,383278,2014-12-17,Senate,"Senate Third Reading: Given Immediate Effect Roll Call # 822",37,0,0,1,38
657706,382464,2014-12-04,House,"Reported With Recommendation Without Amendment",10,0,0,0,10
657706,382659,2014-12-10,House,"House Third Reading: Given Immediate Effect Roll Call # 660",97,13,0,0,110
657706,383318,2014-12-17,Senate,"Reported Favorably With Substitute  S-1",4,0,0,0,4
657706,383319,2014-12-17,Senate,"Senate Third Reading: Given Immediate Effect Roll Call # 836",36,0,1,1,38
657706,383613,2014-12-18,House,"House Third Reading: Roll Call # 712",94,14,0,0,108
657708,381694,2014-11-13,House,"Reported With Recommendation Without Amendment",12,0,0,0,12
657708,382391,2014-12-04,House,"House Third Reading: Given Immediate Effect Roll Call # 612",109,0,0,0,109
657708,383755,2014-12-18,Senate,"Senate Third Reading: Given Immediate Effect Roll Call # 892",38,0,0,0,38
657719,380569,2014-10-22,Senate,"Reported Favorably With Substitute  S-1",4,0,0,0,4
657719,380570,2014-10-22,Senate,"Senate Third Reading: Passed Roll Call # 638",32,4,1,1,38
657719,381651,2014-11-13,House,"Reported With Recommendation With Substitute  H-1",10,7,0,0,17
657719,382434,2014-12-04,House,"House Third Reading: Given Immediate Effect Roll Call # 637",73,37,0,0,110
657719,382548,2014-12-09,Senate,"Senate Third Reading:  Roll Call # 725",33,4,0,1,38
657719,382709,2014-12-09,Senate,"Senate Third Reading: Roll Call # 725",33,4,0,1,38
657721,381691,2014-11-13,Senate,"Reported Favorably With Substitute  S-1",4,1,0,0,5
657721,381692,2014-11-13,Senate,"Senate Third Reading: Passed Roll Call # 678",31,5,0,2,38
657771,381679,2014-11-13,Senate,"Reported Favorably Without Amendment",4,1,0,0,5
657771,381680,2014-11-13,Senate,"Senate Third Reading: Passed Roll Call # 677",36,0,0,2,38
657771,383684,2014-12-19,House,"House Third Reading: Given Immediate Effect Roll Call # 803",70,40,0,0,110
658174,381717,2014-11-13,Senate,"Senate Third Reading: Passed Roll Call # 683",36,0,0,2,38
658174,382468,2014-12-04,House,"Reported With Recommendation With Substitute  H-1",12,0,0,0,12
658174,383387,2014-12-17,Senate,"Senate Third Reading: Roll Call # 860",37,0,0,1,38
658174,383466,2014-12-17,House,"House Third Reading: Given Immediate Effect Roll Call # 694",108,0,0,0,108
658187,381716,2014-11-13,Senate,"Reported Favorably Without Amendment",4,0,0,0,4
658187,382277,2014-12-03,Senate,"Senate Third Reading: Passed Roll Call # 695",37,1,0,0,38
658189,381707,2014-11-13,Senate,"Reported Favorably Without Amendment",4,0,0,0,4
658189,382274,2014-12-03,Senate,"Senate Third Reading: Passed Roll Call # 694",37,1,0,0,38
658192,381724,2014-11-13,Senate,"Reported Favorably Without Amendment",4,0,0,0,4
658192,382265,2014-12-03,Senate,"Senate Third Reading: Passed Roll Call # 696",28,10,0,0,38
659142,381723,2014-11-13,Senate,"Reported Favorably With Substitute  S-1",3,0,0,0,3
659142,382276,2014-12-03,Senate,"Senate Third Reading: Passed Roll Call # 693",37,0,1,0,38
659143,381631,2014-11-13,Senate,"Reported Favorably Without Amendment",3,0,0,0,3
659143,382416,2014-12-04,Senate,"Senate Third Reading: Passed Roll Call # 719",36,1,0,1,38
659145,381639,2014-11-13,Senate,"Reported Favorably Without Amendment",3,0,0,0,3
659145,382257,2014-12-03,Senate,"Senate Third Reading: Passed Roll Call # 697",38,0,0,0,38
659148,381660,2014-11-13,Senate,"Reported Favorably Without Amendment",3,0,0,0,3
659148,382430,2014-12-04,Senate,"Senate Third Reading: Passed Roll Call # 718",37,0,0,1,38
659151,381635,2014-11-13,Senate,"Reported Favorably Without Amendment",4,1,0,0,5
659151,381636,2014-11-13,Senate,"Senate Third Reading: Passed Roll Call # 679",35,0,1,2,38
659158,381612,2014-11-12,House,"Reported With Recommendation Without Amendment",29,0,0,0,29
659158,382396,2014-12-04,House,"House Third Reading: Given Immediate Effect Roll Call # 626",105,4,0,0,109
659158,383717,2014-12-18,Senate,"Senate Third Reading: Given Immediate Effect Roll Call # 907",38,0,0,0,38
659158,383718,2014-12-19,House,"House Third Reading: Roll Call # 797",106,4,0,0,110
659162,381613,2014-11-12,House,"Reported With Recommendation Without Amendment",27,1,0,0,28
659162,382420,2014-12-04,House,"House Third Reading: Given Immediate Effect Roll Call # 627",105,4,0,0,109
659162,383779,2014-12-18,Senate,"Senate Third Reading: Given Immediate Effect Roll Call # 908",37,1,0,0,38
659162,383780,2014-12-19,House,"House Third Reading: Senate Amendment(s) Concurred In Roll Call # 798",106,4,0,0,110
659171,382467,2014-12-04,House,"Reported With Recommendation Without Amendment",9,0,0,0,9
659173,382540,2014-12-09,House,"Reported With Recommendation With Substitute  H-2",14,0,0,0,14
659173,382731,2014-12-09,House,"House Third Reading: Passed Roll Call # 645",102,7,0,0,109
659173,383290,2014-12-17,Senate,"Reported Favorably Without Amendment",4,0,0,0,4
659173,383291,2014-12-17,Senate,"Senate Third Reading: Given Immediate Effect Roll Call # 835",37,0,0,1,38
659186,381617,2014-11-12,House,"Reported With Recommendation Without Amendment",13,1,0,0,14
659186,382435,2014-12-04,House,"House Third Reading: Passed Roll Call # 611",99,10,0,0,109
659190,381589,2014-11-12,House,"Reported With Recommendation Without Amendment",20,1,0,0,21
659190,382385,2014-12-04,House,"House Third Reading: Given Immediate Effect Roll Call # 628",96,13,0,0,109
659190,383716,2014-12-18,Senate,"Senate Third Reading: Defeated Roll Call # 909",11,27,0,0,38
659191,381592,2014-11-12,House,"Reported With Recommendation Without Amendment",21,3,0,0,24
659191,382380,2014-12-04,House,"House Third Reading: Given Immediate Effect Roll Call # 629",91,18,0,0,109
659191,383723,2014-12-18,Senate,"Senate Third Reading: Defeated Roll Call # 910",12,26,0,0,38
659968,382584,2014-12-10,Senate,"Reported Favorably With Substitute  S-3",3,0,0,0,3
659970,382812,2014-12-11,Senate,"Reported Favorably With Substitute  S-1",3,0,0,0,3
659970,382813,2014-12-11,Senate,"Senate Third Reading: Passed Roll Call # 766",37,0,0,1,38
659970,383419,2014-12-17,House,"Reported With Recommendation Without Amendment",16,0,0,0,16
659970,383420,2014-12-18,House,"House Third Reading: Passed Roll Call # 744",104,5,0,0,109
659978,382828,2014-12-11,Senate,"Reported Favorably With Substitute  S-1",3,0,0,0,3
659985,382230,2014-12-03,Senate,"Reported Favorably Without Amendment",5,0,0,0,5
659985,382759,2014-12-11,Senate,"Senate Third Reading: Passed Roll Call # 774",23,14,0,1,38
659985,383501,2014-12-18,House,"House Third Reading: Given Immediate Effect Roll Call # 749",101,8,0,0,109
659985,383502,2014-12-17,House,"Reported With Recommendation With Substitute  H-1",14,0,0,0,14
659985,383787,2014-12-18,Senate,"Senate Third Reading: Roll Call # 906",20,17,1,0,38
659985,383788,2014-12-19,House,"House Third Reading: Roll Call # 799",100,10,0,0,110
660049,382347,2014-12-03,House,"Reported With Recommendation Without Amendment",28,0,0,0,28
660049,382658,2014-12-09,House,"House Third Reading: Given Immediate Effect Roll Call # 643",109,0,0,0,109
660049,383760,2014-12-18,Senate,"Senate Third Reading: Given Immediate Effect Roll Call # 884",37,1,0,0,38
660064,382087,2014-12-02,House,"Reported With Recommendation With Substitute  H-1",10,4,0,0,14
660071,382376,2014-12-04,House,"Reported With Recommendation With Substitute  H-3",13,2,0,0,15
660167,382462,2014-12-04,House,"Reported With Recommendation Without Amendment",5,0,0,0,5
660167,382655,2014-12-10,House,"House Third Reading: Given Immediate Effect Roll Call # 658",108,2,0,0,110
660171,382241,2014-12-03,Senate,"Senate Third Reading: Passed Roll Call # 692",25,13,0,0,38
660172,382085,2014-12-02,Senate,"Senate Third Reading: Defeated Roll Call # 686",15,22,0,1,38
660182,382231,2014-12-03,Senate,"Senate Third Reading: Given Immediate Effect Roll Call # 691",38,0,0,0,38
660182,382333,2014-12-03,Senate,"Senate Third Reading: Passed Roll Call # 691",38,0,0,0,38
660182,382634,2014-12-09,House,"Reported With Recommendation Without Amendment",15,0,0,0,15
660182,383625,2014-12-17,House,"House Third Reading: Passed Roll Call # 704",108,0,0,0,108
660182,383778,2014-12-18,Senate,"Senate Third Reading: Roll Call # 862",38,0,0,0,38
660186,382460,2014-12-04,House,"Reported With Recommendation Without Amendment",5,0,0,0,5
660186,382721,2014-12-10,House,"House Third Reading: Given Immediate Effect Roll Call # 656",108,2,0,0,110
660187,382424,2014-12-04,House,"Reported With Recommendation Without Amendment",7,4,0,0,11
660187,382425,2014-12-04,House,"House Third Reading: Given Immediate Effect Roll Call # 615",59,50,0,0,109
661293,382580,2014-12-09,House,"Reported With Recommendation With Substitute  H-3",8,7,0,0,15
661294,382398,2014-12-03,House,"Reported With Recommendation With Substitute  H-1",9,4,0,0,13
661294,382744,2014-12-09,House,"House Third Reading: Given Immediate Effect Roll Call # 648",59,50,0,0,109
661294,383219,2014-12-16,Senate,"Senate Third Reading: Given Immediate Effect Roll Call # 818",25,11,1,1,38
661386,382822,2014-12-11,Senate,"Reported Favorably With Substitute  S-1",3,0,0,0,3
661656,382817,2014-12-11,Senate,"Reported Favorably With Substitute  S-1",3,0,0,0,3
661656,382818,2014-12-11,Senate,"Senate Third Reading: Passed Roll Call # 777",35,2,0,1,38
661656,383275,2014-12-16,House,"Reported With Recommendation With Substitute  H-1",9,0,0,0,9
661656,383504,2014-12-18,House,"House Third Reading: Given Immediate Effect Roll Call # 748",92,17,0,0,109
661656,383738,2014-12-18,Senate,"Senate Third Reading: Roll Call # 904",36,2,0,0,38
661663,382767,2014-12-11,Senate,"Senate Third Reading: Passed Roll Call # 768",26,11,0,1,38
661669,382815,2014-12-11,Senate,"Reported Favorably With Substitute  S-1",3,0,0,0,3
661669,382816,2014-12-11,Senate,"Senate Third Reading: Passed Roll Call # 775",35,2,0,1,38
661677,382779,2014-12-11,Senate,"Reported Favorably With Substitute  S-1",3,0,0,0,3
661677,382780,2014-12-11,Senate,"Senate Third Reading: Passed Roll Call # 776",35,2,0,1,38
661725,382859,2014-12-11,Senate,"Senate Third Reading: Passed Roll Call # 769",26,11,0,1,38
661755,382653,2014-12-10,House,"Reported With Recommendation Without Amendment",17,0,0,0,17
661755,382770,2014-12-11,House,"House Third Reading: Given Immediate Effect Roll Call # 676",105,1,0,0,106
661755,383721,2014-12-18,Senate,"Senate Third Reading: Given Immediate Effect Roll Call # 888",38,0,0,0,38
664467,383674,2014-12-19,House,"House Third Reading: Roll Call # 789",94,16,0,0,110
664467,383803,2014-12-19,Senate,"Senate Third Reading: Defeated Roll Call # 938",25,13,0,0,38
664467,383804,2014-12-19,Senate,"Senate Third Reading: Adopted By 2/3 Vote Roll Call # 939",26,12,0,0,38
