bill_id,roll_call_id,date,chamber,description,yea,nay,nv,absent,total
1404492,987357,2021-01-13,House,"House Third Reading: Roll Call # 2",107,0,0,0,107
1404608,987358,2021-01-13,House,"House Third Reading: Roll Call # 3",107,0,0,0,107
1405855,1030036,2021-03-11,Senate,"Reported Favorably Without Amendment",5,2,0,0,7
1405855,1032915,2021-03-18,Senate,"Senate Third Reading: Passed Roll Call # 61",20,15,0,1,36
1405855,1205452,2022-05-17,House,"Reported With Recommendation Without Amendment",7,4,0,0,11
1405856,1007706,2021-02-16,Senate,"Reported Favorably Without Amendment",10,0,0,0,10
1405856,1010044,2021-02-18,Senate,"Senate Third Reading: Passed Roll Call # 14",25,10,0,1,36
1405856,1086766,2021-05-27,House,"Reported With Recommendation Without Amendment",14,5,0,0,19
1405859,1014054,2021-02-23,House,"Reported With Recommendation Without Amendment",5,0,0,0,5
1405859,1015908,2021-02-24,House,"House Third Reading: Adopted By 2/3 Vote Roll Call # 13",102,7,0,0,109
1405860,994677,2021-02-02,Senate,"Reported Favorably Without Amendment",5,0,0,0,5
1405860,1004030,2021-02-10,Senate,"Senate Third Reading: Passed Roll Call # 8",34,0,0,2,36
1405860,1004031,2021-02-10,Senate,"Senate Third Reading: Passed Roll Call # 9",35,0,0,1,36
1405860,1021654,2021-03-03,House,"Reported With Recommendation Without Amendment",13,0,0,0,13
1405860,1064718,2021-04-28,House,"House Third Reading: Given Immediate Effect Roll Call # 155",101,9,0,0,110
1405864,1016396,2021-02-25,Senate,"Reported Favorably With Substitute S-3",4,1,0,0,5
1405864,1016397,2021-02-25,Senate,"Senate Third Reading: Passed Roll Call # 19",20,15,0,1,36
1405864,1026493,2021-03-10,House,"House Third Reading: Given Immediate Effect Roll Call # 41",60,50,0,0,110
1405864,1032923,2021-03-17,Senate,"Senate Third Reading: Roll Call: Roll Call # 55",20,15,0,1,36
1405864,1032924,2021-03-17,House,"House Third Reading: Roll Call # 48",60,49,0,0,109
1405866,1016752,2021-02-24,Senate,"Reported Favorably Without Amendment",6,3,0,0,9
1405866,1022559,2021-03-04,Senate,"Senate Third Reading: Passed Roll Call # 42",20,15,0,1,36
1405866,1076317,2021-05-11,House,"Reported With Recommendation Without Amendment",5,4,0,0,9
1405866,1167989,2022-03-10,House,"House Third Reading: Given Immediate Effect Roll Call # 102",58,43,0,0,101
1405868,1032940,2021-03-18,Senate,"Reported Favorably Without Amendment",4,1,0,0,5
1405868,1032941,2021-03-18,Senate,"Senate Third Reading: Passed Roll Call # 63",20,15,0,1,36
1405869,1020350,2021-03-02,Senate,"Senate Third Reading: Passed Roll Call # 38",20,15,0,1,36
1405869,1026361,2021-03-09,House,"House Third Reading: Given Immediate Effect Roll Call # 33",59,50,0,0,109
1405872,1032899,2021-03-11,Senate,"Reported Favorably Without Amendment",5,2,0,0,7
1405872,1033056,2021-03-18,Senate,"Senate Third Reading: Passed Roll Call # 62",20,15,0,1,36
1405872,1205504,2022-05-17,House,"Reported With Recommendation Without Amendment",7,4,0,0,11
1405873,996389,2021-02-02,Senate,"Reported Favorably Without Amendment",4,1,0,0,5
1405873,1007902,2021-02-11,Senate,"Senate Third Reading: Passed Roll Call # 11",24,11,0,1,36
1405873,1021412,2021-03-03,House,"Reported With Recommendation With Substitute H-1",10,3,0,0,13
1405873,1065006,2021-04-28,House,"House Third Reading: Given Immediate Effect Roll Call # 156",61,49,0,0,110
1405873,1073323,2021-05-05,Senate,"Senate Third Reading: Roll Call: Roll Call # 114",24,12,0,0,36
1405875,1035301,2021-03-23,Senate,"Reported Favorably Without Amendment",6,2,0,0,8
1405879,996706,2021-02-04,Senate,"Reported Favorably With Substitute S-1",3,0,0,0,3
1405879,1003911,2021-02-10,Senate,"Senate Third Reading: Passed Roll Call # 10",35,0,0,1,36
1405879,1035392,2021-03-23,House,"Reported With Recommendation With Substitute H-2",9,0,0,0,9
1405879,1094611,2021-06-08,House,"House Third Reading: Given Immediate Effect Roll Call # 300",109,0,0,0,109
1405879,1095595,2021-06-09,Senate,"Senate Third Reading: Roll Call: Roll Call # 254",35,0,0,1,36
1405880,1032973,2021-03-18,Senate,"Reported Favorably Without Amendment",4,1,0,0,5
1405880,1032974,2021-03-18,Senate,"Senate Third Reading: Passed Roll Call # 64",20,15,0,1,36
1405880,1101880,2021-06-24,House,"House Third Reading: Given Immediate Effect Roll Call # 398",95,13,0,0,108
1405880,1103244,2021-06-30,Senate,"Senate Third Reading: Roll Call: Roll Call # 325",33,0,1,2,36
1405880,1103245,2021-06-30,House,"House Third Reading: Roll Call # 418",79,30,0,0,109
1405881,1032956,2021-03-18,Senate,"Reported Favorably Without Amendment",12,5,0,0,17
1405881,1037290,2021-03-25,Senate,"Senate Third Reading: Passed Roll Call # 88",20,15,0,1,36
1405881,1103566,2021-06-30,House,"House Third Reading: Given Immediate Effect Roll Call # 399",106,3,0,0,109
1405881,1105145,2021-07-15,Senate,"Senate Third Reading: Roll Call: Roll Call # 326",35,0,0,1,36
1405883,1099084,2021-06-17,Senate,"Reported Favorably With Substitute S-1",3,0,0,0,3
1405883,1101324,2021-06-24,Senate,"Senate Third Reading: Passed Roll Call # 298",34,1,0,1,36
1405884,1063670,2021-04-27,House,"Reported With Recommendation With Substitute H-4",7,0,0,0,7
1405884,1074010,2021-05-06,House,"House Third Reading: Given Immediate Effect Roll Call # 175",105,3,0,0,108
1405887,1027483,2021-03-11,Senate,"Reported Favorably With Substitute S-1",7,0,0,0,7
1405887,1035314,2021-03-23,Senate,"Senate Third Reading: Passed Roll Call # 69",35,0,0,1,36
1405887,1064778,2021-04-28,House,"Reported With Recommendation Without Amendment",14,0,0,0,14
1405887,1110144,2021-10-14,House,"House Third Reading: Given Immediate Effect Roll Call # 472",105,2,0,0,107
1432134,1066918,2021-04-29,Senate,"Reported Favorably With Substitute S-2",17,0,0,0,17
1432141,1061121,2021-04-22,Senate,"Reported Favorably Without Amendment",8,0,0,0,8
1432141,1073053,2021-05-05,Senate,"Senate Third Reading: Passed Roll Call # 118",35,1,0,0,36
1432141,1098121,2021-06-15,House,"Reported With Recommendation Without Amendment",13,0,0,0,13
1432141,1108892,2021-09-14,House,"House Third Reading: Given Immediate Effect Roll Call # 437",101,3,0,0,104
1432147,1027519,2021-03-11,House,"Reported With Recommendation Without Amendment",8,1,0,0,9
1432147,1037288,2021-03-25,House,"House Third Reading: Given Immediate Effect Roll Call # 96",79,27,0,0,106
1432147,1076647,2021-05-12,Senate,"Reported Favorably Without Amendment",3,1,0,0,4
1432150,1014457,2021-02-23,House,"Reported With Recommendation With Substitute H-3",15,0,0,0,15
1432150,1015379,2021-02-24,House,"House Third Reading: Given Immediate Effect Roll Call # 14",102,7,0,0,109
1432150,1095618,2021-06-09,Senate,"Reported Favorably Without Amendment",9,0,0,0,9
1432150,1098360,2021-06-16,Senate,"Senate Third Reading: Passed Roll Call # 272",35,0,0,1,36
1432164,1064507,2021-04-28,House,"Reported With Recommendation Without Amendment",8,5,0,0,13
1432164,1099310,2021-06-17,House,"House Third Reading: Given Immediate Effect Roll Call # 333",69,41,0,0,110
1432164,1110064,2021-10-12,Senate,"Reported Favorably With Substitute S-1",3,1,0,0,4
1432164,1110325,2021-10-19,Senate,"Senate Third Reading: Passed Roll Call # 391",25,11,0,0,36
1432164,1110704,2021-10-26,House,"House Third Reading: Roll Call # 496",66,38,0,0,104
1432168,1015702,2021-02-24,House,"Reported With Recommendation Without Amendment",19,0,0,0,19
1432168,1020499,2021-03-02,House,"House Third Reading: Given Immediate Effect Roll Call # 17",108,2,0,0,110
1432168,1079081,2021-05-18,Senate,"Reported Favorably Without Amendment",10,0,0,0,10
1432168,1087089,2021-05-27,Senate,"Senate Third Reading: Passed Roll Call # 233",36,0,0,0,36
1432175,1027673,2021-03-11,House,"Reported With Recommendation Without Amendment",8,0,0,0,8
1432175,1037453,2021-03-25,House,"House Third Reading: Given Immediate Effect Roll Call # 95",106,0,0,0,106
1432175,1117269,2021-12-09,Senate,"Reported Favorably Without Amendment",5,0,0,0,5
1432175,1125387,2022-01-18,Senate,"Senate Third Reading: Given Immediate Effect Roll Call # 3",38,0,0,0,38
1432190,1204370,2022-05-12,Senate,"Reported Favorably Without Amendment",7,0,0,0,7
1432190,1207072,2022-05-19,Senate,"Senate Third Reading: Passed Roll Call # 241",35,0,1,2,38
1432190,1218424,2022-06-21,House,"Reported With Recommendation Without Amendment",11,1,0,0,12
1432190,1230468,2022-12-07,House,"House Third Reading: Given Immediate Effect Roll Call # 494",87,10,0,0,97
1432195,996185,2021-02-03,House,"Reported With Recommendation With Substitute H-3",17,12,0,0,29
1432195,997135,2021-02-04,House,"House Third Reading: Given Immediate Effect Roll Call # 4",59,50,0,0,109
1432195,1057184,2021-04-20,Senate,"Senate Third Reading: Given Immediate Effect Roll Call # 91",35,0,0,1,36
1432195,1058497,2021-04-21,House,"House Third Reading: Roll Call # 124",108,0,0,0,108
1432199,1000097,2021-02-04,House,"Reported With Recommendation Without Amendment",6,3,0,0,9
1432228,1022906,2021-03-04,House,"Reported With Recommendation Without Amendment",9,0,0,0,9
1432228,1036639,2021-03-24,House,"House Third Reading: Given Immediate Effect Roll Call # 67",91,16,0,0,107
1432228,1081110,2021-05-20,Senate,"Reported Favorably Without Amendment",5,0,0,0,5
1432228,1100396,2021-06-09,Senate,"Senate Third Reading: Given Immediate Effect Roll Call # 256",34,1,0,1,36
1432234,1015407,2021-02-24,House,"Reported With Recommendation Without Amendment",19,0,0,0,19
1432234,1020965,2021-03-02,House,"House Third Reading: Given Immediate Effect Roll Call # 16",109,1,0,0,110
1432234,1079390,2021-05-18,Senate,"Reported Favorably Without Amendment",10,0,0,0,10
1432234,1087210,2021-05-27,Senate,"Senate Third Reading: Passed Roll Call # 232",36,0,0,0,36
1432237,1030039,2021-03-16,House,"Reported With Recommendation With Substitute H-1",8,4,0,0,12
1432237,1101884,2021-06-24,House,"House Third Reading: Given Immediate Effect Roll Call # 379",72,37,0,0,109
1432237,1206030,2022-05-18,Senate,"Reported Favorably With Substitute S-1",5,1,0,0,6
1432254,1076270,2021-05-11,House,"Reported With Recommendation With Substitute H-2",6,1,0,0,7
1432254,1085435,2021-05-26,House,"House Third Reading: Given Immediate Effect Roll Call # 243",66,43,0,0,109
1432254,1210672,2022-05-26,Senate,"Reported Favorably Without Amendment",7,2,0,0,9
1432263,998088,2021-02-04,Senate,"Reported Favorably With Substitute S-1",3,0,0,0,3
1432277,1159963,2022-03-01,House,"Reported With Recommendation Without Amendment",9,0,0,0,9
1432277,1168283,2022-03-10,House,"House Third Reading: Given Immediate Effect Roll Call # 113",99,2,0,0,101
1432277,1221600,2022-06-30,Senate,"Senate Third Reading: Passed Roll Call # 399",37,0,0,1,38
1432277,1221694,2022-06-30,House,"House Third Reading: Senate Amendment(s) Concurred In Roll Call # 349",104,2,0,0,106
1432301,1015668,2021-02-24,House,"Reported With Recommendation Without Amendment",19,0,0,0,19
1432301,1020645,2021-03-02,House,"House Third Reading: Given Immediate Effect Roll Call # 18",108,2,0,0,110
1432301,1052199,2021-04-13,Senate,"Reported Favorably With Substitute S-1",9,0,0,0,9
1432301,1060283,2021-04-22,Senate,"Senate Third Reading: Passed Roll Call # 104",34,0,0,2,36
1432301,1063977,2021-04-27,House,"House Third Reading: Roll Call # 140",107,2,0,0,109
1432312,1219047,2022-05-12,Senate,"Reported Favorably Without Amendment",7,0,0,0,7
1432312,1219048,2022-05-19,Senate,"Senate Third Reading: Passed Roll Call # 240",35,0,1,2,38
1432312,1219049,2022-06-21,House,"Reported With Recommendation Without Amendment",11,1,0,0,12
1432312,1230469,2022-12-07,House,"House Third Reading: Given Immediate Effect Roll Call # 493",88,9,0,0,97
1432350,1016637,2021-02-23,House,"Reported With Recommendation Without Amendment",13,0,0,0,13
1432350,1026406,2021-03-10,House,"House Third Reading: Given Immediate Effect Roll Call # 40",109,1,0,0,110
1432350,1054251,2021-04-15,Senate,"Reported Favorably Without Amendment",8,0,0,0,8
1432350,1064227,2021-04-27,Senate,"Senate Third Reading: Given Immediate Effect Roll Call # 106",34,1,0,1,36
1432376,1016918,2021-02-25,House,"Reported With Recommendation With Substitute H-1",9,0,0,0,9
1432376,1027466,2021-03-11,House,"House Third Reading: Given Immediate Effect Roll Call # 46",107,3,0,0,110
1432376,1035459,2021-03-23,Senate,"Reported Favorably Without Amendment",8,0,0,0,8
1432376,1094997,2021-06-08,Senate,"Senate Third Reading: Passed Roll Call # 253",35,0,0,1,36
1432388,1026917,2021-03-09,House,"Reported With Recommendation Without Amendment",13,0,0,0,13
1432388,1053733,2021-04-14,House,"House Third Reading: Given Immediate Effect Roll Call # 103",107,3,0,0,110
1432388,1098921,2021-06-17,Senate,"Reported Favorably Without Amendment",6,0,0,0,6
1432388,1100715,2021-06-23,Senate,"Senate Third Reading: Given Immediate Effect Roll Call # 293",33,2,0,1,36
1432395,1021715,2021-03-02,House,"Reported With Recommendation Without Amendment",12,0,0,0,12
1432395,1037524,2021-03-25,House,"House Third Reading: Given Immediate Effect Roll Call # 90",106,0,0,0,106
1432395,1086786,2021-05-27,Senate,"Reported Favorably With Substitute S-1",9,0,0,0,9
1432395,1105158,2021-07-15,Senate,"Senate Third Reading: Passed Roll Call # 334",35,0,0,1,36
1432395,1110365,2021-10-19,House,"House Third Reading: Roll Call # 479",103,0,0,0,103
1432405,996062,2021-02-03,House,"Reported With Recommendation With Substitute H-2",17,12,0,0,29
1432405,997116,2021-02-04,House,"House Third Reading: Given Immediate Effect Roll Call # 5",60,49,0,0,109
1432405,1016642,2021-02-25,Senate,"Reported Favorably With Substitute S-1",12,0,0,0,12
1432405,1020485,2021-03-02,Senate,"Senate Third Reading: Given Immediate Effect Roll Call # 34",34,1,0,1,36
1432405,1021635,2021-03-03,House,"House Third Reading: Roll Call # 19",85,25,0,0,110
1432405,1027908,2021-03-09,House,"House Third Reading: Motion To Override Line Item(s) Failed Roll Call # 34",64,45,0,0,109
1432405,1027909,2021-03-09,House,"House Third Reading: Motion To Override Line Item(s) Failed Roll Call # 35",66,43,0,0,109
1432423,993514,2021-01-28,Senate,"Reported Favorably With Substitute S-1",6,0,0,0,6
1432427,1110723,2021-10-26,House,"Reported With Recommendation Without Amendment",11,0,0,0,11
1432427,1115808,2021-11-09,House,"House Third Reading: Given Immediate Effect Roll Call # 539",75,29,0,0,104
1432435,1008808,2021-02-17,House,"Reported With Recommendation Without Amendment",29,0,0,0,29
1432435,1010340,2021-02-18,House,"House Third Reading: Given Immediate Effect Roll Call # 11",107,0,0,0,107
1432496,1110724,2021-10-26,House,"Reported With Recommendation Without Amendment",10,0,0,0,10
1432496,1115770,2021-11-09,House,"House Third Reading: Given Immediate Effect Roll Call # 541",75,29,0,0,104
1432508,1008748,2021-02-17,House,"Reported With Recommendation Without Amendment",29,0,0,0,29
1432508,1010312,2021-02-18,House,"House Third Reading: Given Immediate Effect Roll Call # 10",107,0,0,0,107
1432520,1065310,2021-04-28,House,"Reported With Recommendation With Substitute H-2",9,1,0,0,10
1432520,1074071,2021-05-06,House,"House Third Reading: Given Immediate Effect Roll Call # 176",83,25,0,0,108
1432520,1119543,2021-12-14,Senate,"Reported Favorably With Substitute S-1",8,0,0,0,8
1432520,1125271,2022-01-18,Senate,"Senate Third Reading: Passed Roll Call # 4",29,9,0,0,38
1432520,1128793,2022-01-25,House,"House Third Reading: Roll Call # 1",76,25,0,0,101
1432553,1072302,2021-05-04,House,"Reported With Recommendation Without Amendment",12,1,0,0,13
1432553,1081509,2021-05-20,House,"House Third Reading: Given Immediate Effect Roll Call # 215",98,10,0,0,108
1432553,1100609,2021-06-23,Senate,"Reported Favorably Without Amendment",9,0,0,0,9
1432553,1108649,2021-09-01,Senate,"Senate Third Reading: Passed Roll Call # 348",27,9,0,0,36
1432564,996288,2021-02-03,House,"Reported With Recommendation With Substitute H-1",17,12,0,0,29
1432564,997356,2021-02-04,House,"House Third Reading: Given Immediate Effect Roll Call # 7",57,52,0,0,109
1432564,1020783,2021-03-02,Senate,"Senate Third Reading: Given Immediate Effect Roll Call # 37",20,15,0,1,36
1432564,1021910,2021-03-03,House,"House Third Reading: Senate Amendment(s) Concurred In Roll Call # 21",60,50,0,0,110
1432569,995820,2021-02-03,House,"Reported With Recommendation With Substitute H-1",17,12,0,0,29
1432569,997359,2021-02-04,House,"House Third Reading: Given Immediate Effect Roll Call # 6",58,51,0,0,109
1432569,1020522,2021-03-02,Senate,"Senate Third Reading: Given Immediate Effect Roll Call # 36",31,4,0,1,36
1432569,1021411,2021-03-03,House,"House Third Reading: Roll Call # 20",77,33,0,0,110
1432569,1022568,2021-03-04,Senate,"Senate Third Reading: Roll Call: Roll Call # 41",31,4,0,1,36
1432569,1025430,2021-03-09,House,"House Third Reading: Motion To Override Line Item(s) Failed Roll Call # 36",64,45,0,0,109
1432569,1025431,2021-03-09,House,"House Third Reading: Motion To Override Line Item(s) Failed Roll Call # 37",65,44,0,0,109
1432576,1009089,2021-02-17,House,"Reported With Recommendation Without Amendment",29,0,0,0,29
1432576,1009970,2021-02-18,House,"House Third Reading: Given Immediate Effect Roll Call # 9",107,0,0,0,107
1432587,996677,2021-02-04,Senate,"Senate Third Reading: Passed Roll Call # 7",34,0,0,2,36
1432587,1002601,2021-02-09,House,"Reported With Recommendation Without Amendment",13,0,0,0,13
1432587,1007934,2021-02-11,House,"House Third Reading: Given Immediate Effect Roll Call # 8",109,0,0,0,109
1432595,1032936,2021-03-16,House,"Reported With Recommendation With Substitute H-1",8,4,0,0,12
1432595,1101942,2021-06-24,House,"House Third Reading: Given Immediate Effect Roll Call # 378",72,37,0,0,109
1432595,1206033,2022-05-18,Senate,"Reported Favorably Without Amendment",5,1,0,0,6
1432605,1016796,2021-02-25,House,"Reported With Recommendation Without Amendment",3,2,0,0,5
1432605,1021876,2021-03-03,House,"House Third Reading: Given Immediate Effect Roll Call # 23",63,47,0,0,110
1432605,1098899,2021-06-17,Senate,"Reported Favorably Without Amendment",6,3,0,0,9
1432605,1107564,2021-09-01,Senate,"Senate Third Reading: Passed Roll Call # 349",20,16,0,0,36
1432613,1003651,2021-02-10,Senate,"Reported Favorably With Substitute S-1",8,0,0,0,8
1432613,1009908,2021-02-18,Senate,"Senate Third Reading: Passed Roll Call # 12",20,15,0,1,36
1432613,1026475,2021-03-09,House,"Reported With Recommendation With Substitute H-1",7,4,0,0,11
1432613,1037378,2021-03-25,House,"House Third Reading: Given Immediate Effect Roll Call # 89",57,49,0,0,106
1432613,1059093,2021-04-21,Senate,"Senate Third Reading: Roll Call: Roll Call # 96",19,14,1,2,36
1432613,1059094,2021-04-21,Senate,"Senate Third Reading: Roll Call: Roll Call # 97",20,14,0,2,36
1432613,1066969,2021-04-27,House,"House Third Reading: Roll Call # 139",58,51,0,0,109
1432613,1079157,2021-05-18,Senate,"Senate Third Reading: Veto Override Defeated Roll Call # 189",20,15,0,1,36
1432615,1109597,2021-10-05,House,"Reported With Recommendation With Substitute H-1",10,1,0,0,11
1432615,1168086,2022-03-10,House,"House Third Reading: Given Immediate Effect Roll Call # 103",74,27,0,0,101
1432621,1215384,2022-06-09,House,"Reported With Recommendation With Substitute H-1",7,1,0,0,8
1432628,1026847,2021-03-09,House,"Reported With Recommendation With Substitute H-1",13,0,0,0,13
1432628,1053143,2021-04-14,House,"House Third Reading: Given Immediate Effect Roll Call # 102",107,3,0,0,110
1432628,1098918,2021-06-17,Senate,"Reported Favorably Without Amendment",6,0,0,0,6
1432628,1100714,2021-06-23,Senate,"Senate Third Reading: Given Immediate Effect Roll Call # 292",34,1,0,1,36
1432633,1030027,2021-03-16,House,"Reported With Recommendation With Substitute H-1",8,2,0,0,10
1432633,1064228,2021-04-27,House,"House Third Reading: Given Immediate Effect Roll Call # 142",87,22,0,0,109
1432650,1026789,2021-03-10,House,"Reported With Recommendation Without Amendment",8,1,0,0,9
1432650,1053247,2021-04-14,House,"House Third Reading: Given Immediate Effect Roll Call # 104",78,32,0,0,110
1432668,1076297,2021-05-11,Senate,"Reported Favorably Without Amendment",12,6,0,0,18
1432668,1078398,2021-05-13,Senate,"Senate Third Reading: Passed Roll Call # 184",35,0,0,1,36
1432668,1098006,2021-06-15,House,"House Third Reading: Given Immediate Effect Roll Call # 331",105,4,0,0,109
1432668,1098481,2021-06-16,Senate,"Senate Third Reading: Roll Call: Roll Call # 271",35,0,0,1,36
1432688,1014802,2021-02-24,Senate,"Reported Favorably Without Amendment",6,3,0,0,9
1432688,1017150,2021-02-25,Senate,"Senate Third Reading: Passed Roll Call # 17",35,0,0,1,36
1432688,1079500,2021-05-18,House,"Reported With Recommendation With Substitute H-1",14,0,0,0,14
1432688,1103642,2021-06-30,House,"House Third Reading: Given Immediate Effect Roll Call # 402",109,0,0,0,109
1432688,1105159,2021-07-15,Senate,"Senate Third Reading: Roll Call: Roll Call # 327",34,1,0,1,36
1432697,1060190,2021-04-22,House,"Reported With Recommendation With Substitute H-3",4,1,0,0,5
1432697,1073326,2021-05-05,House,"House Third Reading: Given Immediate Effect Roll Call # 165",87,21,0,0,108
1432703,1026809,2021-03-09,House,"Reported With Recommendation With Substitute H-1",11,1,0,0,12
1432703,1036265,2021-03-24,House,"House Third Reading: Given Immediate Effect Roll Call # 85",94,13,0,0,107
1432725,1015080,2021-02-24,Senate,"Reported Favorably Without Amendment",6,3,0,0,9
1432725,1016681,2021-02-25,Senate,"Senate Third Reading: Passed Roll Call # 16",34,1,0,1,36
1432725,1058025,2021-04-20,House,"Reported With Recommendation Without Amendment",15,0,0,0,15
1432725,1079429,2021-05-18,House,"House Third Reading: Given Immediate Effect Roll Call # 211",108,0,0,0,108
1432729,1073722,2021-05-06,House,"Reported With Recommendation Without Amendment",18,0,0,0,18
1432729,1091458,2021-06-03,House,"House Third Reading: Given Immediate Effect Roll Call # 287",108,2,0,0,110
1432729,1110054,2021-10-12,Senate,"Reported Favorably Without Amendment",10,0,0,0,10
1432729,1110669,2021-10-26,Senate,"Senate Third Reading: Passed Roll Call # 404",34,0,0,2,36
1432729,1115384,2021-11-02,House,"House Third Reading: Senate Amendment(s) Concurred In Roll Call # 516",101,1,0,0,102
1433400,1073805,2021-05-06,Senate,"Reported Favorably With Substitute S-1",10,8,0,0,18
1433400,1076445,2021-05-11,Senate,"Senate Third Reading: Passed Roll Call # 154",32,3,0,1,36
1433400,1081305,2021-05-20,House,"House Third Reading: Given Immediate Effect Roll Call # 233",108,0,0,0,108
1433400,1086079,2021-05-26,Senate,"Senate Third Reading: Defeated Roll Call # 227",0,36,0,0,36
1433405,1075920,2021-05-11,Senate,"Reported Favorably With Substitute S-3",12,6,0,0,18
1433405,1077321,2021-05-12,Senate,"Senate Third Reading: Passed Roll Call # 167",19,17,0,0,36
1433405,1081610,2021-05-20,House,"House Third Reading: Given Immediate Effect Roll Call # 222",108,0,0,0,108
1433405,1085670,2021-05-26,Senate,"Senate Third Reading: Defeated Roll Call # 217",0,36,0,0,36
1433432,1074226,2021-05-06,Senate,"Reported Favorably With Substitute S-1",12,6,0,0,18
1433432,1076357,2021-05-11,Senate,"Senate Third Reading: Passed Roll Call # 129",20,15,0,1,36
1433432,1081091,2021-05-20,House,"House Third Reading: Given Immediate Effect Roll Call # 225",108,0,0,0,108
1433432,1086040,2021-05-26,Senate,"Senate Third Reading: Defeated Roll Call # 219",0,36,0,0,36
1433441,1073803,2021-05-06,Senate,"Reported Favorably With Substitute S-1",18,0,0,0,18
1433441,1076704,2021-05-12,Senate,"Senate Third Reading: Passed Roll Call # 155",36,0,0,0,36
1433441,1081257,2021-05-20,House,"House Third Reading: Given Immediate Effect Roll Call # 227",108,0,0,0,108
1433441,1086001,2021-05-26,Senate,"Senate Third Reading: Defeated Roll Call # 221",0,36,0,0,36
1433446,1076261,2021-05-11,Senate,"Reported Favorably With Substitute S-2",12,6,0,0,18
1433446,1077027,2021-05-12,Senate,"Senate Third Reading: Passed Roll Call # 176",20,16,0,0,36
1433446,1081325,2021-05-20,House,"House Third Reading: Given Immediate Effect Roll Call # 229",108,0,0,0,108
1433446,1085977,2021-05-26,Senate,"Senate Third Reading: Defeated Roll Call # 223",0,36,0,0,36
1433478,1074005,2021-05-06,Senate,"Reported Favorably With Substitute S-1",12,6,0,0,18
1433478,1076363,2021-05-11,Senate,"Senate Third Reading: Passed Roll Call # 148",20,15,0,1,36
1433478,1081081,2021-05-20,House,"House Third Reading: Given Immediate Effect Roll Call # 223",108,0,0,0,108
1433478,1086286,2021-05-26,Senate,"Senate Third Reading: Defeated Roll Call # 218",0,36,0,0,36
1433512,1076229,2021-05-11,Senate,"Reported Favorably With Substitute S-2",12,6,0,0,18
1433512,1076994,2021-05-12,Senate,"Senate Third Reading: Passed Roll Call # 164",20,16,0,0,36
1433512,1082309,2021-05-20,House,"House Third Reading: Given Immediate Effect Roll Call # 230",108,0,0,0,108
1433512,1085416,2021-05-26,Senate,"Senate Third Reading: Defeated Roll Call # 224",0,36,0,0,36
1433517,1075896,2021-05-11,Senate,"Reported Favorably With Substitute S-2",12,6,0,0,18
1433517,1076751,2021-05-12,Senate,"Senate Third Reading: Passed Roll Call # 170",20,16,0,0,36
1433517,1081361,2021-05-20,House,"House Third Reading: Given Immediate Effect Roll Call # 220",108,0,0,0,108
1433517,1085816,2021-05-26,Senate,"Senate Third Reading: Defeated Roll Call # 215",0,36,0,0,36
1433534,1074219,2021-05-06,Senate,"Reported Favorably With Substitute S-2",12,6,0,0,18
1433534,1076337,2021-05-11,Senate,"Senate Third Reading: Passed Roll Call # 126",20,15,0,1,36
1433534,1082336,2021-05-20,House,"House Third Reading: Given Immediate Effect Roll Call # 226",108,0,0,0,108
1433534,1085769,2021-05-26,Senate,"Senate Third Reading: Defeated Roll Call # 220",0,36,0,0,36
1433571,1076227,2021-05-11,Senate,"Reported Favorably With Substitute S-3",12,6,0,0,18
1433571,1078014,2021-05-13,Senate,"Senate Third Reading: Passed Roll Call # 183",20,15,0,1,36
1433571,1082135,2021-05-20,House,"House Third Reading: Given Immediate Effect Roll Call # 234",108,0,0,0,108
1433571,1085930,2021-05-26,Senate,"Senate Third Reading: Defeated Roll Call # 213",0,36,0,0,36
1433577,1076537,2021-05-11,Senate,"Reported Favorably With Substitute S-4",12,6,0,0,18
1433577,1076538,2021-05-11,Senate,"Senate Third Reading: Passed Roll Call # 144",20,15,0,1,36
1433577,1082340,2021-05-20,House,"House Third Reading: Given Immediate Effect Roll Call # 224",108,0,0,0,108
1433577,1116707,2021-12-02,Senate,"Senate Third Reading: Roll Call: Roll Call # 462",0,34,0,4,38
1433577,1119661,2021-12-14,Senate,"Senate Third Reading: Senate Adopted Conference Report With Immediate Effect Roll Call # 508",25,11,0,2,38
1433577,1119662,2021-12-14,House,"House Third Reading: Conference Report Adopted Roll Call # 641",78,25,0,0,103
1433586,1215330,2022-06-09,Senate,"Reported Favorably With Substitute S-5",17,0,0,0,17
1433595,1074236,2021-05-06,Senate,"Reported Favorably With Substitute S-3",12,6,0,0,18
1433595,1076366,2021-05-11,Senate,"Senate Third Reading: Passed Roll Call # 136",20,15,0,1,36
1433595,1082271,2021-05-20,House,"House Third Reading: Given Immediate Effect Roll Call # 221",108,0,0,0,108
1433595,1085978,2021-05-26,Senate,"Senate Third Reading: Defeated Roll Call # 216",0,36,0,0,36
1433595,1109059,2021-09-21,Senate,"Senate Third Reading: Senate Adopted Conference Report With Immediate Effect Roll Call # 351",35,0,0,1,36
1433595,1109060,2021-09-22,House,"House Third Reading: Conference Report Adopted Roll Call # 442",99,6,0,0,105
1433601,1073809,2021-05-06,Senate,"Reported Favorably With Substitute S-1",12,6,0,0,18
1433601,1075900,2021-05-11,Senate,"Senate Third Reading: Passed Roll Call # 152",20,15,0,1,36
1433601,1081322,2021-05-20,House,"House Third Reading: Given Immediate Effect Roll Call # 218",108,0,0,0,108
1433601,1085943,2021-05-26,Senate,"Senate Third Reading: Defeated Roll Call # 212",0,36,0,0,36
1433606,1076171,2021-05-11,Senate,"Reported Favorably With Substitute S-4",12,6,0,0,18
1433606,1076912,2021-05-12,Senate,"Senate Third Reading: Passed Roll Call # 172",19,17,0,0,36
1433606,1076913,2021-05-12,Senate,"Senate Third Reading: Passed Roll Call # 173",20,16,0,0,36
1433606,1081401,2021-05-20,House,"House Third Reading: Given Immediate Effect Roll Call # 231",108,0,0,0,108
1433606,1085758,2021-05-26,Senate,"Senate Third Reading: Defeated Roll Call # 225",0,36,0,0,36
1433614,1076444,2021-05-11,Senate,"Reported Favorably With Substitute S-1",12,6,0,0,18
1433614,1077399,2021-05-12,Senate,"Senate Third Reading: Passed Roll Call # 160",20,16,0,0,36
1433614,1081256,2021-05-20,House,"House Third Reading: Given Immediate Effect Roll Call # 228",107,1,0,0,108
1433614,1085765,2021-05-26,Senate,"Senate Third Reading: Defeated Roll Call # 222",0,36,0,0,36
1433621,1074221,2021-05-06,Senate,"Reported Favorably With Substitute S-2",12,6,0,0,18
1433621,1076352,2021-05-11,Senate,"Senate Third Reading: Passed Roll Call # 145",20,15,0,1,36
1433621,1081283,2021-05-20,House,"House Third Reading: Given Immediate Effect Roll Call # 219",108,0,0,0,108
1433621,1085797,2021-05-26,Senate,"Senate Third Reading: Defeated Roll Call # 214",0,36,0,0,36
1433697,1101903,2021-06-24,House,"Reported With Recommendation Without Amendment",19,0,0,0,19
1433697,1109711,2021-10-06,House,"House Third Reading: Given Immediate Effect Roll Call # 453",101,2,0,0,103
1433697,1221515,2022-06-30,Senate,"Reported Favorably With Substitute S-1",17,0,0,0,17
1433697,1221661,2022-06-30,Senate,"Senate Third Reading: Given Immediate Effect Roll Call # 386",38,0,0,0,38
1433697,1221662,2022-06-30,House,"House Third Reading: Roll Call # 347",105,2,0,0,107
1433745,1086659,2021-05-27,House,"Reported With Recommendation With Substitute H-2",17,2,0,0,19
1433745,1103557,2021-06-30,House,"House Third Reading: Given Immediate Effect Roll Call # 405",97,12,0,0,109
1433745,1109869,2021-10-12,Senate,"Reported Favorably Without Amendment",10,0,0,0,10
1433745,1110074,2021-10-14,Senate,"Senate Third Reading: Passed Roll Call # 385",35,0,0,1,36
1433799,1073830,2021-05-06,Senate,"Reported Favorably With Substitute S-1",10,8,0,0,18
1433799,1076442,2021-05-11,Senate,"Senate Third Reading: Passed Roll Call # 153",33,2,0,1,36
1433799,1081173,2021-05-20,House,"House Third Reading: Given Immediate Effect Roll Call # 232",108,0,0,0,108
1433799,1086215,2021-05-26,Senate,"Senate Third Reading: Defeated Roll Call # 226",0,36,0,0,36
1433824,1115831,2021-11-09,House,"Reported With Recommendation With Substitute H-3",13,0,0,0,13
1433824,1148659,2022-02-17,House,"House Third Reading: Given Immediate Effect Roll Call # 60",94,7,0,0,101
1433851,1081778,2021-05-20,House,"Reported With Recommendation Without Amendment",5,1,0,0,6
1433851,1101927,2021-06-24,House,"House Third Reading: Given Immediate Effect Roll Call # 371",69,38,0,0,107
1433851,1176832,2022-03-24,Senate,"Reported Favorably With Substitute S-1",4,0,0,0,4
1433936,1101891,2021-06-24,House,"Reported With Recommendation Without Amendment",19,0,0,0,19
1433936,1109698,2021-10-06,House,"House Third Reading: Given Immediate Effect Roll Call # 454",100,3,0,0,103
1433936,1221505,2022-06-30,Senate,"Reported Favorably With Substitute S-2",17,0,0,0,17
1433936,1221680,2022-06-30,Senate,"Senate Third Reading: Given Immediate Effect Roll Call # 387",38,0,0,0,38
1433936,1221681,2022-06-30,House,"House Third Reading: Roll Call # 348",105,2,0,0,107
1433962,1116962,2021-12-07,House,"Reported With Recommendation Without Amendment",6,3,0,0,9
1433962,1200734,2022-05-05,House,"House Third Reading: Given Immediate Effect Roll Call # 195",60,43,0,0,103
1434037,1109075,2021-09-21,House,"Reported With Recommendation With Substitute H-2",11,1,0,0,12
1434037,1110822,2021-10-27,House,"House Third Reading: Given Immediate Effect Roll Call # 498",101,3,0,0,104
1434094,1156549,2022-02-22,House,"Reported With Recommendation Without Amendment",8,3,0,0,11
1434094,1168070,2022-03-10,House,"House Third Reading: Given Immediate Effect Roll Call # 107",65,36,0,0,101
1434175,1066884,2021-04-29,House,"Reported With Recommendation Without Amendment",17,12,0,0,29
1434175,1077737,2021-05-13,House,"House Third Reading: Given Immediate Effect Roll Call # 206",58,49,0,0,107
1434175,1119668,2021-12-14,Senate,"Senate Third Reading: Given Immediate Effect Roll Call # 496",26,10,0,2,38
1434175,1119669,2021-12-14,House,"House Third Reading: Roll Call # 635",93,10,0,0,103
1434175,1119670,2021-12-14,House,"House Third Reading: Roll Call # 637",95,8,0,0,103
1434201,1073849,2021-05-06,House,"Reported With Recommendation With Substitute H-1",8,0,0,0,8
1434201,1081638,2021-05-20,House,"House Third Reading: Given Immediate Effect Roll Call # 216",61,47,0,0,108
1434201,1086845,2021-05-27,Senate,"Reported Favorably Without Amendment",4,1,0,0,5
1434201,1109550,2021-09-30,Senate,"Senate Third Reading: Passed Roll Call # 356",20,15,1,0,36
1434226,1110824,2021-10-27,House,"House Third Reading: Given Immediate Effect Roll Call # 499",100,4,0,0,104
1434226,1124459,2021-09-21,House,"Reported With Recommendation Without Amendment",11,1,0,0,12
1434226,1230508,2022-12-06,Senate,"Reported Favorably Without Amendment",6,0,0,0,6
1434249,1072348,2021-05-04,House,"Reported With Recommendation Without Amendment",10,3,0,0,13
1434249,1080533,2021-05-19,House,"House Third Reading: Given Immediate Effect Roll Call # 212",95,13,0,0,108
1434249,1140828,2022-02-02,Senate,"Reported Favorably With Substitute S-1",5,2,0,0,7
1434249,1172400,2022-03-17,Senate,"Senate Third Reading: Passed Roll Call # 92",21,17,0,0,38
1434249,1175107,2022-03-22,House,"House Third Reading: Roll Call # 131",96,9,0,0,105
1435407,1226393,2022-09-21,House,"Reported With Recommendation With Substitute H-2",11,3,0,0,14
1435685,1021903,2021-03-02,House,"Reported With Recommendation Without Amendment",12,0,0,0,12
1435685,1037619,2021-03-25,House,"House Third Reading: Given Immediate Effect Roll Call # 91",106,0,0,0,106
1435685,1086804,2021-05-27,Senate,"Reported Favorably With Substitute S-1",9,0,0,0,9
1435685,1105002,2021-07-15,Senate,"Senate Third Reading: Passed Roll Call # 335",35,0,0,1,36
1435685,1110374,2021-10-19,House,"House Third Reading: Roll Call # 480",101,2,0,0,103
1435685,1115370,2021-11-02,Senate,"Senate Third Reading: Roll Call: Roll Call # 418",35,0,0,1,36
1435725,1005033,2021-02-11,Senate,"Reported Favorably Without Amendment",7,0,0,0,7
1435725,1010315,2021-02-18,Senate,"Senate Third Reading: Passed Roll Call # 13",35,0,0,1,36
1435725,1021433,2021-03-02,House,"Reported With Recommendation Without Amendment",9,0,0,0,9
1435725,1032957,2021-03-18,House,"House Third Reading: Given Immediate Effect Roll Call # 56",109,0,0,0,109
1435740,1021965,2021-03-02,House,"Reported With Recommendation Without Amendment",10,3,0,0,13
1435740,1032925,2021-03-18,House,"House Third Reading: Given Immediate Effect Roll Call # 55",61,47,0,0,108
1435820,1051448,2021-04-13,House,"Reported With Recommendation Without Amendment",13,0,0,0,13
1435820,1065010,2021-04-28,House,"House Third Reading: Given Immediate Effect Roll Call # 159",110,0,0,0,110
1435961,1051668,2021-04-13,House,"Reported With Recommendation Without Amendment",13,0,0,0,13
1435961,1065017,2021-04-28,House,"House Third Reading: Passed Roll Call # 157",108,2,0,0,110
1435961,1065018,2021-04-28,House,"House Third Reading: Given Immediate Effect Roll Call # 158",109,1,0,0,110
1436038,1096873,2021-06-10,Senate,"Reported Favorably Without Amendment",17,0,0,0,17
1436038,1116636,2021-12-02,Senate,"Senate Third Reading: Passed Roll Call # 457",32,2,0,4,38
1436057,1061256,2021-04-22,House,"Reported With Recommendation Without Amendment",18,0,0,0,18
1436057,1065897,2021-04-29,House,"House Third Reading: Given Immediate Effect Roll Call # 162",75,34,0,0,109
1436746,1110133,2021-10-12,Senate,"Reported Favorably With Substitute S-3",10,0,0,0,10
1436746,1219050,2022-05-18,Senate,"Senate Third Reading: Passed Roll Call # 233",37,0,0,1,38
1436746,1219051,2022-06-21,House,"Reported With Recommendation With Substitute H-2",11,1,0,0,12
1436746,1221522,2022-06-30,House,"House Third Reading: Given Immediate Effect Roll Call # 341",79,27,0,0,106
1436746,1221523,2022-06-30,Senate,"Senate Third Reading: Roll Call: Roll Call # 397",37,0,0,1,38
1436858,1012929,2021-02-18,Senate,"Reported Favorably Without Amendment",4,1,0,0,5
1436858,1027553,2021-03-11,Senate,"Senate Third Reading: Passed Roll Call # 47",20,14,0,2,36
1436902,1167259,2022-03-09,Senate,"Reported Favorably With Substitute S-1",6,1,0,0,7
1437013,1016721,2021-02-23,House,"Reported With Recommendation Without Amendment",7,0,0,0,7
1437013,1025423,2021-03-09,House,"House Third Reading: Given Immediate Effect Roll Call # 28",87,22,0,0,109
1437013,1168097,2022-03-10,Senate,"Reported Favorably Without Amendment",4,0,0,0,4
1437044,1026359,2021-03-09,House,"Reported With Recommendation Without Amendment",13,0,0,0,13
1437044,1054789,2021-04-15,House,"House Third Reading: Given Immediate Effect Roll Call # 111",106,0,0,0,106
1437044,1117272,2021-12-09,Senate,"Reported Favorably Without Amendment",5,0,0,0,5
1437044,1142626,2022-02-10,Senate,"Senate Third Reading: Given Immediate Effect Roll Call # 23",38,0,0,0,38
1437120,1021616,2021-03-02,House,"Reported With Recommendation With Substitute H-1",9,0,0,0,9
1437120,1032905,2021-03-16,House,"House Third Reading: Given Immediate Effect Roll Call # 47",108,1,0,0,109
1437120,1082293,2021-05-20,Senate,"Reported Favorably With Substitute S-1",7,0,0,0,7
1437120,1091386,2021-06-03,Senate,"Senate Third Reading: Given Immediate Effect Roll Call # 248",36,0,0,0,36
1437120,1094916,2021-06-08,House,"House Third Reading: Roll Call # 299",109,0,0,0,109
1437171,1026476,2021-03-09,House,"Reported With Recommendation With Substitute H-1",8,4,0,0,12
1437171,1085580,2021-05-26,House,"House Third Reading: Given Immediate Effect Roll Call # 239",66,43,0,0,109
1437171,1148732,2022-02-17,Senate,"Reported Favorably Without Amendment",4,0,0,0,4
1437246,1022638,2021-03-04,House,"Reported With Recommendation Without Amendment",9,0,0,0,9
1437246,1036740,2021-03-24,House,"House Third Reading: Given Immediate Effect Roll Call # 68",104,3,0,0,107
1437246,1095633,2021-06-09,Senate,"Reported Favorably With Substitute S-1",7,0,0,0,7
1437246,1098570,2021-06-16,Senate,"Senate Third Reading: Given Immediate Effect Roll Call # 273",35,0,0,1,36
1437246,1100358,2021-06-22,House,"House Third Reading: Roll Call # 353",107,3,0,0,110
1437276,1027412,2021-03-11,House,"Reported With Recommendation With Substitute H-1",8,1,0,0,9
1437276,1065543,2021-04-28,House,"House Third Reading: Given Immediate Effect Roll Call # 154",61,49,0,0,110
1437298,1032932,2021-03-16,House,"Reported With Recommendation With Substitute H-1",12,0,0,0,12
1437298,1058933,2021-04-21,House,"House Third Reading: Given Immediate Effect Roll Call # 127",107,1,0,0,108
1437349,1077669,2021-05-13,House,"Reported With Recommendation With Substitute H-3",9,0,0,0,9
1437349,1090602,2021-06-02,House,"House Third Reading: Given Immediate Effect Roll Call # 282",93,16,0,0,109
1437376,1016598,2021-02-23,House,"Reported With Recommendation With Substitute H-2",6,1,0,0,7
1437376,1025417,2021-03-09,House,"House Third Reading: Given Immediate Effect Roll Call # 26",61,48,0,0,109
1437376,1168090,2022-03-10,Senate,"Reported Favorably Without Amendment",3,1,0,0,4
1437376,1172834,2022-03-17,Senate,"Senate Third Reading: Passed Roll Call # 88",22,16,0,0,38
1437392,1016950,2021-02-23,House,"Reported With Recommendation With Substitute H-3",7,0,0,0,7
1437392,1025515,2021-03-09,House,"House Third Reading: Given Immediate Effect Roll Call # 30",108,1,0,0,109
1437392,1168251,2022-03-10,Senate,"Reported Favorably Without Amendment",3,1,0,0,4
1437424,1057247,2021-04-20,House,"Reported With Recommendation Without Amendment",11,0,0,0,11
1437424,1066797,2021-04-29,House,"House Third Reading: Given Immediate Effect Roll Call # 161",109,0,0,0,109
1437462,1026432,2021-03-09,House,"Reported With Recommendation Without Amendment",13,0,0,0,13
1437462,1058983,2021-04-21,House,"House Third Reading: Given Immediate Effect Roll Call # 125",108,0,0,0,108
1437488,1016739,2021-02-23,House,"Reported With Recommendation With Substitute H-1",7,0,0,0,7
1437488,1025421,2021-03-09,House,"House Third Reading: Given Immediate Effect Roll Call # 31",79,30,0,0,109
1437507,1026377,2021-03-09,House,"Reported With Recommendation With Substitute H-1",13,0,0,0,13
1437507,1054192,2021-04-15,House,"House Third Reading: Given Immediate Effect Roll Call # 110",106,0,0,0,106
1437507,1117268,2021-12-09,Senate,"Reported Favorably Without Amendment",5,0,0,0,5
1437507,1143048,2022-02-10,Senate,"Senate Third Reading: Given Immediate Effect Roll Call # 22",38,0,0,0,38
1437541,1032938,2021-03-16,House,"Reported With Recommendation With Substitute H-1",13,0,0,0,13
1437541,1059209,2021-04-21,House,"House Third Reading: Given Immediate Effect Roll Call # 126",108,0,0,0,108
1437560,1016626,2021-02-23,House,"Reported With Recommendation Without Amendment",7,0,0,0,7
1437560,1025420,2021-03-09,House,"House Third Reading: Given Immediate Effect Roll Call # 29",109,0,0,0,109
1437560,1167997,2022-03-10,Senate,"Reported Favorably Without Amendment",4,0,0,0,4
1437594,1026490,2021-03-09,House,"Reported With Recommendation With Substitute H-1",8,4,0,0,12
1437594,1085582,2021-05-26,House,"House Third Reading: Given Immediate Effect Roll Call # 240",65,44,0,0,109
1437594,1148765,2022-02-17,Senate,"Reported Favorably Without Amendment",4,0,0,0,4
1437619,1009947,2021-02-18,House,"Reported With Recommendation With Substitute H-1",9,0,0,0,9
1437619,1014276,2021-02-23,House,"House Third Reading: Given Immediate Effect Roll Call # 12",109,0,0,0,109
1437619,1032904,2021-03-18,Senate,"Reported Favorably Without Amendment",5,0,0,0,5
1437619,1037934,2021-03-25,Senate,"Senate Third Reading: Given Immediate Effect Roll Call # 80",34,1,0,1,36
1437651,1138667,2022-02-08,House,"Reported With Recommendation With Substitute H-2",7,0,0,0,7
1437651,1176782,2022-03-24,House,"House Third Reading: Given Immediate Effect Roll Call # 149",58,44,0,0,102
1437683,1016668,2021-02-23,House,"Reported With Recommendation With Substitute H-2",7,0,0,0,7
1437683,1025436,2021-03-09,House,"House Third Reading: Given Immediate Effect Roll Call # 27",66,43,0,0,109
1437683,1167993,2022-03-10,Senate,"Reported Favorably Without Amendment",3,1,0,0,4
1437683,1172888,2022-03-17,Senate,"Senate Third Reading: Passed Roll Call # 89",22,16,0,0,38
1437706,1016712,2021-02-23,House,"Reported With Recommendation Without Amendment",7,0,0,0,7
1437706,1025418,2021-03-09,House,"House Third Reading: Given Immediate Effect Roll Call # 32",104,5,0,0,109
1437762,1030033,2021-03-16,House,"Reported With Recommendation With Substitute H-1",13,0,0,0,13
1437762,1059438,2021-04-21,House,"House Third Reading: Given Immediate Effect Roll Call # 128",108,0,0,0,108
1437799,1032921,2021-03-16,House,"Reported With Recommendation With Substitute H-2",13,0,0,0,13
1437799,1053975,2021-04-15,House,"House Third Reading: Given Immediate Effect Roll Call # 112",106,0,0,0,106
1437799,1117274,2021-12-09,Senate,"Reported Favorably With Substitute S-2",5,0,0,0,5
1437799,1142629,2022-02-10,Senate,"Senate Third Reading: Given Immediate Effect Roll Call # 24",38,0,0,0,38
1437799,1153115,2022-02-23,House,"House Third Reading: Roll Call # 68",101,3,0,0,104
1437834,1110145,2021-10-06,Senate,"Reported Favorably With Substitute S-2",8,2,0,0,10
1437834,1110658,2021-10-26,Senate,"Senate Third Reading: Given Immediate Effect Roll Call # 411",28,6,0,2,36
1437834,1116424,2021-11-10,House,"Reported With Recommendation Without Amendment",11,2,0,0,13
1437834,1116615,2021-12-01,House,"House Third Reading: Given Immediate Effect Roll Call # 565",71,29,0,0,100
1442256,1116657,2021-12-01,House,"Reported With Recommendation With Substitute H-1",26,0,0,0,26
1442256,1128695,2022-01-25,House,"House Third Reading: Given Immediate Effect Roll Call # 5",96,5,0,0,101
1442349,1052277,2021-04-13,House,"Reported With Recommendation With Substitute H-1",8,3,0,0,11
1442548,1035423,2021-03-23,House,"Reported With Recommendation Without Amendment",13,0,0,0,13
1442548,1057408,2021-04-20,House,"House Third Reading: Given Immediate Effect Roll Call # 115",107,2,0,0,109
1442573,1022625,2021-03-04,House,"Reported With Recommendation With Substitute H-1",16,0,0,0,16
1442573,1032903,2021-03-17,House,"House Third Reading: Given Immediate Effect Roll Call # 51",106,3,0,0,109
1442573,1110897,2021-10-28,Senate,"Reported Favorably Without Amendment",9,0,0,0,9
1442573,1116483,2021-11-10,Senate,"Senate Third Reading: Given Immediate Effect Roll Call # 435",35,0,0,1,36
1442573,1116641,2021-12-02,House,"House Third Reading: Roll Call # 579",96,3,0,0,99
1442649,1016501,2021-02-25,Senate,"Reported Favorably With Substitute S-2",4,1,0,0,5
1442649,1016502,2021-02-25,Senate,"Senate Third Reading: Passed Roll Call # 30",19,15,1,1,36
1442649,1016503,2021-02-25,Senate,"Senate Third Reading: Passed Roll Call # 31",20,14,1,1,36
1442649,1016504,2021-02-25,Senate,"Senate Third Reading: Passed Roll Call # 32",20,15,0,1,36
1442649,1026728,2021-03-10,House,"House Third Reading: Given Immediate Effect Roll Call # 43",66,44,0,0,110
1442649,1032906,2021-03-17,Senate,"Senate Third Reading: Roll Call: Roll Call # 57",20,15,0,1,36
1442649,1032907,2021-03-17,House,"House Third Reading: Roll Call # 49",64,45,0,0,109
1442675,1022602,2021-03-04,House,"Reported With Recommendation Without Amendment",16,0,0,0,16
1442675,1032916,2021-03-17,House,"House Third Reading: Given Immediate Effect Roll Call # 50",106,3,0,0,109
1442675,1110918,2021-10-28,Senate,"Reported Favorably Without Amendment",9,0,0,0,9
1442675,1116224,2021-11-10,Senate,"Senate Third Reading: Given Immediate Effect Roll Call # 434",35,0,0,1,36
1442675,1116225,2021-11-10,House,"House Third Reading: Roll Call # 558",103,2,0,0,105
1442775,1146403,2022-02-15,House,"Reported With Recommendation Without Amendment",12,0,0,0,12
1442775,1155266,2022-02-24,House,"House Third Reading: Given Immediate Effect Roll Call # 75",102,0,0,0,102
1442775,1217834,2022-06-07,Senate,"Reported Favorably Without Amendment",8,0,0,0,8
1442775,1217835,2022-06-15,Senate,"Senate Third Reading: Given Immediate Effect Roll Call # 319",37,0,0,1,38
1444522,1032927,2021-03-17,Senate,"Reported Favorably Without Amendment",9,0,0,0,9
1444522,1037037,2021-03-24,Senate,"Senate Third Reading: Passed Roll Call # 73",35,0,0,1,36
1444550,1064720,2021-04-28,Senate,"Reported Favorably Without Amendment",9,0,0,0,9
1444550,1073504,2021-05-05,Senate,"Senate Third Reading: Passed Roll Call # 120",36,0,0,0,36
1444605,1016829,2021-02-25,Senate,"Reported Favorably With Substitute S-1",12,6,0,0,18
1444605,1022630,2021-03-04,Senate,"Senate Third Reading: Passed Roll Call # 43",35,0,0,1,36
1444605,1035496,2021-03-23,House,"Reported With Recommendation With Substitute H-1",13,0,0,0,13
1444605,1065942,2021-04-29,House,"House Third Reading: Given Immediate Effect Roll Call # 160",109,0,0,0,109
1444605,1073208,2021-05-05,Senate,"Senate Third Reading: Roll Call: Roll Call # 115",36,0,0,0,36
1444636,1012131,2021-02-18,Senate,"Reported Favorably Without Amendment",4,0,0,0,4
1444636,1016306,2021-02-24,Senate,"Senate Third Reading: Passed Roll Call # 15",35,0,0,1,36
1444716,1095435,2021-06-09,Senate,"Reported Favorably Without Amendment",4,2,0,0,6
1444795,1065058,2021-04-28,Senate,"Reported Favorably With Substitute S-1",9,0,0,0,9
1444795,1073510,2021-05-05,Senate,"Senate Third Reading: Passed Roll Call # 121",36,0,0,0,36
1444795,1100387,2021-06-22,House,"Reported With Recommendation Without Amendment",14,0,0,0,14
1444795,1109411,2021-09-29,House,"House Third Reading: Given Immediate Effect Roll Call # 445",104,0,0,0,104
1444877,1032918,2021-03-17,Senate,"Reported Favorably Without Amendment",9,0,0,0,9
1444877,1035842,2021-03-24,Senate,"Senate Third Reading: Passed Roll Call # 74",35,0,0,1,36
1444979,1035490,2021-03-23,House,"Reported With Recommendation Without Amendment",12,1,0,0,13
1444979,1057623,2021-04-20,House,"House Third Reading: Given Immediate Effect Roll Call # 116",100,9,0,0,109
1444979,1101460,2021-06-24,Senate,"Reported Favorably Without Amendment",7,0,0,0,7
1444979,1101461,2021-06-24,Senate,"Senate Third Reading: Given Immediate Effect Roll Call # 305",35,0,0,1,36
1445051,1079471,2021-05-18,House,"Reported With Recommendation Without Amendment",13,0,0,0,13
1445051,1086246,2021-05-26,House,"House Third Reading: Given Immediate Effect Roll Call # 245",106,3,0,0,109
1445051,1110085,2021-10-06,Senate,"Reported Favorably Without Amendment",8,0,0,0,8
1445051,1110654,2021-10-26,Senate,"Senate Third Reading: Passed Roll Call # 403",34,0,0,2,36
1445084,1109604,2021-10-05,House,"Reported With Recommendation Without Amendment",9,2,0,0,11
1445223,1026434,2021-03-09,House,"Reported With Recommendation With Substitute H-1",7,4,0,0,11
1445223,1032919,2021-03-17,House,"House Third Reading: Given Immediate Effect Roll Call # 52",59,50,0,0,109
1445223,1037326,2021-03-25,Senate,"Reported Favorably Without Amendment",7,3,0,0,10
1445223,1037327,2021-03-25,Senate,"Senate Third Reading: Passed Roll Call # 85",20,15,0,1,36
1445262,1035592,2021-03-23,House,"Reported With Recommendation Without Amendment",11,1,0,0,12
1445262,1057900,2021-04-20,House,"House Third Reading: Given Immediate Effect Roll Call # 119",102,7,0,0,109
1445262,1101062,2021-06-24,Senate,"Reported Favorably Without Amendment",7,0,0,0,7
1445262,1101063,2021-06-24,Senate,"Senate Third Reading: Given Immediate Effect Roll Call # 308",35,0,0,1,36
1445298,1102031,2021-06-24,House,"Reported With Recommendation Without Amendment",9,0,0,0,9
1445298,1103290,2021-06-30,House,"House Third Reading: Given Immediate Effect Roll Call # 412",103,6,0,0,109
1445298,1172706,2022-03-17,Senate,"Reported Favorably Without Amendment",5,0,0,0,5
1445298,1175440,2022-03-23,Senate,"Senate Third Reading: Given Immediate Effect Roll Call # 104",37,0,0,1,38
1445405,1051498,2021-04-13,House,"Reported With Recommendation With Substitute H-1",5,2,0,0,7
1445405,1063662,2021-04-27,House,"House Third Reading: Given Immediate Effect Roll Call # 144",60,49,0,0,109
1445513,1100061,2021-06-22,House,"Reported With Recommendation With Amendment(s)",5,4,0,0,9
1445546,1035498,2021-03-23,House,"Reported With Recommendation Without Amendment",11,1,0,0,12
1445546,1057415,2021-04-20,House,"House Third Reading: Given Immediate Effect Roll Call # 117",102,7,0,0,109
1445546,1101052,2021-06-24,Senate,"Reported Favorably Without Amendment",7,0,0,0,7
1445546,1101053,2021-06-24,Senate,"Senate Third Reading: Given Immediate Effect Roll Call # 306",35,0,0,1,36
1445585,1128662,2022-01-25,House,"Reported With Recommendation With Substitute H-1",10,0,0,0,10
1445585,1148204,2022-02-16,House,"House Third Reading: Given Immediate Effect Roll Call # 49",104,0,0,0,104
1445585,1221631,2022-06-30,Senate,"Reported Favorably With Substitute S-2",17,0,0,0,17
1445585,1221632,2022-06-30,Senate,"Senate Third Reading: Given Immediate Effect Roll Call # 391",38,0,0,0,38
1445585,1221633,2022-06-30,House,"House Third Reading: Roll Call # 350",103,3,0,0,106
1445618,1101946,2021-06-24,House,"Reported With Recommendation Without Amendment",8,0,0,0,8
1445618,1103572,2021-06-30,House,"House Third Reading: Given Immediate Effect Roll Call # 411",103,6,0,0,109
1445618,1172139,2022-03-17,Senate,"Reported Favorably Without Amendment",5,0,0,0,5
1445618,1175916,2022-03-23,Senate,"Senate Third Reading: Given Immediate Effect Roll Call # 103",37,0,0,1,38
1445653,1117242,2021-12-09,House,"Reported With Recommendation Without Amendment",18,0,0,0,18
1445653,1140091,2022-02-09,House,"House Third Reading: Given Immediate Effect Roll Call # 36",106,0,0,0,106
1445728,1035502,2021-03-23,House,"Reported With Recommendation Without Amendment",12,1,0,0,13
1445728,1057513,2021-04-20,House,"House Third Reading: Given Immediate Effect Roll Call # 118",100,9,0,0,109
1445728,1101426,2021-06-24,Senate,"Reported Favorably Without Amendment",7,0,0,0,7
1445728,1101427,2021-06-24,Senate,"Senate Third Reading: Given Immediate Effect Roll Call # 307",35,0,0,1,36
1447402,1229282,2022-10-11,Senate,"Reported Favorably With Substitute S-3",3,0,0,0,3
1447535,1084173,2021-05-25,Senate,"Reported Favorably Without Amendment",9,0,0,0,9
1447535,1097003,2021-06-09,Senate,"Senate Third Reading: Passed Roll Call # 257",35,0,0,1,36
1447535,1117090,2021-12-08,House,"Reported With Recommendation Without Amendment",11,0,0,0,11
1447535,1153639,2022-02-23,House,"House Third Reading: Given Immediate Effect Roll Call # 69",104,0,0,0,104
1447863,1072300,2021-05-04,House,"Reported With Recommendation Without Amendment",14,0,0,0,14
1447863,1080107,2021-05-19,House,"House Third Reading: Given Immediate Effect Roll Call # 213",107,1,0,0,108
1447916,1052894,2021-04-14,House,"Reported With Recommendation Without Amendment",9,6,0,0,15
1447916,1076279,2021-05-11,House,"House Third Reading: Given Immediate Effect Roll Call # 177",58,49,0,0,107
1447916,1096751,2021-06-10,Senate,"Reported Favorably Without Amendment",5,1,0,0,6
1447972,1084208,2021-05-25,House,"Reported With Recommendation Without Amendment",11,0,0,0,11
1447972,1098259,2021-06-15,House,"House Third Reading: Given Immediate Effect Roll Call # 328",106,3,0,0,109
1447972,1098260,2021-06-15,House,"House Third Reading: Passed Roll Call # 332",108,1,0,0,109
1447972,1230509,2022-12-06,Senate,"Reported Favorably Without Amendment",8,0,0,0,8
1448028,1084227,2021-05-25,House,"Reported With Recommendation Without Amendment",11,0,0,0,11
1448028,1098257,2021-06-15,House,"House Third Reading: Given Immediate Effect Roll Call # 329",108,1,0,0,109
1448196,1115408,2021-11-02,House,"Reported With Recommendation Without Amendment",13,0,0,0,13
1448196,1116974,2021-12-07,House,"House Third Reading: Given Immediate Effect Roll Call # 583",64,39,0,0,103
1448196,1203589,2022-05-11,Senate,"Reported Favorably With Substitute S-2",6,4,0,0,10
1448196,1217699,2022-05-19,Senate,"Senate Third Reading: Given Immediate Effect Roll Call # 248",25,11,0,2,38
1448196,1217700,2022-06-07,House,"House Third Reading: Roll Call # 280",78,29,0,0,107
1448309,1016699,2021-02-23,House,"Reported With Recommendation With Substitute H-1",11,2,0,0,13
1448309,1026336,2021-03-10,House,"House Third Reading: Given Immediate Effect Roll Call # 38",93,17,0,0,110
1448309,1071876,2021-05-04,Senate,"Reported Favorably With Substitute S-1",7,0,0,0,7
1448309,1096877,2021-06-10,Senate,"Senate Third Reading: Passed Roll Call # 265",30,4,1,1,36
1448309,1096878,2021-06-10,Senate,"Senate Third Reading: Passed Roll Call # 267",29,5,1,1,36
1448309,1106268,2021-08-17,House,"House Third Reading: Roll Call # 426",92,16,0,0,108
1448422,1030000,2021-03-16,House,"Reported With Recommendation With Substitute H-1",12,0,0,0,12
1448422,1036637,2021-03-24,House,"House Third Reading: Given Immediate Effect Roll Call # 86",100,7,0,0,107
1448760,1098017,2021-06-15,House,"Reported With Recommendation With Substitute H-1",12,0,0,0,12
1448760,1101893,2021-06-24,House,"House Third Reading: Given Immediate Effect Roll Call # 375",84,23,0,0,107
1448874,1016804,2021-02-25,House,"Reported With Recommendation With Substitute H-1",11,0,0,0,11
1448874,1021465,2021-03-03,House,"House Third Reading: Given Immediate Effect Roll Call # 24",104,6,0,0,110
1448874,1080914,2021-05-20,Senate,"Reported Favorably With Substitute S-1",7,0,0,0,7
1448874,1090210,2021-06-02,Senate,"Senate Third Reading: Given Immediate Effect Roll Call # 241",36,0,0,0,36
1448874,1095090,2021-06-08,House,"House Third Reading: Roll Call # 297",102,7,0,0,109
1448874,1105918,2021-06-30,House,"House Third Reading: Motion To Override Veto Failed Roll Call # 400",62,47,0,0,109
1449152,1016635,2021-02-25,House,"Reported With Recommendation With Substitute H-2",11,0,0,0,11
1449152,1021712,2021-03-03,House,"House Third Reading: Given Immediate Effect Roll Call # 25",104,6,0,0,110
1449152,1081756,2021-05-20,Senate,"Reported Favorably With Substitute S-1",7,0,0,0,7
1449152,1090059,2021-06-02,Senate,"Senate Third Reading: Given Immediate Effect Roll Call # 242",36,0,0,0,36
1449152,1094678,2021-06-08,House,"House Third Reading: Roll Call # 298",102,7,0,0,109
1449152,1105991,2021-06-30,House,"House Third Reading: Motion To Override Veto Failed Roll Call # 401",62,47,0,0,109
1449265,1032926,2021-03-16,House,"Reported With Recommendation With Substitute H-1",13,0,0,0,13
1449265,1036587,2021-03-24,House,"House Third Reading: Given Immediate Effect Roll Call # 87",100,7,0,0,107
1449377,1203620,2022-05-10,House,"Reported With Recommendation Without Amendment",12,0,0,0,12
1449377,1209889,2022-05-25,House,"House Third Reading: Given Immediate Effect Roll Call # 273",106,1,0,0,107
1449433,1098116,2021-06-15,House,"Reported With Recommendation Without Amendment",13,0,0,0,13
1449433,1102073,2021-06-24,House,"House Third Reading: Given Immediate Effect Roll Call # 376",83,24,0,0,107
1449487,1016665,2021-02-23,House,"Reported With Recommendation With Substitute H-1",11,2,0,0,13
1449487,1026334,2021-03-10,House,"House Third Reading: Given Immediate Effect Roll Call # 39",93,17,0,0,110
1449487,1071553,2021-05-04,Senate,"Reported Favorably With Substitute S-1",7,0,0,0,7
1449487,1096838,2021-06-10,Senate,"Senate Third Reading: Passed Roll Call # 266",29,5,1,1,36
1449487,1106263,2021-08-17,House,"House Third Reading: Roll Call # 427",92,16,0,0,108
1451811,1036626,2021-03-24,Senate,"Reported Favorably With Substitute S-1",4,0,0,0,4
1451811,1037996,2021-03-25,Senate,"Senate Third Reading: Passed Roll Call # 83",34,1,0,1,36
1451811,1058004,2021-04-20,House,"Reported With Recommendation Without Amendment",15,0,0,0,15
1451811,1073980,2021-05-06,House,"House Third Reading: Given Immediate Effect Roll Call # 173",107,0,0,0,107
1451863,1036009,2021-03-24,Senate,"Reported Favorably With Substitute S-1",4,0,0,0,4
1451863,1037950,2021-03-25,Senate,"Senate Third Reading: Passed Roll Call # 82",34,1,0,1,36
1451863,1057560,2021-04-20,House,"Reported With Recommendation Without Amendment",15,0,0,0,15
1451863,1073792,2021-05-06,House,"House Third Reading: Given Immediate Effect Roll Call # 172",107,0,0,0,107
1451886,1052169,2021-04-13,Senate,"Reported Favorably With Substitute S-1",10,0,0,0,10
1451886,1058974,2021-04-21,Senate,"Senate Third Reading: Passed Roll Call # 95",33,1,0,2,36
1451886,1214805,2022-06-07,House,"Reported With Recommendation With Substitute H-1",10,1,0,0,11
1451886,1221640,2022-06-30,House,"House Third Reading: Given Immediate Effect Roll Call # 357",96,10,0,0,106
1451886,1221641,2022-07-01,Senate,"Senate Third Reading: Roll Call: Roll Call # 401",36,1,0,1,38
1451964,1036347,2021-03-24,Senate,"Reported Favorably With Substitute S-1",4,0,0,0,4
1451964,1037897,2021-03-25,Senate,"Senate Third Reading: Passed Roll Call # 84",34,1,0,1,36
1451964,1057325,2021-04-20,House,"Reported With Recommendation Without Amendment",15,0,0,0,15
1451964,1073886,2021-05-06,House,"House Third Reading: Given Immediate Effect Roll Call # 174",106,0,0,0,106
1452057,1035886,2021-03-24,Senate,"Reported Favorably With Substitute S-1",4,0,0,0,4
1452057,1037434,2021-03-25,Senate,"Senate Third Reading: Passed Roll Call # 81",34,1,0,1,36
1452057,1057361,2021-04-20,House,"Reported With Recommendation Without Amendment",15,0,0,0,15
1452057,1073906,2021-05-06,House,"House Third Reading: Given Immediate Effect Roll Call # 171",107,0,0,0,107
1452143,1117030,2021-12-07,House,"Reported With Recommendation With Substitute H-1",10,1,0,0,11
1452143,1142684,2022-02-10,House,"House Third Reading: Given Immediate Effect Roll Call # 47",101,4,0,0,105
1452143,1176807,2022-03-24,Senate,"Reported Favorably Without Amendment",10,0,0,0,10
1452143,1188317,2022-04-13,Senate,"Senate Third Reading: Given Immediate Effect Roll Call # 112",38,0,0,0,38
1452194,1035652,2021-03-23,House,"Reported With Recommendation With Substitute H-1",15,0,0,0,15
1452194,1081417,2021-05-20,House,"Reported With Recommendation With Substitute H-4",10,0,0,0,10
1452194,1091108,2021-06-03,House,"House Third Reading: Given Immediate Effect Roll Call # 291",108,2,0,0,110
1452220,1054147,2021-04-15,House,"Reported With Recommendation Without Amendment",9,0,0,0,9
1452220,1063626,2021-04-27,House,"House Third Reading: Given Immediate Effect Roll Call # 152",59,50,0,0,109
1452220,1109413,2021-09-29,Senate,"Reported Favorably With Substitute S-1",4,0,0,0,4
1452220,1116698,2021-11-30,Senate,"Senate Third Reading: Passed Roll Call # 449",24,12,1,1,38
1452220,1116699,2021-11-30,Senate,"Senate Third Reading: Passed Roll Call # 450",25,12,0,1,38
1452220,1117007,2021-12-07,House,"House Third Reading: Roll Call # 580",70,33,0,0,103
1452248,1027500,2021-03-11,House,"Reported With Recommendation Without Amendment",11,0,0,0,11
1452248,1037932,2021-03-25,House,"House Third Reading: Given Immediate Effect Roll Call # 92",103,3,0,0,106
1452297,1035549,2021-03-23,House,"Reported With Recommendation With Substitute H-1",15,0,0,0,15
1452297,1091514,2021-06-03,House,"House Third Reading: Given Immediate Effect Roll Call # 290",107,3,0,0,110
1452321,1008913,2021-02-17,House,"Reported With Recommendation Without Amendment",29,0,0,0,29
1452321,1021787,2021-03-03,House,"House Third Reading: Given Immediate Effect Roll Call # 22",110,0,0,0,110
1452348,1073859,2021-05-06,House,"Reported With Recommendation Without Amendment",6,2,0,0,8
1452348,1086157,2021-05-26,House,"House Third Reading: Given Immediate Effect Roll Call # 242",66,43,0,0,109
1452348,1142200,2022-02-10,Senate,"Reported Favorably With Substitute S-2",5,0,0,0,5
1452348,1151404,2022-02-22,Senate,"Senate Third Reading: Given Immediate Effect Roll Call # 32",37,1,0,0,38
1452348,1160220,2022-03-01,House,"House Third Reading: Roll Call # 79",86,18,0,0,104
1452401,1035727,2021-03-23,House,"Reported With Recommendation With Substitute H-1",15,0,0,0,15
1452401,1091603,2021-06-03,House,"House Third Reading: Given Immediate Effect Roll Call # 289",108,2,0,0,110
1452453,1027623,2021-03-11,House,"Reported With Recommendation Without Amendment",11,0,0,0,11
1452453,1037368,2021-03-25,House,"House Third Reading: Given Immediate Effect Roll Call # 94",104,2,0,0,106
1452453,1230511,2022-12-06,Senate,"Reported Favorably With Substitute S-1",6,0,0,0,6
1452510,1072322,2021-05-04,House,"Reported With Recommendation Without Amendment",14,0,0,0,14
1452510,1087174,2021-05-27,House,"House Third Reading: Given Immediate Effect Roll Call # 264",94,14,0,0,108
1452510,1147046,2022-02-09,Senate,"Reported Favorably Without Amendment",10,0,0,0,10
1452510,1188839,2022-04-14,Senate,"Senate Third Reading: Passed Roll Call # 115",32,4,2,0,38
1452510,1188840,2022-04-14,Senate,"Senate Third Reading: Passed Roll Call # 116",34,4,0,0,38
1452510,1193638,2022-04-26,House,"House Third Reading: Roll Call # 163",80,22,0,0,102
1452537,1027453,2021-03-11,House,"Reported With Recommendation Without Amendment",11,0,0,0,11
1452537,1037454,2021-03-25,House,"House Third Reading: Given Immediate Effect Roll Call # 93",102,4,0,0,106
1452537,1230510,2022-12-06,Senate,"Reported Favorably With Substitute S-1",8,0,0,0,8
1452562,1008709,2021-02-17,House,"Reported With Recommendation Without Amendment",29,0,0,0,29
1452562,1016588,2021-02-25,House,"House Third Reading: Given Immediate Effect Roll Call # 15",109,0,0,0,109
1452562,1109456,2021-09-30,Senate,"Reported Favorably Without Amendment",18,0,0,0,18
1452562,1116557,2021-12-01,Senate,"Senate Third Reading: Given Immediate Effect Roll Call # 455",36,0,0,2,38
1453999,1016525,2021-02-25,Senate,"Reported Favorably Without Amendment",4,1,0,0,5
1454118,1034563,2021-03-23,Senate,"Reported Favorably Without Amendment",8,0,0,0,8
1454243,1024759,2021-02-25,Senate,"Reported Favorably Without Amendment",4,1,0,0,5
1455061,1110489,2021-10-21,Senate,"Reported Favorably With Substitute S-2",7,0,0,0,7
1455061,1110716,2021-10-26,Senate,"Senate Third Reading: Given Immediate Effect Roll Call # 414",32,2,0,2,36
1455061,1110775,2021-10-27,House,"Reported With Recommendation Without Amendment",11,2,0,0,13
1455061,1115454,2021-11-03,House,"House Third Reading: Given Immediate Effect Roll Call # 525",91,12,0,0,103
1455093,1022639,2021-03-04,Senate,"Reported Favorably With Substitute S-1",6,0,0,0,6
1455111,1037379,2021-03-25,Senate,"Reported Favorably Without Amendment",6,1,0,0,7
1455111,1060336,2021-04-22,Senate,"Senate Third Reading: Passed Roll Call # 98",31,3,0,2,36
1455111,1110127,2021-10-13,House,"Reported With Recommendation With Substitute H-3",13,2,0,0,15
1455111,1129188,2022-01-26,House,"House Third Reading: Given Immediate Effect Roll Call # 17",86,16,0,0,102
1455111,1130666,2022-01-27,Senate,"Senate Third Reading: Roll Call: Roll Call # 9",36,1,0,1,38
1455187,1037279,2021-03-25,Senate,"Reported Favorably Without Amendment",6,1,0,0,7
1455187,1060177,2021-04-22,Senate,"Senate Third Reading: Passed Roll Call # 100",29,5,0,2,36
1455187,1110139,2021-10-13,House,"Reported With Recommendation With Substitute H-1",13,2,0,0,15
1455250,1051499,2021-04-13,Senate,"Reported Favorably With Substitute S-1",10,0,0,0,10
1455250,1060078,2021-04-22,Senate,"Senate Third Reading: Passed Roll Call # 102",34,0,0,2,36
1455250,1091353,2021-06-03,House,"Reported With Recommendation Without Amendment",19,0,0,0,19
1455250,1096973,2021-06-10,House,"House Third Reading: Given Immediate Effect Roll Call # 323",109,0,0,0,109
1455266,1022647,2021-03-04,Senate,"Reported Favorably With Substitute S-1",6,0,0,0,6
1455266,1058607,2021-04-21,Senate,"Senate Third Reading: Passed Roll Call # 93",34,0,0,2,36
1455266,1076253,2021-05-11,House,"Reported With Recommendation Without Amendment",14,0,0,0,14
1455266,1086534,2021-05-27,House,"House Third Reading: Given Immediate Effect Roll Call # 265",108,0,0,0,108
1455294,1051724,2021-04-13,Senate,"Reported Favorably With Substitute S-3",10,0,0,0,10
1455294,1060484,2021-04-22,Senate,"Senate Third Reading: Passed Roll Call # 103",34,0,0,2,36
1455294,1091510,2021-06-03,House,"Reported With Recommendation Without Amendment",19,0,0,0,19
1455294,1097052,2021-06-10,House,"House Third Reading: Given Immediate Effect Roll Call # 324",108,1,0,0,109
1455348,1036603,2021-03-24,House,"Reported With Recommendation With Substitute H-5",25,0,0,0,25
1455348,1057876,2021-04-20,House,"House Third Reading: Given Immediate Effect Roll Call # 120",108,0,0,0,108
1455348,1204244,2022-05-12,Senate,"Reported Favorably With Substitute S-1",16,0,0,0,16
1455395,1036566,2021-03-24,House,"Reported With Recommendation With Substitute H-3",25,0,0,0,25
1455395,1057917,2021-04-20,House,"House Third Reading: Given Immediate Effect Roll Call # 123",108,0,0,0,108
1455395,1204251,2022-05-12,Senate,"Reported Favorably With Substitute S-1",17,0,0,0,17
1455430,1108884,2021-09-14,House,"Reported With Recommendation With Substitute H-2",13,1,0,0,14
1455430,1110088,2021-10-14,House,"House Third Reading: Given Immediate Effect Roll Call # 473",94,13,0,0,107
1455473,1036593,2021-03-24,House,"Reported With Recommendation With Substitute H-2",3,2,0,0,5
1455604,1036734,2021-03-24,House,"Reported With Recommendation With Substitute H-2",25,0,0,0,25
1455604,1057942,2021-04-20,House,"House Third Reading: Given Immediate Effect Roll Call # 121",108,0,0,0,108
1455604,1204305,2022-05-12,Senate,"Reported Favorably With Substitute S-1",17,0,0,0,17
1455649,1035395,2021-03-23,House,"Reported With Recommendation Without Amendment",8,3,0,0,11
1455649,1057935,2021-04-20,House,"House Third Reading: Given Immediate Effect Roll Call # 114",75,34,0,0,109
1455649,1095563,2021-06-09,Senate,"Reported Favorably Without Amendment",5,2,0,0,7
1455649,1107843,2021-09-01,Senate,"Senate Third Reading: Passed Roll Call # 345",20,16,0,0,36
1455738,1036556,2021-03-24,House,"Reported With Recommendation With Substitute H-2",16,6,0,0,22
1455738,1057465,2021-04-20,House,"House Third Reading: Given Immediate Effect Roll Call # 122",69,39,0,0,108
1455738,1204252,2022-05-12,Senate,"Reported Favorably With Substitute S-3",17,0,0,0,17
1461281,1026943,2021-03-10,House,"Reported With Recommendation Without Amendment",6,1,0,0,7
1461281,1053184,2021-04-14,House,"House Third Reading: Given Immediate Effect Roll Call # 106",90,20,0,0,110
1461281,1110082,2021-10-14,Senate,"Reported Favorably Without Amendment",4,0,0,0,4
1461281,1119650,2021-12-14,Senate,"Senate Third Reading: Given Immediate Effect Roll Call # 486",35,1,0,2,38
1461299,1026735,2021-03-10,House,"Reported With Recommendation Without Amendment",6,1,0,0,7
1461299,1053725,2021-04-14,House,"House Third Reading: Given Immediate Effect Roll Call # 105",90,20,0,0,110
1461299,1110084,2021-10-14,Senate,"Reported Favorably Without Amendment",4,0,0,0,4
1461299,1119545,2021-12-14,Senate,"Senate Third Reading: Given Immediate Effect Roll Call # 485",35,1,0,2,38
1461318,1027060,2021-03-10,House,"Reported With Recommendation Without Amendment",6,1,0,0,7
1461318,1053665,2021-04-14,House,"House Third Reading: Given Immediate Effect Roll Call # 108",90,20,0,0,110
1461318,1110083,2021-10-14,Senate,"Reported Favorably Without Amendment",4,0,0,0,4
1461318,1119549,2021-12-14,Senate,"Senate Third Reading: Given Immediate Effect Roll Call # 488",35,1,0,2,38
1461335,1064635,2021-04-28,House,"Reported With Recommendation With Substitute H-1",9,1,0,0,10
1461335,1077413,2021-05-13,House,"House Third Reading: Given Immediate Effect Roll Call # 205",88,18,0,0,106
1461335,1086745,2021-05-27,Senate,"Reported Favorably Without Amendment",5,2,0,0,7
1461335,1100620,2021-06-23,Senate,"Senate Third Reading: Given Immediate Effect Roll Call # 291",29,6,0,1,36
1461374,1057885,2021-04-20,House,"Reported With Recommendation With Substitute H-1",15,0,0,0,15
1461374,1077070,2021-05-12,House,"House Third Reading: Given Immediate Effect Roll Call # 198",90,17,0,0,107
1461390,1025962,2021-03-09,House,"Reported With Recommendation With Substitute H-1",12,0,0,0,12
1461390,1026347,2021-03-10,House,"House Third Reading: Given Immediate Effect Roll Call # 44",105,5,0,0,110
1461390,1071593,2021-05-04,Senate,"Reported Favorably Without Amendment",7,0,0,0,7
1461390,1097190,2021-06-10,Senate,"Senate Third Reading: Passed Roll Call # 268",34,0,1,1,36
1461390,1106271,2021-08-17,House,"House Third Reading: Senate Amendment(s) Concurred In Roll Call # 428",104,4,0,0,108
1461410,1072394,2021-05-04,House,"Reported With Recommendation Without Amendment",9,0,0,0,9
1461410,1086574,2021-05-27,House,"House Third Reading: Given Immediate Effect Roll Call # 262",56,52,0,0,108
1461448,1057651,2021-04-20,House,"Reported With Recommendation With Substitute H-1",15,0,0,0,15
1461448,1077126,2021-05-12,House,"House Third Reading: Given Immediate Effect Roll Call # 199",94,13,0,0,107
1461485,1100126,2021-06-22,House,"Reported With Recommendation Without Amendment",7,0,0,0,7
1461485,1105329,2021-07-21,House,"House Third Reading: Given Immediate Effect Roll Call # 422",103,5,0,0,108
1461485,1110122,2021-10-14,Senate,"Reported Favorably Without Amendment",3,0,0,0,3
1461485,1116239,2021-11-10,Senate,"Senate Third Reading: Passed Roll Call # 439",24,11,0,1,36
1461505,1036315,2021-03-24,House,"Reported With Recommendation With Substitute H-2",12,2,0,0,14
1461505,1061250,2021-04-22,House,"House Third Reading: Given Immediate Effect Roll Call # 129",89,15,0,0,104
1461505,1110902,2021-10-28,Senate,"Reported Favorably Without Amendment",6,0,0,0,6
1461563,1036294,2021-03-24,House,"Reported With Recommendation Without Amendment",12,2,0,0,14
1461563,1060701,2021-04-22,House,"House Third Reading: Given Immediate Effect Roll Call # 130",86,18,0,0,104
1461563,1110919,2021-10-28,Senate,"Reported Favorably With Substitute S-1",6,0,0,0,6
1461563,1127094,2022-01-20,Senate,"Senate Third Reading: Given Immediate Effect Roll Call # 7",38,0,0,0,38
1461563,1129303,2022-01-26,House,"House Third Reading: Roll Call # 18",85,17,0,0,102
1461601,1072334,2021-05-04,House,"Reported With Recommendation Without Amendment",10,2,0,0,12
1461601,1128822,2022-01-25,House,"House Third Reading: Given Immediate Effect Roll Call # 4",76,25,0,0,101
1461601,1221688,2022-06-30,Senate,"Reported Favorably Without Amendment",6,0,0,0,6
1461621,1057931,2021-04-20,House,"Reported With Recommendation With Substitute H-1",15,0,0,0,15
1461621,1076911,2021-05-12,House,"House Third Reading: Given Immediate Effect Roll Call # 200",89,18,0,0,107
1461640,1057507,2021-04-20,House,"Reported With Recommendation With Substitute H-1",15,0,0,0,15
1461640,1077098,2021-05-12,House,"House Third Reading: Given Immediate Effect Roll Call # 204",97,10,0,0,107
1461658,1058043,2021-04-20,House,"Reported With Recommendation With Substitute H-1",15,0,0,0,15
1461658,1077076,2021-05-12,House,"House Third Reading: Given Immediate Effect Roll Call # 202",91,16,0,0,107
1461697,1072353,2021-05-04,House,"Reported With Recommendation With Substitute H-1",10,2,0,0,12
1461697,1128664,2022-01-25,House,"House Third Reading: Given Immediate Effect Roll Call # 3",76,25,0,0,101
1461697,1221626,2022-06-30,Senate,"Reported Favorably Without Amendment",6,0,0,0,6
1461717,1110093,2021-10-06,House,"Reported With Recommendation With Substitute H-2",13,0,0,0,13
1461717,1110800,2021-10-27,House,"House Third Reading: Given Immediate Effect Roll Call # 509",95,11,0,0,106
1461717,1115530,2021-11-02,Senate,"Senate Third Reading: Given Immediate Effect Roll Call # 426",35,0,0,1,36
1461736,1057233,2021-04-20,House,"Reported With Recommendation With Substitute H-1",15,0,0,0,15
1461736,1077071,2021-05-12,House,"House Third Reading: Given Immediate Effect Roll Call # 203",90,17,0,0,107
1461753,1034846,2021-03-23,House,"Reported With Recommendation With Substitute H-1",14,1,0,0,15
1461753,1084769,2021-05-25,House,"House Third Reading: Given Immediate Effect Roll Call # 235",97,11,0,0,108
1461753,1109424,2021-09-29,Senate,"Reported Favorably With Substitute S-1",8,1,0,0,9
1461753,1109955,2021-10-13,Senate,"Senate Third Reading: Given Immediate Effect Roll Call # 381",35,1,0,0,36
1461753,1110733,2021-10-26,House,"House Third Reading: Roll Call # 495",97,7,0,0,104
1461791,1026522,2021-03-10,House,"Reported With Recommendation Without Amendment",6,1,0,0,7
1461791,1053697,2021-04-14,House,"House Third Reading: Given Immediate Effect Roll Call # 107",90,20,0,0,110
1461791,1110140,2021-10-14,Senate,"Reported Favorably Without Amendment",4,0,0,0,4
1461791,1119552,2021-12-14,Senate,"Senate Third Reading: Given Immediate Effect Roll Call # 487",35,1,0,2,38
1461810,1072314,2021-05-04,House,"Reported With Recommendation Without Amendment",9,0,0,0,9
1461810,1086741,2021-05-27,House,"House Third Reading: Given Immediate Effect Roll Call # 263",56,52,0,0,108
1461810,1119551,2021-12-14,Senate,"Reported Favorably With Substitute S-1",8,0,0,0,8
1461810,1119671,2021-12-14,Senate,"Senate Third Reading: Given Immediate Effect Roll Call # 497",23,13,0,2,38
1461810,1119672,2021-12-14,House,"House Third Reading: Roll Call # 632",55,48,0,0,103
1461822,1057966,2021-04-20,House,"Reported With Recommendation With Substitute H-1",15,0,0,0,15
1461822,1076975,2021-05-12,House,"House Third Reading: Given Immediate Effect Roll Call # 201",91,16,0,0,107
1461870,1072311,2021-05-04,House,"Reported With Recommendation With Substitute H-1",10,2,0,0,12
1461870,1128404,2022-01-25,House,"House Third Reading: Given Immediate Effect Roll Call # 2",75,26,0,0,101
1461870,1221614,2022-06-30,Senate,"Reported Favorably With Substitute S-1",6,0,0,0,6
1461945,1026159,2021-03-09,House,"Reported With Recommendation Without Amendment",12,0,0,0,12
1461945,1026410,2021-03-10,House,"House Third Reading: Given Immediate Effect Roll Call # 45",105,5,0,0,110
1461945,1071592,2021-05-04,Senate,"Reported Favorably Without Amendment",7,0,0,0,7
1461945,1097177,2021-06-10,Senate,"Senate Third Reading: Passed Roll Call # 269",34,0,1,1,36
1461945,1106264,2021-08-17,House,"House Third Reading: Senate Amendment(s) Concurred In Roll Call # 429",104,4,0,0,108
1462022,1109474,2021-09-30,House,"Reported With Recommendation With Substitute H-2",11,7,0,0,18
1462022,1110816,2021-10-27,House,"House Third Reading: Given Immediate Effect Roll Call # 500",56,48,0,0,104
1462022,1133845,2022-02-01,Senate,"Reported Favorably Without Amendment",6,4,0,0,10
1462690,1035489,2021-03-23,Senate,"Reported Favorably Without Amendment",6,2,0,0,8
1462690,1037248,2021-03-24,Senate,"Senate Third Reading: Passed Roll Call # 77",35,0,0,1,36
1462743,1032900,2021-03-18,Senate,"Reported Favorably With Substitute S-1",4,1,0,0,5
1462779,1035495,2021-03-23,Senate,"Reported Favorably Without Amendment",6,2,0,0,8
1462779,1037276,2021-03-24,Senate,"Senate Third Reading: Passed Roll Call # 76",35,0,0,1,36
1462853,1024569,2021-03-04,House,"Reported With Recommendation With Substitute H-1",4,0,0,0,4
1462874,1022683,2021-03-04,House,"Reported With Recommendation Without Amendment",5,0,0,0,5
1462891,1035511,2021-03-23,Senate,"Reported Favorably Without Amendment",6,2,0,0,8
1462891,1037313,2021-03-24,Senate,"Senate Third Reading: Passed Roll Call # 75",20,15,0,1,36
1462907,1030058,2021-03-11,Senate,"Reported Favorably Without Amendment",10,0,0,0,10
1462907,1037421,2021-03-24,Senate,"Senate Third Reading: Passed Roll Call # 72",34,0,1,1,36
1462907,1115553,2021-11-04,House,"Reported With Recommendation Without Amendment",18,0,0,0,18
1462907,1200135,2022-05-04,House,"House Third Reading: Given Immediate Effect Roll Call # 182",103,0,0,0,103
1462907,1219000,2022-05-11,Senate,"Senate Third Reading: Roll Call: Roll Call # 206",33,0,0,5,38
1463011,1022666,2021-03-04,Senate,"Reported Favorably Without Amendment",5,0,0,0,5
1463011,1026698,2021-03-10,Senate,"Senate Third Reading: Passed By 3/4 Vote Roll Call # 45",35,0,0,1,36
1463011,1084783,2021-05-25,House,"Reported With Recommendation With Substitute H-1",14,0,0,0,14
1463011,1219128,2022-05-19,House,"House Third Reading: Given Immediate Effect Roll Call # 249",104,1,0,0,105
1463011,1226316,2022-09-20,Senate,"Senate Third Reading: Roll Call: Roll Call # 406",35,0,1,2,38
1463062,1032947,2021-03-17,House,"Reported With Recommendation Without Amendment",18,0,0,0,18
1463062,1036552,2021-03-24,House,"House Third Reading: Given Immediate Effect Roll Call # 77",100,7,0,0,107
1463076,1032912,2021-03-18,House,"Reported With Recommendation With Substitute H-1",12,7,0,0,19
1463076,1036188,2021-03-24,House,"House Third Reading: Given Immediate Effect Roll Call # 78",56,51,0,0,107
1463141,1032908,2021-03-18,House,"Reported With Recommendation With Substitute H-1",14,3,0,0,17
1463141,1036400,2021-03-24,House,"House Third Reading: Given Immediate Effect Roll Call # 80",91,15,0,0,106
1463191,1034228,2021-03-10,House,"Reported With Recommendation Without Amendment",14,2,0,0,16
1463191,1036267,2021-03-24,House,"House Third Reading: Given Immediate Effect Roll Call # 81",82,25,0,0,107
1463191,1097995,2021-06-15,Senate,"Reported Favorably With Substitute S-3",7,3,0,0,10
1463191,1098868,2021-06-17,Senate,"Senate Third Reading: Passed Roll Call # 289",31,4,0,1,36
1463191,1101105,2021-06-24,Senate,"Senate Third Reading: Given Immediate Effect Roll Call # 321",31,4,0,1,36
1463191,1101867,2021-06-24,House,"House Third Reading: Roll Call # 389",95,13,0,0,108
1463191,1101868,2021-06-24,House,"House Third Reading: Roll Call # 393",96,12,0,0,108
1463212,1032917,2021-03-17,House,"Reported With Recommendation With Substitute H-3",18,0,0,0,18
1463212,1036132,2021-03-24,House,"House Third Reading: Given Immediate Effect Roll Call # 71",101,6,0,0,107
1463234,1030095,2021-03-16,House,"Reported With Recommendation Without Amendment",8,5,0,0,13
1463234,1079547,2021-05-18,House,"House Third Reading: Given Immediate Effect Roll Call # 209",59,49,0,0,108
1463234,1167344,2022-03-09,Senate,"Reported Favorably With Substitute S-1",5,1,0,0,6
1463286,1036375,2021-03-24,House,"Reported With Recommendation Without Amendment",10,3,0,0,13
1463353,1022599,2021-03-04,House,"Reported With Recommendation With Substitute H-1",14,2,0,0,16
1463353,1036360,2021-03-24,House,"House Third Reading: Given Immediate Effect Roll Call # 73",91,16,0,0,107
1463498,1032902,2021-03-18,House,"Reported With Recommendation Without Amendment",19,0,0,0,19
1463498,1036084,2021-03-24,House,"House Third Reading: Given Immediate Effect Roll Call # 84",104,3,0,0,107
1463590,1032914,2021-03-18,House,"Reported With Recommendation With Substitute H-1",18,1,0,0,19
1463590,1036508,2021-03-24,House,"House Third Reading: Given Immediate Effect Roll Call # 70",97,10,0,0,107
1463590,1142302,2022-02-09,Senate,"Reported Favorably With Substitute S-1",7,0,0,0,7
1463590,1146978,2022-02-15,Senate,"Senate Third Reading: Given Immediate Effect Roll Call # 27",38,0,0,0,38
1463590,1146979,2022-02-16,House,"House Third Reading: Roll Call # 56",101,4,0,0,105
1463615,1027460,2021-03-11,House,"Reported With Recommendation With Substitute H-3",19,0,0,0,19
1463615,1036574,2021-03-24,House,"House Third Reading: Given Immediate Effect Roll Call # 75",106,1,0,0,107
1463615,1142258,2022-02-01,Senate,"Reported Favorably Without Amendment",10,0,0,0,10
1463615,1147602,2022-02-16,Senate,"Senate Third Reading: Given Immediate Effect Roll Call # 30",38,0,0,0,38
1463615,1147603,2022-02-16,House,"House Third Reading: Roll Call # 57",104,1,0,0,105
1463637,1032945,2021-03-18,House,"Reported With Recommendation Without Amendment",19,0,0,0,19
1463637,1036147,2021-03-24,House,"House Third Reading: Given Immediate Effect Roll Call # 83",99,8,0,0,107
1463710,1027618,2021-03-11,House,"Reported With Recommendation Without Amendment",18,0,0,0,18
1463710,1036459,2021-03-24,House,"House Third Reading: Given Immediate Effect Roll Call # 72",98,9,0,0,107
1463736,1027465,2021-03-11,House,"Reported With Recommendation With Substitute H-1",19,0,0,0,19
1463736,1036382,2021-03-24,House,"House Third Reading: Given Immediate Effect Roll Call # 82",100,7,0,0,107
1463757,1082284,2021-05-20,House,"Reported With Recommendation With Substitute H-1",8,0,0,0,8
1463757,1099095,2021-06-17,House,"House Third Reading: Given Immediate Effect Roll Call # 334",110,0,0,0,110
1463757,1172741,2022-03-17,Senate,"Reported Favorably Without Amendment",5,0,0,0,5
1463757,1175923,2022-03-23,Senate,"Senate Third Reading: Passed Roll Call # 105",37,0,0,1,38
1463781,1026863,2021-03-10,House,"Reported With Recommendation With Substitute H-1",9,0,0,0,9
1463781,1072027,2021-05-04,House,"House Third Reading: Given Immediate Effect Roll Call # 163",109,1,0,0,110
1463781,1082300,2021-05-20,Senate,"Reported Favorably Without Amendment",7,0,0,0,7
1463781,1091946,2021-06-03,Senate,"Senate Third Reading: Passed Roll Call # 249",36,0,0,0,36
1463856,1030026,2021-03-16,House,"Reported With Recommendation Without Amendment",12,1,0,0,13
1463856,1053024,2021-04-14,House,"House Third Reading: Given Immediate Effect Roll Call # 109",105,5,0,0,110
1463856,1110790,2021-10-27,Senate,"Reported Favorably Without Amendment",4,0,0,0,4
1463878,1022732,2021-03-04,House,"Reported With Recommendation With Substitute H-1",16,3,0,0,19
1463878,1036405,2021-03-24,House,"House Third Reading: Given Immediate Effect Roll Call # 74",56,51,0,0,107
1463878,1098101,2021-06-15,Senate,"Reported Favorably With Substitute S-1",6,2,0,0,8
1464118,1032946,2021-03-18,House,"Reported With Recommendation With Substitute H-1",19,0,0,0,19
1464118,1036124,2021-03-24,House,"House Third Reading: Given Immediate Effect Roll Call # 79",102,5,0,0,107
1464300,1027448,2021-03-11,House,"Reported With Recommendation Without Amendment",19,0,0,0,19
1464300,1036399,2021-03-24,House,"House Third Reading: Given Immediate Effect Roll Call # 76",106,1,0,0,107
1464300,1142305,2022-02-01,Senate,"Reported Favorably With Substitute S-1",9,0,0,0,9
1464300,1147133,2022-02-16,Senate,"Senate Third Reading: Given Immediate Effect Roll Call # 31",38,0,0,0,38
1464300,1147134,2022-02-16,House,"House Third Reading: Roll Call # 58",103,2,0,0,105
1464648,1057367,2021-04-20,Senate,"Reported Favorably Without Amendment",8,0,0,0,8
1464648,1065781,2021-04-29,Senate,"Senate Third Reading: Passed Roll Call # 110",35,0,0,1,36
1464675,1035512,2021-03-23,Senate,"Reported Favorably With Substitute S-1",6,2,0,0,8
1464675,1037270,2021-03-24,Senate,"Senate Third Reading: Passed Roll Call # 78",35,0,0,1,36
1464701,1116593,2021-12-01,Senate,"Reported Favorably Without Amendment",5,0,0,0,5
1464701,1229665,2022-09-20,Senate,"Senate Third Reading: Passed Roll Call # 407",35,1,0,2,38
1464785,1116568,2021-12-01,Senate,"Reported Favorably Without Amendment",5,0,0,0,5
1464785,1229654,2022-09-20,Senate,"Senate Third Reading: Passed Roll Call # 408",35,1,0,2,38
1464812,1022560,2021-03-04,Senate,"Reported Favorably With Substitute S-1",5,0,0,0,5
1464812,1022561,2021-03-04,Senate,"Senate Third Reading: Passed Roll Call # 44",35,0,0,1,36
1464812,1026445,2021-03-10,House,"Reported With Recommendation With Amendment(s)",10,1,0,0,11
1464812,1032910,2021-03-17,House,"House Third Reading: Given Immediate Effect Roll Call # 53",108,1,0,0,109
1464812,1032911,2021-03-18,Senate,"Senate Third Reading: House Amendment(s) Concurred In Roll Call # 58",34,0,1,1,36
1464873,1030013,2021-03-16,House,"Reported With Recommendation With Substitute H-1",15,0,0,0,15
1464873,1038058,2021-03-25,House,"House Third Reading: Given Immediate Effect Roll Call # 97",106,0,0,0,106
1464873,1065958,2021-04-29,Senate,"Reported Favorably Without Amendment",7,0,0,0,7
1464873,1085219,2021-05-25,Senate,"Senate Third Reading: Passed Roll Call # 209",36,0,0,0,36
1464873,1086793,2021-05-27,Senate,"Senate Third Reading: Given Immediate Effect Roll Call # 236",36,0,0,0,36
1464873,1091456,2021-06-03,House,"House Third Reading: Roll Call # 283",110,0,0,0,110
1465136,1079492,2021-05-18,House,"Reported With Recommendation With Substitute H-1",13,0,0,0,13
1465136,1099081,2021-06-17,House,"House Third Reading: Given Immediate Effect Roll Call # 346",110,0,0,0,110
1465136,1109469,2021-09-30,Senate,"Reported Favorably Without Amendment",8,0,0,0,8
1465136,1109805,2021-10-07,Senate,"Senate Third Reading: Given Immediate Effect Roll Call # 377",36,0,0,0,36
1465160,1079490,2021-05-18,House,"Reported With Recommendation With Substitute H-1",13,0,0,0,13
1465160,1099300,2021-06-17,House,"House Third Reading: Given Immediate Effect Roll Call # 345",110,0,0,0,110
1465160,1109574,2021-10-05,Senate,"Reported Favorably With Substitute S-1",8,0,0,0,8
1465160,1109772,2021-10-07,Senate,"Senate Third Reading: Given Immediate Effect Roll Call # 378",36,0,0,0,36
1465160,1110735,2021-10-26,House,"House Third Reading: Roll Call # 494",105,0,0,0,105
1465221,1030133,2021-03-16,House,"Reported With Recommendation With Substitute H-1",15,0,0,0,15
1465221,1037953,2021-03-25,House,"House Third Reading: Given Immediate Effect Roll Call # 98",106,0,0,0,106
1465221,1066906,2021-04-29,Senate,"Reported Favorably With Substitute S-1",7,0,0,0,7
1465221,1085083,2021-05-25,Senate,"Senate Third Reading: Passed Roll Call # 210",36,0,0,0,36
1465221,1091464,2021-06-03,House,"House Third Reading: Roll Call # 284",110,0,0,0,110
1465253,1079494,2021-05-18,House,"Reported With Recommendation Without Amendment",13,0,0,0,13
1465253,1099179,2021-06-17,House,"House Third Reading: Given Immediate Effect Roll Call # 344",110,0,0,0,110
1465253,1109470,2021-09-30,Senate,"Reported Favorably With Substitute S-1",8,0,0,0,8
1465253,1109773,2021-10-07,Senate,"Senate Third Reading: Given Immediate Effect Roll Call # 376",36,0,0,0,36
1465253,1110753,2021-10-26,House,"House Third Reading: Roll Call # 493",106,0,0,0,106
1465343,1175226,2022-03-22,House,"Reported With Recommendation With Substitute H-2",13,0,0,0,13
1465343,1200150,2022-05-04,House,"House Third Reading: Given Immediate Effect Roll Call # 184",102,1,0,0,103
1465343,1205953,2022-05-18,Senate,"Reported Favorably With Substitute S-2",7,0,0,0,7
1465343,1221508,2022-06-30,Senate,"Senate Third Reading: Given Immediate Effect Roll Call # 378",37,1,0,0,38
1465343,1221668,2022-06-30,House,"House Third Reading: Roll Call # 345",105,2,0,0,107
1465365,1022664,2021-03-04,House,"Reported With Recommendation With Substitute H-1",9,0,0,0,9
1465365,1036719,2021-03-24,House,"House Third Reading: Given Immediate Effect Roll Call # 69",104,3,0,0,107
1465365,1117271,2021-12-09,Senate,"Reported Favorably Without Amendment",5,0,0,0,5
1465365,1125006,2022-01-18,Senate,"Senate Third Reading: Passed Roll Call # 2",38,0,0,0,38
1471054,1148526,2022-02-17,Senate,"Reported Favorably With Substitute S-1",4,2,0,0,6
1471054,1162793,2022-03-03,Senate,"Senate Third Reading: Passed Roll Call # 53",23,14,0,1,38
1471054,1175947,2022-03-23,House,"Reported With Recommendation Without Amendment",12,3,0,0,15
1471054,1230443,2022-12-07,House,"House Third Reading: Given Immediate Effect Roll Call # 491",63,34,0,0,97
1471154,1085423,2021-05-26,House,"Reported With Recommendation With Substitute H-1",13,0,0,0,13
1471154,1103561,2021-06-30,House,"House Third Reading: Given Immediate Effect Roll Call # 403",107,2,0,0,109
1471154,1146992,2022-02-10,Senate,"Reported Favorably Without Amendment",7,0,0,0,7
1471157,1076189,2021-05-11,House,"Reported With Recommendation With Substitute H-4",21,8,0,0,29
1471157,1076190,2021-05-11,House,"House Third Reading: Given Immediate Effect Roll Call # 185",85,22,0,0,107
1471157,1079931,2021-05-19,Senate,"Senate Third Reading: Passed Roll Call # 195",20,16,0,0,36
1471157,1086232,2021-05-26,House,"House Third Reading: Roll Call # 253",0,109,0,0,109
1471163,1027481,2021-03-11,House,"Reported With Recommendation Without Amendment",9,0,0,0,9
1471163,1032922,2021-03-18,House,"House Third Reading: Given Immediate Effect Roll Call # 66",109,0,0,0,109
1471167,1076339,2021-05-11,House,"Reported With Recommendation With Substitute H-1",17,12,0,0,29
1471167,1076340,2021-05-11,House,"House Third Reading: Given Immediate Effect Roll Call # 187",57,50,0,0,107
1471167,1079924,2021-05-19,Senate,"Senate Third Reading: Passed Roll Call # 197",20,16,0,0,36
1471167,1085734,2021-05-26,House,"House Third Reading: Roll Call # 259",0,109,0,0,109
1471186,1035115,2021-03-23,House,"Reported With Recommendation Without Amendment",13,1,0,0,14
1471186,1064371,2021-04-27,House,"House Third Reading: Given Immediate Effect Roll Call # 141",89,20,0,0,109
1471186,1098437,2021-06-15,Senate,"Reported Favorably Without Amendment",9,0,0,0,9
1471199,1074233,2021-05-06,House,"Reported With Recommendation With Substitute H-2",17,12,0,0,29
1471199,1076999,2021-05-12,House,"House Third Reading: Given Immediate Effect Roll Call # 191",59,48,0,0,107
1471199,1086318,2021-05-26,House,"House Third Reading: Roll Call # 251",0,109,0,0,109
1471199,1105921,2021-05-19,Senate,"Senate Third Reading: Passed Roll Call # 200",20,16,0,0,36
1471203,1027605,2021-03-11,House,"Reported With Recommendation Without Amendment",9,0,0,0,9
1471203,1032935,2021-03-18,House,"House Third Reading: Given Immediate Effect Roll Call # 63",109,0,0,0,109
1471208,1101911,2021-06-24,House,"House Third Reading: Given Immediate Effect Roll Call # 395",104,4,0,0,108
1471208,1103619,2021-06-30,Senate,"Senate Third Reading: Passed Roll Call # 322",32,0,2,2,36
1471208,1103620,2021-06-30,Senate,"Senate Third Reading: Given Immediate Effect Roll Call # 323",34,0,0,2,36
1471208,1138669,2022-02-08,House,"House Third Reading: Roll Call # 33",104,0,0,0,104
1471208,1139887,2022-02-09,Senate,"Senate Third Reading: Roll Call: Roll Call # 20",38,0,0,0,38
1471208,1139888,2022-02-09,House,"House Third Reading: Roll Call # 34",106,0,0,0,106
1471224,1076365,2021-05-11,House,"Reported With Recommendation With Substitute H-2",17,11,0,0,28
1471224,1077082,2021-05-12,House,"House Third Reading: Given Immediate Effect Roll Call # 195",57,50,0,0,107
1471224,1080430,2021-05-19,Senate,"Senate Third Reading: Passed Roll Call # 201",20,16,0,0,36
1471224,1086190,2021-05-26,House,"House Third Reading: Roll Call # 252",1,108,0,0,109
1471224,1109066,2021-09-22,House,"House Third Reading: Conference Report Adopted Roll Call # 441",97,8,0,0,105
1471224,1109067,2021-09-22,Senate,"Senate Third Reading: Senate Adopted Conference Report With Immediate Effect Roll Call # 352",34,2,0,0,36
1471228,1027508,2021-03-11,House,"Reported With Recommendation Without Amendment",9,0,0,0,9
1471228,1032931,2021-03-18,House,"House Third Reading: Given Immediate Effect Roll Call # 58",109,0,0,0,109
1471234,1076353,2021-05-11,House,"Reported With Recommendation With Substitute H-1",17,10,0,0,27
1471234,1077079,2021-05-12,House,"House Third Reading: Given Immediate Effect Roll Call # 194",63,44,0,0,107
1471234,1080012,2021-05-19,Senate,"Senate Third Reading: Passed Roll Call # 206",20,16,0,0,36
1471234,1085906,2021-05-26,House,"House Third Reading: Roll Call # 260",0,109,0,0,109
1471239,1027507,2021-03-11,House,"Reported With Recommendation With Substitute H-1",9,0,0,0,9
1471239,1032937,2021-03-18,House,"House Third Reading: Given Immediate Effect Roll Call # 65",109,0,0,0,109
1471249,1027514,2021-03-11,House,"Reported With Recommendation Without Amendment",9,0,0,0,9
1471249,1032920,2021-03-18,House,"House Third Reading: Given Immediate Effect Roll Call # 59",109,0,0,0,109
1471255,1027478,2021-03-11,House,"Reported With Recommendation Without Amendment",9,0,0,0,9
1471255,1032909,2021-03-18,House,"House Third Reading: Given Immediate Effect Roll Call # 61",109,0,0,0,109
1471265,1076374,2021-05-11,House,"Reported With Recommendation With Substitute H-3",17,12,0,0,29
1471265,1077090,2021-05-12,House,"House Third Reading: Given Immediate Effect Roll Call # 197",57,50,0,0,107
1471265,1080619,2021-05-19,Senate,"Senate Third Reading: Passed Roll Call # 199",20,16,0,0,36
1471265,1086187,2021-05-26,House,"House Third Reading: Roll Call # 250",0,109,0,0,109
1471265,1119576,2021-12-14,House,"House Third Reading: Conference Report Adopted Roll Call # 631",94,9,0,0,103
1471265,1119667,2021-12-14,Senate,"Senate Third Reading: Senate Adopted Conference Report With Immediate Effect Roll Call # 501",35,1,0,2,38
1471270,1064920,2021-04-28,House,"Reported With Recommendation With Substitute H-2",17,10,0,0,27
1471270,1076440,2021-05-11,House,"House Third Reading: Given Immediate Effect Roll Call # 181",60,47,0,0,107
1471278,1027539,2021-03-11,House,"Reported With Recommendation Without Amendment",9,0,0,0,9
1471278,1032901,2021-03-18,House,"House Third Reading: Given Immediate Effect Roll Call # 64",109,0,0,0,109
1471285,1074216,2021-05-06,House,"Reported With Recommendation With Substitute H-1",17,12,0,0,29
1471285,1076316,2021-05-11,House,"House Third Reading: Given Immediate Effect Roll Call # 184",58,49,0,0,107
1471285,1080297,2021-05-19,Senate,"Senate Third Reading: Passed Roll Call # 193",20,16,0,0,36
1471285,1086199,2021-05-26,House,"House Third Reading: Roll Call # 247",3,106,0,0,109
1471289,1027488,2021-03-11,House,"Reported With Recommendation Without Amendment",9,0,0,0,9
1471289,1032913,2021-03-18,House,"House Third Reading: Given Immediate Effect Roll Call # 60",109,0,0,0,109
1471305,1076358,2021-05-11,House,"Reported With Recommendation With Substitute H-2",17,12,0,0,29
1471305,1077081,2021-05-12,House,"House Third Reading: Given Immediate Effect Roll Call # 196",67,40,0,0,107
1471305,1079988,2021-05-19,Senate,"Senate Third Reading: Passed Roll Call # 205",20,16,0,0,36
1471305,1085789,2021-05-26,House,"House Third Reading: Roll Call # 257",0,109,0,0,109
1471309,1076411,2021-05-11,House,"Reported With Recommendation With Substitute H-3",17,12,0,0,29
1471309,1077110,2021-05-12,House,"House Third Reading: Given Immediate Effect Roll Call # 188",59,48,0,0,107
1471309,1080112,2021-05-19,Senate,"Senate Third Reading: Passed Roll Call # 202",20,16,0,0,36
1471309,1085919,2021-05-26,House,"House Third Reading: Roll Call # 254",0,109,0,0,109
1471314,1074204,2021-05-06,House,"Reported With Recommendation With Substitute H-3",17,12,0,0,29
1471314,1076302,2021-05-11,House,"House Third Reading: Given Immediate Effect Roll Call # 183",57,50,0,0,107
1471314,1079886,2021-05-19,Senate,"Senate Third Reading: Passed Roll Call # 192",20,16,0,0,36
1471314,1085714,2021-05-26,House,"House Third Reading: Roll Call # 246",0,109,0,0,109
1471320,1085415,2021-05-26,House,"Reported With Recommendation Without Amendment",13,0,0,0,13
1471320,1103590,2021-06-30,House,"House Third Reading: Given Immediate Effect Roll Call # 404",107,2,0,0,109
1471320,1148205,2022-02-10,Senate,"Reported Favorably Without Amendment",7,0,0,0,7
1471331,1032953,2021-03-11,House,"Reported With Recommendation Without Amendment",9,0,0,0,9
1471331,1032954,2021-03-18,House,"House Third Reading: Given Immediate Effect Roll Call # 57",109,0,0,0,109
1471336,1079537,2021-05-18,House,"Reported With Recommendation With Substitute H-1",8,1,0,0,9
1471336,1098258,2021-06-15,House,"House Third Reading: Given Immediate Effect Roll Call # 327",97,12,0,0,109
1471336,1110895,2021-10-28,Senate,"Reported Favorably Without Amendment",7,0,0,0,7
1471341,1217760,2022-06-21,House,"Reported With Recommendation With Substitute H-2",11,1,0,0,12
1471351,1200249,2022-05-04,House,"Reported With Recommendation With Substitute H-2",12,0,0,0,12
1471351,1217818,2022-06-15,House,"House Third Reading: Given Immediate Effect Roll Call # 302",105,0,0,0,105
1471351,1230073,2022-11-29,Senate,"Reported Favorably With Substitute S-1",3,0,0,0,3
1471356,1101896,2021-06-24,House,"House Third Reading: Given Immediate Effect Roll Call # 396",105,3,0,0,108
1471356,1103498,2021-06-30,House,"House Third Reading: Roll Call # 417",106,3,0,0,109
1471356,1103602,2021-06-30,Senate,"Senate Third Reading: Given Immediate Effect Roll Call # 324",33,1,0,2,36
1471356,1105919,2021-07-21,House,"House Third Reading: Motion To Override Line Item(s) Failed Roll Call # 420",54,54,0,0,108
1471362,1076347,2021-05-11,House,"Reported With Recommendation With Substitute H-1",18,10,0,0,28
1471362,1077078,2021-05-12,House,"House Third Reading: Given Immediate Effect Roll Call # 192",65,42,0,0,107
1471362,1080454,2021-05-19,Senate,"Senate Third Reading: Passed Roll Call # 198",20,16,0,0,36
1471362,1086293,2021-05-26,House,"House Third Reading: Roll Call # 248",0,109,0,0,109
1471366,1065559,2021-04-28,House,"Reported With Recommendation With Substitute H-2",17,10,0,0,27
1471366,1076097,2021-05-11,House,"House Third Reading: Given Immediate Effect Roll Call # 180",96,11,0,0,107
1471366,1098273,2021-06-15,Senate,"Senate Third Reading: Given Immediate Effect Roll Call # 270",35,0,0,1,36
1471366,1101967,2021-06-24,House,"House Third Reading: Roll Call # 397",105,3,0,0,108
1471384,1065902,2021-04-29,House,"Reported With Recommendation With Substitute H-3",17,9,0,0,26
1471384,1077401,2021-05-13,House,"House Third Reading: Given Immediate Effect Roll Call # 208",65,42,0,0,107
1471389,1076375,2021-05-11,House,"Reported With Recommendation With Substitute H-1",17,11,0,0,28
1471389,1077092,2021-05-12,House,"House Third Reading: Given Immediate Effect Roll Call # 190",58,49,0,0,107
1471389,1080364,2021-05-19,Senate,"Senate Third Reading: Passed Roll Call # 204",20,16,0,0,36
1471389,1086226,2021-05-26,House,"House Third Reading: Roll Call # 256",0,109,0,0,109
1471393,1076310,2021-05-11,House,"Reported With Recommendation With Substitute H-1",17,11,0,0,28
1471393,1077068,2021-05-12,House,"House Third Reading: Given Immediate Effect Roll Call # 189",56,51,0,0,107
1471393,1079867,2021-05-19,Senate,"Senate Third Reading: Passed Roll Call # 203",20,16,0,0,36
1471393,1086222,2021-05-26,House,"House Third Reading: Roll Call # 255",1,108,0,0,109
1471401,1076103,2021-05-11,House,"Reported With Recommendation With Substitute H-4",26,1,0,0,27
1471401,1076104,2021-05-11,House,"House Third Reading: Given Immediate Effect Roll Call # 186",89,18,0,0,107
1471401,1079870,2021-05-19,Senate,"Senate Third Reading: Passed Roll Call # 196",20,16,0,0,36
1471401,1085814,2021-05-26,House,"House Third Reading: Roll Call # 258",0,109,0,0,109
1471428,1074231,2021-05-06,House,"Reported With Recommendation With Substitute H-1",17,12,0,0,29
1471428,1076355,2021-05-11,House,"House Third Reading: Given Immediate Effect Roll Call # 182",56,51,0,0,107
1471428,1080443,2021-05-19,Senate,"Senate Third Reading: Passed Roll Call # 194",20,16,0,0,36
1471428,1085995,2021-05-26,House,"House Third Reading: Roll Call # 249",0,109,0,0,109
1471434,1027542,2021-03-11,House,"Reported With Recommendation Without Amendment",9,0,0,0,9
1471434,1032930,2021-03-18,House,"House Third Reading: Given Immediate Effect Roll Call # 62",109,0,0,0,109
1472516,1026447,2021-03-10,House,"Reported With Recommendation Without Amendment",9,0,0,0,9
1472556,1084456,2021-05-25,House,"Reported With Recommendation With Substitute H-3",14,0,0,0,14
1472556,1117249,2021-12-09,House,"House Third Reading: Given Immediate Effect Roll Call # 598",102,0,0,0,102
1472637,1117175,2021-12-08,House,"Reported With Recommendation Without Amendment",11,0,0,0,11
1472718,1100125,2021-06-22,House,"Reported With Recommendation With Substitute H-1",7,0,0,0,7
1472718,1105330,2021-07-21,House,"House Third Reading: Given Immediate Effect Roll Call # 423",107,1,0,0,108
1473194,1030047,2021-03-16,House,"Reported With Recommendation With Substitute H-1",15,0,0,0,15
1473194,1063480,2021-04-27,House,"House Third Reading: Given Immediate Effect Roll Call # 146",88,20,0,0,108
1473194,1095624,2021-06-09,Senate,"Reported Favorably Without Amendment",7,0,0,0,7
1473219,1054437,2021-04-15,House,"Reported With Recommendation With Substitute H-1",9,0,0,0,9
1473219,1063922,2021-04-27,House,"House Third Reading: Given Immediate Effect Roll Call # 153",98,11,0,0,109
1473219,1080611,2021-05-19,Senate,"Reported Favorably Without Amendment",3,1,0,0,4
1473219,1086735,2021-05-27,Senate,"Senate Third Reading: Passed Roll Call # 234",21,15,0,0,36
1473249,1032934,2021-03-16,House,"Reported With Recommendation Without Amendment",15,0,0,0,15
1473249,1064336,2021-04-27,House,"House Third Reading: Given Immediate Effect Roll Call # 143",88,20,0,0,108
1473249,1095602,2021-06-09,Senate,"Reported Favorably With Substitute S-2",7,0,0,0,7
1473367,1030097,2021-03-16,House,"Reported With Recommendation Without Amendment",13,0,0,0,13
1473367,1036727,2021-03-24,House,"House Third Reading: Given Immediate Effect Roll Call # 88",106,1,0,0,107
1473367,1054762,2021-04-15,Senate,"Reported Favorably Without Amendment",8,0,0,0,8
1473367,1064382,2021-04-27,Senate,"Senate Third Reading: Given Immediate Effect Roll Call # 107",34,1,0,1,36
1473424,1063481,2021-04-27,House,"Reported With Recommendation Without Amendment",14,0,0,0,14
1473424,1073235,2021-05-05,House,"House Third Reading: Given Immediate Effect Roll Call # 169",108,0,0,0,108
1473424,1086803,2021-05-27,Senate,"Reported Favorably Without Amendment",9,0,0,0,9
1473424,1091532,2021-06-03,Senate,"Senate Third Reading: Passed Roll Call # 251",36,0,0,0,36
1473620,1096898,2021-06-10,House,"Reported With Recommendation With Substitute H-1",9,0,0,0,9
1473620,1099318,2021-06-17,House,"House Third Reading: Given Immediate Effect Roll Call # 350",60,49,0,0,109
1473620,1101757,2021-06-24,Senate,"Senate Third Reading: Passed Roll Call # 320",19,16,0,1,36
1473620,1101939,2021-06-24,House,"House Third Reading: Roll Call # 390",57,51,0,0,108
1473620,1101940,2021-06-24,House,"House Third Reading: Roll Call # 394",59,49,0,0,108
1473648,1071862,2021-05-04,House,"Reported With Recommendation Without Amendment",14,0,0,0,14
1473648,1080109,2021-05-19,House,"House Third Reading: Given Immediate Effect Roll Call # 214",107,1,0,0,108
1473648,1108913,2021-09-15,Senate,"Reported Favorably With Substitute S-3",9,0,0,0,9
1473648,1109453,2021-09-29,Senate,"Senate Third Reading: Given Immediate Effect Roll Call # 353",36,0,0,0,36
1473648,1110107,2021-10-13,House,"House Third Reading: Roll Call # 465",105,1,0,0,106
1473679,1099350,2021-06-17,House,"Reported With Recommendation With Substitute H-1",7,4,0,0,11
1473679,1110322,2021-10-19,House,"House Third Reading: Given Immediate Effect Roll Call # 484",60,43,0,0,103
1475955,1027512,2021-03-11,Senate,"Reported Favorably Without Amendment",4,1,0,0,5
1475955,1032939,2021-03-17,Senate,"Senate Third Reading: Passed Roll Call # 51",20,15,0,1,36
1475955,1148544,2022-02-17,House,"Reported With Recommendation Without Amendment",5,2,0,0,7
1475986,1057586,2021-04-20,Senate,"Reported Favorably With Substitute S-1",8,0,0,0,8
1475986,1064352,2021-04-27,Senate,"Senate Third Reading: Passed Roll Call # 105",35,0,0,1,36
1475986,1110656,2021-10-26,House,"Reported With Recommendation With Substitute H-1",9,0,0,0,9
1475986,1119605,2021-12-14,House,"House Third Reading: Given Immediate Effect Roll Call # 610",103,0,0,0,103
1475986,1119684,2021-12-14,Senate,"Senate Third Reading: Roll Call: Roll Call # 498",36,0,0,2,38
1476021,1062157,2021-04-22,House,"Reported With Recommendation Without Amendment",6,1,0,0,7
1476057,1073847,2021-05-06,Senate,"Reported Favorably Without Amendment",4,0,0,0,4
1476057,1090584,2021-06-02,Senate,"Senate Third Reading: Passed Roll Call # 240",36,0,0,0,36
1476057,1109615,2021-10-05,House,"Reported With Recommendation Without Amendment",7,0,0,0,7
1476057,1119633,2021-12-14,House,"House Third Reading: Given Immediate Effect Roll Call # 615",102,0,0,0,102
1476089,1027551,2021-03-11,Senate,"Reported Favorably Without Amendment",4,0,0,0,4
1476089,1032933,2021-03-17,Senate,"Senate Third Reading: Passed Roll Call # 52",20,15,0,1,36
1476089,1148699,2022-02-17,House,"Reported With Recommendation With Substitute H-1",5,2,0,0,7
1476130,1027505,2021-03-11,Senate,"Reported Favorably Without Amendment",4,0,0,0,4
1476130,1032929,2021-03-17,Senate,"Senate Third Reading: Passed Roll Call # 53",19,16,0,1,36
1476130,1148569,2022-02-17,House,"Reported With Recommendation With Substitute H-1",5,2,0,0,7
1476162,1140038,2022-01-27,House,"Reported With Recommendation With Substitute H-1",6,2,0,0,8
1476842,1128391,2021-03-10,Senate,"Senate Third Reading: Roll Call: Roll Call # 46",20,15,0,1,36
1476857,1080046,2021-05-19,House,"Reported With Recommendation With Substitute H-3",21,5,0,0,26
1476857,1090145,2021-06-02,House,"House Third Reading: Given Immediate Effect Roll Call # 278",98,11,0,0,109
1476872,1076379,2021-05-11,House,"Reported With Recommendation With Substitute H-1",17,12,0,0,29
1476872,1077099,2021-05-12,House,"House Third Reading: Given Immediate Effect Roll Call # 193",66,41,0,0,107
1476872,1080060,2021-05-19,Senate,"Senate Third Reading: Passed Roll Call # 207",20,16,0,0,36
1476872,1085924,2021-05-26,House,"House Third Reading: Roll Call # 261",0,109,0,0,109
1476888,1038020,2021-03-25,House,"Reported With Recommendation With Substitute H-1",7,0,0,0,7
1476888,1060587,2021-04-22,House,"House Third Reading: Given Immediate Effect Roll Call # 137",85,19,0,0,104
1476904,1037762,2021-03-25,House,"Reported With Recommendation Without Amendment",7,0,0,0,7
1476904,1060345,2021-04-22,House,"House Third Reading: Given Immediate Effect Roll Call # 135",83,21,0,0,104
1476920,1037705,2021-03-25,House,"Reported With Recommendation With Substitute H-1",7,0,0,0,7
1476920,1061262,2021-04-22,House,"House Third Reading: Given Immediate Effect Roll Call # 138",78,26,0,0,104
1476960,1080074,2021-05-19,House,"Reported With Recommendation With Substitute H-1",21,5,0,0,26
1476960,1090063,2021-06-02,House,"House Third Reading: Given Immediate Effect Roll Call # 279",99,10,0,0,109
1476976,1032943,2021-03-17,House,"Reported With Recommendation Without Amendment",28,0,0,0,28
1476976,1032944,2021-03-17,House,"House Third Reading: Given Immediate Effect Roll Call # 54",104,5,0,0,109
1476976,1037322,2021-03-25,Senate,"Reported Favorably Without Amendment",18,0,0,0,18
1476976,1058456,2021-04-21,Senate,"Senate Third Reading: Given Immediate Effect Roll Call # 92",34,0,0,2,36
1476994,1079480,2021-05-18,House,"Reported With Recommendation Without Amendment",13,0,0,0,13
1476994,1090297,2021-06-02,House,"House Third Reading: Given Immediate Effect Roll Call # 277",105,4,0,0,109
1476994,1162647,2022-03-03,Senate,"Reported Favorably With Substitute S-1",9,0,0,0,9
1476994,1171030,2022-03-10,Senate,"Senate Third Reading: Given Immediate Effect Roll Call # 77",38,0,0,0,38
1476994,1171031,2022-03-15,House,"House Third Reading: Roll Call # 116",100,3,0,0,103
1477000,1037907,2021-03-25,House,"Reported With Recommendation Without Amendment",7,0,0,0,7
1477000,1060984,2021-04-22,House,"House Third Reading: Given Immediate Effect Roll Call # 136",87,17,0,0,104
1477021,1084665,2021-05-25,House,"Reported With Recommendation With Substitute H-1",10,0,0,0,10
1477021,1100191,2021-06-22,House,"House Third Reading: Given Immediate Effect Roll Call # 357",110,0,0,0,110
1477040,1037804,2021-03-25,House,"Reported With Recommendation With Substitute H-1",7,0,0,0,7
1477040,1060293,2021-04-22,House,"House Third Reading: Given Immediate Effect Roll Call # 134",88,16,0,0,104
1477055,1038006,2021-03-25,House,"Reported With Recommendation Without Amendment",7,0,0,0,7
1477055,1060287,2021-04-22,House,"House Third Reading: Given Immediate Effect Roll Call # 131",87,17,0,0,104
1477073,1038027,2021-03-25,House,"Reported With Recommendation Without Amendment",7,0,0,0,7
1477073,1060996,2021-04-22,House,"House Third Reading: Given Immediate Effect Roll Call # 132",87,17,0,0,104
1477088,1038278,2021-03-25,House,"Reported With Recommendation With Substitute H-1",7,0,0,0,7
1477088,1060385,2021-04-22,House,"House Third Reading: Given Immediate Effect Roll Call # 133",86,18,0,0,104
1477340,1230075,2022-11-29,Senate,"Reported Favorably Without Amendment",5,0,0,0,5
1477370,1032958,2021-03-18,Senate,"Reported Favorably Without Amendment",4,1,0,0,5
1477370,1032959,2021-03-18,Senate,"Senate Third Reading: Passed Roll Call # 65",20,15,0,1,36
1477396,1230089,2022-11-29,Senate,"Reported Favorably Without Amendment",5,0,0,0,5
1477420,1066902,2021-04-29,Senate,"Reported Favorably With Substitute S-2",17,0,0,0,17
1477483,1230080,2022-11-29,Senate,"Reported Favorably Without Amendment",5,0,0,0,5
1477507,1230081,2022-11-29,Senate,"Reported Favorably Without Amendment",5,0,0,0,5
1477538,1060509,2021-04-22,Senate,"Reported Favorably With Substitute S-2",8,0,0,0,8
1477538,1073290,2021-05-05,Senate,"Senate Third Reading: Passed Roll Call # 119",36,0,0,0,36
1477538,1100450,2021-06-22,House,"Reported With Recommendation Without Amendment",12,0,0,0,12
1477538,1110368,2021-10-19,House,"House Third Reading: Given Immediate Effect Roll Call # 481",87,16,0,0,103
1477538,1115413,2021-11-02,Senate,"Senate Third Reading: House Amendment(s) Concurred In Roll Call # 417",34,0,1,1,36
1477617,1230107,2022-11-29,Senate,"Reported Favorably Without Amendment",5,0,0,0,5
1478311,1052918,2021-04-14,House,"Reported With Recommendation Without Amendment",13,2,0,0,15
1478311,1079274,2021-05-18,House,"House Third Reading: Given Immediate Effect Roll Call # 210",83,25,0,0,108
1478311,1091477,2021-06-03,Senate,"Reported Favorably Without Amendment",5,1,0,0,6
1478311,1110821,2021-10-26,Senate,"Senate Third Reading: Given Immediate Effect Roll Call # 412",28,6,0,2,36
1478769,1036152,2021-03-24,Senate,"Reported Favorably Without Amendment",4,0,0,0,4
1478806,1059448,2021-04-21,Senate,"Reported Favorably With Substitute S-1",5,0,0,0,5
1478806,1064672,2021-04-28,Senate,"Senate Third Reading: Passed Roll Call # 108",19,15,1,1,36
1478806,1110707,2021-10-26,House,"Reported With Recommendation With Substitute H-3",15,0,0,0,15
1478882,1036673,2021-03-24,Senate,"Reported Favorably Without Amendment",4,0,0,0,4
1478961,1029557,2021-03-11,Senate,"Senate Third Reading: Roll Call: Roll Call # 50",20,14,0,2,36
1479158,1036648,2021-03-24,Senate,"Reported Favorably Without Amendment",4,0,0,0,4
1479177,1035897,2021-03-24,Senate,"Reported Favorably Without Amendment",4,0,0,0,4
1479193,1076284,2021-05-11,House,"Reported With Recommendation With Substitute H-2",6,1,0,0,7
1479193,1085461,2021-05-26,House,"House Third Reading: Given Immediate Effect Roll Call # 244",67,42,0,0,109
1479193,1210665,2022-05-26,Senate,"Reported Favorably Without Amendment",7,2,0,0,9
1479211,1051727,2021-04-13,House,"Reported With Recommendation With Substitute H-1",7,0,0,0,7
1479211,1063500,2021-04-27,House,"House Third Reading: Given Immediate Effect Roll Call # 145",109,0,0,0,109
1479211,1216828,2022-06-16,Senate,"Reported Favorably Without Amendment",4,0,0,0,4
1479211,1228712,2022-09-28,Senate,"Senate Third Reading: Given Immediate Effect Roll Call # 465",32,1,0,5,38
1479263,1036572,2021-03-24,Senate,"Reported Favorably Without Amendment",4,0,0,0,4
1479279,1151585,2022-02-22,House,"Reported With Recommendation With Substitute H-1",13,0,0,0,13
1479279,1162638,2022-03-03,House,"House Third Reading: Given Immediate Effect Roll Call # 95",99,6,0,0,105
1479279,1210694,2022-05-26,Senate,"Reported Favorably Without Amendment",7,2,0,0,9
1479279,1217692,2022-06-15,Senate,"Senate Third Reading: Passed Roll Call # 326",21,16,0,1,38
1479296,1072488,2021-05-04,Senate,"Reported Favorably Without Amendment",5,0,0,0,5
1479296,1091301,2021-06-03,Senate,"Senate Third Reading: Passed Roll Call # 246",32,4,0,0,36
1479296,1116549,2021-11-10,House,"Reported With Recommendation Without Amendment",10,2,0,0,12
1479296,1117133,2021-12-08,House,"House Third Reading: Given Immediate Effect Roll Call # 587",75,29,0,0,104
1479373,1035923,2021-03-24,Senate,"Reported Favorably Without Amendment",4,0,0,0,4
1479390,1060261,2021-04-22,House,"Reported With Recommendation With Substitute H-1",14,4,0,0,18
1479390,1073245,2021-05-05,House,"House Third Reading: Given Immediate Effect Roll Call # 168",82,26,0,0,108
1479413,1035830,2021-03-24,Senate,"Reported Favorably Without Amendment",4,0,0,0,4
1479427,1151589,2022-02-22,House,"Reported With Recommendation With Substitute H-1",13,0,0,0,13
1479427,1162633,2022-03-03,House,"House Third Reading: Given Immediate Effect Roll Call # 94",99,6,0,0,105
1479427,1210683,2022-05-26,Senate,"Reported Favorably Without Amendment",7,2,0,0,9
1479427,1217736,2022-06-15,Senate,"Senate Third Reading: Passed Roll Call # 325",21,16,0,1,38
1479444,1051646,2021-04-13,House,"Reported With Recommendation With Substitute H-1",7,0,0,0,7
1479444,1063547,2021-04-27,House,"House Third Reading: Given Immediate Effect Roll Call # 147",106,3,0,0,109
1479444,1109480,2021-09-30,Senate,"Reported Favorably With Substitute S-1",7,0,0,0,7
1479444,1109481,2021-09-30,Senate,"Senate Third Reading: Passed Roll Call # 362",21,15,0,0,36
1479444,1109482,2021-09-30,House,"House Third Reading: Roll Call # 449",84,21,0,0,105
1479462,1037990,2021-03-25,Senate,"Reported Favorably With Substitute S-1",18,0,0,0,18
1479555,1036577,2021-03-24,Senate,"Reported Favorably Without Amendment",4,0,0,0,4
1479588,1036563,2021-03-24,Senate,"Reported Favorably Without Amendment",4,0,0,0,4
1479675,1035918,2021-03-24,Senate,"Reported Favorably Without Amendment",4,0,0,0,4
1479688,1081957,2021-05-20,House,"Reported With Recommendation Without Amendment",3,2,0,0,5
1479688,1084850,2021-05-25,House,"House Third Reading: Given Immediate Effect Roll Call # 237",74,34,0,0,108
1479688,1094580,2021-06-08,Senate,"Reported Favorably Without Amendment",6,3,0,0,9
1479688,1115378,2021-11-02,Senate,"Senate Third Reading: Passed Roll Call # 419",19,16,0,1,36
1482928,1079226,2021-05-18,Senate,"Reported Favorably With Substitute S-1",10,0,0,0,10
1482928,1086898,2021-05-27,Senate,"Senate Third Reading: Passed Roll Call # 230",36,0,0,0,36
1482928,1148158,2022-02-10,House,"Reported With Recommendation Without Amendment",18,1,0,0,19
1482928,1162706,2022-03-03,House,"House Third Reading: Given Immediate Effect Roll Call # 92",96,9,0,0,105
1482988,1109476,2021-09-30,Senate,"Reported Favorably With Substitute S-1",7,0,0,0,7
1482988,1117057,2021-12-08,Senate,"Senate Third Reading: Passed Roll Call # 470",36,0,0,2,38
1482988,1128655,2022-01-25,House,"Reported With Recommendation Without Amendment",10,0,0,0,10
1482988,1171063,2022-03-15,House,"House Third Reading: Given Immediate Effect Roll Call # 118",103,0,0,0,103
1483045,1072527,2021-05-04,Senate,"Reported Favorably Without Amendment",5,0,0,0,5
1483045,1091584,2021-06-03,Senate,"Senate Third Reading: Passed Roll Call # 247",32,4,0,0,36
1483045,1116453,2021-11-10,House,"Reported With Recommendation Without Amendment",10,2,0,0,12
1483045,1117106,2021-12-08,House,"House Third Reading: Given Immediate Effect Roll Call # 588",75,29,0,0,104
1483096,1064175,2021-04-27,Senate,"Reported Favorably With Substitute S-2",8,0,0,0,8
1483096,1066272,2021-04-29,Senate,"Senate Third Reading: Passed Roll Call # 112",35,0,0,1,36
1483096,1174981,2022-03-22,House,"Reported With Recommendation Without Amendment",18,0,0,0,18
1483096,1175496,2022-03-23,House,"House Third Reading: Given Immediate Effect Roll Call # 134",103,2,0,0,105
1483096,1176813,2022-03-24,Senate,"Senate Third Reading: Roll Call: Roll Call # 106",37,0,0,1,38
1483143,1100444,2021-06-22,House,"Reported With Recommendation With Substitute H-2",11,1,0,0,12
1483143,1106261,2021-08-17,House,"House Third Reading: Given Immediate Effect Roll Call # 434",104,4,0,0,108
1483194,1064244,2021-04-27,House,"Reported With Recommendation Without Amendment",14,0,0,0,14
1483194,1099352,2021-06-17,House,"Reported With Recommendation With Substitute H-1",11,0,0,0,11
1483194,1100691,2021-06-23,House,"House Third Reading: Given Immediate Effect Roll Call # 365",84,26,0,0,110
1483194,1205951,2022-05-18,Senate,"Reported Favorably Without Amendment",9,0,0,0,9
1483194,1210126,2022-05-26,Senate,"Senate Third Reading: Given Immediate Effect Roll Call # 278",37,0,0,1,38
1483264,1097481,2021-06-08,House,"Reported With Recommendation With Substitute H-3",11,0,0,0,11
1483264,1099239,2021-06-17,House,"House Third Reading: Given Immediate Effect Roll Call # 349",105,4,0,0,109
1483264,1109459,2021-09-30,Senate,"Reported Favorably Without Amendment",7,0,0,0,7
1483264,1109460,2021-09-30,Senate,"Senate Third Reading: Passed Roll Call # 360",21,15,0,0,36
1483264,1109461,2021-09-30,House,"House Third Reading: Roll Call # 448",81,24,0,0,105
1483274,1100448,2021-06-22,House,"Reported With Recommendation With Substitute H-1",11,1,0,0,12
1483274,1106265,2021-08-17,House,"House Third Reading: Given Immediate Effect Roll Call # 435",104,4,0,0,108
1483287,1079525,2021-05-18,House,"Reported With Recommendation With Substitute H-4",13,0,0,0,13
1483287,1086738,2021-05-27,House,"House Third Reading: Given Immediate Effect Roll Call # 268",103,5,0,0,108
1483287,1098942,2021-06-17,Senate,"Reported Favorably Without Amendment",9,0,0,0,9
1483287,1101872,2021-06-24,Senate,"Senate Third Reading: Given Immediate Effect Roll Call # 310",35,0,0,1,36
1483287,1101873,2021-06-24,House,"House Third Reading: Senate Amendment(s) Concurred In By 3/4 Vote Roll Call # 392",103,5,0,0,108
1483301,1076441,2021-05-11,House,"Reported With Recommendation With Substitute H-1",14,0,0,0,14
1483301,1086590,2021-05-27,House,"House Third Reading: Given Immediate Effect Roll Call # 267",102,6,0,0,108
1483301,1098919,2021-06-17,Senate,"Reported Favorably Without Amendment",9,0,0,0,9
1483301,1102036,2021-06-24,Senate,"Senate Third Reading: Given Immediate Effect Roll Call # 309",35,0,0,1,36
1483301,1102037,2021-06-24,House,"House Third Reading: Senate Amendment(s) Concurred In By 3/4 Vote Roll Call # 391",102,6,0,0,108
1483343,1086696,2021-05-27,House,"Reported With Recommendation Without Amendment",19,0,0,0,19
1483343,1099072,2021-06-17,House,"House Third Reading: Given Immediate Effect Roll Call # 335",110,0,0,0,110
1483343,1110077,2021-10-12,Senate,"Reported Favorably Without Amendment",10,0,0,0,10
1483343,1116637,2021-12-02,Senate,"Senate Third Reading: Passed Roll Call # 459",34,0,0,4,38
1483740,1037977,2021-03-25,Senate,"Reported Favorably With Substitute S-1",7,0,0,0,7
1483740,1060204,2021-04-22,Senate,"Senate Third Reading: Passed Roll Call # 101",34,0,0,2,36
1483740,1086216,2021-05-26,House,"Reported With Recommendation Without Amendment",15,0,0,0,15
1483740,1116441,2021-11-10,House,"House Third Reading: Given Immediate Effect Roll Call # 543",104,1,0,0,105
1483740,1221489,2022-06-30,Senate,"Senate Third Reading: Roll Call: Roll Call # 396",35,0,2,1,38
1483822,1035508,2021-03-23,Senate,"Reported Favorably With Substitute S-1",6,2,0,0,8
1483822,1037252,2021-03-25,Senate,"Senate Third Reading: Passed Roll Call # 79",20,15,0,1,36
1483851,1063655,2021-04-27,House,"Reported With Recommendation Without Amendment",5,4,0,0,9
1483861,1096899,2021-06-10,Senate,"Reported Favorably With Substitute S-1",5,0,0,0,5
1483861,1098937,2021-06-17,Senate,"Senate Third Reading: Passed Roll Call # 288",35,0,0,1,36
1483861,1117255,2021-12-09,House,"Reported With Recommendation Without Amendment",9,0,0,0,9
1483861,1161066,2022-03-02,House,"House Third Reading: Given Immediate Effect Roll Call # 89",95,9,0,0,104
1483919,1051548,2021-04-13,House,"Reported With Recommendation With Substitute H-1",6,1,0,0,7
1483919,1063825,2021-04-27,House,"House Third Reading: Given Immediate Effect Roll Call # 150",65,44,0,0,109
1483919,1229264,2022-10-11,Senate,"Reported Favorably With Substitute S-1",3,0,0,0,3
1484079,1052245,2021-04-13,House,"Reported With Recommendation With Substitute H-1",6,1,0,0,7
1484079,1064255,2021-04-27,House,"House Third Reading: Given Immediate Effect Roll Call # 151",65,44,0,0,109
1484079,1229257,2022-10-11,Senate,"Reported Favorably With Substitute S-3",3,0,0,0,3
1484131,1052417,2021-04-13,House,"Reported With Recommendation With Substitute H-1",6,1,0,0,7
1484131,1063423,2021-04-27,House,"House Third Reading: Given Immediate Effect Roll Call # 149",67,42,0,0,109
1484131,1229268,2022-10-11,Senate,"Reported Favorably With Substitute S-1",3,0,0,0,3
1484185,1051770,2021-04-13,House,"Reported With Recommendation With Substitute H-1",6,1,0,0,7
1484185,1063948,2021-04-27,House,"House Third Reading: Given Immediate Effect Roll Call # 148",63,46,0,0,109
1484185,1228974,2022-10-11,Senate,"Reported Favorably With Substitute S-3",3,0,0,0,3
1486196,1036328,2021-03-24,House,"Reported With Recommendation With Substitute H-1",5,0,0,0,5
1486198,1100610,2021-06-23,Senate,"Reported Favorably With Substitute S-2",5,0,0,0,5
1486198,1109579,2021-10-05,Senate,"Senate Third Reading: Passed Roll Call # 364",34,0,0,2,36
1486198,1172119,2022-03-16,House,"Reported With Recommendation Without Amendment",12,0,0,0,12
1486198,1195619,2022-04-28,House,"House Third Reading: Given Immediate Effect Roll Call # 174",61,38,0,0,99
1486199,1035171,2021-03-23,Senate,"Senate Third Reading: Passed Roll Call # 70",20,15,0,1,36
1486202,1100731,2021-06-23,Senate,"Reported Favorably Without Amendment",5,0,0,0,5
1486202,1109618,2021-10-05,Senate,"Senate Third Reading: Passed Roll Call # 365",34,0,0,2,36
1486202,1172079,2022-03-16,House,"Reported With Recommendation Without Amendment",12,0,0,0,12
1486202,1196220,2022-04-28,House,"House Third Reading: Given Immediate Effect Roll Call # 175",62,37,0,0,99
1486204,1032948,2021-03-18,Senate,"Senate Third Reading: Roll Call: Roll Call # 68",20,15,0,1,36
1486205,1099169,2021-06-17,House,"Reported With Recommendation Without Amendment",9,0,0,0,9
1486205,1110373,2021-10-19,House,"House Third Reading: Given Immediate Effect Roll Call # 483",91,12,0,0,103
1486206,1100454,2021-06-22,House,"Reported With Recommendation Without Amendment",5,4,0,0,9
1486207,1099099,2021-06-17,House,"Reported With Recommendation With Substitute H-2",9,0,0,0,9
1486207,1110348,2021-10-19,House,"House Third Reading: Given Immediate Effect Roll Call # 482",101,2,0,0,103
1486211,1061366,2021-04-22,House,"Reported With Recommendation Without Amendment",4,1,0,0,5
1486211,1073330,2021-05-05,House,"House Third Reading: Given Immediate Effect Roll Call # 167",93,15,0,0,108
1486211,1098926,2021-06-17,Senate,"Reported Favorably With Substitute S-1",9,0,0,0,9
1486211,1098927,2021-06-17,Senate,"Senate Third Reading: Given Immediate Effect Roll Call # 287",33,2,0,1,36
1486211,1100162,2021-06-22,House,"House Third Reading: Roll Call # 355",92,18,0,0,110
1486212,1130387,2022-01-27,House,"Reported With Recommendation Without Amendment",12,0,0,0,12
1486212,1146991,2022-02-16,House,"House Third Reading: Given Immediate Effect Roll Call # 52",105,0,0,0,105
1486212,1215363,2022-06-09,Senate,"Reported Favorably Without Amendment",6,0,0,0,6
1486212,1218984,2022-06-23,Senate,"Senate Third Reading: Given Immediate Effect Roll Call # 346",38,0,0,0,38
1486215,1086644,2021-05-27,Senate,"Reported Favorably With Substitute S-2",4,2,0,0,6
1486218,1054748,2021-04-15,House,"Reported With Recommendation Without Amendment",6,2,0,0,8
1486218,1057828,2021-04-20,House,"House Third Reading: Roll Call # 113",59,50,0,0,109
1486219,1035479,2021-03-23,House,"Reported With Recommendation Without Amendment",11,0,0,0,11
1486219,1101959,2021-06-24,House,"House Third Reading: Given Immediate Effect Roll Call # 380",88,21,0,0,109
1486219,1206010,2022-05-18,Senate,"Reported Favorably With Substitute S-2",5,1,0,0,6
1486222,1086869,2021-05-27,Senate,"Reported Favorably With Substitute S-1",4,2,0,0,6
1486226,1037822,2021-03-25,Senate,"Reported Favorably Without Amendment",18,0,0,0,18
1486226,1066143,2021-04-29,Senate,"Senate Third Reading: Passed Roll Call # 111",35,0,0,1,36
1486226,1096208,2021-06-09,House,"Reported With Recommendation Without Amendment",29,0,0,0,29
1486226,1099344,2021-06-17,House,"House Third Reading: Given Immediate Effect Roll Call # 342",110,0,0,0,110
1486227,1060154,2021-04-22,House,"Reported With Recommendation Without Amendment",5,0,0,0,5
1486227,1073277,2021-05-05,House,"House Third Reading: Given Immediate Effect Roll Call # 166",107,1,0,0,108
1486227,1099044,2021-06-17,Senate,"Reported Favorably With Substitute S-1",9,0,0,0,9
1486227,1099045,2021-06-17,Senate,"Senate Third Reading: Given Immediate Effect Roll Call # 286",33,2,0,1,36
1486227,1100355,2021-06-22,House,"House Third Reading: Roll Call # 354",106,4,0,0,110
1487138,1061238,2021-04-21,Senate,"Reported Favorably Without Amendment",4,0,0,0,4
1487138,1079360,2021-05-18,Senate,"Senate Third Reading: Adopted By 2/3 Vote Roll Call # 190",35,0,0,1,36
1487138,1097543,2021-06-10,House,"Reported With Recommendation Without Amendment",9,0,0,0,9
1487138,1109792,2021-10-06,House,"House Third Reading: Not Adopted Roll Call # 451",65,38,0,0,103
1487269,1095157,2021-06-08,House,"Reported With Recommendation Without Amendment",13,0,0,0,13
1487269,1099067,2021-06-17,House,"House Third Reading: Given Immediate Effect Roll Call # 337",98,10,0,0,108
1487269,1110098,2021-10-06,Senate,"Reported Favorably With Substitute S-1",5,0,0,0,5
1487272,1036140,2021-03-24,House,"Reported With Recommendation Without Amendment",15,0,0,0,15
1487272,1052478,2021-04-13,House,"House Third Reading: Given Immediate Effect Roll Call # 99",108,1,0,0,109
1487272,1217767,2022-05-19,Senate,"Senate Third Reading: Passed Roll Call # 269",22,14,0,2,38
1487272,1217768,2022-05-19,House,"House Third Reading: Roll Call # 252",69,34,0,0,103
1487277,1095167,2021-06-08,House,"Reported With Recommendation With Substitute H-1",13,0,0,0,13
1487277,1099351,2021-06-17,House,"House Third Reading: Given Immediate Effect Roll Call # 340",100,10,0,0,110
1487277,1110100,2021-10-06,Senate,"Reported Favorably Without Amendment",5,0,0,0,5
1487290,1097858,2021-06-08,House,"Reported With Recommendation With Substitute H-1",13,0,0,0,13
1487290,1099276,2021-06-17,House,"House Third Reading: Given Immediate Effect Roll Call # 339",100,10,0,0,110
1487290,1110091,2021-10-06,Senate,"Reported Favorably Without Amendment",5,0,0,0,5
1487293,1036150,2021-03-24,House,"Reported With Recommendation Without Amendment",15,0,0,0,15
1487293,1052534,2021-04-13,House,"House Third Reading: Given Immediate Effect Roll Call # 101",109,0,0,0,109
1487293,1054447,2021-04-15,Senate,"Reported Favorably Without Amendment",6,0,0,0,6
1487293,1057893,2021-04-20,Senate,"Senate Third Reading: Given Immediate Effect Roll Call # 90",35,0,0,1,36
1487301,1039453,2021-03-24,House,"Reported With Recommendation Without Amendment",15,0,0,0,15
1487301,1052274,2021-04-13,House,"House Third Reading: Given Immediate Effect Roll Call # 100",109,0,0,0,109
1487301,1054464,2021-04-15,Senate,"Reported Favorably Without Amendment",6,0,0,0,6
1487301,1057566,2021-04-20,Senate,"Senate Third Reading: Given Immediate Effect Roll Call # 89",35,0,0,1,36
1487303,1079303,2021-05-18,House,"Reported With Recommendation With Substitute H-3",12,0,0,0,12
1487303,1094988,2021-06-08,House,"House Third Reading: Given Immediate Effect Roll Call # 301",101,8,0,0,109
1487303,1159671,2022-03-01,Senate,"Reported Favorably With Substitute S-1",8,0,0,0,8
1487303,1162295,2022-03-03,Senate,"Senate Third Reading: Given Immediate Effect Roll Call # 51",35,2,0,1,38
1487303,1162802,2022-03-03,House,"House Third Reading: Roll Call # 91",95,10,0,0,105
1487327,1079498,2021-05-18,House,"Reported With Recommendation Without Amendment",12,0,0,0,12
1487327,1094963,2021-06-08,House,"House Third Reading: Given Immediate Effect Roll Call # 302",102,7,0,0,109
1487327,1159651,2022-03-01,Senate,"Reported Favorably Without Amendment",8,0,0,0,8
1487327,1162610,2022-03-03,Senate,"Senate Third Reading: Given Immediate Effect Roll Call # 52",37,0,0,1,38
1487329,1095161,2021-06-08,House,"Reported With Recommendation With Substitute H-1",13,0,0,0,13
1487329,1099355,2021-06-17,House,"House Third Reading: Given Immediate Effect Roll Call # 338",100,10,0,0,110
1487329,1110097,2021-10-06,Senate,"Reported Favorably Without Amendment",5,0,0,0,5
1487356,1095159,2021-06-08,House,"Reported With Recommendation Without Amendment",13,0,0,0,13
1487356,1099346,2021-06-17,House,"House Third Reading: Given Immediate Effect Roll Call # 341",97,10,0,0,107
1487356,1110076,2021-10-06,Senate,"Reported Favorably Without Amendment",5,0,0,0,5
1487542,1079396,2021-05-18,House,"Reported With Recommendation Without Amendment",5,2,0,0,7
1487640,1099185,2021-06-17,Senate,"Reported Favorably With Substitute S-1",3,0,0,0,3
1487640,1101001,2021-06-24,Senate,"Senate Third Reading: Passed Roll Call # 302",34,1,0,1,36
1487643,1099191,2021-06-17,Senate,"Reported Favorably With Substitute S-1",3,0,0,0,3
1487643,1100998,2021-06-24,Senate,"Senate Third Reading: Passed Roll Call # 300",30,5,0,1,36
1487643,1110321,2021-10-19,House,"Reported With Recommendation With Substitute H-1",5,2,0,0,7
1487643,1176819,2022-03-24,House,"House Third Reading: Given Immediate Effect Roll Call # 148",62,40,0,0,102
1487643,1188209,2022-04-13,Senate,"Senate Third Reading: Roll Call: Roll Call # 111",24,14,0,0,38
1487649,1147862,2022-01-20,Senate,"Reported Favorably With Substitute S-2",3,0,0,0,3
1487688,1116440,2021-11-30,Senate,"Reported Favorably With Substitute S-1",3,1,0,0,4
1487688,1117297,2021-12-09,Senate,"Senate Third Reading: Passed Roll Call # 471",21,16,0,1,38
1487688,1208704,2022-05-24,House,"Reported With Recommendation With Substitute H-2",5,2,0,0,7
1487692,1059019,2021-04-21,Senate,"Senate Third Reading: Passed Roll Call # 94",34,0,0,2,36
1487692,1076333,2021-05-11,House,"Reported With Recommendation Without Amendment",14,0,0,0,14
1487692,1086788,2021-05-27,House,"House Third Reading: Given Immediate Effect Roll Call # 266",108,0,0,0,108
1487698,1101470,2021-06-24,Senate,"Reported Favorably With Substitute S-1",7,0,0,0,7
1487698,1108701,2021-09-14,Senate,"Senate Third Reading: Passed Roll Call # 350",35,0,0,1,36
1487698,1215123,2022-06-08,House,"Reported With Recommendation With Substitute H-3",9,2,0,0,11
1487706,1091462,2021-06-03,Senate,"Reported Favorably With Substitute S-1",3,1,0,0,4
1487706,1098462,2021-06-16,Senate,"Senate Third Reading: Passed Roll Call # 274",19,16,0,1,36
1487710,1091619,2021-06-03,Senate,"Reported Favorably Without Amendment",3,1,0,0,4
1487710,1098474,2021-06-16,Senate,"Senate Third Reading: Passed Roll Call # 276",19,16,0,1,36
1487710,1100856,2021-06-23,House,"Reported With Recommendation With Substitute H-1",5,2,0,0,7
1487710,1100857,2021-06-23,House,"House Third Reading: Given Immediate Effect Roll Call # 369",58,52,0,0,110
1487710,1109734,2021-10-07,Senate,"Senate Third Reading: Roll Call: Roll Call # 372",20,16,0,0,36
1487710,1110092,2021-10-14,House,"House Third Reading: Roll Call # 471",56,51,0,0,107
1487727,1210715,2022-05-26,Senate,"Reported Favorably With Substitute S-1",6,0,0,0,6
1487727,1219031,2022-06-15,Senate,"Senate Third Reading: Passed Roll Call # 312",37,0,0,1,38
1487771,1117253,2021-12-09,Senate,"Reported Favorably With Substitute S-1",3,1,0,0,4
1487771,1172716,2022-03-17,Senate,"Senate Third Reading: Passed Roll Call # 90",22,16,0,0,38
1487774,1107748,2021-09-02,Senate,"Reported Favorably With Substitute S-1",3,1,0,0,4
1487774,1109452,2021-09-30,Senate,"Senate Third Reading: Passed Roll Call # 358",20,16,0,0,36
1487774,1109714,2021-10-06,House,"House Third Reading: Given Immediate Effect Roll Call # 463",55,48,0,0,103
1487791,1116439,2021-11-30,Senate,"Reported Favorably With Substitute S-1",3,1,0,0,4
1487791,1117263,2021-12-09,Senate,"Senate Third Reading: Passed Roll Call # 472",21,16,0,1,38
1487791,1208707,2022-05-24,House,"Reported With Recommendation With Substitute H-2",5,2,0,0,7
1487805,1110488,2021-10-21,Senate,"Reported Favorably With Substitute S-1",3,1,0,0,4
1487805,1116263,2021-11-10,Senate,"Senate Third Reading: Passed Roll Call # 440",20,15,0,1,36
1487810,1099109,2021-06-17,Senate,"Reported Favorably With Substitute S-2",4,0,0,0,4
1487810,1101069,2021-06-24,Senate,"Senate Third Reading: Passed Roll Call # 299",32,3,0,1,36
1487810,1101070,2021-06-24,Senate,"Senate Third Reading: Passed Roll Call # 303",31,4,0,1,36
1487810,1109468,2021-09-30,House,"House Third Reading: Given Immediate Effect Roll Call # 446",80,25,0,0,105
1487824,1107747,2021-09-02,Senate,"Reported Favorably With Substitute S-1",4,0,0,0,4
1487824,1116275,2021-11-10,Senate,"Senate Third Reading: Passed Roll Call # 429",34,0,1,1,36
1487824,1116276,2021-11-10,Senate,"Senate Third Reading: Passed Roll Call # 431",31,4,0,1,36
1487867,1091220,2021-06-03,Senate,"Reported Favorably Without Amendment",3,1,0,0,4
1487867,1098361,2021-06-16,Senate,"Senate Third Reading: Passed Roll Call # 275",19,16,0,1,36
1487867,1100744,2021-06-23,House,"Reported With Recommendation With Substitute H-1",5,2,0,0,7
1487867,1100745,2021-06-23,House,"House Third Reading: Given Immediate Effect Roll Call # 368",58,52,0,0,110
1487867,1109705,2021-10-06,Senate,"Senate Third Reading: Roll Call: Roll Call # 369",20,15,0,1,36
1487867,1110086,2021-10-14,House,"House Third Reading: Roll Call # 469",56,51,0,0,107
1488027,1058860,2021-04-21,Senate,"Reported Favorably Without Amendment",6,0,0,0,6
1488048,1108914,2021-09-15,Senate,"Reported Favorably Without Amendment",5,0,0,0,5
1488048,1109554,2021-09-29,Senate,"Senate Third Reading: Passed Roll Call # 355",36,0,0,0,36
1488050,1058687,2021-04-21,Senate,"Reported Favorably With Substitute S-1",6,0,0,0,6
1488183,1073184,2021-05-05,Senate,"Senate Third Reading: Passed Roll Call # 124",21,15,0,0,36
1488257,1226381,2022-09-21,House,"Reported With Recommendation Without Amendment",5,0,0,0,5
1488271,1065035,2021-04-28,House,"Reported With Recommendation Without Amendment",10,1,0,0,11
1488271,1076388,2021-05-11,House,"House Third Reading: Given Immediate Effect Roll Call # 178",106,1,0,0,107
1488380,1061107,2021-04-22,House,"Reported With Recommendation With Substitute H-3",9,0,0,0,9
1488380,1072257,2021-05-04,House,"House Third Reading: Given Immediate Effect Roll Call # 164",110,0,0,0,110
1488380,1176015,2022-03-23,Senate,"Reported Favorably With Substitute S-1",4,0,0,0,4
1488418,1064837,2021-04-28,House,"Reported With Recommendation Without Amendment",10,1,0,0,11
1488418,1076451,2021-05-11,House,"House Third Reading: Given Immediate Effect Roll Call # 179",106,1,0,0,107
1493567,1064731,2021-04-28,Senate,"Reported Favorably Without Amendment",6,0,0,0,6
1493567,1073257,2021-05-05,Senate,"Senate Third Reading: Passed Roll Call # 117",20,16,0,0,36
1493627,1065065,2021-04-28,Senate,"Reported Favorably With Substitute S-1",6,0,0,0,6
1493627,1073075,2021-05-05,Senate,"Senate Third Reading: Passed Roll Call # 116",20,16,0,0,36
1495850,1079528,2021-05-18,House,"Reported With Recommendation With Substitute H-1",9,0,0,0,9
1495859,1215364,2022-06-09,House,"Reported With Recommendation With Substitute H-2",8,0,0,0,8
1495871,1077111,2021-05-12,House,"Reported With Recommendation Without Amendment",11,0,0,0,11
1495871,1081388,2021-05-20,House,"House Third Reading: Given Immediate Effect Roll Call # 217",103,5,0,0,108
1495871,1100614,2021-06-23,Senate,"Reported Favorably Without Amendment",5,0,0,0,5
1495871,1101809,2021-06-24,Senate,"Senate Third Reading: Given Immediate Effect Roll Call # 296",34,1,0,1,36
1495881,1100701,2021-06-23,House,"Reported With Recommendation Without Amendment",11,0,0,0,11
1495881,1115556,2021-11-04,House,"House Third Reading: Given Immediate Effect Roll Call # 536",102,0,0,0,102
1495881,1221629,2022-06-30,Senate,"Reported Favorably Without Amendment",17,0,0,0,17
1495881,1221630,2022-06-30,Senate,"Senate Third Reading: Given Immediate Effect Roll Call # 389",38,0,0,0,38
1495938,1100702,2021-06-23,House,"Reported With Recommendation With Substitute H-2",11,0,0,0,11
1495938,1115589,2021-11-04,House,"House Third Reading: Given Immediate Effect Roll Call # 537",102,0,0,0,102
1495938,1221659,2022-06-30,Senate,"Reported Favorably Without Amendment",17,0,0,0,17
1495938,1221660,2022-06-30,Senate,"Senate Third Reading: Given Immediate Effect Roll Call # 390",38,0,0,0,38
1495946,1079534,2021-05-18,House,"Reported With Recommendation With Substitute H-1",9,0,0,0,9
1495962,1084498,2021-05-25,House,"Reported With Recommendation Without Amendment",13,0,0,0,13
1495962,1094947,2021-06-08,House,"House Third Reading: Given Immediate Effect Roll Call # 303",109,0,0,0,109
1496010,1151640,2022-02-22,House,"Reported With Recommendation With Substitute H-2",13,1,0,0,14
1496097,1079544,2021-05-18,House,"Reported With Recommendation Without Amendment",9,0,0,0,9
1496111,1064234,2021-04-22,House,"Reported With Recommendation With Substitute H-2",11,0,0,0,11
1499070,1079499,2021-05-18,House,"Reported With Recommendation Without Amendment",10,2,0,0,12
1499083,1079539,2021-05-18,House,"Reported With Recommendation Without Amendment",7,1,0,0,8
1499083,1217622,2022-06-21,House,"House Third Reading: Given Immediate Effect Roll Call # 320",82,23,0,0,105
1499095,1062248,2021-04-21,Senate,"Reported Favorably Without Amendment",11,0,0,0,11
1499134,1076186,2021-05-11,House,"Reported With Recommendation Without Amendment",8,3,0,0,11
1499134,1091400,2021-06-03,House,"House Third Reading: Given Immediate Effect Roll Call # 285",77,33,0,0,110
1499134,1103562,2021-06-30,Senate,"Reported Favorably Without Amendment",4,3,0,0,7
1499134,1205928,2022-05-18,Senate,"Senate Third Reading: Given Immediate Effect Roll Call # 238",24,13,0,1,38
1499159,1076320,2021-05-11,House,"Reported With Recommendation Without Amendment",8,3,0,0,11
1499159,1091632,2021-06-03,House,"House Third Reading: Given Immediate Effect Roll Call # 286",80,30,0,0,110
1499159,1103567,2021-06-30,Senate,"Reported Favorably Without Amendment",4,3,0,0,7
1499159,1205767,2022-05-18,Senate,"Senate Third Reading: Given Immediate Effect Roll Call # 239",24,13,0,1,38
1499204,1080608,2021-05-19,House,"Reported With Recommendation Without Amendment",13,0,0,0,13
1499204,1091481,2021-06-03,House,"House Third Reading: Given Immediate Effect Roll Call # 288",94,16,0,0,110
1499204,1109962,2021-10-12,Senate,"Reported Favorably Without Amendment",5,0,0,0,5
1499204,1110313,2021-10-19,Senate,"Senate Third Reading: Passed Roll Call # 390",36,0,0,0,36
1500578,1098303,2021-06-15,Senate,"Reported Favorably With Substitute S-1",9,0,0,0,9
1500578,1099163,2021-06-17,Senate,"Senate Third Reading: Passed Roll Call # 279",29,6,0,1,36
1500589,1058426,2021-04-20,House,"Reported With Recommendation Without Amendment",14,0,0,0,14
1500612,1098408,2021-06-15,Senate,"Reported Favorably With Substitute S-1",9,0,0,0,9
1500612,1098920,2021-06-17,Senate,"Senate Third Reading: Passed Roll Call # 278",29,6,0,1,36
1500620,1098444,2021-06-15,Senate,"Reported Favorably With Substitute S-2",9,0,0,0,9
1500620,1098941,2021-06-17,Senate,"Senate Third Reading: Passed Roll Call # 280",28,7,0,1,36
1500620,1216579,2022-06-15,House,"Reported With Recommendation With Substitute H-3",7,3,0,0,10
1500629,1098289,2021-06-15,Senate,"Reported Favorably With Substitute S-2",9,0,0,0,9
1500629,1099073,2021-06-17,Senate,"Senate Third Reading: Passed Roll Call # 281",29,6,0,1,36
1500629,1216584,2022-06-15,House,"Reported With Recommendation With Substitute H-2",7,2,0,0,9
1500657,1216191,2022-06-15,House,"Reported With Recommendation With Substitute H-1",7,2,0,0,9
1500691,1072358,2021-05-04,House,"Reported With Recommendation Without Amendment",11,0,0,0,11
1500691,1085770,2021-05-26,House,"House Third Reading: Given Immediate Effect Roll Call # 241",101,8,0,0,109
1500691,1098294,2021-06-15,Senate,"Reported Favorably Without Amendment",9,0,0,0,9
1500691,1099100,2021-06-17,Senate,"Senate Third Reading: Given Immediate Effect Roll Call # 277",32,3,0,1,36
1500720,1095601,2021-06-08,House,"Reported With Recommendation With Substitute H-1",11,1,0,0,12
1500720,1096775,2021-06-10,House,"House Third Reading: Given Immediate Effect Roll Call # 326",104,5,0,0,109
1500720,1103568,2021-06-30,Senate,"Reported Favorably Without Amendment",6,1,0,0,7
1500720,1105021,2021-07-15,Senate,"Senate Third Reading: Passed Roll Call # 333",34,1,0,1,36
1500743,1110108,2021-10-14,House,"Reported With Recommendation With Substitute H-3",15,3,0,0,18
1500743,1115845,2021-11-09,House,"House Third Reading: Given Immediate Effect Roll Call # 540",92,12,0,0,104
1500796,1079533,2021-05-18,House,"Reported With Recommendation With Substitute H-1",5,3,0,0,8
1500796,1100739,2021-06-23,House,"House Third Reading: Given Immediate Effect Roll Call # 359",58,52,0,0,110
1500796,1110477,2021-10-21,Senate,"Reported Favorably Without Amendment",5,2,0,0,7
1502047,1084634,2021-05-25,House,"Reported With Recommendation With Substitute H-1",10,0,0,0,10
1502047,1100105,2021-06-22,House,"House Third Reading: Given Immediate Effect Roll Call # 358",110,0,0,0,110
1502053,1077465,2021-05-13,House,"Reported With Recommendation With Substitute H-4",6,3,0,0,9
1502053,1090173,2021-06-02,House,"House Third Reading: Given Immediate Effect Roll Call # 276",62,47,0,0,109
1502053,1110657,2021-10-26,Senate,"Reported Favorably Without Amendment",6,4,0,0,10
1502077,1091551,2021-06-03,House,"Reported With Recommendation Without Amendment",19,0,0,0,19
1502077,1103603,2021-06-30,House,"House Third Reading: Given Immediate Effect Roll Call # 406",109,0,0,0,109
1502077,1109862,2021-10-12,Senate,"Reported Favorably Without Amendment",10,0,0,0,10
1502077,1110075,2021-10-14,Senate,"Senate Third Reading: Given Immediate Effect Roll Call # 386",35,0,0,1,36
1502089,1098012,2021-06-15,House,"Reported With Recommendation With Substitute H-2",14,0,0,0,14
1502089,1109465,2021-09-30,House,"House Third Reading: Given Immediate Effect Roll Call # 450",105,0,0,0,105
1502240,1065526,2021-04-28,Senate,"Senate Third Reading: Passed Roll Call # 109",33,2,0,1,36
1502259,1066049,2021-04-29,Senate,"Reported Favorably Without Amendment",6,0,0,0,6
1502259,1078350,2021-05-13,Senate,"Senate Third Reading: Passed Roll Call # 186",25,10,0,1,36
1502308,1109472,2021-09-30,Senate,"Reported Favorably Without Amendment",7,0,0,0,7
1502320,1086828,2021-05-27,Senate,"Reported Favorably Without Amendment",7,1,0,0,8
1502320,1101284,2021-06-24,Senate,"Senate Third Reading: Passed Roll Call # 297",19,16,0,1,36
1502333,1086022,2021-05-26,Senate,"Reported Favorably Without Amendment",12,0,0,0,12
1502333,1091473,2021-06-03,Senate,"Senate Third Reading: Passed Roll Call # 250",36,0,0,0,36
1502333,1100881,2021-06-23,House,"Reported With Recommendation Without Amendment",10,0,0,0,10
1502333,1103253,2021-06-30,House,"House Third Reading: Given Immediate Effect Roll Call # 410",81,28,0,0,109
1502355,1076436,2021-05-11,House,"Reported With Recommendation With Substitute H-1",5,0,0,0,5
1502355,1096244,2021-06-09,House,"House Third Reading: Given Immediate Effect Roll Call # 311",68,41,0,0,109
1502357,1079543,2021-05-18,House,"Reported With Recommendation With Substitute H-1",7,0,0,0,7
1502357,1096164,2021-06-09,House,"House Third Reading: Given Immediate Effect Roll Call # 313",106,3,0,0,109
1502365,1081749,2021-05-20,House,"Reported With Recommendation Without Amendment",10,0,0,0,10
1502365,1096288,2021-06-09,House,"House Third Reading: Given Immediate Effect Roll Call # 315",97,12,0,0,109
1502370,1076435,2021-05-11,House,"Reported With Recommendation Without Amendment",6,0,0,0,6
1502370,1096246,2021-06-09,House,"House Third Reading: Given Immediate Effect Roll Call # 308",73,36,0,0,109
1502377,1115771,2021-11-09,House,"Reported With Recommendation With Substitute H-3",10,0,0,0,10
1502377,1117130,2021-12-08,House,"House Third Reading: Given Immediate Effect Roll Call # 590",96,8,0,0,104
1502377,1191555,2022-04-20,Senate,"Reported Favorably Without Amendment",5,1,0,0,6
1502377,1200229,2022-05-04,Senate,"Senate Third Reading: Given Immediate Effect Roll Call # 201",33,1,0,4,38
1502382,1116681,2021-11-09,House,"Reported With Recommendation Without Amendment",6,2,0,0,8
1502386,1115755,2021-11-09,House,"Reported With Recommendation Without Amendment",6,2,0,0,8
1502390,1217674,2022-06-21,House,"Reported With Recommendation With Substitute H-2",10,4,0,0,14
1502396,1076434,2021-05-11,House,"Reported With Recommendation With Substitute H-1",5,0,0,0,5
1502396,1096228,2021-06-09,House,"House Third Reading: Given Immediate Effect Roll Call # 310",64,45,0,0,109
1502404,1082331,2021-05-20,House,"Reported With Recommendation Without Amendment",10,0,0,0,10
1502404,1096217,2021-06-09,House,"House Third Reading: Given Immediate Effect Roll Call # 317",107,2,0,0,109
1502407,1115752,2021-11-09,House,"Reported With Recommendation Without Amendment",6,2,0,0,8
1502413,1115772,2021-11-09,House,"Reported With Recommendation With Substitute H-2",10,0,0,0,10
1502413,1117138,2021-12-08,House,"House Third Reading: Given Immediate Effect Roll Call # 591",96,8,0,0,104
1502413,1190838,2022-04-20,Senate,"Reported Favorably Without Amendment",5,2,0,0,7
1502413,1200165,2022-05-04,Senate,"Senate Third Reading: Given Immediate Effect Roll Call # 202",33,1,0,4,38
1502416,1079532,2021-05-18,House,"Reported With Recommendation With Substitute H-1",7,0,0,0,7
1502416,1096171,2021-06-09,House,"House Third Reading: Passed By 2/3 Vote Roll Call # 318",81,28,0,0,109
1502419,1082324,2021-05-20,House,"Reported With Recommendation Without Amendment",10,0,0,0,10
1502419,1096206,2021-06-09,House,"House Third Reading: Given Immediate Effect Roll Call # 316",106,3,0,0,109
1502427,1076437,2021-05-11,House,"Reported With Recommendation With Substitute H-1",6,0,0,0,6
1502427,1096258,2021-06-09,House,"House Third Reading: Given Immediate Effect Roll Call # 305",72,37,0,0,109
1502437,1076446,2021-05-11,House,"Reported With Recommendation With Substitute H-1",6,0,0,0,6
1502437,1096268,2021-06-09,House,"House Third Reading: Given Immediate Effect Roll Call # 307",71,38,0,0,109
1502452,1066883,2021-04-29,House,"Reported With Recommendation Without Amendment",17,12,0,0,29
1502452,1077738,2021-05-13,House,"House Third Reading: Given Immediate Effect Roll Call # 207",58,49,0,0,107
1502459,1082329,2021-05-20,House,"Reported With Recommendation Without Amendment",10,0,0,0,10
1502459,1096256,2021-06-09,House,"House Third Reading: Given Immediate Effect Roll Call # 314",93,16,0,0,109
1502466,1076438,2021-05-11,House,"Reported With Recommendation Without Amendment",6,0,0,0,6
1502466,1096269,2021-06-09,House,"House Third Reading: Given Immediate Effect Roll Call # 306",72,37,0,0,109
1502471,1217824,2022-06-21,House,"Reported With Recommendation With Substitute H-1",10,4,0,0,14
1502475,1100383,2021-06-22,House,"Reported With Recommendation Without Amendment",11,3,0,0,14
1502475,1110815,2021-10-27,House,"House Third Reading: Given Immediate Effect Roll Call # 506",104,2,0,0,106
1502475,1142070,2022-02-09,Senate,"Reported Favorably Without Amendment",10,0,0,0,10
1502475,1151433,2022-02-22,Senate,"Senate Third Reading: Given Immediate Effect Roll Call # 33",38,0,0,0,38
1502481,1115818,2021-11-09,House,"Reported With Recommendation With Substitute H-1",6,2,0,0,8
1502485,1079536,2021-05-18,House,"Reported With Recommendation With Substitute H-1",7,0,0,0,7
1502485,1096270,2021-06-09,House,"House Third Reading: Given Immediate Effect Roll Call # 312",93,16,0,0,109
1502490,1076377,2021-05-11,House,"Reported With Recommendation With Substitute H-1",5,0,0,0,5
1502490,1096050,2021-06-09,House,"House Third Reading: Given Immediate Effect Roll Call # 309",65,44,0,0,109
1502806,1175937,2022-03-23,Senate,"Reported Favorably With Substitute S-2",7,0,0,0,7
1502806,1219032,2022-05-11,Senate,"Senate Third Reading: Passed Roll Call # 227",32,1,0,5,38
1502807,1065390,2021-04-28,House,"Reported With Recommendation Without Amendment",10,1,0,0,11
1502807,1119666,2021-12-09,Senate,"Reported Favorably Without Amendment",5,0,0,0,5
1502813,1176244,2022-03-23,Senate,"Reported Favorably With Substitute S-2",7,0,0,0,7
1502813,1219012,2022-05-11,Senate,"Senate Third Reading: Passed Roll Call # 226",32,1,0,5,38
1502825,1176274,2022-03-23,Senate,"Reported Favorably With Substitute S-2",7,0,0,0,7
1502825,1219018,2022-05-11,Senate,"Senate Third Reading: Passed Roll Call # 228",33,0,0,5,38
1502829,1175563,2022-03-23,Senate,"Reported Favorably With Substitute S-2",7,0,0,0,7
1502829,1217746,2022-05-11,Senate,"Senate Third Reading: Passed Roll Call # 225",33,0,0,5,38
1502864,1099277,2021-06-17,House,"Reported With Recommendation With Substitute H-1",7,2,0,0,9
1502864,1115555,2021-11-04,House,"House Third Reading: Given Immediate Effect Roll Call # 535",91,11,0,0,102
1502864,1171813,2022-03-16,Senate,"Reported Favorably Without Amendment",5,0,0,0,5
1502864,1188873,2022-04-14,Senate,"Senate Third Reading: Passed Roll Call # 114",33,5,0,0,38
1502876,1084787,2021-05-25,House,"Reported With Recommendation Without Amendment",13,0,0,0,13
1502876,1094730,2021-06-08,House,"House Third Reading: Given Immediate Effect Roll Call # 304",109,0,0,0,109
1502876,1110154,2021-10-14,Senate,"Reported Favorably Without Amendment",8,0,0,0,8
1502876,1110486,2021-10-21,Senate,"Senate Third Reading: Given Immediate Effect Roll Call # 398",34,1,0,1,36
1502885,1115461,2021-11-02,House,"Reported With Recommendation With Substitute H-1",9,5,0,0,14
1502900,1110691,2021-10-26,House,"Reported With Recommendation With Substitute H-1",11,1,0,0,12
1502900,1115925,2021-11-10,House,"House Third Reading: Given Immediate Effect Roll Call # 551",91,14,0,0,105
1502900,1216542,2022-06-15,Senate,"Reported Favorably Without Amendment",8,0,0,0,8
1502919,1086229,2021-05-26,House,"Reported With Recommendation Without Amendment",11,0,0,0,11
1502919,1098049,2021-06-15,House,"House Third Reading: Given Immediate Effect Roll Call # 330",109,0,0,0,109
1502919,1110910,2021-10-28,Senate,"Reported Favorably Without Amendment",9,0,0,0,9
1502919,1116233,2021-11-10,Senate,"Senate Third Reading: Given Immediate Effect Roll Call # 436",35,0,0,1,36
1502940,1100844,2021-06-23,House,"Reported With Recommendation With Substitute H-1",12,3,0,0,15
1502940,1106262,2021-08-17,House,"House Third Reading: Given Immediate Effect Roll Call # 433",87,21,0,0,108
1502940,1109555,2021-10-05,Senate,"Reported Favorably Without Amendment",9,0,0,0,9
1502940,1110053,2021-10-13,Senate,"Senate Third Reading: Given Immediate Effect Roll Call # 382",29,7,0,0,36
1502948,1109077,2021-09-21,House,"Reported With Recommendation Without Amendment",13,0,0,0,13
1502948,1109963,2021-10-13,House,"House Third Reading: Given Immediate Effect Roll Call # 466",102,4,0,0,106
1502948,1110798,2021-10-27,Senate,"Reported Favorably Without Amendment",8,0,0,0,8
1502948,1116236,2021-11-10,Senate,"Senate Third Reading: Given Immediate Effect Roll Call # 430",35,0,0,1,36
1502972,1205457,2022-05-17,House,"Reported With Recommendation Without Amendment",13,0,0,0,13
1502972,1217623,2022-06-21,House,"House Third Reading: Given Immediate Effect Roll Call # 323",105,0,0,0,105
1502980,1076334,2021-05-11,House,"Reported With Recommendation With Substitute H-1",11,0,0,0,11
1502980,1084575,2021-05-25,House,"House Third Reading: Given Immediate Effect Roll Call # 236",104,4,0,0,108
1502980,1216446,2022-06-15,Senate,"Reported Favorably Without Amendment",7,1,0,0,8
1502980,1221619,2022-06-30,Senate,"Senate Third Reading: Given Immediate Effect Roll Call # 388",31,7,0,0,38
1502987,1110799,2021-10-26,House,"Reported With Recommendation With Substitute H-1",11,1,0,0,12
1502987,1115921,2021-11-10,House,"House Third Reading: Given Immediate Effect Roll Call # 552",91,14,0,0,105
1502987,1216591,2022-06-15,Senate,"Reported Favorably Without Amendment",8,0,0,0,8
1503934,1086737,2021-05-27,Senate,"Reported Favorably With Substitute S-1",5,2,0,0,7
1503934,1096998,2021-06-09,Senate,"Senate Third Reading: Passed Roll Call # 258",19,16,0,1,36
1503934,1117179,2021-12-08,House,"Reported With Recommendation Without Amendment",9,6,0,0,15
1503948,1091443,2021-06-03,Senate,"Reported Favorably Without Amendment",5,2,0,0,7
1503948,1169933,2022-03-03,Senate,"Senate Third Reading: Passed Roll Call # 58",22,15,0,1,38
1504145,1084822,2021-05-25,House,"Reported With Recommendation Without Amendment",12,0,0,0,12
1504145,1100400,2021-06-22,House,"House Third Reading: Given Immediate Effect Roll Call # 356",110,0,0,0,110
1504206,1084249,2021-05-25,House,"Reported With Recommendation With Substitute H-1",7,2,0,0,9
1504206,1110791,2021-10-27,House,"House Third Reading: Passed Roll Call # 502",55,47,0,0,102
1504206,1110792,2021-10-27,House,"House Third Reading: Given Immediate Effect Roll Call # 503",55,48,0,0,103
1504206,1228984,2022-10-11,Senate,"Reported Favorably Without Amendment",6,3,0,0,9
1504227,1098129,2021-06-15,House,"Reported With Recommendation With Substitute H-1",13,0,0,0,13
1504227,1106270,2021-08-17,House,"House Third Reading: Given Immediate Effect Roll Call # 432",100,8,0,0,108
1504227,1218318,2022-06-07,Senate,"Reported Favorably With Substitute S-1",8,0,0,0,8
1504256,1097309,2021-06-08,House,"Reported With Recommendation With Substitute H-3",9,0,0,0,9
1504256,1100874,2021-06-23,House,"House Third Reading: Given Immediate Effect Roll Call # 360",77,33,0,0,110
1504322,1066781,2021-04-29,Senate,"Reported Favorably Without Amendment",12,0,0,0,12
1504327,1072401,2021-05-04,Senate,"Reported Favorably Without Amendment",6,1,0,0,7
1504327,1073145,2021-05-05,Senate,"Senate Third Reading: Passed Roll Call # 122",35,1,0,0,36
1504327,1076312,2021-05-11,House,"Reported With Recommendation Without Amendment",11,0,0,0,11
1504327,1085824,2021-05-26,House,"House Third Reading: Given Immediate Effect Roll Call # 238",91,18,0,0,109
1504333,1079295,2021-05-18,Senate,"Reported Favorably Without Amendment",5,0,0,0,5
1504333,1115375,2021-11-02,Senate,"Senate Third Reading: Passed Roll Call # 422",27,8,0,1,36
1504337,1084207,2021-05-25,Senate,"Reported Favorably Without Amendment",10,0,0,0,10
1504347,1079324,2021-05-18,Senate,"Reported Favorably Without Amendment",5,0,0,0,5
1504347,1115372,2021-11-02,Senate,"Senate Third Reading: Passed Roll Call # 425",28,7,0,1,36
1504357,1079167,2021-05-18,Senate,"Reported Favorably Without Amendment",5,0,0,0,5
1504357,1115437,2021-11-02,Senate,"Senate Third Reading: Passed Roll Call # 423",25,10,0,1,36
1504370,1079225,2021-05-18,Senate,"Reported Favorably Without Amendment",5,0,0,0,5
1504370,1115388,2021-11-02,Senate,"Senate Third Reading: Passed By 3/4 Vote Roll Call # 424",27,8,0,1,36
1504371,1084305,2021-05-25,Senate,"Reported Favorably Without Amendment",10,0,0,0,10
1504468,1097282,2021-06-08,House,"Reported With Recommendation Without Amendment",11,0,0,0,11
1504468,1101921,2021-06-24,House,"House Third Reading: Given Immediate Effect Roll Call # 372",97,10,0,0,107
1504468,1146966,2022-02-15,Senate,"Reported Favorably Without Amendment",10,0,0,0,10
1504789,1098943,2021-06-17,Senate,"Reported Favorably With Substitute S-1",8,1,0,0,9
1504789,1109775,2021-10-05,Senate,"Senate Third Reading: Passed Roll Call # 363",24,10,0,2,36
1504789,1151247,2022-02-22,House,"Reported With Recommendation Without Amendment",13,1,0,0,14
1504794,1219001,2022-06-07,Senate,"Reported Favorably With Substitute S-1",8,0,0,0,8
1504794,1219002,2022-06-15,Senate,"Senate Third Reading: Passed Roll Call # 317",37,0,0,1,38
1504794,1219003,2022-06-21,House,"Reported With Recommendation Without Amendment",9,1,0,0,10
1504794,1221511,2022-06-30,House,"House Third Reading: Given Immediate Effect Roll Call # 361",106,0,0,0,106
1504806,1072340,2021-05-04,House,"Reported With Recommendation Without Amendment",8,5,0,0,13
1504806,1073483,2021-05-05,House,"House Third Reading: Given Immediate Effect Roll Call # 170",60,48,0,0,108
1504806,1079458,2021-05-18,Senate,"Senate Third Reading: Passed Roll Call # 191",22,13,0,1,36
1504812,1079524,2021-05-18,House,"Reported With Recommendation With Substitute H-1",13,0,0,0,13
1504812,1086818,2021-05-27,House,"House Third Reading: Given Immediate Effect Roll Call # 269",104,4,0,0,108
1504812,1098928,2021-06-17,Senate,"Reported Favorably Without Amendment",9,0,0,0,9
1504812,1101441,2021-06-24,Senate,"Senate Third Reading: Given Immediate Effect Roll Call # 311",35,0,0,1,36
1504812,1101882,2021-06-24,House,"House Third Reading: Senate Amendment(s) Concurred In Roll Call # 382",104,4,0,0,108
1504818,1094683,2021-06-08,House,"Reported With Recommendation Without Amendment",13,0,0,0,13
1504818,1099034,2021-06-17,House,"House Third Reading: Given Immediate Effect Roll Call # 352",108,0,0,0,108
1504818,1110115,2021-10-14,Senate,"Reported Favorably Without Amendment",8,0,0,0,8
1504818,1110481,2021-10-21,Senate,"Senate Third Reading: Given Immediate Effect Roll Call # 399",34,1,0,1,36
1504824,1079538,2021-05-18,House,"Reported With Recommendation Without Amendment",14,0,0,0,14
1504824,1086568,2021-05-27,House,"House Third Reading: Given Immediate Effect Roll Call # 271",104,4,0,0,108
1504824,1098912,2021-06-17,Senate,"Reported Favorably Without Amendment",9,0,0,0,9
1504824,1101823,2021-06-24,Senate,"Senate Third Reading: Given Immediate Effect Roll Call # 313",35,0,0,1,36
1504824,1102020,2021-06-24,House,"House Third Reading: Senate Amendment(s) Concurred In Roll Call # 384",104,4,0,0,108
1504830,1079535,2021-05-18,House,"Reported With Recommendation Without Amendment",14,0,0,0,14
1504830,1086827,2021-05-27,House,"House Third Reading: Given Immediate Effect Roll Call # 275",103,5,0,0,108
1504830,1098911,2021-06-17,Senate,"Reported Favorably Without Amendment",9,0,0,0,9
1504830,1101858,2021-06-24,Senate,"Senate Third Reading: Given Immediate Effect Roll Call # 317",35,0,0,1,36
1504830,1102048,2021-06-24,House,"House Third Reading: Senate Amendment(s) Concurred In Roll Call # 388",103,5,0,0,108
1504866,1079531,2021-05-18,House,"Reported With Recommendation Without Amendment",14,0,0,0,14
1504866,1086812,2021-05-27,House,"House Third Reading: Given Immediate Effect Roll Call # 272",104,4,0,0,108
1504866,1099208,2021-06-17,Senate,"Reported Favorably Without Amendment",9,0,0,0,9
1504866,1101380,2021-06-24,Senate,"Senate Third Reading: Given Immediate Effect Roll Call # 314",35,0,0,1,36
1504866,1101877,2021-06-24,House,"House Third Reading: Senate Amendment(s) Concurred In Roll Call # 385",104,4,0,0,108
1504873,1079526,2021-05-18,House,"Reported With Recommendation With Substitute H-1",14,0,0,0,14
1504873,1086585,2021-05-27,House,"House Third Reading: Given Immediate Effect Roll Call # 274",103,5,0,0,108
1504873,1098914,2021-06-17,Senate,"Reported Favorably Without Amendment",9,0,0,0,9
1504873,1101914,2021-06-24,Senate,"Senate Third Reading: Given Immediate Effect Roll Call # 316",35,0,0,1,36
1504873,1101915,2021-06-24,House,"House Third Reading: Senate Amendment(s) Concurred In By 3/4 Vote Roll Call # 387",103,5,0,0,108
1504892,1116961,2021-12-07,House,"Reported With Recommendation With Substitute H-1",7,1,0,0,8
1504892,1194850,2022-04-27,House,"House Third Reading: Given Immediate Effect Roll Call # 171",66,37,0,0,103
1504892,1226463,2022-09-21,Senate,"Reported Favorably With Substitute S-2",9,0,0,0,9
1504902,1094635,2021-06-08,House,"Reported With Recommendation Without Amendment",13,0,0,0,13
1504902,1099027,2021-06-17,House,"House Third Reading: Given Immediate Effect Roll Call # 351",108,0,0,0,108
1504902,1105160,2021-07-15,Senate,"Reported Favorably With Substitute S-1",8,0,0,0,8
1504902,1105161,2021-07-15,Senate,"Senate Third Reading: Given Immediate Effect Roll Call # 337",35,0,0,1,36
1504902,1105291,2021-07-21,House,"House Third Reading: Roll Call # 421",108,0,0,0,108
1504912,1079422,2021-05-18,House,"Reported With Recommendation Without Amendment",14,0,0,0,14
1504912,1086836,2021-05-27,House,"House Third Reading: Given Immediate Effect Roll Call # 270",104,4,0,0,108
1504912,1098925,2021-06-17,Senate,"Reported Favorably Without Amendment",9,0,0,0,9
1504912,1101389,2021-06-24,Senate,"Senate Third Reading: Given Immediate Effect Roll Call # 312",35,0,0,1,36
1504912,1101878,2021-06-24,House,"House Third Reading: Senate Amendment(s) Concurred In Roll Call # 383",104,4,0,0,108
1504978,1080087,2021-05-19,House,"Reported With Recommendation Without Amendment",28,1,0,0,29
1504978,1095834,2021-06-09,House,"House Third Reading: Given Immediate Effect Roll Call # 320",105,4,0,0,109
1504991,1086547,2021-05-27,House,"Reported With Recommendation Without Amendment",19,0,0,0,19
1504991,1099033,2021-06-17,House,"House Third Reading: Given Immediate Effect Roll Call # 336",107,3,0,0,110
1504991,1230473,2022-12-07,Senate,"Reported Favorably With Substitute S-5",8,0,0,0,8
1504997,1079425,2021-05-18,House,"Reported With Recommendation Without Amendment",14,0,0,0,14
1504997,1086855,2021-05-27,House,"House Third Reading: Given Immediate Effect Roll Call # 273",104,4,0,0,108
1504997,1098938,2021-06-17,Senate,"Reported Favorably Without Amendment",9,0,0,0,9
1504997,1101385,2021-06-24,Senate,"Senate Third Reading: Given Immediate Effect Roll Call # 315",35,0,0,1,36
1504997,1101879,2021-06-24,House,"House Third Reading: Senate Amendment(s) Concurred In Roll Call # 386",104,4,0,0,108
1505003,1080017,2021-05-19,House,"Reported With Recommendation Without Amendment",28,1,0,0,29
1505003,1096036,2021-06-09,House,"House Third Reading: Given Immediate Effect Roll Call # 319",105,4,0,0,109
1505946,1103569,2021-06-30,Senate,"Reported Favorably With Substitute S-2",10,0,0,0,10
1505946,1109408,2021-09-29,Senate,"Senate Third Reading: Passed Roll Call # 354",36,0,0,0,36
1505946,1130503,2022-01-27,House,"Reported With Recommendation With Substitute H-1",17,1,0,0,18
1505946,1147152,2022-02-16,House,"House Third Reading: Given Immediate Effect Roll Call # 53",97,8,0,0,105
1505946,1175035,2022-02-22,Senate,"Senate Third Reading: Roll Call: Roll Call # 38",38,0,0,0,38
1505960,1079221,2021-05-18,Senate,"Reported Favorably Without Amendment",5,0,0,0,5
1505960,1086587,2021-05-27,Senate,"Senate Third Reading: Passed Roll Call # 235",25,11,0,0,36
1505960,1105333,2021-07-21,House,"House Third Reading: Given Immediate Effect Roll Call # 425",93,15,0,0,108
1505960,1107328,2021-08-31,Senate,"Senate Third Reading: Roll Call: Roll Call # 342",36,0,0,0,36
1506199,1084572,2021-05-25,House,"Reported With Recommendation Without Amendment",14,0,0,0,14
1506199,1091369,2021-06-03,House,"House Third Reading: Given Immediate Effect Roll Call # 295",104,6,0,0,110
1506199,1110080,2021-10-06,Senate,"Reported Favorably Without Amendment",8,0,0,0,8
1506199,1117128,2021-12-08,Senate,"Senate Third Reading: Given Immediate Effect Roll Call # 468",36,0,0,2,38
1506199,1117292,2021-12-09,House,"House Third Reading: Roll Call # 596",98,4,0,0,102
1506207,1086669,2021-05-27,House,"Reported With Recommendation With Substitute H-1",8,0,0,0,8
1506207,1115470,2021-11-02,House,"House Third Reading: Given Immediate Effect Roll Call # 517",88,14,0,0,102
1506214,1086675,2021-05-27,House,"Reported With Recommendation Without Amendment",8,0,0,0,8
1506214,1110903,2021-10-28,House,"House Third Reading: Given Immediate Effect Roll Call # 511",94,11,0,0,105
1506221,1096232,2021-06-09,House,"Reported With Recommendation With Substitute H-1",11,0,0,0,11
1506221,1100653,2021-06-23,House,"House Third Reading: Given Immediate Effect Roll Call # 363",110,0,0,0,110
1506221,1110471,2021-10-20,Senate,"Reported Favorably With Substitute S-1",4,0,0,0,4
1506221,1115379,2021-11-02,Senate,"Senate Third Reading: Given Immediate Effect Roll Call # 420",35,0,0,1,36
1506221,1115773,2021-11-09,House,"House Third Reading: Roll Call # 538",104,0,0,0,104
1506223,1086711,2021-05-27,House,"Reported With Recommendation Without Amendment",8,0,0,0,8
1506223,1110851,2021-10-28,House,"House Third Reading: Given Immediate Effect Roll Call # 513",95,10,0,0,105
1506229,1084566,2021-05-25,House,"Reported With Recommendation Without Amendment",14,0,0,0,14
1506229,1091249,2021-06-03,House,"House Third Reading: Given Immediate Effect Roll Call # 296",104,6,0,0,110
1506229,1110079,2021-10-06,Senate,"Reported Favorably Without Amendment",8,0,0,0,8
1506229,1117135,2021-12-08,Senate,"Senate Third Reading: Given Immediate Effect Roll Call # 469",34,2,0,2,38
1506229,1117258,2021-12-09,House,"House Third Reading: Roll Call # 597",98,4,0,0,102
1506272,1086674,2021-05-27,House,"Reported With Recommendation Without Amendment",8,0,0,0,8
1506272,1110856,2021-10-28,House,"House Third Reading: Given Immediate Effect Roll Call # 510",97,8,0,0,105
1506284,1084800,2021-05-25,House,"Reported With Recommendation Without Amendment",14,0,0,0,14
1506284,1091428,2021-06-03,House,"House Third Reading: Given Immediate Effect Roll Call # 294",104,6,0,0,110
1506284,1110078,2021-10-06,Senate,"Reported Favorably Without Amendment",8,0,0,0,8
1506284,1117216,2021-12-08,Senate,"Senate Third Reading: Given Immediate Effect Roll Call # 467",35,1,0,2,38
1506293,1086650,2021-05-27,House,"Reported With Recommendation Without Amendment",8,0,0,0,8
1506293,1110852,2021-10-28,House,"House Third Reading: Given Immediate Effect Roll Call # 512",100,5,0,0,105
1506300,1086660,2021-05-27,House,"Reported With Recommendation Without Amendment",8,0,0,0,8
1506300,1110906,2021-10-28,House,"House Third Reading: Given Immediate Effect Roll Call # 514",97,8,0,0,105
1506328,1084430,2021-05-25,House,"Reported With Recommendation Without Amendment",14,0,0,0,14
1506328,1091318,2021-06-03,House,"House Third Reading: Given Immediate Effect Roll Call # 293",106,4,0,0,110
1506328,1110153,2021-10-06,Senate,"Reported Favorably Without Amendment",8,0,0,0,8
1506328,1117207,2021-12-08,Senate,"Senate Third Reading: Passed By 3/4 Vote Roll Call # 465",34,0,2,2,38
1506328,1117208,2021-12-08,Senate,"Senate Third Reading: Passed By 3/4 Vote Roll Call # 466",36,0,0,2,38
1506445,1090148,2021-06-02,Senate,"Reported Favorably With Substitute S-2",10,0,0,0,10
1506445,1096886,2021-06-09,Senate,"Senate Third Reading: Passed Roll Call # 255",35,0,0,1,36
1506445,1101881,2021-06-24,House,"Reported With Recommendation Without Amendment",19,0,0,0,19
1506527,1094636,2021-06-08,House,"Reported With Recommendation Without Amendment",13,0,0,0,13
1506527,1101900,2021-06-24,House,"House Third Reading: Given Immediate Effect Roll Call # 373",107,0,0,0,107
1506527,1116670,2021-12-02,Senate,"Reported Favorably With Substitute S-1",9,0,0,0,9
1506527,1117312,2021-12-09,Senate,"Senate Third Reading: Given Immediate Effect Roll Call # 474",37,0,0,1,38
1506527,1119634,2021-12-14,House,"House Third Reading: Roll Call # 608",103,0,0,0,103
1506544,1215380,2022-06-09,House,"Reported With Recommendation With Substitute H-2",7,1,0,0,8
1506637,1100124,2021-06-22,House,"Reported With Recommendation Without Amendment",7,0,0,0,7
1506637,1105323,2021-07-21,House,"House Third Reading: Given Immediate Effect Roll Call # 424",59,49,0,0,108
1506769,1078387,2021-05-13,Senate,"Senate Third Reading: Passed Roll Call # 187",20,15,0,1,36
1506781,1110123,2021-10-12,Senate,"Reported Favorably With Substitute S-1",10,0,0,0,10
1506830,1101079,2021-06-24,Senate,"Reported Favorably With Substitute S-1",6,0,0,0,6
1506830,1107745,2021-09-01,Senate,"Senate Third Reading: Passed Roll Call # 346",36,0,0,0,36
1506863,1110087,2021-10-12,Senate,"Reported Favorably With Substitute S-1",10,0,0,0,10
1506868,1101060,2021-06-24,Senate,"Reported Favorably With Substitute S-1",6,0,0,0,6
1506868,1107746,2021-09-01,Senate,"Senate Third Reading: Passed Roll Call # 347",36,0,0,0,36
1506879,1098423,2021-06-15,Senate,"Reported Favorably With Substitute S-1",9,0,0,0,9
1506879,1098915,2021-06-17,Senate,"Senate Third Reading: Passed Roll Call # 282",28,7,0,1,36
1506879,1216583,2022-06-15,House,"Reported With Recommendation With Substitute H-3",7,3,0,0,10
1506896,1166130,2022-03-08,House,"Reported With Recommendation With Substitute H-1",13,0,0,0,13
1506896,1176042,2022-03-23,House,"House Third Reading: Given Immediate Effect Roll Call # 137",104,1,0,0,105
1506896,1206032,2022-05-18,Senate,"Reported Favorably Without Amendment",7,0,0,0,7
1506901,1086240,2021-05-26,House,"Reported With Recommendation With Substitute H-1",8,2,0,0,10
1506901,1098981,2021-06-17,House,"House Third Reading: Given Immediate Effect Roll Call # 347",103,7,0,0,110
1506901,1216942,2022-06-16,Senate,"Reported Favorably Without Amendment",7,0,0,0,7
1506901,1221510,2022-06-30,Senate,"Senate Third Reading: Given Immediate Effect Roll Call # 369",38,0,0,0,38
1506909,1100128,2021-06-22,House,"Reported With Recommendation With Substitute H-3",11,2,0,0,13
1506909,1110354,2021-10-19,House,"House Third Reading: Given Immediate Effect Roll Call # 485",85,18,0,0,103
1506921,1100133,2021-06-22,House,"Reported With Recommendation With Substitute H-3",10,3,0,0,13
1506921,1110338,2021-10-19,House,"House Third Reading: Given Immediate Effect Roll Call # 486",88,15,0,0,103
1506963,1166234,2022-03-08,House,"Reported With Recommendation With Substitute H-1",13,0,0,0,13
1506963,1176105,2022-03-23,House,"House Third Reading: Given Immediate Effect Roll Call # 136",104,1,0,0,105
1506963,1217704,2022-05-18,Senate,"Reported Favorably With Substitute S-2",7,0,0,0,7
1506975,1115381,2021-11-02,House,"Reported With Recommendation With Substitute H-1",12,1,0,0,13
1506975,1116673,2021-12-02,House,"House Third Reading: Given Immediate Effect Roll Call # 568",95,5,0,0,100
1506975,1166214,2022-03-08,Senate,"Reported Favorably With Substitute S-1",5,0,0,0,5
1507012,1110721,2021-10-26,House,"Reported With Recommendation With Substitute H-1",9,1,0,0,10
1507012,1130478,2022-01-27,House,"House Third Reading: Given Immediate Effect Roll Call # 22",99,3,0,0,102
1507012,1218057,2022-06-07,Senate,"Reported Favorably Without Amendment",8,0,0,0,8
1507012,1218058,2022-06-15,Senate,"Senate Third Reading: Given Immediate Effect Roll Call # 320",37,0,0,1,38
1507021,1110722,2021-10-26,House,"Reported With Recommendation Without Amendment",9,1,0,0,10
1507021,1130357,2022-01-27,House,"House Third Reading: Given Immediate Effect Roll Call # 23",98,4,0,0,102
1507021,1217773,2022-06-07,Senate,"Reported Favorably Without Amendment",8,0,0,0,8
1507021,1217774,2022-06-15,Senate,"Senate Third Reading: Given Immediate Effect Roll Call # 321",37,0,0,1,38
1507827,1098021,2021-06-15,House,"Reported With Recommendation With Substitute H-1",9,0,0,0,9
1507827,1109427,2021-09-29,House,"House Third Reading: Given Immediate Effect Roll Call # 444",102,2,0,0,104
1507827,1159333,2022-03-01,Senate,"Reported Favorably Without Amendment",8,0,0,0,8
1507827,1166116,2022-03-08,Senate,"Senate Third Reading: Given Immediate Effect Roll Call # 63",38,0,0,0,38
1507843,1098443,2021-06-15,Senate,"Reported Favorably With Substitute S-2",9,0,0,0,9
1507843,1098950,2021-06-17,Senate,"Senate Third Reading: Passed Roll Call # 283",29,6,0,1,36
1507843,1216190,2022-06-15,House,"Reported With Recommendation With Substitute H-1",7,3,0,0,10
1507851,1085907,2021-05-26,House,"Reported With Recommendation Without Amendment",15,0,0,0,15
1507860,1079903,2021-05-19,House,"Reported With Recommendation Without Amendment",8,3,0,0,11
1507860,1090221,2021-06-02,House,"House Third Reading: Given Immediate Effect Roll Call # 281",87,22,0,0,109
1507870,1085779,2021-05-26,House,"Reported With Recommendation Without Amendment",15,0,0,0,15
1507870,1215113,2022-06-08,House,"House Third Reading: Given Immediate Effect Roll Call # 286",106,0,0,0,106
1507895,1086220,2021-05-26,House,"Reported With Recommendation With Substitute H-1",9,1,0,0,10
1507895,1099321,2021-06-17,House,"House Third Reading: Given Immediate Effect Roll Call # 348",102,7,0,0,109
1507910,1090111,2021-06-02,Senate,"Reported Favorably Without Amendment",10,0,0,0,10
1507910,1090112,2021-06-02,Senate,"Senate Third Reading: Passed Roll Call # 239",20,16,0,0,36
1507920,1079951,2021-05-19,House,"Reported With Recommendation Without Amendment",8,3,0,0,11
1507920,1090474,2021-06-02,House,"House Third Reading: Given Immediate Effect Roll Call # 280",88,21,0,0,109
1507930,1086221,2021-05-26,House,"Reported With Recommendation Without Amendment",15,0,0,0,15
1507937,1098197,2021-06-15,House,"Reported With Recommendation With Substitute H-1",3,2,0,0,5
1507937,1103570,2021-06-30,House,"House Third Reading: Given Immediate Effect Roll Call # 407",104,5,0,0,109
1507947,1088259,2021-05-25,Senate,"Reported Favorably Without Amendment",9,0,0,0,9
1507955,1090526,2021-06-03,Senate,"Reported Favorably With Substitute S-3",10,0,0,0,10
1507955,1090527,2021-06-02,Senate,"Senate Third Reading: Passed Roll Call # 237",19,17,0,0,36
1507978,1216578,2022-06-15,House,"Reported With Recommendation With Substitute H-2",7,3,0,0,10
1508017,1090037,2021-06-02,Senate,"Reported Favorably Without Amendment",10,0,0,0,10
1508017,1090038,2021-06-02,Senate,"Senate Third Reading: Passed Roll Call # 238",20,16,0,0,36
1508351,1084189,2021-05-25,Senate,"Reported Favorably With Substitute S-1",9,0,0,0,9
1508351,1091492,2021-06-03,Senate,"Senate Third Reading: Passed Roll Call # 252",32,4,0,0,36
1508351,1096312,2021-06-09,House,"Reported With Recommendation Without Amendment",12,3,0,0,15
1508351,1096313,2021-06-09,House,"House Third Reading: Given Immediate Effect Roll Call # 322",87,22,0,0,109
1508364,1079174,2021-05-18,Senate,"Reported Favorably Without Amendment",10,0,0,0,10
1508364,1086829,2021-05-27,Senate,"Senate Third Reading: Passed Roll Call # 231",36,0,0,0,36
1508364,1147009,2022-02-10,House,"Reported With Recommendation With Substitute H-1",18,1,0,0,19
1508364,1162108,2022-03-03,House,"House Third Reading: Given Immediate Effect Roll Call # 93",97,8,0,0,105
1508364,1165970,2022-03-08,Senate,"Senate Third Reading: Roll Call: Roll Call # 61",38,0,0,0,38
1508382,1098940,2021-06-17,House,"House Third Reading: Given Immediate Effect Roll Call # 343",109,1,0,0,110
1508382,1100086,2021-06-10,Senate,"Senate Third Reading: Passed Roll Call # 264",35,0,0,1,36
1508382,1100672,2021-06-23,Senate,"Senate Third Reading: Roll Call: Roll Call # 295",35,0,0,1,36
1508407,1084192,2021-05-25,Senate,"Reported Favorably With Substitute S-1",9,0,0,0,9
1508407,1085362,2021-05-26,Senate,"Senate Third Reading: Passed Roll Call # 228",36,0,0,0,36
1508407,1091519,2021-06-03,House,"Reported With Recommendation Without Amendment",16,0,0,0,16
1508407,1096954,2021-06-10,House,"House Third Reading: Given Immediate Effect Roll Call # 325",82,27,0,0,109
1508427,1110817,2021-10-27,House,"Reported With Recommendation With Substitute H-1",12,0,0,0,12
1508427,1116248,2021-11-10,House,"House Third Reading: Given Immediate Effect Roll Call # 557",103,2,0,0,105
1508427,1147621,2022-02-01,Senate,"Reported Favorably Without Amendment",5,0,0,0,5
1508427,1159853,2022-03-01,Senate,"Senate Third Reading: Given Immediate Effect Roll Call # 47",35,2,0,1,38
1508427,1161732,2022-03-02,House,"House Third Reading: Roll Call # 85",99,5,0,0,104
1508427,1171710,2022-03-16,Senate,"Senate Third Reading: Passed Roll Call # 86",34,2,0,2,38
1508427,1171711,2022-03-16,House,"House Third Reading: Roll Call # 122",100,4,0,0,104
1508466,1098124,2021-06-15,House,"Reported With Recommendation Without Amendment",13,0,0,0,13
1508466,1100679,2021-06-23,House,"House Third Reading: Given Immediate Effect Roll Call # 364",109,1,0,0,110
1508466,1110114,2021-10-14,Senate,"Reported Favorably Without Amendment",8,0,0,0,8
1508466,1110490,2021-10-21,Senate,"Senate Third Reading: Given Immediate Effect Roll Call # 400",34,1,0,1,36
1508488,1110826,2021-10-27,House,"Reported With Recommendation With Substitute H-1",12,0,0,0,12
1508488,1115928,2021-11-10,House,"House Third Reading: Given Immediate Effect Roll Call # 556",102,3,0,0,105
1508488,1147205,2022-02-01,Senate,"Reported Favorably Without Amendment",5,0,0,0,5
1508488,1158499,2022-03-01,Senate,"Senate Third Reading: Given Immediate Effect Roll Call # 46",35,2,0,1,38
1508488,1161028,2022-03-02,House,"House Third Reading: Roll Call # 84",99,5,0,0,104
1508837,1100117,2021-06-22,House,"Reported With Recommendation With Substitute H-2",5,2,0,0,7
1508837,1106269,2021-08-17,House,"House Third Reading: Given Immediate Effect Roll Call # 431",75,33,0,0,108
1508837,1109454,2021-09-30,Senate,"Reported Favorably Without Amendment",7,0,0,0,7
1508837,1109455,2021-09-30,Senate,"Senate Third Reading: Passed Roll Call # 359",21,15,0,0,36
1508837,1109483,2021-09-30,House,"House Third Reading: Roll Call # 447",72,33,0,0,105
1508870,1100381,2021-06-22,House,"Reported With Recommendation Without Amendment",13,1,0,0,14
1508870,1103558,2021-06-30,House,"House Third Reading: Given Immediate Effect Roll Call # 408",90,17,0,0,107
1508870,1190473,2022-04-20,Senate,"Reported Favorably With Substitute S-1",9,0,0,0,9
1508870,1196274,2022-04-28,Senate,"Senate Third Reading: Given Immediate Effect Roll Call # 140",33,2,0,3,38
1508870,1218729,2022-06-16,Senate,"Senate Third Reading: Passed Roll Call # 340",34,1,0,3,38
1508870,1218730,2022-06-21,House,"House Third Reading: Roll Call # 327",93,10,0,0,103
1508885,1100123,2021-06-22,House,"Reported With Recommendation With Substitute H-1",7,0,0,0,7
1508885,1106266,2021-08-17,House,"House Third Reading: Given Immediate Effect Roll Call # 436",80,28,0,0,108
1508900,1079213,2021-05-19,Senate,"Reported Favorably Without Amendment",5,0,0,0,5
1508900,1080082,2021-05-19,Senate,"Senate Third Reading: Roll Call: Roll Call # 208",20,16,0,0,36
1508911,1097401,2021-06-08,House,"Reported With Recommendation With Substitute H-1",5,1,0,0,6
1508911,1100842,2021-06-23,House,"House Third Reading: Given Immediate Effect Roll Call # 361",106,4,0,0,110
1508968,1097400,2021-06-08,House,"Reported With Recommendation With Substitute H-1",5,1,0,0,6
1508968,1106267,2021-08-17,House,"House Third Reading: Given Immediate Effect Roll Call # 430",77,31,0,0,108
1508968,1109478,2021-09-30,Senate,"Reported Favorably Without Amendment",7,0,0,0,7
1508968,1109479,2021-09-30,Senate,"Senate Third Reading: Passed Roll Call # 361",21,15,0,0,36
1508992,1087094,2021-05-27,Senate,"Reported Favorably With Substitute S-1",5,3,0,0,8
1509007,1098315,2021-06-15,Senate,"Reported Favorably With Substitute S-1",9,0,0,0,9
1509007,1099194,2021-06-17,Senate,"Senate Third Reading: Passed Roll Call # 284",35,0,0,1,36
1509007,1130430,2022-01-27,House,"Reported With Recommendation With Substitute H-1",9,0,0,0,9
1509007,1151588,2022-02-22,House,"House Third Reading: Given Immediate Effect Roll Call # 67",101,3,0,0,104
1509007,1153631,2022-02-23,Senate,"Senate Third Reading: Roll Call: Roll Call # 39",38,0,0,0,38
1509853,1215133,2022-06-08,Senate,"Reported Favorably With Substitute S-1",4,2,0,0,6
1509853,1219008,2022-06-08,Senate,"Reported Favorably With Recommendation For Referral To Committee On Appropriations",4,2,0,0,6
1509862,1110911,2021-10-28,Senate,"Reported Favorably With Substitute S-2",9,0,0,0,9
1509862,1116552,2021-11-10,Senate,"Senate Third Reading: Passed Roll Call # 432",35,0,0,1,36
1509862,1207109,2022-05-19,House,"Reported With Recommendation Without Amendment",15,0,0,0,15
1509862,1215247,2022-06-09,House,"House Third Reading: Given Immediate Effect Roll Call # 291",102,2,0,0,104
1509862,1219036,2022-06-15,Senate,"Senate Third Reading: House Amendment(s) Concurred In Roll Call # 303",36,0,1,1,38
1509862,1219037,2022-06-15,Senate,"Senate Third Reading: House Amendment(s) Concurred In Roll Call # 304",37,0,0,1,38
1509867,1090141,2021-06-02,Senate,"Reported Favorably Without Amendment",7,1,0,0,8
1509867,1219004,2022-05-11,Senate,"Senate Third Reading: Passed Roll Call # 229",33,0,0,5,38
1509867,1230002,2022-11-10,House,"Reported With Recommendation Without Amendment",19,0,0,0,19
1509867,1230003,2022-11-10,House,"Reported With Recommendation Without Amendment",19,0,0,0,19
1509867,1230462,2022-12-07,House,"House Third Reading: Given Immediate Effect Roll Call # 495",93,4,0,0,97
1509879,1110917,2021-10-28,Senate,"Reported Favorably Without Amendment",7,1,0,0,8
1509879,1116652,2021-12-02,Senate,"Senate Third Reading: Passed Roll Call # 458",20,14,0,4,38
1509879,1199176,2022-05-03,House,"Reported With Recommendation With Substitute H-1",8,0,0,0,8
1510014,1109327,2021-09-28,House,"Reported With Recommendation Without Amendment",10,1,0,0,11
1510014,1115575,2021-11-04,House,"House Third Reading: Given Immediate Effect Roll Call # 528",95,7,0,0,102
1510015,1109311,2021-09-28,House,"Reported With Recommendation Without Amendment",11,0,0,0,11
1510015,1115564,2021-11-04,House,"House Third Reading: Given Immediate Effect Roll Call # 526",102,0,0,0,102
1510018,1217765,2022-06-21,House,"Reported With Recommendation With Substitute H-1",7,2,0,0,9
1510026,1108876,2021-09-14,House,"Reported With Recommendation With Substitute H-1",5,1,0,0,6
1510026,1167999,2022-03-10,House,"House Third Reading: Given Immediate Effect Roll Call # 114",55,46,0,0,101
1510045,1109328,2021-09-28,House,"Reported With Recommendation Without Amendment",11,0,0,0,11
1510045,1115562,2021-11-04,House,"House Third Reading: Given Immediate Effect Roll Call # 527",102,0,0,0,102
1510053,1097403,2021-06-08,House,"Reported With Recommendation Without Amendment",6,0,0,0,6
1510053,1100843,2021-06-23,House,"House Third Reading: Given Immediate Effect Roll Call # 362",107,3,0,0,110
1510061,1217729,2022-06-21,House,"Reported With Recommendation With Substitute H-1",9,1,0,0,10
1510069,1098100,2021-06-15,House,"Reported With Recommendation Without Amendment",11,1,0,0,12
1510069,1109434,2021-09-29,House,"House Third Reading: Given Immediate Effect Roll Call # 443",104,0,0,0,104
1510069,1116677,2021-12-02,Senate,"Reported Favorably Without Amendment",9,0,0,0,9
1510069,1117265,2021-12-09,Senate,"Senate Third Reading: Given Immediate Effect Roll Call # 473",37,0,0,1,38
1510079,1217724,2022-06-21,House,"Reported With Recommendation With Substitute H-1",8,1,0,0,9
1510084,1110343,2021-10-19,House,"Reported With Recommendation Without Amendment",12,0,0,0,12
1510084,1116267,2021-11-10,House,"House Third Reading: Given Immediate Effect Roll Call # 545",104,1,0,0,105
1510098,1217714,2022-06-21,House,"Reported With Recommendation With Substitute H-2",8,1,0,0,9
1510106,1109312,2021-09-28,House,"Reported With Recommendation With Substitute H-1",9,1,0,0,10
1510106,1115551,2021-11-04,House,"House Third Reading: Given Immediate Effect Roll Call # 529",96,6,0,0,102
1510110,1110359,2021-10-19,House,"Reported With Recommendation Without Amendment",12,0,0,0,12
1510110,1115923,2021-11-10,House,"House Third Reading: Given Immediate Effect Roll Call # 547",105,0,0,0,105
1510111,1110361,2021-10-19,House,"Reported With Recommendation Without Amendment",12,0,0,0,12
1510111,1115933,2021-11-10,House,"House Third Reading: Given Immediate Effect Roll Call # 546",105,0,0,0,105
1510136,1110366,2021-10-19,House,"Reported With Recommendation Without Amendment",12,0,0,0,12
1510136,1115934,2021-11-10,House,"House Third Reading: Given Immediate Effect Roll Call # 544",104,1,0,0,105
1510242,1084261,2021-05-25,Senate,"Reported Favorably Without Amendment",9,0,0,0,9
1510242,1085575,2021-05-26,Senate,"Senate Third Reading: Passed Roll Call # 229",33,3,0,0,36
1510242,1098003,2021-06-15,House,"Reported With Recommendation Without Amendment",11,0,0,0,11
1510242,1101964,2021-06-24,House,"House Third Reading: Given Immediate Effect Roll Call # 374",90,17,0,0,107
1510275,1084958,2021-05-25,Senate,"Senate Third Reading: Passed Roll Call # 211",20,16,0,0,36
1510311,1085567,2021-05-26,Senate,"Reported Favorably With Substitute S-2",3,1,0,0,4
1510311,1090307,2021-06-02,Senate,"Senate Third Reading: Passed Roll Call # 245",20,16,0,0,36
1510362,1176025,2022-03-23,House,"Reported With Recommendation With Substitute H-1",8,1,0,0,9
1510362,1218579,2022-06-14,House,"House Third Reading: Given Immediate Effect Roll Call # 294",61,43,0,0,104
1510379,1117182,2021-12-08,House,"Reported With Recommendation With Substitute H-2",10,5,0,0,15
1510431,1081200,2021-05-20,House,"Reported With Recommendation With Substitute H-1",9,0,0,0,9
1510431,1091233,2021-06-03,House,"House Third Reading: Given Immediate Effect Roll Call # 292",105,5,0,0,110
1510454,1175866,2022-03-23,House,"Reported With Recommendation With Substitute H-1",8,1,0,0,9
1510454,1218535,2022-06-14,House,"House Third Reading: Given Immediate Effect Roll Call # 295",60,44,0,0,104
1510499,1110683,2021-10-26,House,"Reported With Recommendation Without Amendment",11,1,0,0,12
1510499,1115754,2021-11-09,House,"House Third Reading: Given Immediate Effect Roll Call # 542",101,3,0,0,104
1510499,1171057,2022-03-15,Senate,"Reported Favorably Without Amendment",10,0,0,0,10
1510499,1172789,2022-03-17,Senate,"Senate Third Reading: Given Immediate Effect Roll Call # 94",38,0,0,0,38
1510731,1110125,2021-10-14,Senate,"Reported Favorably With Substitute S-3",9,0,0,0,9
1510731,1117288,2021-12-09,Senate,"Senate Third Reading: Passed Roll Call # 477",37,0,0,1,38
1510731,1147163,2022-02-01,House,"Reported With Recommendation With Substitute H-1",11,0,0,0,11
1510731,1166173,2022-03-08,House,"House Third Reading: Given Immediate Effect Roll Call # 97",101,0,0,0,101
1510731,1167181,2022-03-09,Senate,"Senate Third Reading: Roll Call: Roll Call # 64",37,1,0,0,38
1510735,1098880,2021-06-17,Senate,"Reported Favorably Without Amendment",9,0,0,0,9
1510735,1105162,2021-07-15,Senate,"Senate Third Reading: Passed Roll Call # 332",35,0,0,1,36
1510735,1115457,2021-11-02,House,"Reported With Recommendation Without Amendment",14,0,0,0,14
1510735,1119564,2021-12-14,House,"House Third Reading: Given Immediate Effect Roll Call # 617",94,8,0,0,102
1510735,1119565,2021-12-14,Senate,"Senate Third Reading: Roll Call: Roll Call # 500",36,0,0,2,38
1510747,1110478,2021-10-21,Senate,"Reported Favorably Without Amendment",7,0,0,0,7
1510747,1115419,2021-11-02,Senate,"Senate Third Reading: Passed Roll Call # 421",35,0,0,1,36
1510752,1096732,2021-06-10,Senate,"Reported Favorably Without Amendment",4,0,0,0,4
1510776,1110774,2021-10-27,Senate,"Reported Favorably With Substitute S-1",4,1,0,0,5
1510790,1110109,2021-10-14,Senate,"Reported Favorably With Substitute S-1",9,0,0,0,9
1510790,1117250,2021-12-09,Senate,"Senate Third Reading: Passed Roll Call # 478",37,0,0,1,38
1510790,1146973,2022-02-01,House,"Reported With Recommendation Without Amendment",11,0,0,0,11
1510790,1166141,2022-03-08,House,"House Third Reading: Given Immediate Effect Roll Call # 98",101,0,0,0,101
1510896,1109330,2021-09-28,House,"Reported With Recommendation With Substitute H-1",8,0,0,0,8
1510896,1140441,2022-02-09,House,"House Third Reading: Given Immediate Effect Roll Call # 37",79,27,0,0,106
1510896,1217838,2022-06-07,Senate,"Reported Favorably Without Amendment",6,2,0,0,8
1510896,1217839,2022-06-15,Senate,"Senate Third Reading: Passed Roll Call # 322",21,16,0,1,38
1510968,1098913,2021-06-17,Senate,"Reported Favorably Without Amendment",9,0,0,0,9
1510968,1105168,2021-07-15,Senate,"Senate Third Reading: Passed Roll Call # 331",35,0,0,1,36
1510968,1115425,2021-11-02,House,"Reported With Recommendation With Substitute H-2",14,0,0,0,14
1510968,1119606,2021-12-14,House,"House Third Reading: Given Immediate Effect Roll Call # 616",94,8,0,0,102
1510968,1119607,2021-12-14,Senate,"Senate Third Reading: Roll Call: Roll Call # 499",36,0,0,2,38
1512183,1205611,2022-05-17,House,"Reported With Recommendation Without Amendment",13,0,0,0,13
1512183,1216050,2022-06-14,House,"House Third Reading: Given Immediate Effect Roll Call # 299",104,0,0,0,104
1512183,1230513,2022-12-06,Senate,"Reported Favorably With Substitute S-1",8,0,0,0,8
1512185,1175086,2022-03-22,House,"Reported With Recommendation Without Amendment",11,0,0,0,11
1512188,1205491,2022-05-17,House,"Reported With Recommendation Without Amendment",13,0,0,0,13
1512188,1216030,2022-06-14,House,"House Third Reading: Given Immediate Effect Roll Call # 297",103,1,0,0,104
1512188,1230512,2022-12-06,Senate,"Reported Favorably With Substitute S-1",8,0,0,0,8
1512198,1175160,2022-03-22,House,"Reported With Recommendation With Substitute H-3",11,0,0,0,11
1512207,1205549,2022-05-17,House,"Reported With Recommendation Without Amendment",13,0,0,0,13
1512207,1216062,2022-06-14,House,"House Third Reading: Given Immediate Effect Roll Call # 298",104,0,0,0,104
1512210,1151220,2022-02-22,House,"Reported With Recommendation With Substitute H-2",8,0,0,0,8
1512213,1098541,2021-06-16,House,"Reported With Recommendation With Substitute H-1",10,1,0,0,11
1512213,1168011,2022-03-10,House,"Reported With Recommendation With Substitute H-4",8,0,0,0,8
1512213,1172255,2022-03-17,House,"House Third Reading: Given Immediate Effect Roll Call # 127",85,17,0,0,102
1512220,1108877,2021-09-14,House,"Reported With Recommendation With Substitute H-1",5,1,0,0,6
1512220,1168022,2022-03-10,House,"House Third Reading: Given Immediate Effect Roll Call # 110",54,47,0,0,101
1512226,1110116,2021-10-14,House,"Reported With Recommendation With Substitute H-1",9,0,0,0,9
1512226,1115523,2021-11-03,House,"House Third Reading: Given Immediate Effect Roll Call # 519",103,0,0,0,103
1512234,1205391,2022-05-17,House,"Reported With Recommendation With Substitute H-1",13,0,0,0,13
1512234,1218060,2022-06-14,House,"House Third Reading: Given Immediate Effect Roll Call # 296",104,0,0,0,104
1512248,1174993,2022-03-22,House,"Reported With Recommendation With Substitute H-3",11,0,0,0,11
1512462,1091419,2021-06-03,Senate,"Reported Favorably Without Amendment",4,1,0,0,5
1512462,1096859,2021-06-10,Senate,"Senate Third Reading: Passed Roll Call # 260",19,16,0,1,36
1512554,1109079,2021-09-21,House,"Reported With Recommendation Without Amendment",13,0,0,0,13
1512554,1109974,2021-10-13,House,"House Third Reading: Given Immediate Effect Roll Call # 467",105,1,0,0,106
1512554,1115520,2021-11-03,Senate,"Reported Favorably Without Amendment",9,0,0,0,9
1512554,1116444,2021-11-30,Senate,"Senate Third Reading: Given Immediate Effect Roll Call # 451",36,1,0,1,38
1512654,1102418,2021-06-23,House,"Reported With Recommendation With Substitute H-1",5,0,0,0,5
1512724,1115565,2021-11-04,Senate,"Reported Favorably With Substitute S-2",15,1,0,0,16
1512724,1116220,2021-11-10,Senate,"Senate Third Reading: Passed Roll Call # 444",34,1,0,1,36
1512724,1116672,2021-12-01,House,"Reported With Recommendation Without Amendment",26,0,0,0,26
1512724,1117170,2021-12-08,House,"House Third Reading: Given Immediate Effect Roll Call # 589",100,4,0,0,104
1512728,1098753,2021-06-16,House,"Reported With Recommendation With Substitute H-1",14,0,0,0,14
1512728,1115504,2021-11-03,House,"House Third Reading: Given Immediate Effect Roll Call # 524",85,18,0,0,103
1512728,1148605,2022-02-17,Senate,"Reported Favorably With Substitute S-2",4,1,0,0,5
1512728,1228584,2022-09-28,Senate,"Senate Third Reading: Given Immediate Effect Roll Call # 430",30,6,0,2,38
1512818,1098748,2021-06-16,House,"Reported With Recommendation With Substitute H-1",14,0,0,0,14
1512818,1115505,2021-11-03,House,"House Third Reading: Given Immediate Effect Roll Call # 523",83,20,0,0,103
1512818,1148601,2022-02-17,Senate,"Reported Favorably With Substitute S-2",4,1,0,0,5
1512818,1229217,2022-09-28,Senate,"Senate Third Reading: Given Immediate Effect Roll Call # 429",30,6,0,2,38
1513735,1110090,2021-10-06,House,"Reported With Recommendation With Substitute H-1",9,2,0,0,11
1513735,1143192,2022-02-10,House,"House Third Reading: Given Immediate Effect Roll Call # 45",96,9,0,0,105
1513742,1110134,2021-10-06,House,"Reported With Recommendation Without Amendment",9,2,0,0,11
1513742,1143241,2022-02-10,House,"House Third Reading: Given Immediate Effect Roll Call # 46",94,11,0,0,105
1513745,1110344,2021-10-19,House,"Reported With Recommendation With Substitute H-2",13,0,0,0,13
1513745,1133805,2022-02-01,House,"House Third Reading: Given Immediate Effect Roll Call # 27",94,11,0,0,105
1513745,1166922,2022-03-09,Senate,"Reported Favorably With Substitute S-2",7,0,0,0,7
1513745,1219259,2022-05-17,Senate,"Senate Third Reading: Passed Roll Call # 231",36,0,0,2,38
1513745,1219260,2022-05-18,House,"House Third Reading: Roll Call # 213",97,8,0,0,105
1513745,1219261,2022-05-18,House,"House Third Reading: Roll Call # 214",98,8,0,0,106
1513761,1095375,2021-06-08,House,"Reported With Recommendation Without Amendment",8,4,0,0,12
1513761,1096276,2021-06-09,House,"House Third Reading: Given Immediate Effect Roll Call # 321",57,52,0,0,109
1513761,1100706,2021-06-23,Senate,"Reported Favorably With Substitute S-1",5,0,0,0,5
1513761,1100707,2021-06-23,Senate,"Senate Third Reading: Given Immediate Effect Roll Call # 294",26,9,0,1,36
1513761,1100708,2021-06-23,House,"House Third Reading: Roll Call # 366",57,53,0,0,110
1513765,1110102,2021-10-06,House,"Reported With Recommendation With Substitute H-1",9,2,0,0,11
1513765,1142857,2022-02-10,House,"House Third Reading: Given Immediate Effect Roll Call # 44",96,9,0,0,105
1513962,1109948,2021-10-06,House,"Reported With Recommendation With Substitute H-1",9,2,0,0,11
1514032,1097967,2021-06-15,Senate,"Reported Favorably With Substitute S-1",9,0,0,0,9
1514032,1099231,2021-06-17,Senate,"Senate Third Reading: Passed Roll Call # 285",35,0,0,1,36
1514032,1102012,2021-06-24,House,"Reported With Recommendation Without Amendment",9,0,0,0,9
1514032,1102013,2021-06-24,House,"House Third Reading: Given Immediate Effect Roll Call # 381",103,6,0,0,109
1514047,1110117,2021-10-12,Senate,"Reported Favorably Without Amendment",10,0,0,0,10
1514047,1167461,2022-03-09,Senate,"Senate Third Reading: Passed Roll Call # 69",38,0,0,0,38
1514088,1110132,2021-10-12,Senate,"Reported Favorably With Substitute S-1",10,0,0,0,10
1514088,1167089,2022-03-09,Senate,"Senate Third Reading: Passed Roll Call # 68",38,0,0,0,38
1514095,1091060,2021-06-08,Senate,"Reported Favorably Without Amendment",4,1,0,0,5
1514095,1096822,2021-06-10,Senate,"Senate Third Reading: Roll Call: Roll Call # 259",19,16,0,1,36
1514152,1096996,2021-06-10,Senate,"Senate Third Reading: Passed Roll Call # 262",25,10,0,1,36
1514152,1102006,2021-06-24,House,"Reported With Recommendation With Substitute H-3",6,3,0,0,9
1514152,1103255,2021-06-30,House,"House Third Reading: Given Immediate Effect Roll Call # 414",93,16,0,0,109
1514152,1105163,2021-07-15,Senate,"Senate Third Reading: Roll Call: Roll Call # 329",35,0,0,1,36
1514186,1096901,2021-06-10,Senate,"Senate Third Reading: Passed Roll Call # 261",25,10,0,1,36
1514186,1101917,2021-06-24,House,"Reported With Recommendation With Substitute H-3",6,3,0,0,9
1514186,1103530,2021-06-30,House,"House Third Reading: Given Immediate Effect Roll Call # 413",95,14,0,0,109
1514186,1105164,2021-07-15,Senate,"Senate Third Reading: Roll Call: Roll Call # 328",35,0,0,1,36
1514200,1097137,2021-06-10,Senate,"Senate Third Reading: Passed Roll Call # 263",32,3,0,1,36
1514200,1101976,2021-06-24,House,"Reported With Recommendation With Substitute H-2",6,3,0,0,9
1514200,1103586,2021-06-30,House,"House Third Reading: Given Immediate Effect Roll Call # 415",94,15,0,0,109
1514200,1105169,2021-07-15,Senate,"Senate Third Reading: Roll Call: Roll Call # 330",35,0,0,1,36
1514333,1110379,2021-10-19,House,"Reported With Recommendation With Substitute H-1",11,1,0,0,12
1514333,1117028,2021-12-07,House,"House Third Reading: Given Immediate Effect Roll Call # 582",102,1,0,0,103
1514333,1204238,2022-05-12,Senate,"Reported Favorably Without Amendment",8,0,0,0,8
1514333,1205926,2022-05-18,Senate,"Senate Third Reading: Given Immediate Effect Roll Call # 234",37,0,0,1,38
1514347,1110382,2021-10-19,House,"Reported With Recommendation Without Amendment",11,1,0,0,12
1514347,1117019,2021-12-07,House,"House Third Reading: Given Immediate Effect Roll Call # 581",99,4,0,0,103
1515001,1100750,2021-06-23,Senate,"Reported Favorably Without Amendment",10,0,0,0,10
1515057,1110324,2021-10-19,House,"Reported With Recommendation Without Amendment",7,2,0,0,9
1515057,1130363,2022-01-27,House,"House Third Reading: Given Immediate Effect Roll Call # 21",71,31,0,0,102
1515072,1117018,2021-12-07,House,"Reported With Recommendation With Substitute H-1",9,1,0,0,10
1515072,1119603,2021-12-14,House,"House Third Reading: Given Immediate Effect Roll Call # 619",85,17,0,0,102
1515086,1110662,2021-10-26,House,"Reported With Recommendation Without Amendment",13,0,0,0,13
1515086,1139952,2022-02-09,House,"House Third Reading: Given Immediate Effect Roll Call # 35",106,0,0,0,106
1515086,1204240,2022-05-12,Senate,"Reported Favorably Without Amendment",7,0,0,0,7
1515086,1207172,2022-05-19,Senate,"Senate Third Reading: Given Immediate Effect Roll Call # 242",35,0,1,2,38
1515090,1115424,2021-11-02,House,"Reported With Recommendation With Substitute H-1",11,1,0,0,12
1515090,1116676,2021-12-02,House,"House Third Reading: Given Immediate Effect Roll Call # 569",95,5,0,0,100
1515090,1166278,2022-03-08,Senate,"Reported Favorably With Substitute S-1",5,0,0,0,5
1515200,1105165,2021-07-15,Senate,"Senate Third Reading: Passed Roll Call # 339",23,12,0,1,36
1515201,1133849,2022-02-01,Senate,"Reported Favorably With Substitute S-1",5,0,0,0,5
1515201,1140401,2022-02-09,Senate,"Senate Third Reading: Passed Roll Call # 18",38,0,0,0,38
1515273,1110345,2021-10-19,House,"Reported With Recommendation With Substitute H-2",12,1,0,0,13
1515273,1115587,2021-11-04,House,"House Third Reading: Given Immediate Effect Roll Call # 533",101,1,0,0,102
1515273,1141795,2022-02-10,Senate,"Reported Favorably Without Amendment",10,0,0,0,10
1515273,1153821,2022-02-23,Senate,"Senate Third Reading: Given Immediate Effect Roll Call # 41",38,0,0,0,38
1515280,1110380,2021-10-19,House,"Reported With Recommendation With Substitute H-2",12,1,0,0,13
1515280,1115596,2021-11-04,House,"House Third Reading: Given Immediate Effect Roll Call # 534",101,1,0,0,102
1515280,1141788,2022-02-10,Senate,"Reported Favorably Without Amendment",10,0,0,0,10
1515280,1153740,2022-02-23,Senate,"Senate Third Reading: Given Immediate Effect Roll Call # 42",38,0,0,0,38
1515288,1110342,2021-10-19,House,"Reported With Recommendation With Substitute H-2",12,1,0,0,13
1515288,1115566,2021-11-04,House,"House Third Reading: Given Immediate Effect Roll Call # 532",101,1,0,0,102
1515288,1142009,2022-02-10,Senate,"Reported Favorably Without Amendment",10,0,0,0,10
1515288,1153753,2022-02-23,Senate,"Senate Third Reading: Given Immediate Effect Roll Call # 40",38,0,0,0,38
1515327,1219237,2022-05-11,Senate,"Reported Favorably Without Amendment",4,0,0,0,4
1515327,1219238,2022-05-18,Senate,"Senate Third Reading: Passed Roll Call # 232",37,0,0,1,38
1515327,1229288,2022-09-28,House,"Reported With Recommendation Without Amendment",8,0,0,0,8
1515415,1098872,2021-06-17,Senate,"Senate Third Reading: Given Immediate Effect Roll Call # 290",35,0,0,1,36
1515420,1115796,2021-11-09,House,"Reported With Recommendation Without Amendment",10,2,0,0,12
1515433,1115794,2021-11-09,House,"Reported With Recommendation Without Amendment",10,2,0,0,12
1515478,1099353,2021-06-17,House,"Reported With Recommendation With Substitute H-1",6,0,0,0,6
1515478,1102046,2021-06-24,House,"House Third Reading: Given Immediate Effect Roll Call # 377",96,12,0,0,108
1515478,1105166,2021-07-15,Senate,"Reported Favorably Without Amendment",8,0,0,0,8
1515478,1105167,2021-07-15,Senate,"Senate Third Reading: Given Immediate Effect Roll Call # 336",28,7,0,1,36
1515495,1110653,2021-10-26,House,"Reported With Recommendation Without Amendment",9,5,0,0,14
1516156,1117000,2021-12-07,House,"Reported With Recommendation With Amendment(s)",9,0,0,0,9
1516156,1133843,2022-02-01,House,"House Third Reading: Given Immediate Effect Roll Call # 31",102,3,0,0,105
1516156,1175010,2022-03-22,Senate,"Reported Favorably Without Amendment",10,0,0,0,10
1516156,1175964,2022-03-23,Senate,"Senate Third Reading: Given Immediate Effect Roll Call # 101",37,0,0,1,38
1516195,1100377,2021-06-22,House,"Reported With Recommendation Without Amendment",13,3,0,0,16
1516208,1187543,2022-04-12,House,"Reported With Recommendation Without Amendment",6,0,0,0,6
1516213,1109594,2021-10-05,House,"Reported With Recommendation Without Amendment",10,3,0,0,13
1516213,1110808,2021-10-27,House,"House Third Reading: Given Immediate Effect Roll Call # 508",95,11,0,0,106
1516221,1133837,2022-02-01,House,"Reported With Recommendation Without Amendment",7,0,0,0,7
1516221,1143196,2022-02-10,House,"House Third Reading: Given Immediate Effect Roll Call # 48",80,25,0,0,105
1516221,1219089,2022-05-26,Senate,"Reported Favorably Without Amendment",3,1,0,0,4
1516221,1219090,2022-06-15,Senate,"Senate Third Reading: Passed Roll Call # 315",23,14,0,1,38
1516225,1100456,2021-06-22,House,"Reported With Recommendation Without Amendment",13,3,0,0,16
1516248,1109715,2021-10-06,House,"House Third Reading: Given Immediate Effect Roll Call # 464",89,14,0,0,103
1516248,1110071,2021-10-14,Senate,"Reported Favorably Without Amendment",9,0,0,0,9
1516248,1110072,2021-10-14,Senate,"Senate Third Reading: Given Immediate Effect Roll Call # 387",35,0,0,1,36
1516251,1100721,2021-06-23,House,"Reported With Recommendation Without Amendment",3,2,0,0,5
1516251,1100722,2021-06-23,House,"House Third Reading: Given Immediate Effect Roll Call # 367",58,52,0,0,110
1516251,1109774,2021-10-07,Senate,"Senate Third Reading: Passed Roll Call # 375",20,16,0,0,36
1516251,1110143,2021-10-14,House,"House Third Reading: Roll Call # 470",56,51,0,0,107
1516257,1109592,2021-10-05,House,"Reported With Recommendation Without Amendment",10,3,0,0,13
1516257,1110806,2021-10-27,House,"House Third Reading: Given Immediate Effect Roll Call # 507",95,11,0,0,106
1516476,1109308,2021-09-28,House,"Reported With Recommendation With Substitute H-1",9,0,0,0,9
1516476,1109696,2021-10-06,House,"House Third Reading: Given Immediate Effect Roll Call # 462",103,0,0,0,103
1516476,1219653,2022-06-07,Senate,"Reported Favorably Without Amendment",5,0,0,0,5
1516476,1219654,2022-06-08,Senate,"Senate Third Reading: Given Immediate Effect Roll Call # 298",38,0,0,0,38
1516478,1109313,2021-09-28,House,"Reported With Recommendation Without Amendment",9,0,0,0,9
1516478,1109701,2021-10-06,House,"House Third Reading: Given Immediate Effect Roll Call # 459",99,4,0,0,103
1516478,1219019,2022-06-07,Senate,"Reported Favorably Without Amendment",5,0,0,0,5
1516478,1219020,2022-06-08,Senate,"Senate Third Reading: Given Immediate Effect Roll Call # 295",38,0,0,0,38
1516486,1109306,2021-09-28,House,"Reported With Recommendation Without Amendment",9,0,0,0,9
1516486,1109700,2021-10-06,House,"House Third Reading: Given Immediate Effect Roll Call # 460",103,0,0,0,103
1516486,1219120,2022-06-07,Senate,"Reported Favorably Without Amendment",5,0,0,0,5
1516486,1219121,2022-06-08,Senate,"Senate Third Reading: Given Immediate Effect Roll Call # 296",38,0,0,0,38
1516497,1109310,2021-09-28,House,"Reported With Recommendation With Substitute H-1",9,0,0,0,9
1516497,1109709,2021-10-06,House,"House Third Reading: Given Immediate Effect Roll Call # 455",99,4,0,0,103
1516497,1214682,2022-06-07,Senate,"Reported Favorably With Substitute S-2",5,0,0,0,5
1516497,1218994,2022-06-08,Senate,"Senate Third Reading: Given Immediate Effect Roll Call # 291",37,0,0,1,38
1516497,1218995,2022-06-14,Senate,"Senate Third Reading: Passed Roll Call # 302",35,0,0,3,38
1516497,1218996,2022-06-14,House,"House Third Reading: Roll Call # 293",98,6,0,0,104
1516506,1109314,2021-09-28,House,"Reported With Recommendation Without Amendment",9,0,0,0,9
1516506,1109702,2021-10-06,House,"House Third Reading: Given Immediate Effect Roll Call # 461",102,1,0,0,103
1516506,1219740,2022-06-07,Senate,"Reported Favorably Without Amendment",5,0,0,0,5
1516506,1219741,2022-06-08,Senate,"Senate Third Reading: Given Immediate Effect Roll Call # 297",38,0,0,0,38
1516513,1109309,2021-09-28,House,"Reported With Recommendation Without Amendment",9,0,0,0,9
1516513,1109697,2021-10-06,House,"House Third Reading: Given Immediate Effect Roll Call # 458",87,16,0,0,103
1516513,1219023,2022-06-07,Senate,"Reported Favorably Without Amendment",5,0,0,0,5
1516513,1219024,2022-06-08,Senate,"Senate Third Reading: Given Immediate Effect Roll Call # 294",33,5,0,0,38
1516520,1109386,2021-09-28,House,"Reported With Recommendation With Substitute H-1",9,0,0,0,9
1516520,1109713,2021-10-06,House,"House Third Reading: Given Immediate Effect Roll Call # 456",97,6,0,0,103
1516520,1220225,2022-06-07,Senate,"Reported Favorably With Substitute S-2",5,0,0,0,5
1516520,1220226,2022-06-08,Senate,"Senate Third Reading: Given Immediate Effect Roll Call # 292",37,0,0,1,38
1516520,1220227,2022-06-14,House,"House Third Reading: Roll Call # 292",96,8,0,0,104
1516522,1109307,2021-09-28,House,"Reported With Recommendation With Substitute H-1",9,0,0,0,9
1516522,1109721,2021-10-06,House,"House Third Reading: Given Immediate Effect Roll Call # 457",87,16,0,0,103
1516522,1219814,2022-06-07,Senate,"Reported Favorably Without Amendment",5,0,0,0,5
1516522,1219815,2022-06-08,Senate,"Senate Third Reading: Given Immediate Effect Roll Call # 293",32,5,0,1,38
1516533,1110464,2021-10-20,House,"Reported With Recommendation With Substitute H-3",10,1,0,0,11
1516533,1110905,2021-10-28,House,"House Third Reading: Given Immediate Effect Roll Call # 515",99,6,0,0,105
1516533,1115945,2021-11-10,Senate,"Reported Favorably Without Amendment",10,0,0,0,10
1516533,1116443,2021-11-30,Senate,"Senate Third Reading: Given Immediate Effect Roll Call # 454",36,0,1,1,38
1516664,1100878,2021-06-23,House,"House Third Reading: Given Immediate Effect Roll Call # 370",56,54,0,0,110
1516667,1110113,2021-10-14,House,"Reported With Recommendation Without Amendment",18,0,0,0,18
1516667,1110456,2021-10-20,House,"House Third Reading: Given Immediate Effect Roll Call # 492",104,0,0,0,104
1516667,1117010,2021-12-07,Senate,"Reported Favorably Without Amendment",7,0,0,0,7
1516667,1117070,2021-12-08,Senate,"Senate Third Reading: Given Immediate Effect Roll Call # 464",36,0,0,2,38
1516674,1134289,2022-02-01,House,"Reported With Recommendation With Substitute H-1",14,0,0,0,14
1516674,1148849,2022-02-17,House,"House Third Reading: Given Immediate Effect Roll Call # 61",98,3,0,0,101
1516682,1154991,2022-02-24,House,"Reported With Recommendation With Substitute H-1",20,1,0,0,21
1516682,1159479,2022-03-01,House,"House Third Reading: Given Immediate Effect Roll Call # 81",71,33,0,0,104
1516684,1134483,2022-02-01,House,"Reported With Recommendation With Substitute H-2",14,0,0,0,14
1516684,1148828,2022-02-17,House,"House Third Reading: Given Immediate Effect Roll Call # 63",97,4,0,0,101
1516697,1110337,2021-10-19,House,"Reported With Recommendation Without Amendment",15,0,0,0,15
1516697,1115926,2021-11-10,House,"House Third Reading: Given Immediate Effect Roll Call # 549",104,1,0,0,105
1516697,1134058,2022-01-26,Senate,"Reported Favorably Without Amendment",9,0,0,0,9
1516697,1142534,2022-02-10,Senate,"Senate Third Reading: Given Immediate Effect Roll Call # 26",38,0,0,0,38
1516706,1101516,2021-06-24,Senate,"Senate Third Reading: Given Immediate Effect Roll Call # 304",33,2,0,1,36
1516706,1103513,2021-06-30,House,"House Third Reading: Given Immediate Effect Roll Call # 416",107,1,0,0,108
1516711,1134197,2022-02-01,House,"Reported With Recommendation Without Amendment",14,0,0,0,14
1516711,1148819,2022-02-17,House,"House Third Reading: Given Immediate Effect Roll Call # 62",99,2,0,0,101
1517060,1108875,2021-09-14,House,"Reported With Recommendation With Substitute H-1",8,2,0,0,10
1517060,1110340,2021-10-19,House,"House Third Reading: Given Immediate Effect Roll Call # 488",69,34,0,0,103
1517060,1162670,2022-03-03,Senate,"Reported Favorably With Substitute S-2",5,2,0,0,7
1517070,1110803,2021-10-28,House,"Reported With Recommendation Without Amendment",17,0,0,0,17
1517070,1139922,2022-02-09,House,"House Third Reading: Given Immediate Effect Roll Call # 39",106,0,0,0,106
1517073,1110831,2021-10-28,House,"Reported With Recommendation Without Amendment",16,0,0,0,16
1517073,1139902,2022-02-09,House,"House Third Reading: Given Immediate Effect Roll Call # 41",106,0,0,0,106
1517074,1110802,2021-10-28,House,"Reported With Recommendation Without Amendment",17,0,0,0,17
1517074,1139916,2022-02-09,House,"House Third Reading: Given Immediate Effect Roll Call # 40",106,0,0,0,106
1517083,1108878,2021-09-14,House,"Reported With Recommendation With Substitute H-1",8,2,0,0,10
1517083,1110312,2021-10-19,House,"House Third Reading: Given Immediate Effect Roll Call # 487",69,34,0,0,103
1517083,1162637,2022-03-03,Senate,"Reported Favorably With Substitute S-2",5,2,0,0,7
1517086,1109473,2021-09-30,House,"Reported With Recommendation With Substitute H-1",18,0,0,0,18
1517086,1110805,2021-10-27,House,"House Third Reading: Given Immediate Effect Roll Call # 501",94,10,0,0,104
1517086,1193589,2022-04-26,Senate,"Reported Favorably With Substitute S-2",10,0,0,0,10
1517086,1194877,2022-04-27,Senate,"Senate Third Reading: Given Immediate Effect Roll Call # 138",36,0,0,2,38
1517086,1200204,2022-05-04,House,"House Third Reading: Roll Call # 180",101,2,0,0,103
1517093,1110820,2021-10-28,House,"Reported With Recommendation Without Amendment",17,0,0,0,17
1517093,1139896,2022-02-09,House,"House Third Reading: Given Immediate Effect Roll Call # 38",106,0,0,0,106
1517099,1110333,2021-10-19,House,"Reported With Recommendation With Substitute H-2",15,0,0,0,15
1517099,1115919,2021-11-10,House,"House Third Reading: Given Immediate Effect Roll Call # 550",105,0,0,0,105
1517099,1115920,2021-11-10,House,"House Third Reading: Passed Roll Call # 559",104,1,0,0,105
1517099,1147235,2022-01-26,Senate,"Reported Favorably Without Amendment",9,0,0,0,9
1517099,1153216,2022-02-23,Senate,"Senate Third Reading: Given Immediate Effect Roll Call # 45",37,1,0,0,38
1517104,1103331,2021-06-30,House,"House Third Reading: Given Immediate Effect Roll Call # 409",109,0,0,0,109
1517244,1110323,2021-10-19,Senate,"Reported Favorably Without Amendment",8,0,0,0,8
1517244,1110766,2021-10-27,Senate,"Senate Third Reading: Passed Roll Call # 415",28,5,1,2,36
1517244,1110767,2021-10-27,Senate,"Senate Third Reading: Passed Roll Call # 416",29,5,0,2,36
1517244,1130386,2022-01-27,House,"Reported With Recommendation With Substitute H-1",12,0,0,0,12
1517244,1221606,2022-06-30,House,"House Third Reading: Given Immediate Effect Roll Call # 351",97,9,0,0,106
1517244,1221607,2022-07-01,Senate,"Senate Third Reading: Roll Call: Roll Call # 402",32,5,0,1,38
1517277,1110089,2021-10-06,House,"Reported With Recommendation With Substitute H-3",9,2,0,0,11
1517296,1109475,2021-09-30,House,"Reported With Recommendation With Substitute H-1",6,3,0,0,9
1517301,1109337,2021-09-28,House,"Reported With Recommendation Without Amendment",8,5,0,0,13
1517301,1115411,2021-11-02,House,"House Third Reading: Given Immediate Effect Roll Call # 518",55,0,0,0,55
1517301,1215126,2022-06-08,Senate,"Reported Favorably Without Amendment",4,0,0,0,4
1517303,1109044,2021-09-21,House,"House Third Reading: Given Immediate Effect Roll Call # 440",81,23,0,0,104
1517303,1109457,2021-09-30,Senate,"Reported Favorably Without Amendment",7,0,0,0,7
1517303,1109458,2021-09-30,Senate,"Senate Third Reading: Given Immediate Effect Roll Call # 357",35,1,0,0,36
1517475,1116645,2021-12-02,Senate,"Reported Favorably With Substitute S-2",9,0,0,0,9
1517475,1116646,2021-12-02,Senate,"Senate Third Reading: Passed Roll Call # 461",34,0,0,4,38
1517475,1176457,2022-03-24,House,"House Third Reading: Given Immediate Effect Roll Call # 147",95,7,0,0,102
1517475,1176458,2022-03-24,House,"Reported With Recommendation With Substitute H-1",27,0,0,0,27
1517475,1176787,2022-03-24,Senate,"Senate Third Reading: Roll Call: Roll Call # 109",34,3,0,1,38
1517490,1219199,2022-06-23,Senate,"Senate Third Reading: Passed Roll Call # 362",29,9,0,0,38
1517490,1221618,2022-06-30,House,"House Third Reading: Given Immediate Effect Roll Call # 365",79,27,0,0,106
1517505,1115554,2021-11-04,House,"Reported With Recommendation With Substitute H-2",5,0,0,0,5
1517505,1116658,2021-12-02,House,"House Third Reading: Given Immediate Effect Roll Call # 571",95,4,0,0,99
1517508,1115550,2021-11-04,House,"Reported With Recommendation With Substitute H-1",4,0,0,0,4
1517508,1116660,2021-12-02,House,"House Third Reading: Given Immediate Effect Roll Call # 572",95,4,0,0,99
1517520,1215623,2022-06-09,Senate,"Reported Favorably With Substitute S-2",5,0,0,0,5
1517520,1219115,2022-06-23,Senate,"Senate Third Reading: Passed Roll Call # 347",38,0,0,0,38
1517521,1108912,2021-09-15,Senate,"Reported Favorably Without Amendment",6,0,0,0,6
1517521,1126788,2022-01-20,Senate,"Senate Third Reading: Passed Roll Call # 8",23,15,0,0,38
1517547,1115426,2021-11-02,House,"Reported With Recommendation With Substitute H-2",14,0,0,0,14
1517548,1115590,2021-11-04,House,"Reported With Recommendation With Substitute H-1",4,0,0,0,4
1517548,1116664,2021-12-02,House,"House Third Reading: Given Immediate Effect Roll Call # 573",99,0,0,0,99
1517549,1115409,2021-11-02,House,"Reported With Recommendation Without Amendment",14,0,0,0,14
1517556,1110371,2021-10-19,Senate,"Reported Favorably Without Amendment",5,1,0,0,6
1517556,1110465,2021-10-20,Senate,"Senate Third Reading: Passed Roll Call # 395",36,0,0,0,36
1517560,1116990,2021-12-07,House,"Reported With Recommendation With Substitute H-1",12,0,0,0,12
1517560,1128530,2022-01-25,House,"House Third Reading: Given Immediate Effect Roll Call # 6",99,2,0,0,101
1517560,1216577,2022-06-15,Senate,"Reported Favorably With Substitute S-2",8,0,0,0,8
1517560,1221513,2022-06-30,Senate,"Senate Third Reading: Given Immediate Effect Roll Call # 371",38,0,0,0,38
1517560,1221699,2022-06-30,House,"House Third Reading: Roll Call # 344",107,0,0,0,107
1517565,1115563,2021-11-04,House,"Reported With Recommendation With Substitute H-1",5,0,0,0,5
1517565,1116675,2021-12-02,House,"House Third Reading: Given Immediate Effect Roll Call # 570",98,1,0,0,99
1517565,1219150,2022-06-07,Senate,"Reported Favorably With Substitute S-1",7,0,0,0,7
1517566,1219218,2022-06-23,Senate,"Senate Third Reading: Passed Roll Call # 361",28,10,0,0,38
1517566,1221617,2022-06-30,House,"House Third Reading: Given Immediate Effect Roll Call # 364",78,28,0,0,106
1518060,1110111,2021-10-07,House,"Reported With Recommendation Without Amendment",15,1,0,0,16
1518060,1110457,2021-10-20,House,"House Third Reading: Given Immediate Effect Roll Call # 490",96,8,0,0,104
1518060,1219064,2022-06-23,Senate,"Reported Favorably With Substitute S-2",10,0,0,0,10
1518069,1215381,2022-06-09,House,"Reported With Recommendation With Substitute H-4",6,0,0,0,6
1518069,1219188,2022-06-15,House,"House Third Reading: Given Immediate Effect Roll Call # 305",56,49,0,0,105
1518077,1215379,2022-06-09,House,"Reported With Recommendation Without Amendment",6,0,0,0,6
1518077,1216448,2022-06-15,House,"House Third Reading: Given Immediate Effect Roll Call # 306",56,49,0,0,105
1518102,1117323,2021-12-09,House,"Reported With Recommendation Without Amendment",18,0,0,0,18
1518102,1130511,2022-01-27,House,"House Third Reading: Given Immediate Effect Roll Call # 25",102,0,0,0,102
1518102,1187636,2022-04-12,Senate,"Reported Favorably Without Amendment",10,0,0,0,10
1518102,1207192,2022-05-19,Senate,"Senate Third Reading: Given Immediate Effect Roll Call # 247",36,0,0,2,38
1518110,1110112,2021-10-07,House,"Reported With Recommendation Without Amendment",16,0,0,0,16
1518110,1110461,2021-10-20,House,"House Third Reading: Given Immediate Effect Roll Call # 491",100,4,0,0,104
1518110,1218542,2022-06-23,Senate,"Reported Favorably Without Amendment",6,1,0,0,7
1518110,1221602,2022-06-30,Senate,"Senate Third Reading: Given Immediate Effect Roll Call # 370",38,0,0,0,38
1518181,1109861,2021-10-12,Senate,"Reported Favorably Without Amendment",10,0,0,0,10
1518181,1110124,2021-10-14,Senate,"Senate Third Reading: Passed Roll Call # 384",35,0,0,1,36
1518181,1221604,2022-06-30,House,"Reported With Recommendation With Substitute H-1",16,2,0,0,18
1518181,1221706,2022-07-01,House,"House Third Reading: Given Immediate Effect Roll Call # 367",98,8,0,0,106
1518193,1230203,2022-11-29,Senate,"Reported Favorably Without Amendment",3,0,0,0,3
1518196,1109876,2021-10-12,Senate,"Reported Favorably Without Amendment",10,0,0,0,10
1518196,1110128,2021-10-14,Senate,"Senate Third Reading: Passed Roll Call # 383",35,0,0,1,36
1518196,1221611,2022-06-30,House,"Reported With Recommendation Without Amendment",17,1,0,0,18
1518290,1115586,2021-11-04,House,"Reported With Recommendation Without Amendment",5,3,0,0,8
1518290,1167988,2022-03-10,House,"House Third Reading: Given Immediate Effect Roll Call # 105",62,39,0,0,101
1518316,1115389,2021-11-02,House,"Reported With Recommendation With Substitute H-1",8,4,0,0,12
1518316,1116605,2021-12-01,House,"House Third Reading: Given Immediate Effect Roll Call # 566",57,43,0,0,100
1518316,1206048,2022-05-18,Senate,"Reported Favorably With Substitute S-2",7,0,0,0,7
1518316,1219068,2022-05-26,Senate,"Senate Third Reading: Passed Roll Call # 282",35,2,0,1,38
1518316,1219069,2022-06-07,House,"House Third Reading: Roll Call # 281",94,13,0,0,107
1518321,1115585,2021-11-04,House,"Reported With Recommendation Without Amendment",5,3,0,0,8
1518321,1167996,2022-03-10,House,"House Third Reading: Given Immediate Effect Roll Call # 104",61,40,0,0,101
1518350,1216028,2022-06-14,House,"Reported With Recommendation With Substitute H-3",4,1,0,0,5
1518350,1220258,2022-06-15,House,"House Third Reading: Given Immediate Effect Roll Call # 314",73,32,0,0,105
1518350,1220259,2022-06-23,Senate,"Senate Third Reading: Given Immediate Effect Roll Call # 365",37,1,0,0,38
1518359,1172157,2022-03-16,House,"Reported With Recommendation With Substitute H-1",12,0,0,0,12
1518359,1200144,2022-05-04,House,"House Third Reading: Given Immediate Effect Roll Call # 183",91,12,0,0,103
1519246,1109315,2021-09-28,House,"Reported With Recommendation With Substitute H-1",7,0,0,0,7
1519246,1119550,2021-12-14,House,"House Third Reading: Given Immediate Effect Roll Call # 613",102,0,0,0,102
1519246,1147006,2022-02-10,Senate,"Reported Favorably With Substitute S-3",4,0,0,0,4
1519246,1161020,2022-03-02,Senate,"Senate Third Reading: Given Immediate Effect Roll Call # 50",36,0,0,2,38
1519246,1166160,2022-03-08,House,"House Third Reading: Roll Call # 96",101,0,0,0,101
1519299,1110772,2021-10-27,Senate,"Reported Favorably With Substitute S-2",3,1,0,0,4
1519299,1230255,2022-11-29,Senate,"Senate Third Reading: Defeated Roll Call # 512",15,17,3,3,38
1519327,1110748,2021-10-27,Senate,"Reported Favorably With Substitute S-2",3,1,0,0,4
1519327,1230256,2022-11-29,Senate,"Senate Third Reading: Defeated Roll Call # 513",15,19,1,3,38
1520058,1108916,2021-09-15,Senate,"Reported Favorably Without Amendment",4,1,0,0,5
1520058,1110781,2021-10-26,Senate,"Senate Third Reading: Passed Roll Call # 406",19,15,0,2,36
1520058,1218422,2022-06-21,House,"Reported With Recommendation Without Amendment",7,5,0,0,12
1520059,1108911,2021-09-15,Senate,"Reported Favorably Without Amendment",4,1,0,0,5
1520059,1110711,2021-10-26,Senate,"Senate Third Reading: Passed Roll Call # 408",19,15,0,2,36
1520059,1218419,2022-06-21,House,"Reported With Recommendation Without Amendment",7,5,0,0,12
1520063,1108910,2021-09-15,Senate,"Reported Favorably Without Amendment",4,1,0,0,5
1520063,1110770,2021-10-26,Senate,"Senate Third Reading: Passed Roll Call # 405",19,15,0,2,36
1520063,1217619,2022-06-21,House,"Reported With Recommendation Without Amendment",7,5,0,0,12
1520066,1108915,2021-09-15,Senate,"Reported Favorably Without Amendment",4,1,0,0,5
1520066,1110731,2021-10-26,Senate,"Senate Third Reading: Passed Roll Call # 407",19,15,0,2,36
1520066,1218414,2022-06-21,House,"Reported With Recommendation Without Amendment",7,5,0,0,12
1521761,1109351,2021-09-14,House,"Reported With Recommendation Without Amendment",7,0,0,0,7
1521778,1151240,2022-02-22,House,"Reported With Recommendation With Substitute H-1",5,2,0,0,7
1521778,1168063,2022-03-10,House,"House Third Reading: Given Immediate Effect Roll Call # 115",57,44,0,0,101
1521779,1214803,2022-06-07,House,"Reported With Recommendation Without Amendment",5,1,0,0,6
1521780,1115570,2021-11-04,House,"Reported With Recommendation Without Amendment",18,0,0,0,18
1521780,1116587,2021-12-01,House,"House Third Reading: Given Immediate Effect Roll Call # 564",96,4,0,0,100
1521780,1166181,2022-03-08,Senate,"Reported Favorably Without Amendment",9,0,0,0,9
1521780,1171011,2022-03-10,Senate,"Senate Third Reading: Given Immediate Effect Roll Call # 75",38,0,0,0,38
1521782,1108885,2021-09-14,House,"Reported With Recommendation With Substitute H-2",13,1,0,0,14
1521782,1110119,2021-10-14,House,"House Third Reading: Given Immediate Effect Roll Call # 474",94,13,0,0,107
1521782,1110484,2021-10-21,Senate,"Reported Favorably Without Amendment",7,0,0,0,7
1521782,1110780,2021-10-26,Senate,"Senate Third Reading: Given Immediate Effect Roll Call # 413",32,2,0,2,36
1521783,1110318,2021-10-19,House,"Reported With Recommendation With Substitute H-3",5,2,0,0,7
1521783,1167936,2022-03-10,House,"House Third Reading: Given Immediate Effect Roll Call # 112",56,45,0,0,101
1521784,1109331,2021-09-28,House,"Reported With Recommendation Without Amendment",12,0,0,0,12
1521784,1109989,2021-10-13,House,"House Third Reading: Given Immediate Effect Roll Call # 468",94,12,0,0,106
1521784,1134004,2022-01-26,Senate,"Reported Favorably With Substitute S-1",9,1,0,0,10
1521784,1140476,2022-02-09,Senate,"Senate Third Reading: Given Immediate Effect Roll Call # 19",36,2,0,0,38
1521784,1147149,2022-02-16,House,"House Third Reading: Roll Call # 59",91,14,0,0,105
1521787,1115573,2021-11-04,House,"Reported With Recommendation With Substitute H-2",15,3,0,0,18
1521787,1116588,2021-12-01,House,"House Third Reading: Given Immediate Effect Roll Call # 562",91,9,0,0,100
1521787,1166105,2022-03-08,Senate,"Reported Favorably With Substitute S-1",9,0,0,0,9
1521787,1171004,2022-03-10,Senate,"Senate Third Reading: Given Immediate Effect Roll Call # 73",38,0,0,0,38
1521787,1171005,2022-03-15,House,"House Third Reading: Roll Call # 117",93,10,0,0,103
1521792,1109464,2021-09-30,House,"Reported With Recommendation With Substitute H-3",9,0,0,0,9
1521792,1129173,2022-01-26,House,"House Third Reading: Given Immediate Effect Roll Call # 8",101,1,0,0,102
1521793,1109596,2021-10-05,House,"Reported With Recommendation Without Amendment",11,0,0,0,11
1521793,1110081,2021-10-14,House,"House Third Reading: Given Immediate Effect Roll Call # 475",67,40,0,0,107
1521793,1115524,2021-11-03,Senate,"Reported Favorably Without Amendment",7,0,0,0,7
1521793,1115929,2021-11-10,Senate,"Senate Third Reading: Given Immediate Effect Roll Call # 443",34,1,0,1,36
1521794,1171921,2022-03-16,House,"Reported With Recommendation With Substitute H-1",9,0,0,0,9
1521796,1200632,2022-05-05,House,"Reported With Recommendation With Substitute H-1",12,7,0,0,19
1521798,1115574,2021-11-04,House,"Reported With Recommendation With Substitute H-1",18,0,0,0,18
1521798,1116573,2021-12-01,House,"House Third Reading: Given Immediate Effect Roll Call # 563",96,4,0,0,100
1521798,1166201,2022-03-08,Senate,"Reported Favorably Without Amendment",9,0,0,0,9
1521798,1171018,2022-03-10,Senate,"Senate Third Reading: Given Immediate Effect Roll Call # 74",38,0,0,0,38
1521800,1115571,2021-11-04,House,"Reported With Recommendation With Substitute H-1",18,0,0,0,18
1521800,1116578,2021-12-01,House,"House Third Reading: Given Immediate Effect Roll Call # 561",97,3,0,0,100
1521800,1166117,2022-03-08,Senate,"Reported Favorably Without Amendment",9,0,0,0,9
1521800,1171008,2022-03-10,Senate,"Senate Third Reading: Given Immediate Effect Roll Call # 72",38,0,0,0,38
1521801,1109300,2021-09-28,House,"Reported With Recommendation With Substitute H-1",7,0,0,0,7
1521801,1119582,2021-12-14,House,"House Third Reading: Given Immediate Effect Roll Call # 614",102,0,0,0,102
1521801,1176831,2022-03-24,Senate,"Reported Favorably Without Amendment",4,0,0,0,4
1521801,1209933,2022-05-26,Senate,"Senate Third Reading: Given Immediate Effect Roll Call # 283",37,0,0,1,38
1521836,1116989,2021-12-07,House,"Reported With Recommendation With Substitute H-1",9,0,0,0,9
1521836,1119640,2021-12-14,House,"House Third Reading: Given Immediate Effect Roll Call # 622",102,0,0,0,102
1521836,1170475,2022-03-15,Senate,"Reported Favorably With Substitute S-2",8,0,0,0,8
1521836,1190466,2022-04-20,Senate,"Senate Third Reading: Given Immediate Effect Roll Call # 121",37,0,0,1,38
1521836,1193670,2022-04-26,House,"House Third Reading: Roll Call # 165",102,0,0,0,102
1521837,1116997,2021-12-07,House,"Reported With Recommendation With Substitute H-1",9,0,0,0,9
1521837,1119622,2021-12-14,House,"House Third Reading: Given Immediate Effect Roll Call # 626",102,0,0,0,102
1521837,1170962,2022-03-15,Senate,"Reported Favorably Without Amendment",8,0,0,0,8
1521837,1190894,2022-04-20,Senate,"Senate Third Reading: Given Immediate Effect Roll Call # 125",37,0,0,1,38
1521839,1116479,2021-11-30,House,"Reported With Recommendation With Substitute H-2",12,0,0,0,12
1521839,1117293,2021-12-09,House,"House Third Reading: Given Immediate Effect Roll Call # 599",102,0,0,0,102
1521839,1167929,2022-03-10,Senate,"Reported Favorably Without Amendment",10,0,0,0,10
1521839,1175066,2022-03-22,Senate,"Senate Third Reading: Given Immediate Effect Roll Call # 98",38,0,0,0,38
1521845,1117002,2021-12-07,House,"Reported With Recommendation With Substitute H-1",9,0,0,0,9
1521845,1119621,2021-12-14,House,"House Third Reading: Given Immediate Effect Roll Call # 624",102,0,0,0,102
1521845,1171110,2022-03-15,Senate,"Reported Favorably With Substitute S-1",8,0,0,0,8
1521845,1190826,2022-04-20,Senate,"Senate Third Reading: Given Immediate Effect Roll Call # 123",37,0,0,1,38
1521845,1193677,2022-04-26,House,"House Third Reading: Roll Call # 167",102,0,0,0,102
1521847,1110096,2021-10-14,House,"Reported With Recommendation With Substitute H-1",9,0,0,0,9
1521847,1115506,2021-11-03,House,"House Third Reading: Given Immediate Effect Roll Call # 520",103,0,0,0,103
1521851,1116996,2021-12-07,House,"Reported With Recommendation With Substitute H-1",9,0,0,0,9
1521851,1119608,2021-12-14,House,"House Third Reading: Given Immediate Effect Roll Call # 623",102,0,0,0,102
1521851,1171114,2022-03-15,Senate,"Reported Favorably With Substitute S-1",8,0,0,0,8
1521851,1190872,2022-04-20,Senate,"Senate Third Reading: Given Immediate Effect Roll Call # 122",37,0,0,1,38
1521851,1193672,2022-04-26,House,"House Third Reading: Roll Call # 166",102,0,0,0,102
1521854,1116995,2021-12-07,House,"Reported With Recommendation Without Amendment",9,0,0,0,9
1521854,1119590,2021-12-14,House,"House Third Reading: Given Immediate Effect Roll Call # 625",102,0,0,0,102
1521854,1171070,2022-03-15,Senate,"Reported Favorably Without Amendment",8,0,0,0,8
1521854,1190863,2022-04-20,Senate,"Senate Third Reading: Given Immediate Effect Roll Call # 124",37,0,0,1,38
1521858,1116994,2021-12-07,House,"Reported With Recommendation With Substitute H-1",9,0,0,0,9
1521858,1119612,2021-12-14,House,"House Third Reading: Given Immediate Effect Roll Call # 627",102,0,0,0,102
1521858,1171125,2022-03-15,Senate,"Reported Favorably Without Amendment",8,0,0,0,8
1521858,1190858,2022-04-20,Senate,"Senate Third Reading: Given Immediate Effect Roll Call # 126",37,0,0,1,38
1521860,1116998,2021-12-07,House,"Reported With Recommendation With Substitute H-1",9,0,0,0,9
1521860,1119651,2021-12-14,House,"House Third Reading: Given Immediate Effect Roll Call # 621",102,0,0,0,102
1521860,1171053,2022-03-15,Senate,"Reported Favorably With Substitute S-1",8,0,0,0,8
1521860,1190903,2022-04-20,Senate,"Senate Third Reading: Given Immediate Effect Roll Call # 120",37,0,0,1,38
1521860,1193626,2022-04-26,House,"House Third Reading: Roll Call # 164",102,0,0,0,102
1522151,1107749,2021-08-31,Senate,"Senate Third Reading: Given Immediate Effect Roll Call # 343",36,0,0,0,36
1522151,1108879,2021-09-14,House,"House Third Reading: Given Immediate Effect Roll Call # 438",101,3,0,0,104
1522161,1115513,2021-11-03,Senate,"Reported Favorably Without Amendment",5,2,0,0,7
1522171,1107750,2021-08-31,Senate,"Senate Third Reading: Given Immediate Effect Roll Call # 344",36,0,0,0,36
1522171,1108881,2021-09-14,House,"House Third Reading: Given Immediate Effect Roll Call # 439",101,3,0,0,104
1522726,1110916,2021-10-28,Senate,"Reported Favorably Without Amendment",9,0,0,0,9
1522726,1116531,2021-11-10,Senate,"Senate Third Reading: Passed Roll Call # 433",34,1,0,1,36
1522726,1207105,2022-05-19,House,"Reported With Recommendation Without Amendment",16,0,0,0,16
1522726,1221613,2022-06-30,House,"House Third Reading: Given Immediate Effect Roll Call # 334",102,3,0,0,105
1522730,1110142,2021-10-14,Senate,"Reported Favorably With Substitute S-1",18,0,0,0,18
1522730,1110480,2021-10-21,Senate,"Senate Third Reading: Passed Roll Call # 401",34,1,0,1,36
1522730,1116423,2021-11-10,House,"Reported With Recommendation With Substitute H-2",28,0,0,0,28
1522730,1196209,2022-04-28,House,"House Third Reading: Given Immediate Effect Roll Call # 172",99,0,0,0,99
1522730,1200273,2022-05-04,Senate,"Senate Third Reading: Roll Call: Roll Call # 203",34,0,0,4,38
1522730,1220129,2022-05-10,House,"House Third Reading: Roll Call # 206",104,0,0,0,104
1522732,1159149,2022-03-01,Senate,"Reported Favorably Without Amendment",8,0,0,0,8
1522732,1166232,2022-03-08,Senate,"Senate Third Reading: Passed Roll Call # 62",38,0,0,0,38
1522735,1110126,2021-10-14,Senate,"Reported Favorably Without Amendment",18,0,0,0,18
1522735,1110479,2021-10-21,Senate,"Senate Third Reading: Passed Roll Call # 402",34,1,0,1,36
1522735,1116431,2021-11-10,House,"Reported With Recommendation With Substitute H-1",28,0,0,0,28
1522735,1196319,2022-04-28,House,"House Third Reading: Given Immediate Effect Roll Call # 173",99,0,0,0,99
1522735,1200164,2022-05-04,Senate,"Senate Third Reading: Roll Call: Roll Call # 204",34,0,0,4,38
1522741,1115515,2021-11-03,Senate,"Reported Favorably Without Amendment",7,1,0,0,8
1522742,1168082,2022-03-10,Senate,"Reported Favorably Without Amendment",18,0,0,0,18
1522742,1168083,2022-03-10,Senate,"Senate Third Reading: Passed Roll Call # 79",38,0,0,0,38
1522742,1171422,2022-03-16,House,"Reported With Recommendation Without Amendment",12,0,0,0,12
1522742,1172398,2022-03-17,House,"House Third Reading: Given Immediate Effect Roll Call # 129",100,3,0,0,103
1522795,1141799,2022-02-09,Senate,"Reported Favorably With Substitute S-1",10,0,0,0,10
1522795,1154915,2022-02-23,Senate,"Senate Third Reading: Passed Roll Call # 43",38,0,0,0,38
1522798,1219176,2022-06-07,Senate,"Reported Favorably With Substitute S-1",7,1,0,0,8
1522798,1219177,2022-06-15,Senate,"Senate Third Reading: Passed Roll Call # 318",32,5,0,1,38
1523053,1109412,2021-09-29,Senate,"Reported Favorably Without Amendment",4,0,0,0,4
1523053,1116466,2021-11-30,Senate,"Senate Third Reading: Passed Roll Call # 452",31,6,0,1,38
1523342,1110355,2021-10-19,Senate,"Reported Favorably With Substitute S-1",5,1,0,0,6
1523342,1110454,2021-10-20,Senate,"Senate Third Reading: Passed Roll Call # 396",36,0,0,0,36
1523342,1116667,2021-12-02,House,"Reported With Recommendation Without Amendment",16,2,0,0,18
1523342,1117261,2021-12-09,House,"House Third Reading: Given Immediate Effect Roll Call # 605",91,11,0,0,102
1523358,1110327,2021-10-19,Senate,"Reported Favorably With Substitute S-1",5,1,0,0,6
1523358,1110449,2021-10-20,Senate,"Senate Third Reading: Passed Roll Call # 397",36,0,0,0,36
1523358,1116669,2021-12-02,House,"Reported With Recommendation Without Amendment",16,2,0,0,18
1523358,1117287,2021-12-09,House,"House Third Reading: Given Immediate Effect Roll Call # 606",97,5,0,0,102
1523365,1115740,2021-11-02,House,"Reported With Recommendation Without Amendment",9,0,0,0,9
1523368,1116881,2021-11-30,House,"Reported With Recommendation Without Amendment",13,0,0,0,13
1523389,1161590,2022-03-02,House,"Reported With Recommendation Without Amendment",13,0,0,0,13
1523389,1174980,2022-03-22,House,"House Third Reading: Given Immediate Effect Roll Call # 133",102,3,0,0,105
1523389,1200782,2022-05-05,Senate,"Reported Favorably Without Amendment",4,0,0,0,4
1523389,1219322,2022-05-26,Senate,"Senate Third Reading: Given Immediate Effect Roll Call # 284",37,0,0,1,38
1523394,1110101,2021-10-05,House,"Reported With Recommendation With Substitute H-2",5,2,0,0,7
1523394,1168068,2022-03-10,House,"House Third Reading: Given Immediate Effect Roll Call # 111",58,43,0,0,101
1523401,1117126,2021-12-08,House,"Reported With Recommendation Without Amendment",15,1,0,0,16
1523405,1115788,2021-11-09,House,"Reported With Recommendation Without Amendment",15,0,0,0,15
1523405,1116992,2021-12-07,House,"House Third Reading: Given Immediate Effect Roll Call # 585",99,4,0,0,103
1523405,1147231,2022-02-15,Senate,"Reported Favorably Without Amendment",10,0,0,0,10
1523405,1160965,2022-03-02,Senate,"Senate Third Reading: Given Immediate Effect Roll Call # 49",36,0,0,2,38
1523410,1110341,2021-10-19,House,"Reported With Recommendation With Substitute H-1",12,1,0,0,13
1523410,1115930,2021-11-10,House,"House Third Reading: Given Immediate Effect Roll Call # 548",94,11,0,0,105
1523410,1208997,2022-05-24,Senate,"Reported Favorably With Substitute S-1",10,0,0,0,10
1523410,1219214,2022-05-26,Senate,"Senate Third Reading: Given Immediate Effect Roll Call # 280",37,0,0,1,38
1523410,1221693,2022-06-30,House,"House Third Reading: Roll Call # 342",96,11,0,0,107
1523422,1110661,2021-10-26,House,"Reported With Recommendation With Substitute H-1",10,2,0,0,12
1523425,1110655,2021-10-26,House,"Reported With Recommendation Without Amendment",10,2,0,0,12
1523430,1115774,2021-11-09,House,"Reported With Recommendation Without Amendment",15,0,0,0,15
1523430,1116991,2021-12-07,House,"House Third Reading: Given Immediate Effect Roll Call # 584",99,4,0,0,103
1523430,1147232,2022-02-15,Senate,"Reported Favorably Without Amendment",10,0,0,0,10
1523430,1161625,2022-03-02,Senate,"Senate Third Reading: Given Immediate Effect Roll Call # 48",36,0,0,2,38
1523434,1110644,2021-10-26,House,"Reported With Recommendation With Substitute H-4",10,2,0,0,12
1523437,1110648,2021-10-26,House,"Reported With Recommendation Without Amendment",14,1,0,0,15
1523437,1115927,2021-11-10,House,"House Third Reading: Given Immediate Effect Roll Call # 555",98,7,0,0,105
1523437,1142212,2022-02-09,Senate,"Reported Favorably Without Amendment",10,0,0,0,10
1523437,1151251,2022-02-22,Senate,"Senate Third Reading: Given Immediate Effect Roll Call # 34",38,0,0,0,38
1523444,1109326,2021-09-28,House,"Reported With Recommendation Without Amendment",13,0,0,0,13
1523444,1110466,2021-10-20,House,"House Third Reading: Given Immediate Effect Roll Call # 489",104,0,0,0,104
1523444,1116644,2021-12-02,Senate,"Reported Favorably Without Amendment",8,0,0,0,8
1523538,1109690,2021-10-06,Senate,"Reported Favorably Without Amendment",6,0,0,0,6
1523538,1109735,2021-10-07,Senate,"Senate Third Reading: Passed Roll Call # 379",36,0,0,0,36
1523541,1115569,2021-11-04,Senate,"Reported Favorably Without Amendment",16,0,0,0,16
1523541,1116262,2021-11-10,Senate,"Senate Third Reading: Passed Roll Call # 447",35,0,0,1,36
1523544,1119649,2021-12-14,Senate,"Reported Favorably With Substitute S-1",8,0,0,0,8
1523544,1130400,2022-01-27,Senate,"Senate Third Reading: Passed Roll Call # 13",37,0,0,1,38
1523544,1226480,2022-09-21,House,"Reported With Recommendation Without Amendment",15,0,0,0,15
1523544,1230471,2022-12-08,House,"House Third Reading: Given Immediate Effect Roll Call # 498",75,21,0,0,96
1523547,1205574,2022-05-12,Senate,"Reported Favorably Without Amendment",8,0,0,0,8
1523547,1207069,2022-05-19,Senate,"Senate Third Reading: Passed Roll Call # 245",35,0,1,2,38
1523547,1226479,2022-09-21,House,"Reported With Recommendation Without Amendment",11,0,0,0,11
1523560,1219054,2022-06-23,Senate,"Reported Favorably With Substitute S-3",10,0,0,0,10
1523560,1228947,2022-09-28,Senate,"Senate Third Reading: Passed Roll Call # 456",35,0,0,3,38
1523937,1138665,2022-02-08,House,"Reported With Recommendation With Substitute H-2",15,0,0,0,15
1523937,1148559,2022-02-17,House,"House Third Reading: Given Immediate Effect Roll Call # 65",74,27,0,0,101
1523939,1110673,2021-10-26,House,"Reported With Recommendation Without Amendment",10,2,0,0,12
1523956,1134191,2022-02-01,House,"Reported With Recommendation With Substitute H-6",9,2,0,0,11
1523957,1110684,2021-10-26,House,"Reported With Recommendation Without Amendment",10,2,0,0,12
1523958,1133865,2022-02-01,House,"Reported With Recommendation With Substitute H-1",10,1,0,0,11
1523958,1147410,2022-02-16,House,"House Third Reading: Given Immediate Effect Roll Call # 54",99,6,0,0,105
1523958,1216830,2022-06-16,Senate,"Reported Favorably Without Amendment",8,0,0,0,8
1523960,1110680,2021-10-26,House,"Reported With Recommendation Without Amendment",10,2,0,0,12
1523963,1228581,2022-09-28,House,"Reported With Recommendation With Substitute H-5",5,0,0,0,5
1523965,1134273,2022-02-01,House,"Reported With Recommendation With Substitute H-6",9,2,0,0,11
1524052,1116993,2021-12-07,Senate,"Reported Favorably With Substitute S-1",7,0,0,0,7
1524082,1110141,2021-10-13,House,"Reported With Recommendation With Substitute H-1",14,0,0,0,14
1524082,1115588,2021-11-04,House,"House Third Reading: Given Immediate Effect Roll Call # 530",102,0,0,0,102
1524082,1117266,2021-12-09,Senate,"Reported Favorably Without Amendment",7,0,0,0,7
1524082,1125864,2022-01-19,Senate,"Senate Third Reading: Given Immediate Effect Roll Call # 5",37,0,0,1,38
1524088,1115427,2021-11-02,House,"Reported With Recommendation Without Amendment",12,0,0,0,12
1524088,1116584,2021-12-01,House,"House Third Reading: Given Immediate Effect Roll Call # 560",100,0,0,0,100
1524102,1110099,2021-10-13,House,"Reported With Recommendation With Substitute H-1",14,0,0,0,14
1524102,1115567,2021-11-04,House,"House Third Reading: Given Immediate Effect Roll Call # 531",102,0,0,0,102
1524102,1117277,2021-12-09,Senate,"Reported Favorably Without Amendment",7,0,0,0,7
1524102,1126048,2022-01-19,Senate,"Senate Third Reading: Given Immediate Effect Roll Call # 6",37,0,0,1,38
1524228,1146238,2022-02-15,House,"Reported With Recommendation Without Amendment",9,1,0,0,10
1524228,1154954,2022-02-24,House,"House Third Reading: Given Immediate Effect Roll Call # 72",98,5,0,0,103
1524228,1217669,2022-06-16,Senate,"Reported Favorably Without Amendment",6,0,0,0,6
1524247,1138648,2022-02-08,House,"Reported With Recommendation With Substitute H-2",5,2,0,0,7
1524247,1221504,2022-06-30,House,"House Third Reading: Given Immediate Effect Roll Call # 333",56,49,0,0,105
1524567,1115522,2021-11-03,Senate,"Reported Favorably Without Amendment",7,0,0,0,7
1524567,1116442,2021-11-10,Senate,"Senate Third Reading: Passed Roll Call # 441",35,0,0,1,36
1524567,1128654,2022-01-25,House,"Reported With Recommendation With Substitute H-1",10,0,0,0,10
1524567,1130469,2022-01-27,House,"House Third Reading: Given Immediate Effect Roll Call # 19",102,0,0,0,102
1524567,1136255,2022-02-01,Senate,"Senate Third Reading: Roll Call: Roll Call # 15",38,0,0,0,38
1524573,1115521,2021-11-03,Senate,"Reported Favorably With Substitute S-1",9,0,0,0,9
1524573,1116538,2021-12-01,Senate,"Senate Third Reading: Passed Roll Call # 456",35,1,0,2,38
1524573,1219153,2022-05-24,House,"Reported With Recommendation With Substitute H-2",14,0,0,0,14
1524573,1219154,2022-06-08,House,"House Third Reading: Given Immediate Effect Roll Call # 287",78,28,0,0,106
1524573,1219155,2022-06-23,Senate,"Senate Third Reading: Roll Call: Roll Call # 341",37,1,0,0,38
1524743,1117340,2021-12-08,House,"Reported With Recommendation Without Amendment",9,6,0,0,15
1524743,1117341,2021-12-08,House,"House Third Reading: Given Immediate Effect Roll Call # 586",58,46,0,0,104
1524743,1119673,2021-12-14,Senate,"Senate Third Reading: Passed Roll Call # 495",21,15,0,2,38
1524743,1119674,2021-12-14,House,"House Third Reading: Roll Call # 634",58,45,0,0,103
1524847,1109707,2021-10-06,Senate,"Reported Favorably With Substitute S-1",6,0,0,0,6
1524847,1109890,2021-10-07,Senate,"Senate Third Reading: Passed Roll Call # 380",36,0,0,0,36
1524855,1115512,2021-11-03,Senate,"Reported Favorably With Substitute S-1",8,0,0,0,8
1524855,1116485,2021-11-10,Senate,"Senate Third Reading: Passed Roll Call # 438",28,7,0,1,36
1524855,1117122,2021-12-08,House,"Reported With Recommendation Without Amendment",4,1,0,0,5
1524855,1117123,2021-12-08,House,"House Third Reading: Given Immediate Effect Roll Call # 595",78,26,0,0,104
1525326,1110110,2021-10-14,Senate,"Reported Favorably Without Amendment",9,0,0,0,9
1525326,1110463,2021-10-20,Senate,"Senate Third Reading: Passed Roll Call # 393",36,0,0,0,36
1525326,1116471,2021-11-30,House,"Reported With Recommendation Without Amendment",12,0,0,0,12
1525326,1117298,2021-12-09,House,"House Third Reading: Given Immediate Effect Roll Call # 600",98,4,0,0,102
1525327,1109802,2021-10-06,House,"House Third Reading: Roll Call # 452",57,46,0,0,103
1525330,1161045,2022-03-02,Senate,"Reported Favorably With Substitute S-1",9,4,0,0,13
1525330,1167189,2022-03-09,Senate,"Senate Third Reading: Passed Roll Call # 65",20,17,1,0,38
1525383,1196293,2022-04-28,House,"Reported With Recommendation With Substitute H-1",9,0,0,0,9
1525388,1196212,2022-04-28,House,"Reported With Recommendation With Substitute H-1",9,0,0,0,9
1525390,1196316,2022-04-28,House,"Reported With Recommendation Without Amendment",9,0,0,0,9
1525456,1110801,2021-10-26,House,"Reported With Recommendation Without Amendment",7,2,0,0,9
1525505,1110311,2021-10-19,House,"Reported With Recommendation With Substitute H-1",8,0,0,0,8
1525505,1115503,2021-11-03,House,"House Third Reading: Given Immediate Effect Roll Call # 522",69,34,0,0,103
1525518,1115795,2021-11-09,House,"Reported With Recommendation Without Amendment",11,1,0,0,12
1525518,1119574,2021-12-14,House,"House Third Reading: Given Immediate Effect Roll Call # 611",93,10,0,0,103
1525518,1203902,2022-05-12,Senate,"Reported Favorably Without Amendment",8,0,0,0,8
1525518,1207094,2022-05-19,Senate,"Senate Third Reading: Given Immediate Effect Roll Call # 243",35,0,1,2,38
1525573,1110314,2021-10-19,Senate,"Reported Favorably Without Amendment",5,1,0,0,6
1525573,1110448,2021-10-20,Senate,"Senate Third Reading: Passed Roll Call # 394",35,1,0,0,36
1525573,1110645,2021-10-26,House,"Reported With Recommendation Without Amendment",12,0,0,0,12
1525573,1115502,2021-11-03,House,"House Third Reading: Given Immediate Effect Roll Call # 521",103,0,0,0,103
1525579,1151526,2022-02-22,House,"Reported With Recommendation With Substitute H-1",9,0,0,0,9
1525579,1176010,2022-03-23,House,"House Third Reading: Given Immediate Effect Roll Call # 135",103,2,0,0,105
1525582,1110118,2021-10-14,House,"House Third Reading: Given Immediate Effect Roll Call # 476",105,2,0,0,107
1525582,1110923,2021-10-28,Senate,"Reported Favorably Without Amendment",6,0,0,0,6
1525582,1119540,2021-12-14,Senate,"Senate Third Reading: Given Immediate Effect Roll Call # 489",34,2,0,2,38
1525582,1119652,2021-12-14,House,"House Third Reading: Roll Call # 633",100,3,0,0,103
1525914,1115572,2021-11-04,Senate,"Reported Favorably With Substitute S-1",16,0,0,0,16
1525914,1116449,2021-11-30,Senate,"Senate Third Reading: Passed Roll Call # 453",37,0,0,1,38
1526188,1110103,2021-10-14,Senate,"Reported Favorably Without Amendment",18,0,0,0,18
1526188,1110453,2021-10-20,Senate,"Senate Third Reading: Passed Roll Call # 392",36,0,0,0,36
1526188,1110768,2021-10-27,House,"House Third Reading: Given Immediate Effect Roll Call # 497",95,9,0,0,104
1526191,1110840,2021-10-28,House,"Reported With Recommendation Without Amendment",7,2,0,0,9
1526214,1117127,2021-12-08,House,"Reported With Recommendation Without Amendment",11,0,0,0,11
1526214,1130314,2022-01-27,House,"House Third Reading: Given Immediate Effect Roll Call # 24",102,0,0,0,102
1526214,1203595,2022-05-11,Senate,"Reported Favorably Without Amendment",5,0,0,0,5
1526214,1219258,2022-05-24,Senate,"Senate Third Reading: Given Immediate Effect Roll Call # 272",35,2,0,1,38
1526218,1226380,2022-09-21,House,"Reported With Recommendation Without Amendment",12,2,0,0,14
1526270,1110329,2021-10-19,Senate,"Reported Favorably With Substitute S-1",5,1,0,0,6
1526270,1110330,2021-10-19,Senate,"Senate Third Reading: Passed Roll Call # 389",20,16,0,0,36
1526270,1110769,2021-10-27,House,"House Third Reading: Given Immediate Effect Roll Call # 505",55,49,0,0,104
1526278,1110346,2021-10-19,Senate,"Reported Favorably With Substitute S-1",5,1,0,0,6
1526278,1110347,2021-10-19,Senate,"Senate Third Reading: Passed Roll Call # 388",20,16,0,0,36
1526278,1110756,2021-10-27,House,"House Third Reading: Given Immediate Effect Roll Call # 504",55,49,0,0,104
1526338,1110319,2021-10-19,House,"Reported With Recommendation With Substitute H-1",8,5,0,0,13
1526338,1110320,2021-10-19,House,"House Third Reading: Given Immediate Effect Roll Call # 478",55,48,0,0,103
1526338,1110773,2021-10-26,Senate,"Senate Third Reading: Passed Roll Call # 410",19,15,0,2,36
1526350,1110315,2021-10-19,House,"Reported With Recommendation With Substitute H-1",8,5,0,0,13
1526350,1110316,2021-10-19,House,"House Third Reading: Given Immediate Effect Roll Call # 477",55,48,0,0,103
1526350,1110763,2021-10-26,Senate,"Senate Third Reading: Passed Roll Call # 409",19,15,0,2,36
1526747,1166320,2022-03-08,Senate,"Reported Favorably Without Amendment",8,0,0,0,8
1526747,1205263,2022-05-17,Senate,"Senate Third Reading: Passed Roll Call # 230",36,0,0,2,38
1526747,1214872,2022-06-07,House,"Reported With Recommendation Without Amendment",9,1,0,0,10
1526747,1221524,2022-06-30,House,"House Third Reading: Given Immediate Effect Roll Call # 358",67,39,0,0,106
1526859,1110810,2021-10-27,Senate,"Reported Favorably With Substitute S-1",4,1,0,0,5
1526931,1115536,2021-11-03,Senate,"Reported Favorably With Substitute S-2",7,0,0,0,7
1526931,1116452,2021-11-10,Senate,"Senate Third Reading: Passed Roll Call # 442",35,0,0,1,36
1526931,1128686,2022-01-25,House,"Reported With Recommendation With Substitute H-1",11,0,0,0,11
1526931,1130498,2022-01-27,House,"House Third Reading: Given Immediate Effect Roll Call # 20",102,0,0,0,102
1526931,1136244,2022-02-01,Senate,"Senate Third Reading: Roll Call: Roll Call # 16",38,0,0,0,38
1527002,1116665,2021-12-02,House,"Reported With Recommendation Without Amendment",5,0,0,0,5
1527002,1132624,2022-02-01,House,"House Third Reading: Given Immediate Effect Roll Call # 30",91,14,0,0,105
1527011,1203905,2022-05-10,House,"Reported With Recommendation Without Amendment",15,0,0,0,15
1527048,1203733,2022-05-10,House,"Reported With Recommendation With Substitute H-2",15,0,0,0,15
1527057,1116668,2021-12-02,House,"Reported With Recommendation Without Amendment",5,0,0,0,5
1527057,1133876,2022-02-01,House,"House Third Reading: Given Immediate Effect Roll Call # 28",93,12,0,0,105
1527132,1116663,2021-12-02,House,"Reported With Recommendation Without Amendment",5,0,0,0,5
1527132,1133088,2022-02-01,House,"House Third Reading: Given Immediate Effect Roll Call # 29",91,14,0,0,105
1527142,1116472,2021-11-10,House,"Reported With Recommendation Without Amendment",9,4,0,0,13
1527142,1215375,2022-06-09,House,"House Third Reading: Given Immediate Effect Roll Call # 289",81,24,0,0,105
1527142,1230074,2022-11-29,Senate,"Reported Favorably Without Amendment",3,0,0,0,3
1527151,1110650,2021-10-26,House,"Reported With Recommendation Without Amendment",13,0,0,0,13
1527151,1115932,2021-11-10,House,"House Third Reading: Given Immediate Effect Roll Call # 554",103,2,0,0,105
1527151,1116569,2021-12-01,Senate,"Reported Favorably Without Amendment",6,0,0,0,6
1527151,1117280,2021-12-09,Senate,"Senate Third Reading: Passed Roll Call # 480",37,0,0,1,38
1527151,1119575,2021-12-14,House,"House Third Reading: Roll Call # 609",101,2,0,0,103
1527171,1110660,2021-10-26,House,"Reported With Recommendation Without Amendment",13,0,0,0,13
1527171,1115931,2021-11-10,House,"House Third Reading: Given Immediate Effect Roll Call # 553",103,2,0,0,105
1527171,1116571,2021-12-01,Senate,"Reported Favorably Without Amendment",6,0,0,0,6
1527171,1117281,2021-12-09,Senate,"Senate Third Reading: Passed Roll Call # 479",37,0,0,1,38
1527197,1203573,2022-05-10,House,"Reported With Recommendation Without Amendment",15,0,0,0,15
1527206,1203575,2022-05-10,House,"Reported With Recommendation Without Amendment",15,0,0,0,15
1527278,1110922,2021-10-28,Senate,"Reported Favorably Without Amendment",6,0,0,0,6
1527278,1116451,2021-11-10,Senate,"Senate Third Reading: Passed Roll Call # 437",35,0,0,1,36
1527278,1116662,2021-12-01,House,"Reported With Recommendation Without Amendment",14,0,0,0,14
1527278,1117273,2021-12-09,House,"House Third Reading: Given Immediate Effect Roll Call # 602",102,0,0,0,102
1527280,1115568,2021-11-04,Senate,"Reported Favorably Without Amendment",16,0,0,0,16
1527280,1116492,2021-11-10,Senate,"Senate Third Reading: Passed Roll Call # 445",35,0,0,1,36
1527288,1162682,2022-03-03,Senate,"Reported Favorably With Substitute S-1",5,0,0,0,5
1527300,1151516,2022-02-22,House,"Reported With Recommendation Without Amendment",5,4,0,0,9
1527308,1110924,2021-10-28,House,"Reported With Recommendation With Substitute H-1",9,0,0,0,9
1527311,1151228,2022-02-22,House,"Reported With Recommendation Without Amendment",5,4,0,0,9
1527323,1151246,2022-02-22,House,"Reported With Recommendation Without Amendment",5,4,0,0,9
1527348,1188151,2022-04-13,House,"Reported With Recommendation With Substitute H-2",11,0,0,0,11
1527348,1219098,2022-05-25,House,"House Third Reading: Given Immediate Effect Roll Call # 269",88,19,0,0,107
1527357,1116465,2021-11-30,House,"Reported With Recommendation Without Amendment",13,0,0,0,13
1527357,1119548,2021-12-14,House,"House Third Reading: Given Immediate Effect Roll Call # 618",101,1,0,0,102
1527357,1141815,2022-02-09,Senate,"Reported Favorably With Substitute S-1",10,0,0,0,10
1527357,1151227,2022-02-22,Senate,"Senate Third Reading: Given Immediate Effect Roll Call # 35",38,0,0,0,38
1527357,1159379,2022-03-01,House,"House Third Reading: Roll Call # 80",104,0,0,0,104
1527379,1146225,2022-02-15,House,"Reported With Recommendation With Substitute H-1",11,0,0,0,11
1527379,1154930,2022-02-24,House,"House Third Reading: Given Immediate Effect Roll Call # 73",102,0,0,0,102
1527379,1217687,2022-06-16,Senate,"Reported Favorably Without Amendment",8,0,0,0,8
1527379,1221483,2022-06-30,Senate,"Senate Third Reading: Given Immediate Effect Roll Call # 374",38,0,0,0,38
1527760,1111104,2021-10-28,Senate,"Reported Favorably Without Amendment",9,0,0,0,9
1527942,1119656,2021-12-14,Senate,"Reported Favorably With Substitute S-1",7,0,0,0,7
1527942,1130760,2022-01-27,Senate,"Senate Third Reading: Passed Roll Call # 14",33,4,0,1,38
1527942,1220230,2022-05-24,House,"Reported With Recommendation With Substitute H-2",9,3,0,0,12
1527942,1221518,2022-06-30,House,"House Third Reading: Given Immediate Effect Roll Call # 335",59,46,0,0,105
1527942,1221519,2022-06-30,Senate,"Senate Third Reading: Roll Call: Roll Call # 398",35,2,0,1,38
1527944,1217305,2022-06-21,House,"Reported With Recommendation With Substitute H-4",9,1,0,0,10
1527944,1219175,2022-06-21,House,"House Third Reading: Given Immediate Effect Roll Call # 329",89,15,0,0,104
1527944,1221684,2022-06-30,Senate,"Senate Third Reading: Given Immediate Effect Roll Call # 393",38,0,0,0,38
1527996,1217613,2022-06-21,House,"Reported With Recommendation With Substitute H-4",8,1,0,0,9
1527996,1219011,2022-06-21,House,"House Third Reading: Given Immediate Effect Roll Call # 328",91,14,0,0,105
1527996,1221627,2022-06-30,Senate,"Senate Third Reading: Given Immediate Effect Roll Call # 392",38,0,0,0,38
1528194,1220235,2022-06-15,Senate,"Senate Third Reading: Passed Roll Call # 330",36,1,0,1,38
1528202,1210747,2022-05-26,Senate,"Reported Favorably Without Amendment",8,0,0,0,8
1528202,1221621,2022-06-30,Senate,"Senate Third Reading: Passed Roll Call # 385",38,0,0,0,38
1528215,1116661,2021-12-02,House,"Reported With Recommendation Without Amendment",16,2,0,0,18
1528215,1117276,2021-12-09,House,"House Third Reading: Given Immediate Effect Roll Call # 604",95,7,0,0,102
1528215,1219081,2022-06-23,Senate,"Reported Favorably Without Amendment",10,0,0,0,10
1528227,1116650,2021-12-02,House,"Reported With Recommendation Without Amendment",16,2,0,0,18
1528227,1117270,2021-12-09,House,"House Third Reading: Given Immediate Effect Roll Call # 603",95,7,0,0,102
1528227,1219017,2022-06-23,Senate,"Reported Favorably Without Amendment",10,0,0,0,10
1528732,1116537,2021-11-10,House,"Reported With Recommendation Without Amendment",15,0,0,0,15
1528732,1116647,2021-12-02,House,"House Third Reading: Given Immediate Effect Roll Call # 576",99,0,0,0,99
1528732,1117285,2021-12-09,Senate,"Reported Favorably Without Amendment",7,0,0,0,7
1528732,1119680,2021-12-14,Senate,"Senate Third Reading: Given Immediate Effect Roll Call # 492",36,0,0,2,38
1529001,1116535,2021-11-10,House,"Reported With Recommendation Without Amendment",15,0,0,0,15
1529001,1116643,2021-12-02,House,"House Third Reading: Given Immediate Effect Roll Call # 578",99,0,0,0,99
1529001,1117282,2021-12-09,Senate,"Reported Favorably Without Amendment",7,0,0,0,7
1529001,1119678,2021-12-14,Senate,"Senate Third Reading: Given Immediate Effect Roll Call # 494",36,0,0,2,38
1529541,1202972,2022-05-10,House,"Reported With Recommendation With Substitute H-2",8,2,0,0,10
1529811,1116542,2021-11-10,House,"Reported With Recommendation Without Amendment",15,0,0,0,15
1529811,1116649,2021-12-02,House,"House Third Reading: Given Immediate Effect Roll Call # 575",99,0,0,0,99
1529811,1117286,2021-12-09,Senate,"Reported Favorably Without Amendment",7,0,0,0,7
1529811,1119675,2021-12-14,Senate,"Senate Third Reading: Given Immediate Effect Roll Call # 491",36,0,0,2,38
1530081,1116450,2021-11-10,House,"Reported With Recommendation Without Amendment",15,0,0,0,15
1530081,1116656,2021-12-02,House,"House Third Reading: Given Immediate Effect Roll Call # 574",99,0,0,0,99
1530081,1117243,2021-12-09,Senate,"Reported Favorably Without Amendment",7,0,0,0,7
1530081,1119679,2021-12-14,Senate,"Senate Third Reading: Given Immediate Effect Roll Call # 490",36,0,0,2,38
1530350,1203588,2022-05-10,House,"Reported With Recommendation Without Amendment",8,2,0,0,10
1530350,1228989,2022-09-28,House,"House Third Reading: Given Immediate Effect Roll Call # 427",88,18,0,0,106
1530622,1116543,2021-11-10,House,"Reported With Recommendation Without Amendment",15,0,0,0,15
1530622,1116651,2021-12-02,House,"House Third Reading: Given Immediate Effect Roll Call # 577",99,0,0,0,99
1530622,1117283,2021-12-09,Senate,"Reported Favorably Without Amendment",7,0,0,0,7
1530622,1119676,2021-12-14,Senate,"Senate Third Reading: Given Immediate Effect Roll Call # 493",36,0,0,2,38
1530891,1170989,2022-03-15,House,"Reported With Recommendation Without Amendment",11,0,0,0,11
1530891,1194958,2022-04-27,House,"House Third Reading: Given Immediate Effect Roll Call # 170",87,16,0,0,103
1530891,1216480,2022-06-15,Senate,"Reported Favorably Without Amendment",9,0,0,0,9
1530891,1221620,2022-06-30,Senate,"Senate Third Reading: Given Immediate Effect Roll Call # 373",30,8,0,0,38
1531162,1202512,2022-05-10,House,"Reported With Recommendation With Substitute H-1",10,2,0,0,12
1532023,1127344,2022-01-20,Senate,"Reported Favorably Without Amendment",6,1,0,0,7
1532023,1130517,2022-01-27,Senate,"Senate Third Reading: Passed Roll Call # 12",36,1,0,1,38
1532023,1147390,2022-02-16,House,"Reported With Recommendation Without Amendment",10,0,0,0,10
1532023,1155176,2022-02-24,House,"House Third Reading: Given Immediate Effect Roll Call # 78",80,21,0,0,101
1532031,1127323,2022-01-20,Senate,"Reported Favorably With Substitute S-2",6,1,0,0,7
1532031,1130349,2022-01-27,Senate,"Senate Third Reading: Passed Roll Call # 10",36,1,0,1,38
1532031,1147206,2022-02-16,House,"Reported With Recommendation With Substitute H-1",10,0,0,0,10
1532031,1155103,2022-02-24,House,"House Third Reading: Given Immediate Effect Roll Call # 76",78,23,0,0,101
1532031,1220373,2022-06-23,Senate,"Senate Third Reading: Roll Call: Roll Call # 342",38,0,0,0,38
1532035,1127906,2022-01-20,Senate,"Reported Favorably Without Amendment",6,1,0,0,7
1532035,1130520,2022-01-27,Senate,"Senate Third Reading: Passed Roll Call # 11",36,1,0,1,38
1532035,1148231,2022-02-16,House,"Reported With Recommendation Without Amendment",10,0,0,0,10
1532035,1155177,2022-02-24,House,"House Third Reading: Given Immediate Effect Roll Call # 77",81,20,0,0,101
1532051,1116447,2021-11-10,Senate,"Senate Third Reading: Passed Roll Call # 446",32,3,0,1,36
1532051,1116674,2021-12-01,House,"Reported With Recommendation Without Amendment",12,0,0,0,12
1532051,1117301,2021-12-09,House,"House Third Reading: Given Immediate Effect Roll Call # 601",85,17,0,0,102
1532080,1130308,2022-01-27,House,"Reported With Recommendation With Substitute H-2",27,1,0,0,28
1532080,1130309,2022-01-27,House,"House Third Reading: Given Immediate Effect Roll Call # 26",96,6,0,0,102
1532085,1116579,2021-12-01,House,"Reported With Recommendation With Substitute H-5",26,0,0,0,26
1532085,1116648,2021-12-02,House,"House Third Reading: Given Immediate Effect Roll Call # 567",97,3,0,0,100
1532093,1129418,2022-01-26,House,"Reported With Recommendation With Substitute H-1",28,0,0,0,28
1532093,1129419,2022-01-26,House,"House Third Reading: Given Immediate Effect Roll Call # 16",101,1,0,0,102
1532093,1177037,2022-03-24,Senate,"Senate Third Reading: Given Immediate Effect Roll Call # 110",36,1,0,1,38
1532093,1177038,2022-03-24,House,"House Third Reading: Roll Call # 154",98,5,0,0,103
1532103,1119598,2021-12-14,House,"Reported With Recommendation With Substitute H-4",28,0,0,0,28
1532103,1119599,2021-12-14,House,"House Third Reading: Given Immediate Effect Roll Call # 612",98,4,0,0,102
1532103,1138569,2022-02-08,House,"House Third Reading: Roll Call # 32",98,6,0,0,104
1532103,1140486,2022-02-09,Senate,"Senate Third Reading: Roll Call: Roll Call # 21",36,2,0,0,38
1532103,1141338,2022-02-08,Senate,"Senate Third Reading: Given Immediate Effect Roll Call # 17",36,2,0,0,38
1532206,1175233,2022-03-22,House,"Reported With Recommendation Without Amendment",13,0,0,0,13
1532206,1200134,2022-05-04,House,"House Third Reading: Given Immediate Effect Roll Call # 185",103,0,0,0,103
1532206,1205978,2022-05-18,Senate,"Reported Favorably Without Amendment",7,0,0,0,7
1532206,1221506,2022-06-30,Senate,"Senate Third Reading: Given Immediate Effect Roll Call # 379",38,0,0,0,38
1532208,1130427,2022-01-27,House,"Reported With Recommendation Without Amendment",8,0,0,0,8
1532208,1151435,2022-02-22,House,"House Third Reading: Given Immediate Effect Roll Call # 66",82,22,0,0,104
1532208,1193600,2022-04-26,Senate,"Reported Favorably With Substitute S-1",10,0,0,0,10
1532211,1117003,2021-12-07,House,"Reported With Recommendation With Substitute H-1",9,0,0,0,9
1532211,1119613,2021-12-14,House,"House Third Reading: Given Immediate Effect Roll Call # 628",102,0,0,0,102
1532211,1171048,2022-03-15,Senate,"Reported Favorably Without Amendment",8,0,0,0,8
1532211,1190762,2022-04-20,Senate,"Senate Third Reading: Given Immediate Effect Roll Call # 127",37,0,0,1,38
1532217,1125005,2022-01-18,House,"Reported With Recommendation Without Amendment",6,2,0,0,8
1532217,1129179,2022-01-26,House,"House Third Reading: Given Immediate Effect Roll Call # 9",97,5,0,0,102
1532769,1175030,2022-03-22,House,"Reported With Recommendation With Substitute H-3",14,0,0,0,14
1532769,1200634,2022-05-05,House,"House Third Reading: Given Immediate Effect Roll Call # 196",74,29,0,0,103
1532771,1117001,2021-12-07,House,"Reported With Recommendation With Substitute H-1",12,0,0,0,12
1532771,1128527,2022-01-25,House,"House Third Reading: Given Immediate Effect Roll Call # 7",101,0,0,0,101
1532771,1170971,2022-03-15,Senate,"Reported Favorably Without Amendment",8,0,0,0,8
1532771,1176310,2022-03-23,Senate,"Senate Third Reading: Given Immediate Effect Roll Call # 100",35,2,0,1,38
1532852,1116653,2021-12-02,Senate,"Reported Favorably Without Amendment",9,0,0,0,9
1532852,1116654,2021-12-02,Senate,"Senate Third Reading: Passed Roll Call # 460",34,0,0,4,38
1532852,1117284,2021-12-09,House,"Reported With Recommendation Without Amendment",8,1,0,0,9
1532852,1119645,2021-12-14,House,"House Third Reading: Given Immediate Effect Roll Call # 620",100,2,0,0,102
1532853,1171731,2022-03-16,Senate,"Reported Favorably With Substitute S-2",7,0,0,0,7
1532853,1175599,2022-03-23,Senate,"Senate Third Reading: Passed Roll Call # 102",34,2,1,1,38
1532858,1148637,2022-02-17,Senate,"Reported Favorably Without Amendment",6,0,0,0,6
1532858,1162807,2022-03-03,Senate,"Senate Third Reading: Passed Roll Call # 54",37,0,0,1,38
1532878,1125048,2022-01-18,House,"Reported With Recommendation With Substitute H-1",6,2,0,0,8
1532878,1129406,2022-01-26,House,"House Third Reading: Given Immediate Effect Roll Call # 14",69,33,0,0,102
1532880,1116963,2021-12-07,House,"Reported With Recommendation With Substitute H-1",7,5,0,0,12
1532880,1139884,2022-02-09,House,"House Third Reading: Given Immediate Effect Roll Call # 42",55,51,0,0,106
1532880,1221507,2022-07-01,Senate,"Senate Third Reading: Passed Roll Call # 404",21,16,0,1,38
1532880,1221712,2022-07-01,House,"House Third Reading: Roll Call # 378",56,48,0,0,104
1532889,1125080,2022-01-18,House,"Reported With Recommendation With Substitute H-2",9,0,0,0,9
1532889,1129434,2022-01-26,House,"House Third Reading: Given Immediate Effect Roll Call # 10",74,28,0,0,102
1532892,1125073,2022-01-18,House,"Reported With Recommendation With Substitute H-2",9,0,0,0,9
1532892,1129560,2022-01-26,House,"House Third Reading: Given Immediate Effect Roll Call # 12",102,0,0,0,102
1532899,1116988,2021-12-07,House,"Reported With Recommendation Without Amendment",8,2,0,0,10
1532902,1125188,2022-01-18,House,"Reported With Recommendation With Substitute H-1",6,1,0,0,7
1532902,1129583,2022-01-26,House,"House Third Reading: Given Immediate Effect Roll Call # 15",69,33,0,0,102
1532907,1116965,2021-12-07,House,"Reported With Recommendation Without Amendment",8,2,0,0,10
1532910,1125143,2022-01-18,House,"Reported With Recommendation With Substitute H-1",9,0,0,0,9
1532910,1129622,2022-01-26,House,"House Third Reading: Given Immediate Effect Roll Call # 11",102,0,0,0,102
1532912,1117004,2021-12-07,House,"Reported With Recommendation Without Amendment",7,5,0,0,12
1532912,1139995,2022-02-09,House,"House Third Reading: Given Immediate Effect Roll Call # 43",55,51,0,0,106
1532912,1221497,2022-07-01,Senate,"Senate Third Reading: Passed Roll Call # 405",21,16,0,1,38
1532916,1214808,2022-06-07,House,"Reported With Recommendation With Substitute H-1",12,0,0,0,12
1532916,1219078,2022-06-15,House,"House Third Reading: Given Immediate Effect Roll Call # 310",105,0,0,0,105
1532919,1154889,2022-02-24,House,"Reported With Recommendation With Substitute H-2",8,0,0,0,8
1532919,1167864,2022-03-10,House,"House Third Reading: Given Immediate Effect Roll Call # 108",101,0,0,0,101
1532919,1208697,2022-05-24,Senate,"Reported Favorably Without Amendment",10,0,0,0,10
1532919,1209884,2022-05-26,Senate,"Senate Third Reading: Given Immediate Effect Roll Call # 281",37,0,0,1,38
1532934,1125187,2022-01-18,House,"Reported With Recommendation With Substitute H-2",9,0,0,0,9
1532934,1129625,2022-01-26,House,"House Third Reading: Given Immediate Effect Roll Call # 13",74,28,0,0,102
1535126,1116586,2021-12-01,House,"Reported With Recommendation Without Amendment",26,0,0,0,26
1535138,1117109,2021-12-08,House,"Reported With Recommendation Without Amendment",11,3,0,0,14
1535180,1159771,2022-03-01,House,"Reported With Recommendation With Substitute H-3",7,0,0,0,7
1535188,1151408,2022-02-22,House,"Reported With Recommendation Without Amendment",8,0,0,0,8
1535188,1175223,2022-03-22,House,"House Third Reading: Given Immediate Effect Roll Call # 132",67,38,0,0,105
1535197,1146235,2022-02-15,House,"Reported With Recommendation Without Amendment",11,0,0,0,11
1535197,1155117,2022-02-24,House,"House Third Reading: Given Immediate Effect Roll Call # 74",102,0,0,0,102
1535197,1217672,2022-06-16,Senate,"Reported Favorably Without Amendment",8,0,0,0,8
1535209,1193602,2022-04-26,Senate,"Reported Favorably With Substitute S-1",10,0,0,0,10
1535215,1116666,2021-12-02,Senate,"Reported Favorably Without Amendment",11,0,0,0,11
1535215,1117278,2021-12-09,Senate,"Senate Third Reading: Passed Roll Call # 476",21,16,0,1,38
1535221,1148132,2022-01-26,Senate,"Reported Favorably With Substitute S-2",10,0,0,0,10
1535221,1172958,2022-03-17,Senate,"Senate Third Reading: Passed By 3/4 Vote Roll Call # 87",38,0,0,0,38
1535232,1172479,2022-03-17,House,"Reported With Recommendation Without Amendment",5,0,0,0,5
1535232,1188437,2022-04-13,House,"House Third Reading: Given Immediate Effect Roll Call # 157",101,1,0,0,102
1535232,1215370,2022-06-09,Senate,"Reported Favorably Without Amendment",17,1,0,0,18
1535232,1229656,2022-09-20,Senate,"Senate Third Reading: Given Immediate Effect Roll Call # 409",33,2,1,2,38
1535241,1193787,2022-04-26,Senate,"Reported Favorably With Substitute S-1",10,0,0,0,10
1535249,1167143,2022-03-09,House,"House Third Reading: Given Immediate Effect Roll Call # 100",63,39,0,0,102
1535249,1171060,2022-03-15,Senate,"Senate Third Reading: Passed Roll Call # 85",24,14,0,0,38
1535252,1151241,2022-02-22,House,"Reported With Recommendation Without Amendment",5,2,0,0,7
1535259,1208549,2022-05-24,Senate,"Reported Favorably With Substitute S-1",10,0,0,0,10
1535259,1220570,2022-05-26,Senate,"Senate Third Reading: Passed Roll Call # 279",37,0,0,1,38
1535265,1175019,2022-03-22,House,"Reported With Recommendation Without Amendment",10,1,0,0,11
1535267,1168059,2022-03-10,Senate,"Reported Favorably Without Amendment",12,0,0,0,12
1535267,1172896,2022-03-17,Senate,"Senate Third Reading: Passed Roll Call # 91",22,16,0,0,38
1535287,1116642,2021-12-02,Senate,"Reported Favorably Without Amendment",11,0,0,0,11
1535287,1117290,2021-12-09,Senate,"Senate Third Reading: Passed Roll Call # 475",21,16,0,1,38
1535309,1151224,2022-02-22,House,"Reported With Recommendation Without Amendment",5,2,0,0,7
1535317,1193775,2022-04-26,Senate,"Reported Favorably With Substitute S-1",10,0,0,0,10
1535322,1151218,2022-02-22,House,"Reported With Recommendation With Substitute H-1",5,2,0,0,7
1535333,1208682,2022-05-24,Senate,"Reported Favorably With Substitute S-2",10,0,0,0,10
1535333,1220266,2022-06-15,Senate,"Senate Third Reading: Passed Roll Call # 313",37,0,0,1,38
1535333,1221514,2022-06-30,House,"Reported With Recommendation Without Amendment",9,1,0,0,10
1535333,1221733,2022-07-01,House,"House Third Reading: Given Immediate Effect Roll Call # 368",94,12,0,0,106
1535436,1117259,2021-12-09,Senate,"Reported Favorably With Substitute S-1",5,0,0,0,5
1535436,1117260,2021-12-09,Senate,"Senate Third Reading: Passed Roll Call # 484",34,3,0,1,38
1535436,1119553,2021-12-14,House,"House Third Reading: Given Immediate Effect Roll Call # 630",72,30,0,0,102
1535436,1119663,2021-12-14,Senate,"Senate Third Reading: Roll Call: Roll Call # 503",33,3,0,2,38
1535476,1116983,2021-12-07,Senate,"Reported Favorably With Substitute S-1",7,0,0,0,7
1535476,1116984,2021-12-07,Senate,"Senate Third Reading: Given Immediate Effect Roll Call # 463",36,0,0,2,38
1535476,1117279,2021-12-09,House,"Reported With Recommendation Without Amendment",17,1,0,0,18
1535476,1119568,2021-12-14,House,"House Third Reading: Given Immediate Effect Roll Call # 607",88,14,0,0,102
1535563,1168066,2022-03-10,House,"Reported With Recommendation Without Amendment",20,7,0,0,27
1535563,1172019,2022-03-16,House,"House Third Reading: Given Immediate Effect Roll Call # 124",71,33,0,0,104
1535611,1146636,2022-02-15,House,"Reported With Recommendation Without Amendment",12,0,0,0,12
1535611,1160685,2022-03-02,House,"House Third Reading: Given Immediate Effect Roll Call # 87",103,1,0,0,104
1535611,1215373,2022-06-09,Senate,"Reported Favorably Without Amendment",5,0,0,0,5
1535611,1217155,2022-06-16,Senate,"Senate Third Reading: Given Immediate Effect Roll Call # 331",34,1,0,3,38
1536031,1146663,2022-02-15,House,"Reported With Recommendation Without Amendment",12,0,0,0,12
1536031,1159452,2022-03-02,House,"House Third Reading: Given Immediate Effect Roll Call # 88",103,1,0,0,104
1536031,1215360,2022-06-09,Senate,"Reported Favorably Without Amendment",5,0,0,0,5
1536031,1216682,2022-06-16,Senate,"Senate Third Reading: Given Immediate Effect Roll Call # 332",34,1,0,3,38
1536478,1117294,2021-12-09,Senate,"Senate Third Reading: Passed Roll Call # 482",27,10,0,1,38
1536488,1117005,2021-12-07,House,"Reported With Recommendation With Substitute H-1",9,0,0,0,9
1536488,1119620,2021-12-14,House,"House Third Reading: Given Immediate Effect Roll Call # 629",102,0,0,0,102
1536488,1170974,2022-03-15,Senate,"Reported Favorably With Substitute S-1",8,0,0,0,8
1536488,1190864,2022-04-20,Senate,"Senate Third Reading: Given Immediate Effect Roll Call # 128",37,0,0,1,38
1536488,1193712,2022-04-26,House,"House Third Reading: Roll Call # 168",102,0,0,0,102
1536491,1117092,2021-12-08,House,"Reported With Recommendation With Substitute H-1",4,1,0,0,5
1536491,1117204,2021-12-08,House,"House Third Reading: Given Immediate Effect Roll Call # 592",83,21,0,0,104
1536497,1117330,2021-12-09,Senate,"Senate Third Reading: Passed Roll Call # 481",27,10,0,1,38
1536497,1119653,2021-12-14,House,"House Third Reading: Given Immediate Effect Roll Call # 638",81,22,0,0,103
1536497,1119654,2021-12-14,Senate,"Senate Third Reading: Roll Call: Roll Call # 505",24,12,0,2,38
1536497,1119655,2021-12-14,Senate,"Senate Third Reading: Roll Call: Roll Call # 507",25,11,0,2,38
1536503,1214900,2022-06-08,House,"Reported With Recommendation With Substitute H-1",12,0,0,0,12
1536506,1144041,2022-01-27,Senate,"Reported Favorably With Substitute S-1",5,2,0,0,7
1536506,1145552,2022-02-15,Senate,"Senate Third Reading: Passed Roll Call # 29",22,16,0,0,38
1536506,1159286,2022-03-01,House,"House Third Reading: Given Immediate Effect Roll Call # 83",62,42,0,0,104
1536506,1175032,2022-03-03,Senate,"Senate Third Reading: Roll Call: Roll Call # 60",22,15,0,1,38
1536518,1117114,2021-12-08,House,"Reported With Recommendation With Substitute H-1",4,1,0,0,5
1536518,1117115,2021-12-08,House,"House Third Reading: Given Immediate Effect Roll Call # 594",83,21,0,0,104
1536524,1117313,2021-12-09,Senate,"Senate Third Reading: Passed Roll Call # 483",27,10,0,1,38
1536524,1119546,2021-12-14,House,"House Third Reading: Given Immediate Effect Roll Call # 639",81,22,0,0,103
1536524,1119547,2021-12-14,Senate,"Senate Third Reading: Roll Call: Roll Call # 506",25,11,0,2,38
1536526,1117110,2021-12-08,House,"Reported With Recommendation With Substitute H-1",4,1,0,0,5
1536526,1117111,2021-12-08,House,"House Third Reading: Given Immediate Effect Roll Call # 593",83,21,0,0,104
1536526,1119562,2021-12-14,Senate,"Senate Third Reading: Given Immediate Effect Roll Call # 502",25,11,0,2,38
1536526,1119563,2021-12-14,House,"House Third Reading: Roll Call # 640",81,22,0,0,103
1537193,1154900,2022-02-23,Senate,"Reported Favorably Without Amendment",5,0,0,0,5
1537218,1155358,2022-02-23,Senate,"Reported Favorably With Substitute S-1",5,0,0,0,5
1537420,1133872,2022-02-01,House,"Reported With Recommendation With Substitute H-1",8,0,0,0,8
1537420,1170994,2022-03-15,House,"House Third Reading: Adverse Roll Call",14,0,0,0,14
1537420,1170995,2022-03-15,House,"House Third Reading: Roll Call # 120",50,53,0,0,103
1537420,1223344,2022-03-15,House,"House Third Reading: Defeated Roll Call # 120",50,53,0,0,103
1537427,1196227,2022-04-28,House,"Reported With Recommendation With Substitute H-1",18,0,0,0,18
1537427,1219212,2022-05-19,House,"House Third Reading: Given Immediate Effect Roll Call # 250",101,4,0,0,105
1537427,1219213,2022-06-23,Senate,"Reported Favorably With Substitute S-1",6,1,0,0,7
1537427,1221673,2022-06-30,Senate,"Senate Third Reading: Given Immediate Effect Roll Call # 381",38,0,0,0,38
1537427,1221674,2022-06-30,House,"House Third Reading: Roll Call # 346",103,4,0,0,107
1537435,1117112,2021-12-08,House,"Reported With Recommendation Without Amendment",4,0,0,0,4
1537435,1119627,2021-12-14,House,"House Third Reading: Given Immediate Effect Roll Call # 636",95,8,0,0,103
1537468,1134236,2022-02-01,House,"Reported With Recommendation With Substitute H-1",8,0,0,0,8
1537468,1171066,2022-03-15,House,"House Third Reading: Adverse Roll Call",14,0,0,0,14
1537468,1171067,2022-03-15,House,"House Third Reading: Roll Call # 119",49,54,0,0,103
1537468,1222634,2022-03-15,House,"House Third Reading: Defeated Roll Call # 119",49,54,0,0,103
1537574,1162680,2022-03-03,Senate,"Reported Favorably With Substitute S-1",7,0,0,0,7
1537585,1162674,2022-03-03,Senate,"Reported Favorably With Substitute S-1",7,0,0,0,7
1537585,1220237,2022-05-19,Senate,"Senate Third Reading: Passed Roll Call # 271",21,15,0,2,38
1537585,1221378,2022-05-24,House,"House Third Reading: Given Immediate Effect Roll Call # 266",69,38,0,0,107
1537657,1205952,2022-05-18,House,"Reported With Recommendation With Substitute H-1",12,0,0,0,12
1537657,1219035,2022-05-26,House,"House Third Reading: Given Immediate Effect Roll Call # 277",93,12,0,0,105
1537657,1230472,2022-12-07,Senate,"Reported Favorably With Substitute S-1",6,0,0,0,6
1537665,1206019,2022-05-18,House,"Reported With Recommendation With Substitute H-1",12,0,0,0,12
1537665,1219039,2022-05-26,House,"House Third Reading: Given Immediate Effect Roll Call # 278",98,7,0,0,105
1537665,1230476,2022-12-07,Senate,"Reported Favorably With Substitute S-1",6,0,0,0,6
1537683,1134253,2022-02-01,House,"Reported With Recommendation Without Amendment",14,0,0,0,14
1537683,1148822,2022-02-17,House,"House Third Reading: Given Immediate Effect Roll Call # 64",99,2,0,0,101
1537753,1177020,2022-03-24,Senate,"Reported Favorably With Substitute S-3",3,1,0,0,4
1537753,1193594,2022-04-26,Senate,"Senate Third Reading: Passed Roll Call # 135",21,15,1,1,38
1537801,1219028,2022-05-24,House,"Reported With Recommendation Without Amendment",9,0,0,0,9
1537811,1215378,2022-06-09,House,"Reported With Recommendation Without Amendment",8,0,0,0,8
1537830,1171094,2022-03-15,House,"Reported With Recommendation Without Amendment",9,0,0,0,9
1537830,1187875,2022-04-12,House,"House Third Reading: Given Immediate Effect Roll Call # 156",104,0,0,0,104
1537839,1203927,2022-05-10,House,"Reported With Recommendation With Substitute H-1",15,0,0,0,15
1537839,1219135,2022-06-07,House,"House Third Reading: Given Immediate Effect Roll Call # 284",106,1,0,0,107
1537839,1226464,2022-09-21,Senate,"Reported Favorably Without Amendment",10,0,0,0,10
1537839,1228953,2022-09-28,Senate,"Senate Third Reading: Given Immediate Effect Roll Call # 454",34,0,1,3,38
1537839,1228954,2022-09-28,Senate,"Senate Third Reading: Given Immediate Effect Roll Call # 455",35,0,0,3,38
1538429,1210708,2022-05-26,House,"Reported With Recommendation Without Amendment",6,0,0,0,6
1538450,1168038,2022-03-10,Senate,"Reported Favorably Without Amendment",10,0,0,0,10
1538450,1172894,2022-03-17,Senate,"Senate Third Reading: Passed Roll Call # 96",32,6,0,0,38
1538462,1147238,2022-02-15,Senate,"Reported Favorably Without Amendment",10,0,0,0,10
1538462,1154964,2022-02-23,Senate,"Senate Third Reading: Passed Roll Call # 44",38,0,0,0,38
1538462,1187564,2022-04-12,House,"Reported With Recommendation With Substitute H-1",10,0,0,0,10
1538478,1142542,2022-02-10,House,"Reported With Recommendation Without Amendment",13,6,0,0,19
1538478,1153171,2022-02-23,House,"House Third Reading: Given Immediate Effect Roll Call # 71",56,48,0,0,104
1538492,1168016,2022-03-10,Senate,"Reported Favorably With Substitute S-2",10,0,0,0,10
1538492,1172865,2022-03-17,Senate,"Senate Third Reading: Passed Roll Call # 95",37,1,0,0,38
1541283,1187813,2022-04-12,House,"Reported With Recommendation Without Amendment",7,3,0,0,10
1541356,1138666,2022-02-08,House,"Reported With Recommendation With Substitute H-1",7,0,0,0,7
1541356,1159457,2022-03-01,House,"House Third Reading: Given Immediate Effect Roll Call # 82",104,0,0,0,104
1543812,1142561,2022-02-10,House,"Reported With Recommendation With Substitute H-1",7,1,0,0,8
1543812,1172731,2022-03-17,House,"House Third Reading: Given Immediate Effect Roll Call # 126",100,3,0,0,103
1543812,1219133,2022-05-25,Senate,"Reported Favorably Without Amendment",6,0,0,0,6
1543812,1219134,2022-06-15,Senate,"Senate Third Reading: Given Immediate Effect Roll Call # 324",37,0,0,1,38
1543830,1142560,2022-02-10,House,"Reported With Recommendation With Substitute H-1",7,1,0,0,8
1543830,1172840,2022-03-17,House,"House Third Reading: Given Immediate Effect Roll Call # 125",100,3,0,0,103
1543830,1219025,2022-05-25,Senate,"Reported Favorably Without Amendment",6,0,0,0,6
1543830,1219026,2022-06-15,Senate,"Senate Third Reading: Given Immediate Effect Roll Call # 323",37,0,0,1,38
1543842,1133867,2022-02-01,House,"Reported With Recommendation With Substitute H-1",9,2,0,0,11
1543842,1147340,2022-02-16,House,"House Third Reading: Given Immediate Effect Roll Call # 50",96,8,0,0,104
1543842,1176767,2022-03-24,Senate,"Reported Favorably Without Amendment",9,1,0,0,10
1543842,1229670,2022-09-20,Senate,"Senate Third Reading: Given Immediate Effect Roll Call # 412",33,3,0,2,38
1543852,1133841,2022-02-01,House,"Reported With Recommendation With Substitute H-2",9,2,0,0,11
1543852,1147156,2022-02-16,House,"House Third Reading: Given Immediate Effect Roll Call # 51",96,8,0,0,104
1543852,1176770,2022-03-24,Senate,"Reported Favorably Without Amendment",9,1,0,0,10
1543852,1229669,2022-09-20,Senate,"Senate Third Reading: Given Immediate Effect Roll Call # 413",32,4,0,2,38
1552266,1215628,2022-06-09,Senate,"Reported Favorably Without Amendment",5,0,0,0,5
1552490,1162306,2022-03-03,House,"Reported With Recommendation Without Amendment",6,2,0,0,8
1552490,1168062,2022-03-10,House,"House Third Reading: Given Immediate Effect Roll Call # 109",63,38,0,0,101
1552561,1210720,2022-05-26,Senate,"Reported Favorably With Substitute S-1",6,0,0,0,6
1552561,1220236,2022-06-23,Senate,"Senate Third Reading: Passed Roll Call # 344",38,0,0,0,38
1552632,1191408,2022-04-21,Senate,"Reported Favorably With Substitute S-1",7,0,0,0,7
1552632,1194912,2022-04-27,Senate,"Senate Third Reading: Passed Roll Call # 137",36,0,0,2,38
1552782,1229213,2022-09-28,House,"Reported With Recommendation With Substitute H-1",12,0,0,0,12
1552929,1166103,2022-03-08,Senate,"Reported Favorably With Substitute S-1",9,0,0,0,9
1552929,1169924,2022-03-10,Senate,"Senate Third Reading: Passed Roll Call # 76",38,0,0,0,38
1552929,1230001,2022-11-10,House,"Reported With Recommendation Without Amendment",19,0,0,0,19
1553078,1221685,2022-06-30,Senate,"Reported Favorably Without Amendment",17,0,0,0,17
1553078,1221686,2022-06-30,Senate,"Senate Third Reading: Passed Roll Call # 395",24,14,0,0,38
1553448,1221601,2022-06-30,Senate,"Reported Favorably With Substitute S-3",17,0,0,0,17
1553448,1221696,2022-06-30,Senate,"Senate Third Reading: Passed Roll Call # 384",32,6,0,0,38
1553522,1210118,2022-05-26,Senate,"Reported Favorably With Substitute S-1",6,0,0,0,6
1553522,1220560,2022-06-23,Senate,"Senate Third Reading: Passed Roll Call # 343",38,0,0,0,38
1560930,1208994,2022-05-18,House,"Reported With Recommendation With Substitute H-1",9,0,0,0,9
1561280,1167492,2022-03-09,House,"Reported With Recommendation With Substitute H-3",10,0,0,0,10
1561280,1175849,2022-03-23,House,"House Third Reading: Given Immediate Effect Roll Call # 138",61,44,0,0,105
1561280,1226369,2022-09-21,Senate,"Reported Favorably Without Amendment",5,0,0,0,5
1561355,1214801,2022-06-07,House,"Reported With Recommendation Without Amendment",12,0,0,0,12
1561355,1216476,2022-06-15,House,"House Third Reading: Given Immediate Effect Roll Call # 313",105,0,0,0,105
1561383,1160009,2022-03-01,House,"Reported With Recommendation With Substitute H-1",9,0,0,0,9
1561383,1171102,2022-03-15,House,"House Third Reading: Given Immediate Effect Roll Call # 121",101,2,0,0,103
1561383,1204175,2022-05-12,Senate,"Reported Favorably Without Amendment",8,0,0,0,8
1561383,1219080,2022-06-23,Senate,"Senate Third Reading: Given Immediate Effect Roll Call # 349",38,0,0,0,38
1561532,1214625,2022-06-07,House,"Reported With Recommendation Without Amendment",12,0,0,0,12
1561532,1216541,2022-06-15,House,"House Third Reading: Given Immediate Effect Roll Call # 312",105,0,0,0,105
1561580,1214887,2022-06-07,House,"Reported With Recommendation With Substitute H-1",11,1,0,0,12
1561580,1219219,2022-06-15,House,"House Third Reading: Given Immediate Effect Roll Call # 311",92,13,0,0,105
1561605,1140470,2022-02-09,House,"Reported With Recommendation Without Amendment",13,0,0,0,13
1561605,1148534,2022-02-16,House,"House Third Reading: Given Immediate Effect Roll Call # 55",102,3,0,0,105
1563030,1133944,2022-02-01,Senate,"Reported Favorably Without Amendment",5,0,0,0,5
1563030,1147553,2022-02-10,Senate,"Senate Third Reading: Passed Roll Call # 25",34,4,0,0,38
1563030,1176313,2022-03-23,House,"Reported With Recommendation Without Amendment",12,0,0,0,12
1563030,1209053,2022-05-25,House,"House Third Reading: Given Immediate Effect Roll Call # 267",93,14,0,0,107
1563030,1209054,2022-05-25,House,"House Third Reading: Passed Roll Call # 268",93,14,0,0,107
1564605,1221725,2022-05-11,Senate,"Senate Third Reading: Passed Roll Call # 223",21,12,0,5,38
1564605,1221726,2022-05-18,House,"House Third Reading: Given Immediate Effect Roll Call # 232",58,48,0,0,106
1564605,1221727,2022-05-19,Senate,"Senate Third Reading: Defeated Roll Call # 266",0,36,0,2,38
1564629,1196387,2022-04-28,Senate,"Reported Favorably With Substitute S-2",12,6,0,0,18
1564629,1199665,2022-05-03,Senate,"Senate Third Reading: Passed Roll Call # 159",24,11,0,3,38
1564629,1220288,2022-05-18,House,"House Third Reading: Given Immediate Effect Roll Call # 225",58,48,0,0,106
1564629,1220289,2022-05-19,Senate,"Senate Third Reading: Defeated Roll Call # 259",0,36,0,2,38
1564654,1195014,2022-04-27,Senate,"Reported Favorably With Substitute S-2",12,6,0,0,18
1564654,1199496,2022-05-03,Senate,"Senate Third Reading: Passed Roll Call # 141",22,13,0,3,38
1564654,1220240,2022-05-18,House,"House Third Reading: Given Immediate Effect Roll Call # 224",58,48,0,0,106
1564654,1220241,2022-05-19,Senate,"Senate Third Reading: Defeated Roll Call # 258",0,36,0,2,38
1564680,1196373,2022-04-28,Senate,"Reported Favorably With Substitute S-2",11,7,0,0,18
1564680,1199760,2022-05-03,Senate,"Senate Third Reading: Passed Roll Call # 176",22,13,0,3,38
1564680,1221634,2022-05-18,House,"House Third Reading: Given Immediate Effect Roll Call # 228",58,48,0,0,106
1564680,1221635,2022-05-19,Senate,"Senate Third Reading: Defeated Roll Call # 262",0,36,0,2,38
1564706,1196351,2022-04-28,Senate,"Reported Favorably With Substitute S-2",11,7,0,0,18
1564706,1199732,2022-05-03,Senate,"Senate Third Reading: Passed Roll Call # 172",22,13,0,3,38
1564706,1220272,2022-05-18,House,"House Third Reading: Given Immediate Effect Roll Call # 227",58,48,0,0,106
1564706,1220273,2022-05-19,Senate,"Senate Third Reading: Defeated Roll Call # 261",0,36,0,2,38
1564730,1194857,2022-04-27,Senate,"Reported Favorably With Substitute S-1",12,6,0,0,18
1564730,1199468,2022-05-03,Senate,"Senate Third Reading: Passed Roll Call # 146",20,15,0,3,38
1564730,1220313,2022-05-18,House,"House Third Reading: Given Immediate Effect Roll Call # 216",58,48,0,0,106
1564730,1220314,2022-05-19,Senate,"Senate Third Reading: Defeated Roll Call # 251",0,34,0,4,38
1564756,1194861,2022-04-27,Senate,"Reported Favorably With Substitute S-2",11,7,0,0,18
1564756,1199542,2022-05-03,Senate,"Senate Third Reading: Passed Roll Call # 151",21,14,0,3,38
1564756,1220274,2022-05-18,House,"House Third Reading: Given Immediate Effect Roll Call # 222",58,48,0,0,106
1564756,1220275,2022-05-19,Senate,"Senate Third Reading: Defeated Roll Call # 256",0,36,0,2,38
1564783,1195193,2022-04-27,Senate,"Reported Favorably With Substitute S-1",12,6,0,0,18
1564783,1199544,2022-05-03,Senate,"Senate Third Reading: Passed Roll Call # 143",22,13,0,3,38
1564783,1220255,2022-05-18,House,"House Third Reading: Given Immediate Effect Roll Call # 223",58,48,0,0,106
1564783,1220256,2022-05-19,Senate,"Senate Third Reading: Defeated Roll Call # 257",0,36,0,2,38
1564811,1196148,2022-04-28,Senate,"Reported Favorably With Substitute S-4",12,6,0,0,18
1564811,1200288,2022-05-04,Senate,"Senate Third Reading: Passed Roll Call # 199",22,12,1,3,38
1564811,1200289,2022-05-04,Senate,"Senate Third Reading: Passed Roll Call # 199",22,12,1,3,38
1564811,1220536,2022-05-18,House,"House Third Reading: Given Immediate Effect Roll Call # 220",56,50,0,0,106
1564811,1220537,2022-05-19,Senate,"Senate Third Reading: Defeated Roll Call # 250",0,34,0,4,38
1564835,1196370,2022-04-28,Senate,"Reported Favorably With Substitute S-1",12,6,0,0,18
1564835,1199761,2022-05-03,Senate,"Senate Third Reading: Passed Roll Call # 155",35,0,0,3,38
1564835,1221624,2022-05-18,House,"House Third Reading: Given Immediate Effect Roll Call # 226",58,48,0,0,106
1564835,1221625,2022-05-19,Senate,"Senate Third Reading: Defeated Roll Call # 260",0,36,0,2,38
1564862,1221608,2022-05-11,Senate,"Senate Third Reading: Passed Roll Call # 224",21,12,0,5,38
1564862,1221609,2022-05-18,House,"House Third Reading: Given Immediate Effect Roll Call # 233",58,48,0,0,106
1564862,1221610,2022-07-01,Senate,"Senate Third Reading: Senate Adopted Conference Report With Immediate Effect Roll Call # 400",35,2,0,1,38
1564862,1221707,2022-07-01,House,"House Third Reading: Conference Report Adopted Roll Call # 370",99,7,0,0,106
1564862,1221960,2022-05-19,Senate,"Senate Third Reading: Defeated Roll Call # 267",0,36,0,2,38
1564889,1196260,2022-04-28,Senate,"Reported Favorably With Substitute S-2",12,6,0,0,18
1564889,1199521,2022-05-03,Senate,"Senate Third Reading: Passed Roll Call # 170",22,13,0,3,38
1564889,1220558,2022-05-18,House,"House Third Reading: Given Immediate Effect Roll Call # 218",58,48,0,0,106
1564889,1220559,2022-05-19,Senate,"Senate Third Reading: Defeated Roll Call # 253",0,34,0,4,38
1564916,1195055,2022-04-27,Senate,"Reported Favorably With Substitute S-3",12,6,0,0,18
1564916,1200187,2022-05-04,Senate,"Senate Third Reading: Passed Roll Call # 188",21,14,0,3,38
1564916,1220278,2022-05-18,House,"House Third Reading: Given Immediate Effect Roll Call # 221",58,48,0,0,106
1564916,1220279,2022-05-19,Senate,"Senate Third Reading: Defeated Roll Call # 255",0,35,0,3,38
1564941,1196386,2022-04-28,Senate,"Reported Favorably With Substitute S-1",12,6,0,0,18
1564941,1199495,2022-05-03,Senate,"Senate Third Reading: Passed Roll Call # 163",22,13,0,3,38
1564941,1220246,2022-05-18,House,"House Third Reading: Given Immediate Effect Roll Call # 215",58,48,0,0,106
1564941,1220247,2022-05-19,Senate,"Senate Third Reading: Defeated Roll Call # 249",0,34,1,3,38
1564965,1196347,2022-04-28,Senate,"Reported Favorably With Substitute S-1",12,6,0,0,18
1564965,1199463,2022-05-03,Senate,"Senate Third Reading: Passed Roll Call # 160",35,0,0,3,38
1564965,1221637,2022-05-18,House,"House Third Reading: Given Immediate Effect Roll Call # 229",58,48,0,0,106
1564965,1221638,2022-05-19,Senate,"Senate Third Reading: Defeated Roll Call # 263",0,36,0,2,38
1564992,1196261,2022-04-28,Senate,"Reported Favorably With Substitute S-2",17,1,0,0,18
1564992,1199541,2022-05-03,Senate,"Senate Third Reading: Passed Roll Call # 154",33,2,0,3,38
1564992,1221717,2022-05-18,House,"House Third Reading: Given Immediate Effect Roll Call # 231",59,47,0,0,106
1564992,1221718,2022-05-19,Senate,"Senate Third Reading: Defeated Roll Call # 265",0,36,0,2,38
1565017,1196381,2022-04-28,Senate,"Reported Favorably With Substitute S-1",12,6,0,0,18
1565017,1199469,2022-05-03,Senate,"Senate Third Reading: Passed Roll Call # 144",22,13,0,3,38
1565017,1220281,2022-05-18,House,"House Third Reading: Given Immediate Effect Roll Call # 217",58,48,0,0,106
1565017,1220282,2022-05-19,Senate,"Senate Third Reading: Defeated Roll Call # 252",0,34,0,4,38
1565043,1196243,2022-04-28,Senate,"Reported Favorably With Substitute S-2",14,3,0,0,17
1565043,1199517,2022-05-03,Senate,"Senate Third Reading: Passed Roll Call # 153",31,4,0,3,38
1565043,1221715,2022-05-18,House,"House Third Reading: Given Immediate Effect Roll Call # 230",59,47,0,0,106
1565043,1221716,2022-05-19,Senate,"Senate Third Reading: Defeated Roll Call # 264",0,36,0,2,38
1565067,1196380,2022-04-28,Senate,"Reported Favorably With Substitute S-2",10,8,0,0,18
1565067,1200232,2022-05-04,Senate,"Senate Third Reading: Passed Roll Call # 187",20,15,0,3,38
1565067,1220243,2022-05-18,House,"House Third Reading: Given Immediate Effect Roll Call # 219",58,48,0,0,106
1565067,1220244,2022-05-19,Senate,"Senate Third Reading: Defeated Roll Call # 254",0,35,0,3,38
1572060,1166099,2022-03-08,House,"Reported With Recommendation With Substitute H-2",5,0,0,0,5
1572060,1171882,2022-03-16,House,"House Third Reading: Given Immediate Effect Roll Call # 123",88,16,0,0,104
1572192,1139306,2022-02-08,House,"Reported With Recommendation With Substitute H-1",8,3,0,0,11
1572192,1153786,2022-02-23,House,"House Third Reading: Given Immediate Effect Roll Call # 70",54,50,0,0,104
1572192,1205922,2022-05-18,Senate,"Reported Favorably With Substitute S-1",5,2,0,0,7
1572192,1219215,2022-06-15,Senate,"Senate Third Reading: Passed Roll Call # 328",21,16,0,1,38
1572192,1219216,2022-06-21,House,"House Third Reading: Roll Call # 325",56,49,0,0,105
1572976,1166129,2022-03-08,House,"Reported With Recommendation With Substitute H-1",8,4,0,0,12
1573402,1171113,2022-03-15,House,"Reported With Recommendation Without Amendment",14,0,0,0,14
1573402,1176814,2022-03-24,House,"House Third Reading: Given Immediate Effect Roll Call # 150",83,19,0,0,102
1573402,1210664,2022-05-26,Senate,"Reported Favorably Without Amendment",8,0,0,0,8
1573402,1217240,2022-06-16,Senate,"Senate Third Reading: Given Immediate Effect Roll Call # 336",34,1,0,3,38
1573402,1221669,2022-06-30,House,"House Third Reading: Roll Call # 343",91,16,0,0,107
1573439,1171095,2022-03-15,House,"Reported With Recommendation Without Amendment",14,0,0,0,14
1573439,1176900,2022-03-24,House,"House Third Reading: Given Immediate Effect Roll Call # 151",86,17,0,0,103
1573439,1209902,2022-05-26,Senate,"Reported Favorably Without Amendment",8,0,0,0,8
1573439,1216956,2022-06-16,Senate,"Senate Third Reading: Given Immediate Effect Roll Call # 337",34,1,0,3,38
1575216,1151633,2022-02-22,House,"Reported With Recommendation Without Amendment",14,0,0,0,14
1575216,1161013,2022-03-02,House,"House Third Reading: Given Immediate Effect Roll Call # 90",104,0,0,0,104
1575216,1167261,2022-03-09,Senate,"Reported Favorably Without Amendment",7,0,0,0,7
1575216,1172804,2022-03-17,Senate,"Senate Third Reading: Given Immediate Effect Roll Call # 93",38,0,0,0,38
1578259,1155446,2022-02-24,Senate,"Reported Favorably With Substitute S-1",7,0,0,0,7
1578259,1167319,2022-03-09,Senate,"Senate Third Reading: Passed Roll Call # 67",38,0,0,0,38
1578259,1176296,2022-03-23,House,"Reported With Recommendation Without Amendment",15,0,0,0,15
1578361,1174956,2022-03-22,Senate,"Reported Favorably Without Amendment",10,0,0,0,10
1578565,1154901,2022-02-24,Senate,"Reported Favorably With Substitute S-1",7,0,0,0,7
1578565,1167171,2022-03-09,Senate,"Senate Third Reading: Passed Roll Call # 66",38,0,0,0,38
1578565,1176282,2022-03-23,House,"Reported With Recommendation Without Amendment",15,0,0,0,15
1578762,1145945,2022-02-15,House,"Reported With Recommendation Without Amendment",10,2,0,0,12
1578762,1168220,2022-03-10,House,"House Third Reading: Given Immediate Effect Roll Call # 106",85,16,0,0,101
1578762,1228688,2022-09-28,Senate,"Senate Third Reading: Passed Roll Call # 470",28,5,0,5,38
1578953,1216032,2022-06-14,House,"Reported With Recommendation With Substitute H-4",14,0,0,0,14
1579001,1167576,2022-03-09,House,"Reported With Recommendation With Substitute H-2",10,0,0,0,10
1579001,1176346,2022-03-23,House,"House Third Reading: Given Immediate Effect Roll Call # 139",61,44,0,0,105
1579001,1226373,2022-09-21,Senate,"Reported Favorably Without Amendment",5,0,0,0,5
1579975,1221516,2022-06-30,House,"House Third Reading: Given Immediate Effect Roll Call # 354",106,0,0,0,106
1579975,1221954,2022-05-24,House,"Reported With Recommendation Without Amendment",13,0,0,0,13
1580044,1200785,2022-05-05,House,"Reported With Recommendation Without Amendment",8,0,0,0,8
1580044,1216550,2022-06-15,House,"House Third Reading: Given Immediate Effect Roll Call # 303",57,48,0,0,105
1580121,1221512,2022-06-30,House,"House Third Reading: Given Immediate Effect Roll Call # 353",106,0,0,0,106
1580121,1221953,2022-05-24,House,"Reported With Recommendation Without Amendment",13,0,0,0,13
1580158,1221679,2022-06-30,House,"House Third Reading: Given Immediate Effect Roll Call # 352",106,0,0,0,106
1580158,1221952,2022-05-24,House,"Reported With Recommendation With Substitute H-1",13,0,0,0,13
1580158,1230477,2022-12-07,Senate,"Reported Favorably Without Amendment",9,0,0,0,9
1580198,1221636,2022-06-30,House,"House Third Reading: Given Immediate Effect Roll Call # 355",67,39,0,0,106
1580198,1221955,2022-05-24,House,"Reported With Recommendation With Substitute H-3",8,1,0,0,9
1580242,1221623,2022-06-30,House,"House Third Reading: Given Immediate Effect Roll Call # 356",73,33,0,0,106
1580242,1221956,2022-05-24,House,"Reported With Recommendation With Substitute H-1",9,0,0,0,9
1580242,1230470,2022-12-07,Senate,"Reported Favorably With Substitute S-1",8,0,0,0,8
1580281,1151211,2022-02-22,House,"Reported With Recommendation Without Amendment",12,0,0,0,12
1580281,1160657,2022-03-02,House,"House Third Reading: Given Immediate Effect Roll Call # 86",104,0,0,0,104
1580281,1216681,2022-06-16,Senate,"Reported Favorably Without Amendment",8,0,0,0,8
1580281,1221667,2022-06-30,Senate,"Senate Third Reading: Given Immediate Effect Roll Call # 375",38,0,0,0,38
1580356,1200731,2022-05-05,House,"Reported With Recommendation Without Amendment",8,0,0,0,8
1580397,1151293,2022-02-22,House,"Reported With Recommendation Without Amendment",12,0,0,0,12
1580397,1166226,2022-03-08,House,"House Third Reading: Given Immediate Effect Roll Call # 99",100,1,0,0,101
1580397,1217650,2022-06-16,Senate,"Reported Favorably Without Amendment",8,0,0,0,8
1580397,1221612,2022-06-30,Senate,"Senate Third Reading: Given Immediate Effect Roll Call # 377",38,0,0,0,38
1586303,1151245,2022-02-22,House,"Reported With Recommendation Without Amendment",7,0,0,0,7
1586676,1171029,2022-03-15,House,"Reported With Recommendation Without Amendment",14,0,0,0,14
1586676,1176935,2022-03-24,House,"House Third Reading: Given Immediate Effect Roll Call # 152",84,19,0,0,103
1586676,1210217,2022-05-26,Senate,"Reported Favorably Without Amendment",8,0,0,0,8
1586676,1216831,2022-06-16,Senate,"Senate Third Reading: Given Immediate Effect Roll Call # 338",34,1,0,3,38
1587245,1215114,2022-06-08,Senate,"Reported Favorably With Substitute S-1",8,0,0,0,8
1587245,1221639,2022-06-23,Senate,"Senate Third Reading: Passed Roll Call # 350",38,0,0,0,38
1587245,1229298,2022-09-28,House,"Reported With Recommendation With Substitute H-3",12,0,0,0,12
1587355,1162635,2022-03-03,Senate,"Reported Favorably Without Amendment",9,0,0,0,9
1587355,1170060,2022-03-10,Senate,"Senate Third Reading: Passed Roll Call # 78",35,3,0,0,38
1587355,1175175,2022-03-22,House,"Reported With Recommendation Without Amendment",9,2,0,0,11
1587355,1194885,2022-04-27,House,"House Third Reading: Given Immediate Effect Roll Call # 169",76,27,0,0,103
1587385,1172182,2022-03-17,House,"Reported With Recommendation Without Amendment",4,0,0,0,4
1587385,1188375,2022-04-13,House,"House Third Reading: Given Immediate Effect Roll Call # 158",91,11,0,0,102
1587385,1215369,2022-06-09,Senate,"Reported Favorably With Substitute S-1",17,1,0,0,18
1587385,1229663,2022-09-20,Senate,"Senate Third Reading: Given Immediate Effect Roll Call # 410",34,2,0,2,38
1587726,1175277,2022-03-22,House,"Reported With Recommendation With Substitute H-1",10,1,0,0,11
1587726,1219151,2022-05-25,House,"House Third Reading: Given Immediate Effect Roll Call # 274",98,9,0,0,107
1590887,1171991,2022-03-16,House,"Reported With Recommendation Without Amendment",10,1,0,0,11
1590887,1176214,2022-03-23,House,"House Third Reading: Given Immediate Effect Roll Call # 144",105,0,0,0,105
1590887,1208545,2022-05-24,Senate,"Reported Favorably Without Amendment",5,0,0,0,5
1590889,1167991,2022-03-10,Senate,"Reported Favorably Without Amendment",8,0,0,0,8
1590889,1174961,2022-03-22,Senate,"Senate Third Reading: Passed Roll Call # 97",28,10,0,0,38
1590925,1221957,2022-05-24,House,"Reported With Recommendation With Substitute H-2",11,2,0,0,13
1590937,1172041,2022-03-16,House,"Reported With Recommendation Without Amendment",10,1,0,0,11
1590937,1176198,2022-03-23,House,"House Third Reading: Given Immediate Effect Roll Call # 145",104,0,0,0,104
1590937,1208749,2022-05-24,Senate,"Reported Favorably Without Amendment",5,0,0,0,5
1590937,1220400,2022-06-15,Senate,"Senate Third Reading: Given Immediate Effect Roll Call # 309",37,0,0,1,38
1590976,1220224,2022-06-07,House,"Reported With Recommendation With Substitute H-1",12,0,0,0,12
1590996,1172039,2022-03-16,House,"Reported With Recommendation Without Amendment",10,1,0,0,11
1590996,1176192,2022-03-23,House,"House Third Reading: Given Immediate Effect Roll Call # 143",105,0,0,0,105
1590996,1208730,2022-05-24,Senate,"Reported Favorably Without Amendment",5,0,0,0,5
1590996,1220261,2022-06-15,Senate,"Senate Third Reading: Given Immediate Effect Roll Call # 308",37,0,0,1,38
1591007,1172059,2022-03-16,House,"Reported With Recommendation Without Amendment",10,1,0,0,11
1591007,1176217,2022-03-23,House,"House Third Reading: Given Immediate Effect Roll Call # 146",104,0,0,0,104
1591007,1208768,2022-05-24,Senate,"Reported Favorably Without Amendment",5,0,0,0,5
1591007,1220394,2022-06-15,Senate,"Senate Third Reading: Given Immediate Effect Roll Call # 310",37,0,0,1,38
1591029,1172027,2022-03-16,House,"Reported With Recommendation Without Amendment",10,1,0,0,11
1591029,1175855,2022-03-23,House,"House Third Reading: Given Immediate Effect Roll Call # 140",105,0,0,0,105
1591029,1208731,2022-05-24,Senate,"Reported Favorably Without Amendment",5,0,0,0,5
1591029,1219071,2022-06-15,Senate,"Senate Third Reading: Given Immediate Effect Roll Call # 305",37,0,0,1,38
1591066,1172018,2022-03-16,House,"Reported With Recommendation Without Amendment",10,1,0,0,11
1591066,1175755,2022-03-23,House,"House Third Reading: Given Immediate Effect Roll Call # 142",105,0,0,0,105
1591066,1208729,2022-05-24,Senate,"Reported Favorably Without Amendment",5,0,0,0,5
1591066,1219072,2022-06-15,Senate,"Senate Third Reading: Given Immediate Effect Roll Call # 307",37,0,0,1,38
1591079,1172050,2022-03-16,House,"Reported With Recommendation Without Amendment",10,1,0,0,11
1591079,1175859,2022-03-23,House,"House Third Reading: Given Immediate Effect Roll Call # 141",105,0,0,0,105
1591079,1208734,2022-05-24,Senate,"Reported Favorably Without Amendment",5,0,0,0,5
1591079,1219097,2022-06-15,Senate,"Senate Third Reading: Given Immediate Effect Roll Call # 306",37,0,0,1,38
1591116,1193689,2022-04-26,House,"Reported With Recommendation With Substitute H-1",10,1,0,0,11
1591116,1203705,2022-05-10,House,"House Third Reading: Given Immediate Effect Roll Call # 207",96,8,0,0,104
1591116,1216523,2022-06-15,Senate,"Reported Favorably Without Amendment",7,0,0,0,7
1591116,1221517,2022-06-30,Senate,"Senate Third Reading: Given Immediate Effect Roll Call # 372",37,1,0,0,38
1593005,1177025,2022-03-24,Senate,"Reported Favorably With Substitute S-1",3,1,0,0,4
1593005,1200198,2022-05-04,Senate,"Senate Third Reading: Passed Roll Call # 200",22,12,1,3,38
1593074,1210725,2022-05-26,Senate,"Reported Favorably With Substitute S-2",6,0,0,0,6
1593074,1221657,2022-06-23,Senate,"Senate Third Reading: Passed Roll Call # 345",38,0,0,0,38
1593131,1161022,2022-03-02,House,"Reported With Recommendation Without Amendment",16,0,0,0,16
1593287,1168076,2022-03-10,House,"Reported With Recommendation Without Amendment",27,0,0,0,27
1593287,1187547,2022-04-12,House,"House Third Reading: Given Immediate Effect Roll Call # 155",101,3,0,0,104
1593287,1226384,2022-09-21,Senate,"Reported Favorably Without Amendment",16,0,0,0,16
1593287,1228713,2022-09-28,Senate,"Senate Third Reading: Given Immediate Effect Roll Call # 441",36,0,0,2,38
1595564,1172512,2022-03-17,House,"Reported With Recommendation Without Amendment",3,0,0,0,3
1595564,1188170,2022-04-13,House,"House Third Reading: Given Immediate Effect Roll Call # 160",75,27,0,0,102
1595564,1215362,2022-06-09,Senate,"Reported Favorably Without Amendment",16,2,0,0,18
1595595,1172495,2022-03-17,House,"Reported With Recommendation Without Amendment",3,0,0,0,3
1595595,1188321,2022-04-13,House,"House Third Reading: Given Immediate Effect Roll Call # 159",75,27,0,0,102
1595595,1215368,2022-06-09,Senate,"Reported Favorably Without Amendment",17,1,0,0,18
1595595,1229586,2022-09-20,Senate,"Senate Third Reading: Given Immediate Effect Roll Call # 411",34,2,0,2,38
1595652,1174994,2022-03-22,House,"Reported With Recommendation With Substitute H-1",8,1,0,0,9
1595652,1188256,2022-04-13,House,"House Third Reading: Given Immediate Effect Roll Call # 161",92,10,0,0,102
1596081,1196393,2022-04-28,House,"Reported With Recommendation With Substitute H-2",18,4,0,0,22
1596081,1200714,2022-05-05,House,"House Third Reading: Given Immediate Effect Roll Call # 198",62,41,0,0,103
1596081,1219033,2022-05-19,House,"House Third Reading: Roll Call # 236",0,106,0,0,106
1596081,1221958,2022-05-11,Senate,"Senate Third Reading: Passed Roll Call # 216",21,12,0,5,38
1596095,1219327,2022-06-14,House,"House Third Reading: Given Immediate Effect Roll Call # 300",104,0,0,0,104
1596119,1196390,2022-04-28,House,"Reported With Recommendation With Substitute H-3",22,1,0,0,23
1596119,1217698,2022-05-05,House,"House Third Reading: Given Immediate Effect Roll Call # 202",75,28,0,0,103
1596119,1219308,2022-05-11,Senate,"Senate Third Reading: Passed Roll Call # 219",21,12,0,5,38
1596119,1219309,2022-05-19,House,"House Third Reading: Roll Call # 240",1,105,0,0,106
1596155,1196252,2022-04-28,House,"Reported With Recommendation With Substitute H-2",17,7,0,0,24
1596155,1200316,2022-05-04,House,"House Third Reading: Given Immediate Effect Roll Call # 192",78,25,0,0,103
1596155,1219284,2022-05-11,Senate,"Senate Third Reading: Passed Roll Call # 213",21,12,0,5,38
1596155,1219285,2022-05-19,House,"House Third Reading: Roll Call # 245",0,106,0,0,106
1596160,1196377,2022-04-28,House,"Reported With Recommendation With Substitute H-1",17,10,0,0,27
1596160,1200323,2022-05-04,House,"House Third Reading: Given Immediate Effect Roll Call # 191",55,48,0,0,103
1596160,1219300,2022-05-11,Senate,"Senate Third Reading: Passed Roll Call # 212",21,12,0,5,38
1596160,1219301,2022-05-19,House,"House Third Reading: Roll Call # 244",1,105,0,0,106
1596184,1154890,2022-02-24,House,"Reported With Recommendation Without Amendment",9,0,0,0,9
1596190,1196409,2022-04-28,House,"Reported With Recommendation With Substitute H-1",19,5,0,0,24
1596190,1200306,2022-05-04,House,"House Third Reading: Given Immediate Effect Roll Call # 194",55,48,0,0,103
1596190,1219273,2022-05-11,Senate,"Senate Third Reading: Passed Roll Call # 214",22,11,0,5,38
1596198,1196383,2022-04-28,House,"Reported With Recommendation With Substitute H-1",17,9,0,0,26
1596198,1200314,2022-05-04,House,"House Third Reading: Given Immediate Effect Roll Call # 186",57,46,0,0,103
1596198,1219022,2022-05-11,Senate,"Senate Third Reading: Passed Roll Call # 207",21,12,0,5,38
1596198,1219279,2022-05-19,House,"House Third Reading: Roll Call # 237",0,106,0,0,106
1596215,1168087,2022-03-10,House,"Reported With Recommendation With Substitute H-1",7,2,0,0,9
1596215,1172100,2022-03-17,House,"House Third Reading: Given Immediate Effect Roll Call # 128",71,31,0,0,102
1596222,1196391,2022-04-28,House,"Reported With Recommendation With Substitute H-2",25,0,0,0,25
1596222,1200324,2022-05-04,House,"House Third Reading: Given Immediate Effect Roll Call # 190",68,35,0,0,103
1596222,1219291,2022-05-11,Senate,"Senate Third Reading: Passed Roll Call # 211",21,12,0,5,38
1596222,1219292,2022-05-19,House,"House Third Reading: Roll Call # 243",0,106,0,0,106
1596227,1196257,2022-04-28,House,"Reported With Recommendation With Substitute H-2",24,0,0,0,24
1596227,1217689,2022-05-05,House,"House Third Reading: Given Immediate Effect Roll Call # 200",76,27,0,0,103
1596227,1219306,2022-05-11,Senate,"Senate Third Reading: Passed Roll Call # 221",21,12,0,5,38
1596227,1219307,2022-05-19,House,"House Third Reading: Roll Call # 246",0,106,0,0,106
1596271,1196255,2022-04-28,House,"Reported With Recommendation With Substitute H-1",17,10,0,0,27
1596271,1200278,2022-05-04,House,"House Third Reading: Given Immediate Effect Roll Call # 189",56,47,0,0,103
1596271,1219289,2022-05-11,Senate,"Senate Third Reading: Passed Roll Call # 210",21,12,0,5,38
1596271,1219290,2022-05-19,House,"House Third Reading: Roll Call # 241",0,106,0,0,106
1596302,1196392,2022-04-28,House,"Reported With Recommendation With Substitute H-3",25,1,0,0,26
1596302,1217665,2022-05-05,House,"House Third Reading: Given Immediate Effect Roll Call # 201",76,27,0,0,103
1596302,1219061,2022-05-11,Senate,"Senate Third Reading: Passed Roll Call # 215",21,12,0,5,38
1596302,1219062,2022-05-19,House,"House Third Reading: Roll Call # 235",0,106,0,0,106
1596322,1196210,2022-04-28,House,"Reported With Recommendation With Substitute H-1",18,4,0,0,22
1596322,1200188,2022-05-04,House,"House Third Reading: Given Immediate Effect Roll Call # 188",59,44,0,0,103
1596322,1219304,2022-05-11,Senate,"Senate Third Reading: Passed Roll Call # 209",21,12,0,5,38
1596322,1219305,2022-05-19,House,"House Third Reading: Roll Call # 247",0,106,0,0,106
1596349,1196336,2022-04-28,House,"Reported With Recommendation With Substitute H-3",17,9,0,0,26
1596349,1217679,2022-05-05,House,"House Third Reading: Given Immediate Effect Roll Call # 197",54,49,0,0,103
1596349,1219287,2022-05-11,Senate,"Senate Third Reading: Passed Roll Call # 217",21,12,0,5,38
1596349,1219288,2022-05-19,House,"House Third Reading: Roll Call # 238",0,106,0,0,106
1596362,1172105,2022-03-17,House,"House Third Reading: Given Immediate Effect Roll Call # 130",103,0,0,0,103
1596362,1230514,2022-12-06,Senate,"Reported Favorably With Substitute S-2",15,3,0,0,18
1596384,1196279,2022-04-28,House,"Reported With Recommendation With Substitute H-1",17,10,0,0,27
1596384,1200346,2022-05-04,House,"House Third Reading: Given Immediate Effect Roll Call # 187",64,39,0,0,103
1596384,1220361,2022-05-11,Senate,"Senate Third Reading: Passed Roll Call # 208",21,12,0,5,38
1596384,1220362,2022-05-19,House,"House Third Reading: Roll Call # 234",0,106,0,0,106
1596389,1219293,2022-05-11,House,"Reported With Recommendation With Substitute H-1",8,0,0,0,8
1596389,1219294,2022-05-24,House,"House Third Reading: Given Immediate Effect Roll Call # 254",79,28,0,0,107
1596389,1221672,2022-06-30,Senate,"Reported Favorably With Substitute S-1",7,3,0,0,10
1596389,1229659,2022-09-20,Senate,"Senate Third Reading: Given Immediate Effect Roll Call # 415",29,7,0,2,38
1596413,1196404,2022-04-28,House,"Reported With Recommendation With Substitute H-2",24,2,0,0,26
1596413,1217635,2022-05-05,House,"House Third Reading: Given Immediate Effect Roll Call # 204",68,35,0,0,103
1596413,1219282,2022-05-11,Senate,"Senate Third Reading: Passed Roll Call # 218",21,12,0,5,38
1596413,1219283,2022-05-19,House,"House Third Reading: Roll Call # 239",0,106,0,0,106
1596413,1221729,2022-07-01,House,"House Third Reading: Conference Report Adopted Roll Call # 369",97,9,0,0,106
1596413,1221730,2022-07-01,Senate,"Senate Third Reading: Senate Adopted Conference Report With Immediate Effect Roll Call # 403",37,0,0,1,38
1596473,1196158,2022-04-28,House,"Reported With Recommendation With Substitute H-1",18,9,0,0,27
1596473,1217660,2022-05-05,House,"House Third Reading: Given Immediate Effect Roll Call # 199",58,45,0,0,103
1596473,1219302,2022-05-11,Senate,"Senate Third Reading: Passed Roll Call # 220",21,12,0,5,38
1596473,1219303,2022-05-19,House,"House Third Reading: Roll Call # 242",0,106,0,0,106
1596498,1219320,2022-06-14,House,"House Third Reading: Given Immediate Effect Roll Call # 301",104,0,0,0,104
1596747,1196296,2022-04-28,House,"Reported With Recommendation With Substitute H-3",17,9,0,0,26
1596747,1217722,2022-05-05,House,"House Third Reading: Given Immediate Effect Roll Call # 203",65,38,0,0,103
1596747,1219275,2022-05-11,Senate,"Senate Third Reading: Passed Roll Call # 222",21,12,0,5,38
1596747,1219276,2022-05-19,House,"House Third Reading: Roll Call # 248",0,106,0,0,106
1596786,1218991,2022-06-23,Senate,"Reported Favorably With Substitute S-1",6,1,0,0,7
1596786,1221691,2022-06-23,Senate,"Senate Third Reading: Passed Roll Call # 368",28,10,0,0,38
1596807,1176226,2022-03-23,Senate,"Reported Favorably With Substitute S-2",5,2,0,0,7
1596982,1216138,2022-06-14,House,"Reported With Recommendation With Substitute H-2",14,0,0,0,14
1596982,1219321,2022-06-15,House,"House Third Reading: Given Immediate Effect Roll Call # 308",96,9,0,0,105
1596982,1229287,2022-10-11,Senate,"Reported Favorably With Substitute S-3",8,1,0,0,9
1597111,1174992,2022-03-22,House,"Reported With Recommendation With Substitute H-2",8,5,0,0,13
1597111,1219269,2022-06-07,House,"House Third Reading: Adverse Roll Call",14,0,0,0,14
1597111,1219270,2022-06-07,House,"House Third Reading: Roll Call # 282",51,56,0,0,107
1597111,1230053,2022-06-07,House,"House Third Reading: Defeated Roll Call # 282",51,56,0,0,107
1599477,1193064,2022-04-26,Senate,"Reported Favorably Without Amendment",10,0,0,0,10
1599477,1195417,2022-04-28,Senate,"Senate Third Reading: Passed Roll Call # 139",34,0,0,4,38
1599477,1214885,2022-06-07,House,"Reported With Recommendation Without Amendment",10,0,0,0,10
1599477,1217695,2022-06-21,House,"House Third Reading: Given Immediate Effect Roll Call # 324",103,2,0,0,105
1599569,1228950,2022-09-28,Senate,"Senate Third Reading: Passed Roll Call # 462",22,13,0,3,38
1599569,1229326,2022-09-22,Senate,"Reported Favorably With Substitute S-1",4,2,0,0,6
1599797,1215128,2022-06-08,House,"Reported With Recommendation Without Amendment",11,1,0,0,12
1599797,1221656,2022-06-30,House,"House Third Reading: Given Immediate Effect Roll Call # 360",95,11,0,0,106
1599856,1215130,2022-06-08,House,"Reported With Recommendation Without Amendment",11,1,0,0,12
1599856,1221649,2022-06-30,House,"House Third Reading: Given Immediate Effect Roll Call # 359",97,9,0,0,106
1600225,1167127,2022-03-09,Senate,"Reported Favorably Without Amendment",7,0,0,0,7
1600225,1176563,2022-03-24,Senate,"Senate Third Reading: Passed Roll Call # 107",37,0,0,1,38
1600267,1218445,2022-06-16,Senate,"Reported Favorably With Substitute S-1",8,0,0,0,8
1600267,1221647,2022-06-23,Senate,"Senate Third Reading: Passed Roll Call # 355",38,0,0,0,38
1600346,1187601,2022-04-12,Senate,"Reported Favorably With Substitute S-1",10,0,0,0,10
1600346,1188692,2022-04-14,Senate,"Senate Third Reading: Passed Roll Call # 113",37,0,1,0,38
1600419,1167351,2022-03-09,Senate,"Reported Favorably Without Amendment",7,0,0,0,7
1600419,1176863,2022-03-24,Senate,"Senate Third Reading: Passed Roll Call # 108",37,0,0,1,38
1601497,1176815,2022-03-24,House,"Reported With Recommendation Without Amendment",17,0,0,0,17
1601497,1188446,2022-04-13,House,"House Third Reading: Given Immediate Effect Roll Call # 162",99,3,0,0,102
1601497,1205392,2022-05-17,Senate,"Reported Favorably Without Amendment",8,0,0,0,8
1601497,1219277,2022-05-26,Senate,"Senate Third Reading: Given Immediate Effect Roll Call # 276",37,0,0,1,38
1601596,1176834,2022-03-24,House,"Reported With Recommendation With Substitute H-1",13,0,0,0,13
1601596,1196178,2022-04-28,House,"House Third Reading: Given Immediate Effect Roll Call # 176",76,23,0,0,99
1601596,1219299,2022-06-07,Senate,"Reported Favorably Without Amendment",9,0,0,0,9
1601596,1220253,2022-06-15,Senate,"Senate Third Reading: Given Immediate Effect Roll Call # 316",37,0,0,1,38
1601699,1171909,2022-03-16,House,"Reported With Recommendation Without Amendment",9,0,0,0,9
1601748,1171016,2022-03-15,House,"Reported With Recommendation With Substitute H-1",14,0,0,0,14
1601748,1176949,2022-03-24,House,"House Third Reading: Given Immediate Effect Roll Call # 153",101,2,0,0,103
1601748,1229240,2022-10-11,Senate,"Reported Favorably With Substitute S-4",8,1,0,0,9
1604481,1219535,2022-05-24,House,"Reported With Recommendation Without Amendment",13,0,0,0,13
1604481,1219536,2022-06-08,House,"House Third Reading: Given Immediate Effect Roll Call # 288",105,1,0,0,106
1604912,1169275,2022-03-09,House,"House Third Reading: Roll Call # 101",62,40,0,0,102
1605079,1210712,2022-05-26,House,"Reported With Recommendation With Substitute H-1",10,0,0,0,10
1605683,1200627,2022-05-05,House,"Reported With Recommendation With Substitute H-1",9,0,0,0,9
1605683,1219295,2022-05-25,House,"House Third Reading: Given Immediate Effect Roll Call # 270",96,11,0,0,107
1605683,1219296,2022-06-08,Senate,"Reported Favorably Without Amendment",6,0,0,0,6
1605683,1219297,2022-06-16,Senate,"Senate Third Reading: Given Immediate Effect Roll Call # 333",34,1,0,3,38
1605683,1219298,2022-06-21,House,"House Third Reading: Senate Amendment(s) Concurred In Roll Call # 326",94,11,0,0,105
1605712,1219250,2022-05-24,House,"Reported With Recommendation With Substitute H-3",12,1,0,0,13
1605750,1200797,2022-05-05,House,"Reported With Recommendation Without Amendment",9,0,0,0,9
1605750,1209678,2022-05-25,House,"House Third Reading: Given Immediate Effect Roll Call # 271",95,12,0,0,107
1605750,1219189,2022-06-08,Senate,"Reported Favorably Without Amendment",6,0,0,0,6
1605750,1219190,2022-06-16,Senate,"Senate Third Reading: Given Immediate Effect Roll Call # 334",35,0,0,3,38
1605819,1200719,2022-05-05,House,"Reported With Recommendation With Substitute H-1",9,0,0,0,9
1605819,1219183,2022-05-25,House,"House Third Reading: Given Immediate Effect Roll Call # 272",95,12,0,0,107
1605819,1219184,2022-06-08,Senate,"Reported Favorably Without Amendment",6,0,0,0,6
1605819,1221959,2022-06-16,Senate,"Senate Third Reading: Given Immediate Effect Roll Call # 335",35,0,0,3,38
1608151,1215367,2022-06-09,House,"Reported With Recommendation With Substitute H-1",8,0,0,0,8
1608155,1220250,2022-06-09,House,"Reported With Recommendation With Substitute H-1",8,0,0,0,8
1608194,1215385,2022-06-09,House,"Reported With Recommendation With Substitute H-2",8,0,0,0,8
1608218,1215383,2022-06-09,House,"Reported With Recommendation With Substitute H-1",8,0,0,0,8
1608255,1215366,2022-06-09,House,"Reported With Recommendation With Substitute H-2",7,0,0,0,7
1608501,1209882,2022-05-26,Senate,"Reported Favorably With Substitute S-2",9,0,0,0,9
1608501,1221722,2022-05-26,Senate,"Senate Third Reading: Passed Roll Call # 287",36,1,0,1,38
1608504,1210046,2022-05-26,Senate,"Reported Favorably With Substitute S-3",9,0,0,0,9
1608504,1221728,2022-05-26,Senate,"Senate Third Reading: Passed Roll Call # 289",36,1,0,1,38
1608515,1221643,2022-06-30,Senate,"Reported Favorably Without Amendment",17,0,0,0,17
1608515,1221644,2022-06-30,Senate,"Senate Third Reading: Passed Roll Call # 394",38,0,0,0,38
1608515,1229297,2022-09-28,House,"Reported With Recommendation With Substitute H-1",8,0,0,0,8
1608526,1210171,2022-05-26,Senate,"Reported Favorably With Substitute S-2",9,0,0,0,9
1608526,1221677,2022-05-26,Senate,"Senate Third Reading: Passed Roll Call # 288",36,1,0,1,38
1608698,1208767,2022-05-24,House,"Reported With Recommendation Without Amendment",7,0,0,0,7
1608698,1221642,2022-06-30,House,"House Third Reading: Given Immediate Effect Roll Call # 336",99,7,0,0,106
1608698,1228982,2022-10-11,Senate,"Reported Favorably Without Amendment",3,1,0,0,4
1609921,1229242,2022-09-28,House,"Reported With Recommendation With Substitute H-1",8,0,0,0,8
1610081,1221663,2022-06-07,Senate,"Reported Favorably Without Amendment",5,0,0,0,5
1610081,1221664,2022-06-15,Senate,"Senate Third Reading: Passed Roll Call # 314",37,0,0,1,38
1610182,1226043,2022-09-07,House,"Reported With Recommendation With Substitute H-2",25,1,0,0,26
1610204,1205443,2022-05-17,House,"Reported With Recommendation Without Amendment",15,0,0,0,15
1610204,1216487,2022-06-15,House,"House Third Reading: Given Immediate Effect Roll Call # 307",104,1,0,0,105
1610204,1229273,2022-10-11,Senate,"Reported Favorably With Substitute S-2",9,0,0,0,9
1610297,1210168,2022-05-26,House,"Reported With Recommendation Without Amendment",5,1,0,0,6
1610465,1226030,2022-05-11,House,"Reported With Recommendation Without Amendment",8,0,0,0,8
1610497,1187421,2022-04-12,House,"Reported With Recommendation Without Amendment",11,1,0,0,12
1610497,1196224,2022-04-28,House,"House Third Reading: Given Immediate Effect Roll Call # 178",86,13,0,0,99
1610503,1229576,2022-09-22,Senate,"Reported Favorably Without Amendment",8,0,0,0,8
1610544,1187555,2022-04-12,House,"Reported With Recommendation Without Amendment",11,1,0,0,12
1610544,1196174,2022-04-28,House,"House Third Reading: Given Immediate Effect Roll Call # 177",89,10,0,0,99
1610568,1203742,2022-05-11,House,"Reported With Recommendation With Substitute H-1",8,0,0,0,8
1610568,1219194,2022-05-24,House,"House Third Reading: Given Immediate Effect Roll Call # 256",98,9,0,0,107
1610568,1221615,2022-06-30,Senate,"Reported Favorably Without Amendment",10,0,0,0,10
1610568,1229658,2022-09-20,Senate,"Senate Third Reading: Given Immediate Effect Roll Call # 417",36,0,0,2,38
1610610,1203790,2022-05-11,House,"Reported With Recommendation Without Amendment",8,0,0,0,8
1610610,1208640,2022-05-24,House,"House Third Reading: Given Immediate Effect Roll Call # 257",107,0,0,0,107
1610610,1221675,2022-06-30,Senate,"Reported Favorably Without Amendment",10,0,0,0,10
1610610,1229675,2022-09-20,Senate,"Senate Third Reading: Given Immediate Effect Roll Call # 418",36,0,0,2,38
1610617,1203800,2022-05-11,House,"Reported With Recommendation Without Amendment",8,0,0,0,8
1610617,1219193,2022-05-24,House,"House Third Reading: Given Immediate Effect Roll Call # 261",72,35,0,0,107
1610617,1221702,2022-06-30,Senate,"Reported Favorably Without Amendment",6,2,0,0,8
1610617,1229676,2022-09-20,Senate,"Senate Third Reading: Given Immediate Effect Roll Call # 427",27,9,0,2,38
1610636,1203639,2022-05-11,House,"Reported With Recommendation Without Amendment",8,0,0,0,8
1610636,1219114,2022-05-24,House,"House Third Reading: Given Immediate Effect Roll Call # 260",107,0,0,0,107
1610636,1221697,2022-06-30,Senate,"Reported Favorably Without Amendment",10,0,0,0,10
1610636,1229655,2022-09-20,Senate,"Senate Third Reading: Given Immediate Effect Roll Call # 421",36,0,0,2,38
1610645,1229327,2022-09-22,Senate,"Reported Favorably Without Amendment",8,0,0,0,8
1610656,1187880,2022-04-12,House,"Reported With Recommendation Without Amendment",12,0,0,0,12
1610656,1196160,2022-04-28,House,"House Third Reading: Given Immediate Effect Roll Call # 179",95,4,0,0,99
1610664,1202282,2022-05-10,House,"Reported With Recommendation Without Amendment",15,0,0,0,15
1610678,1190164,2022-04-19,Senate,"Reported Favorably Without Amendment",10,0,0,0,10
1610678,1191516,2022-04-21,Senate,"Senate Third Reading: Passed Roll Call # 132",33,0,0,5,38
1610678,1198881,2022-05-03,House,"Reported With Recommendation Without Amendment",8,1,0,0,9
1610678,1203221,2022-05-10,House,"House Third Reading: Given Immediate Effect Roll Call # 208",95,9,0,0,104
1610691,1203812,2022-05-11,House,"Reported With Recommendation Without Amendment",8,0,0,0,8
1610691,1219117,2022-05-24,House,"House Third Reading: Given Immediate Effect Roll Call # 258",107,0,0,0,107
1610691,1221678,2022-06-30,Senate,"Reported Favorably Without Amendment",10,0,0,0,10
1610691,1229674,2022-09-20,Senate,"Senate Third Reading: Given Immediate Effect Roll Call # 419",36,0,0,2,38
1610710,1229304,2022-09-22,Senate,"Reported Favorably Without Amendment",9,0,0,0,9
1610719,1203874,2022-05-11,House,"Reported With Recommendation Without Amendment",8,0,0,0,8
1610719,1219169,2022-05-24,House,"House Third Reading: Given Immediate Effect Roll Call # 259",107,0,0,0,107
1610719,1221676,2022-06-30,Senate,"Reported Favorably Without Amendment",7,0,0,0,7
1610719,1229673,2022-09-20,Senate,"Senate Third Reading: Given Immediate Effect Roll Call # 420",36,0,0,2,38
1610757,1190156,2022-04-19,Senate,"Reported Favorably With Substitute S-1",10,0,0,0,10
1610757,1191482,2022-04-21,Senate,"Senate Third Reading: Passed Roll Call # 133",33,0,0,5,38
1610757,1198894,2022-05-03,House,"Reported With Recommendation Without Amendment",8,1,0,0,9
1610757,1203222,2022-05-10,House,"House Third Reading: Given Immediate Effect Roll Call # 209",91,13,0,0,104
1610779,1200595,2022-05-05,Senate,"Reported Favorably With Substitute S-1",7,0,0,0,7
1610779,1206228,2022-05-19,Senate,"Senate Third Reading: Passed Roll Call # 244",34,0,2,2,38
1610779,1206229,2022-05-19,Senate,"Senate Third Reading: Passed Roll Call # 246",36,0,0,2,38
1610779,1218578,2022-06-22,House,"Reported With Recommendation Without Amendment",7,0,0,0,7
1610779,1221525,2022-06-30,House,"House Third Reading: Given Immediate Effect Roll Call # 362",106,0,0,0,106
1610789,1190279,2022-04-19,Senate,"Reported Favorably Without Amendment",10,0,0,0,10
1610789,1191639,2022-04-21,Senate,"Senate Third Reading: Passed Roll Call # 134",33,0,0,5,38
1610789,1198740,2022-05-03,House,"Reported With Recommendation Without Amendment",9,0,0,0,9
1610789,1203223,2022-05-10,House,"House Third Reading: Given Immediate Effect Roll Call # 210",97,7,0,0,104
1610798,1203798,2022-05-11,House,"Reported With Recommendation With Substitute H-1",8,0,0,0,8
1610798,1219220,2022-05-24,House,"House Third Reading: Given Immediate Effect Roll Call # 255",92,15,0,0,107
1610798,1221628,2022-06-30,Senate,"Reported Favorably With Substitute S-1",10,0,0,0,10
1610798,1229677,2022-09-20,Senate,"Senate Third Reading: Given Immediate Effect Roll Call # 416",36,0,0,2,38
1615148,1191011,2022-04-20,Senate,"Senate Third Reading: Passed Roll Call # 129",37,0,0,1,38
1615148,1203719,2022-05-10,House,"Reported With Recommendation Without Amendment",10,2,0,0,12
1615183,1216486,2022-06-15,Senate,"Reported Favorably Without Amendment",8,0,0,0,8
1615183,1221682,2022-06-23,Senate,"Senate Third Reading: Passed Roll Call # 351",38,0,0,0,38
1615183,1229226,2022-09-28,House,"Reported With Recommendation With Substitute H-1",12,0,0,0,12
1615194,1202896,2022-05-10,House,"Reported With Recommendation With Substitute H-3",14,0,0,0,14
1615194,1219056,2022-05-10,House,"House Third Reading: Given Immediate Effect Roll Call # 211",101,3,0,0,104
1615194,1219057,2022-06-07,Senate,"Reported Favorably Without Amendment",5,0,0,0,5
1615194,1219058,2022-06-08,Senate,"Senate Third Reading: Given Immediate Effect Roll Call # 299",37,1,0,0,38
1615208,1215145,2022-06-08,Senate,"Reported Favorably With Substitute S-1",10,0,0,0,10
1615208,1219191,2022-06-23,Senate,"Senate Third Reading: Passed Roll Call # 348",38,0,0,0,38
1615212,1203605,2022-05-10,House,"Reported With Recommendation Without Amendment",10,2,0,0,12
1615238,1203213,2022-05-10,House,"Reported With Recommendation With Substitute H-2",14,0,0,0,14
1615238,1219140,2022-05-10,House,"House Third Reading: Given Immediate Effect Roll Call # 212",100,4,0,0,104
1615238,1219141,2022-06-07,Senate,"Reported Favorably Without Amendment",5,0,0,0,5
1615238,1219142,2022-06-08,Senate,"Senate Third Reading: Given Immediate Effect Roll Call # 300",37,1,0,0,38
1615321,1205382,2022-05-17,House,"Reported With Recommendation Without Amendment",12,0,0,0,12
1615321,1216468,2022-06-15,House,"House Third Reading: Given Immediate Effect Roll Call # 309",101,4,0,0,105
1615335,1219185,2022-05-19,House,"House Third Reading: Given Immediate Effect Roll Call # 253",103,0,0,0,103
1615335,1220262,2022-05-26,Senate,"Senate Third Reading: Given Immediate Effect Roll Call # 275",37,0,0,1,38
1615335,1220263,2022-05-26,House,"House Third Reading: Roll Call # 275",105,0,0,0,105
1615461,1218421,2022-06-16,Senate,"Reported Favorably Without Amendment",8,0,0,0,8
1615461,1221666,2022-06-23,Senate,"Senate Third Reading: Passed Roll Call # 354",38,0,0,0,38
1615467,1205629,2022-05-17,House,"Reported With Recommendation Without Amendment",12,0,0,0,12
1615474,1205617,2022-05-17,House,"Reported With Recommendation Without Amendment",12,0,0,0,12
1615477,1200145,2022-05-04,House,"Reported With Recommendation With Substitute H-1",12,0,0,0,12
1615477,1219085,2022-05-19,House,"House Third Reading: Given Immediate Effect Roll Call # 251",85,20,0,0,105
1615477,1226465,2022-09-21,Senate,"Reported Favorably Without Amendment",12,0,0,0,12
1615515,1219178,2022-05-19,House,"Reported With Recommendation With Substitute H-1",4,0,0,0,4
1615515,1219179,2022-06-07,House,"House Third Reading: Given Immediate Effect Roll Call # 283",107,0,0,0,107
1615531,1206020,2022-05-18,House,"Reported With Recommendation With Substitute H-2",10,1,0,0,11
1615531,1219040,2022-05-26,House,"House Third Reading: Given Immediate Effect Roll Call # 279",85,20,0,0,105
1615531,1219041,2022-06-23,Senate,"Reported Favorably Without Amendment",8,0,0,0,8
1615531,1221645,2022-06-30,Senate,"Senate Third Reading: Given Immediate Effect Roll Call # 380",35,3,0,0,38
1615532,1207173,2022-05-19,House,"Reported With Recommendation With Substitute H-1",17,1,0,0,18
1615532,1219138,2022-06-09,House,"House Third Reading: Given Immediate Effect Roll Call # 290",93,12,0,0,105
1615873,1205333,2022-05-17,Senate,"Reported Favorably With Substitute S-1",8,0,0,0,8
1615873,1210666,2022-05-26,Senate,"Senate Third Reading: Passed Roll Call # 277",37,0,0,1,38
1615873,1221509,2022-06-30,House,"Reported With Recommendation Without Amendment",15,3,0,0,18
1615873,1221714,2022-07-01,House,"House Third Reading: Given Immediate Effect Roll Call # 366",95,11,0,0,106
1616341,1228981,2022-10-11,Senate,"Reported Favorably With Substitute S-1",8,0,0,0,8
1617084,1200967,2022-05-04,House,"House Third Reading: Roll Call # 181",99,4,0,0,103
1617152,1224152,2022-07-01,Senate,"Reported Favorably With Substitute S-1",5,0,0,0,5
1617170,1221962,2022-07-20,Senate,"Reported Favorably With Substitute S-1",5,0,0,0,5
1617608,1203759,2022-05-11,Senate,"Reported Favorably With Substitute S-1",10,0,0,0,10
1617608,1221695,2022-05-18,Senate,"Senate Third Reading: Passed Roll Call # 237",37,0,0,1,38
1617611,1203597,2022-05-11,Senate,"Reported Favorably With Substitute S-1",10,0,0,0,10
1617611,1221683,2022-05-18,Senate,"Senate Third Reading: Passed Roll Call # 236",37,0,0,1,38
1617615,1216053,2022-06-14,House,"Reported With Recommendation Without Amendment",14,0,0,0,14
1617666,1205450,2022-05-17,House,"Reported With Recommendation Without Amendment",15,0,0,0,15
1617666,1217693,2022-06-21,House,"House Third Reading: Given Immediate Effect Roll Call # 321",105,0,0,0,105
1617684,1205115,2022-05-17,House,"Reported With Recommendation Without Amendment",15,0,0,0,15
1617684,1219070,2022-06-21,House,"House Third Reading: Given Immediate Effect Roll Call # 322",105,0,0,0,105
1618557,1215357,2022-06-09,House,"Reported With Recommendation Without Amendment",5,3,0,0,8
1618586,1228975,2022-10-11,Senate,"Reported Favorably Without Amendment",8,0,0,0,8
1618621,1229260,2022-09-28,House,"Reported With Recommendation Without Amendment",9,3,0,0,12
1618742,1209172,2022-05-18,House,"Reported With Recommendation Without Amendment",9,0,0,0,9
1618887,1217265,2022-06-15,House,"Reported With Recommendation Without Amendment",9,3,0,0,12
1618896,1221719,2022-05-26,Senate,"Reported Favorably With Substitute S-1",9,0,0,0,9
1618896,1221720,2022-05-26,Senate,"Senate Third Reading: Passed Roll Call # 286",30,7,0,1,38
1618904,1204030,2022-05-12,Senate,"Reported Favorably With Substitute S-2",17,0,0,0,17
1618904,1221654,2022-05-18,Senate,"Senate Third Reading: Passed Roll Call # 235",37,0,0,1,38
1618904,1221655,2022-06-30,House,"House Third Reading: Given Immediate Effect Roll Call # 363",101,5,0,0,106
1618914,1216538,2022-06-15,Senate,"Reported Favorably With Substitute S-1",8,0,0,0,8
1618914,1221616,2022-06-23,Senate,"Senate Third Reading: Passed Roll Call # 356",38,0,0,0,38
1618932,1203327,2022-05-11,House,"Reported With Recommendation Without Amendment",8,0,0,0,8
1618932,1208667,2022-05-24,House,"House Third Reading: Given Immediate Effect Roll Call # 264",96,11,0,0,107
1618932,1221646,2022-06-30,Senate,"Reported Favorably Without Amendment",10,0,0,0,10
1618932,1229672,2022-09-20,Senate,"Senate Third Reading: Given Immediate Effect Roll Call # 424",36,0,0,2,38
1618953,1203690,2022-05-11,House,"Reported With Recommendation Without Amendment",8,0,0,0,8
1618953,1208642,2022-05-24,House,"House Third Reading: Given Immediate Effect Roll Call # 265",95,12,0,0,107
1618953,1221652,2022-06-30,Senate,"Reported Favorably Without Amendment",10,0,0,0,10
1618953,1229679,2022-09-20,Senate,"Senate Third Reading: Given Immediate Effect Roll Call # 425",36,0,0,2,38
1618969,1219148,2022-05-24,House,"Reported With Recommendation With Substitute H-1",7,0,0,0,7
1618969,1219149,2022-06-21,House,"House Third Reading: Given Immediate Effect Roll Call # 331",95,9,0,0,104
1618969,1226466,2022-09-21,Senate,"Reported Favorably Without Amendment",4,0,0,0,4
1618969,1228970,2022-09-28,Senate,"Senate Third Reading: Given Immediate Effect Roll Call # 466",33,0,0,5,38
1619006,1203666,2022-05-11,House,"Reported With Recommendation With Substitute H-1",8,0,0,0,8
1619006,1219170,2022-05-24,House,"House Third Reading: Given Immediate Effect Roll Call # 263",104,3,0,0,107
1619006,1221648,2022-06-30,Senate,"Reported Favorably Without Amendment",10,0,0,0,10
1619006,1229671,2022-09-20,Senate,"Senate Third Reading: Given Immediate Effect Roll Call # 423",36,0,0,2,38
1619012,1203671,2022-05-11,House,"Reported With Recommendation With Substitute H-1",8,0,0,0,8
1619012,1219110,2022-05-24,House,"House Third Reading: Given Immediate Effect Roll Call # 262",95,12,0,0,107
1619012,1221687,2022-06-30,Senate,"Reported Favorably Without Amendment",10,0,0,0,10
1619012,1229660,2022-09-20,Senate,"Senate Third Reading: Given Immediate Effect Roll Call # 422",36,0,0,2,38
1619014,1205539,2022-05-17,House,"Reported With Recommendation Without Amendment",13,0,0,0,13
1619014,1214848,2022-06-07,House,"House Third Reading: Given Immediate Effect Roll Call # 285",107,0,0,0,107
1619014,1219063,2022-06-16,Senate,"Reported Favorably Without Amendment",8,0,0,0,8
1619014,1221651,2022-06-30,Senate,"Senate Third Reading: Given Immediate Effect Roll Call # 376",38,0,0,0,38
1619018,1210749,2022-05-26,House,"Reported With Recommendation Without Amendment",8,0,0,0,8
1619592,1225192,2022-05-10,House,"House Third Reading: Roll Call # 205",76,28,0,0,104
1619592,1225193,2022-05-10,Senate,"Senate Third Reading: Adopted By 2/3 Vote Roll Call # 205",26,6,0,6,38
1619644,1219180,2022-06-07,House,"Reported With Recommendation With Substitute H-1",14,0,0,0,14
1619644,1219181,2022-06-15,House,"House Third Reading: Given Immediate Effect Roll Call # 304",100,4,0,0,104
1619644,1219182,2022-06-23,Senate,"Senate Third Reading: Given Immediate Effect Roll Call # 360",38,0,0,0,38
1619656,1222146,2022-05-17,Senate,"Reported Favorably Without Amendment",4,0,0,0,4
1619703,1219139,2022-05-26,House,"Reported With Recommendation Without Amendment",8,0,0,0,8
1620952,1210221,2022-05-26,Senate,"Reported Favorably Without Amendment",9,0,0,0,9
1620952,1221703,2022-06-15,Senate,"Senate Third Reading: Passed Roll Call # 327",37,0,0,1,38
1620958,1216537,2022-06-15,Senate,"Reported Favorably Without Amendment",8,0,0,0,8
1620958,1221665,2022-06-23,Senate,"Senate Third Reading: Passed Roll Call # 352",38,0,0,0,38
1620958,1227398,2022-09-28,House,"Reported With Recommendation Without Amendment",12,0,0,0,12
1620958,1227399,2022-09-28,House,"House Third Reading: Given Immediate Effect Roll Call # 446",106,0,0,0,106
1620960,1216483,2022-06-15,Senate,"Reported Favorably With Substitute S-1",8,0,0,0,8
1620960,1221653,2022-06-23,Senate,"Senate Third Reading: Passed Roll Call # 353",38,0,0,0,38
1620960,1227402,2022-09-28,House,"Reported With Recommendation Without Amendment",12,0,0,0,12
1620960,1227403,2022-09-28,House,"House Third Reading: Given Immediate Effect Roll Call # 447",106,0,0,0,106
1621200,1214844,2022-06-07,House,"Reported With Recommendation With Substitute H-2",14,0,0,0,14
1621200,1221605,2022-06-30,House,"House Third Reading: Given Immediate Effect Roll Call # 339",100,5,0,0,105
1621200,1228556,2022-09-28,Senate,"Reported Favorably With Substitute S-1",8,0,0,0,8
1621200,1228972,2022-09-28,Senate,"Senate Third Reading: Given Immediate Effect Roll Call # 461",35,0,0,3,38
1621233,1219044,2022-06-14,House,"Reported With Recommendation Without Amendment",9,1,0,0,10
1621233,1219045,2022-06-15,House,"House Third Reading: Given Immediate Effect Roll Call # 317",79,26,0,0,105
1621233,1219046,2022-06-23,Senate,"Senate Third Reading: Given Immediate Effect Roll Call # 363",29,9,0,0,38
1621242,1214817,2022-06-07,House,"Reported With Recommendation With Substitute H-1",14,0,0,0,14
1621242,1221492,2022-06-30,House,"House Third Reading: Given Immediate Effect Roll Call # 338",98,7,0,0,105
1621242,1228557,2022-09-28,Senate,"Reported Favorably With Substitute S-1",8,0,0,0,8
1621242,1228969,2022-09-28,Senate,"Senate Third Reading: Given Immediate Effect Roll Call # 460",35,0,0,3,38
1621263,1219209,2022-06-14,House,"Reported With Recommendation Without Amendment",9,1,0,0,10
1621263,1219210,2022-06-15,House,"House Third Reading: Given Immediate Effect Roll Call # 318",78,27,0,0,105
1621263,1219211,2022-06-23,Senate,"Senate Third Reading: Given Immediate Effect Roll Call # 364",28,10,0,0,38
1621278,1214864,2022-06-07,House,"Reported With Recommendation With Substitute H-1",14,0,0,0,14
1621278,1221622,2022-06-30,House,"House Third Reading: Given Immediate Effect Roll Call # 337",100,5,0,0,105
1621278,1228560,2022-09-28,Senate,"Reported Favorably With Substitute S-2",8,0,0,0,8
1621278,1228971,2022-09-28,Senate,"Senate Third Reading: Given Immediate Effect Roll Call # 459",35,0,0,3,38
1621502,1221961,2022-06-07,Senate,"Reported Favorably With Substitute S-1",7,0,0,0,7
1621502,1228951,2022-09-28,Senate,"Senate Third Reading: Passed Roll Call # 457",35,0,0,3,38
1621680,1214851,2022-06-07,House,"Reported With Recommendation With Substitute H-1",9,0,0,0,9
1621685,1214852,2022-06-07,House,"Reported With Recommendation With Substitute H-1",9,0,0,0,9
1621693,1216027,2022-06-14,House,"Reported With Recommendation With Substitute H-1",5,0,0,0,5
1621693,1219042,2022-06-15,House,"House Third Reading: Given Immediate Effect Roll Call # 315",105,0,0,0,105
1621693,1219043,2022-06-23,Senate,"Senate Third Reading: Given Immediate Effect Roll Call # 366",38,0,0,0,38
1621701,1217620,2022-06-21,House,"Reported With Recommendation With Substitute H-1",8,0,0,0,8
1621701,1219143,2022-06-21,House,"House Third Reading: Given Immediate Effect Roll Call # 332",101,3,0,0,104
1621701,1226467,2022-09-21,Senate,"Reported Favorably Without Amendment",3,0,0,0,3
1621704,1214883,2022-06-07,House,"Reported With Recommendation With Substitute H-1",9,0,0,0,9
1621705,1214850,2022-06-07,House,"Reported With Recommendation Without Amendment",9,0,0,0,9
1622108,1230061,2022-05-26,House,"House Third Reading: Roll Call # 276",79,26,0,0,105
1622126,1229039,2022-09-28,House,"Reported With Recommendation With Substitute H-2",16,4,0,0,20
1622342,1215201,2022-06-08,House,"Reported With Recommendation Without Amendment",11,0,0,0,11
1622342,1221650,2022-06-30,House,"House Third Reading: Given Immediate Effect Roll Call # 340",83,23,0,0,106
1622490,1216235,2022-06-15,Senate,"Reported Favorably With Substitute S-1",8,0,0,0,8
1622490,1218443,2022-06-16,Senate,"Senate Third Reading: Passed Roll Call # 339",35,0,0,3,38
1622490,1226478,2022-09-21,House,"Reported With Recommendation With Substitute H-1",15,0,0,0,15
1622498,1218460,2022-06-16,Senate,"Reported Favorably With Substitute S-2",7,0,0,0,7
1622498,1221670,2022-06-23,Senate,"Senate Third Reading: Passed Roll Call # 359",38,0,0,0,38
1622506,1226461,2022-09-21,Senate,"Reported Favorably With Substitute S-1",5,0,0,0,5
1622506,1228955,2022-09-28,Senate,"Senate Third Reading: Passed Roll Call # 444",36,0,0,2,38
1622516,1218571,2022-06-16,Senate,"Reported Favorably With Substitute S-2",7,0,0,0,7
1622516,1219192,2022-06-23,Senate,"Senate Third Reading: Passed Roll Call # 358",38,0,0,0,38
1622522,1216548,2022-06-15,Senate,"Reported Favorably Without Amendment",6,3,0,0,9
1622522,1228711,2022-09-28,Senate,"Senate Third Reading: Passed Roll Call # 438",24,12,0,2,38
1622530,1219207,2022-06-23,Senate,"Reported Favorably Without Amendment",10,0,0,0,10
1622530,1221692,2022-06-30,Senate,"Senate Third Reading: Passed Roll Call # 382",38,0,0,0,38
1622530,1230004,2022-11-10,House,"Reported With Recommendation Without Amendment",18,0,0,0,18
1622538,1221689,2022-06-30,Senate,"Reported Favorably Without Amendment",17,0,0,0,17
1622538,1221690,2022-06-30,Senate,"Senate Third Reading: Passed Roll Call # 383",38,0,0,0,38
1622546,1215663,2022-06-09,Senate,"Reported Favorably Without Amendment",5,0,0,0,5
1622546,1221950,2022-06-15,Senate,"Senate Third Reading: Passed Roll Call # 311",37,0,0,1,38
1622546,1221951,2022-06-21,House,"House Third Reading: Given Immediate Effect Roll Call # 330",100,4,0,0,104
1622569,1218377,2022-06-16,Senate,"Reported Favorably With Substitute S-2",7,0,0,0,7
1622569,1221658,2022-06-23,Senate,"Senate Third Reading: Passed Roll Call # 357",38,0,0,0,38
1623948,1221145,2022-06-16,Senate,"Reported Favorably Without Amendment",4,1,0,0,5
1624020,1230166,2022-06-09,House,"Reported With Recommendation Without Amendment",8,0,0,0,8
1624117,1229290,2022-10-11,Senate,"Reported Favorably Without Amendment",8,0,0,0,8
1624127,1217668,2022-06-22,House,"Reported With Recommendation Without Amendment",6,1,0,0,7
1624127,1226390,2022-09-21,House,"House Third Reading: Given Immediate Effect Roll Call # 421",62,39,0,0,101
1624131,1217649,2022-06-22,House,"Reported With Recommendation Without Amendment",6,1,0,0,7
1624131,1226406,2022-09-21,House,"House Third Reading: Given Immediate Effect Roll Call # 419",62,39,0,0,101
1624133,1217683,2022-06-22,House,"Reported With Recommendation Without Amendment",5,2,0,0,7
1624133,1226388,2022-09-21,House,"House Third Reading: Given Immediate Effect Roll Call # 403",60,44,0,0,104
1624136,1217655,2022-06-22,House,"Reported With Recommendation With Substitute H-1",6,1,0,0,7
1624136,1221723,2022-07-01,House,"House Third Reading: Given Immediate Effect Roll Call # 375",56,48,0,0,104
1624136,1226472,2022-09-21,Senate,"Reported Favorably Without Amendment",4,2,0,0,6
1624136,1228973,2022-09-28,Senate,"Senate Third Reading: Passed Roll Call # 450",22,14,0,2,38
1624140,1217641,2022-06-22,House,"Reported With Recommendation Without Amendment",6,1,0,0,7
1624140,1226394,2022-09-21,House,"House Third Reading: Given Immediate Effect Roll Call # 409",57,39,0,0,96
1624144,1217682,2022-06-22,House,"Reported With Recommendation With Substitute H-1",6,1,0,0,7
1624147,1217673,2022-06-22,House,"Reported With Recommendation Without Amendment",6,1,0,0,7
1624147,1226401,2022-09-21,House,"House Third Reading: Given Immediate Effect Roll Call # 423",62,39,0,0,101
1624149,1217642,2022-06-22,House,"Reported With Recommendation Without Amendment",6,1,0,0,7
1624149,1226397,2022-09-21,House,"House Third Reading: Given Immediate Effect Roll Call # 413",62,38,0,0,100
1624152,1217666,2022-06-22,House,"Reported With Recommendation Without Amendment",6,1,0,0,7
1624152,1226396,2022-09-21,House,"House Third Reading: Given Immediate Effect Roll Call # 418",62,39,0,0,101
1624155,1217661,2022-06-22,House,"Reported With Recommendation Without Amendment",6,1,0,0,7
1624155,1221731,2022-07-01,House,"House Third Reading: Given Immediate Effect Roll Call # 374",56,48,0,0,104
1624155,1226471,2022-09-21,Senate,"Reported Favorably Without Amendment",4,2,0,0,6
1624160,1217647,2022-06-22,House,"Reported With Recommendation Without Amendment",6,1,0,0,7
1624160,1226403,2022-09-21,House,"House Third Reading: Given Immediate Effect Roll Call # 411",60,39,0,0,99
1624162,1217670,2022-06-22,House,"Reported With Recommendation Without Amendment",6,1,0,0,7
1624162,1226377,2022-09-21,House,"House Third Reading: Given Immediate Effect Roll Call # 417",62,39,0,0,101
1624182,1217658,2022-06-22,House,"Reported With Recommendation Without Amendment",5,0,0,0,5
1624182,1221705,2022-07-01,House,"House Third Reading: Given Immediate Effect Roll Call # 371",56,49,0,0,105
1624182,1226468,2022-09-21,Senate,"Reported Favorably Without Amendment",4,2,0,0,6
1624182,1228979,2022-09-28,Senate,"Senate Third Reading: Passed Roll Call # 446",22,14,0,2,38
1624185,1217772,2022-06-22,House,"Reported With Recommendation Without Amendment",6,1,0,0,7
1624185,1226400,2022-09-21,House,"House Third Reading: Given Immediate Effect Roll Call # 415",61,38,0,0,99
1624187,1217651,2022-06-22,House,"Reported With Recommendation Without Amendment",5,2,0,0,7
1624187,1226389,2022-09-21,House,"House Third Reading: Given Immediate Effect Roll Call # 407",58,42,0,0,100
1624189,1219111,2022-06-14,House,"Reported With Recommendation With Substitute H-1",5,0,0,0,5
1624189,1219112,2022-06-15,House,"House Third Reading: Given Immediate Effect Roll Call # 316",105,0,0,0,105
1624189,1219113,2022-06-23,Senate,"Senate Third Reading: Given Immediate Effect Roll Call # 367",38,0,0,0,38
1624194,1217659,2022-06-22,House,"Reported With Recommendation Without Amendment",6,1,0,0,7
1624194,1226398,2022-09-21,House,"House Third Reading: Given Immediate Effect Roll Call # 420",62,39,0,0,101
1624198,1217654,2022-06-22,House,"Reported With Recommendation Without Amendment",5,2,0,0,7
1624198,1226391,2022-09-21,House,"House Third Reading: Given Immediate Effect Roll Call # 412",60,37,0,0,97
1624202,1217656,2022-06-22,House,"Reported With Recommendation Without Amendment",6,1,0,0,7
1624205,1217632,2022-06-22,House,"Reported With Recommendation Without Amendment",6,1,0,0,7
1624205,1226385,2022-09-21,House,"House Third Reading: Given Immediate Effect Roll Call # 424",61,38,0,0,99
1624206,1217657,2022-06-22,House,"Reported With Recommendation Without Amendment",6,1,0,0,7
1624206,1221724,2022-07-01,House,"House Third Reading: Given Immediate Effect Roll Call # 377",56,48,0,0,104
1624206,1226474,2022-09-21,Senate,"Reported Favorably Without Amendment",4,2,0,0,6
1624206,1228976,2022-09-28,Senate,"Senate Third Reading: Passed Roll Call # 453",22,14,0,2,38
1624209,1217652,2022-06-22,House,"Reported With Recommendation Without Amendment",5,1,0,0,6
1624209,1226399,2022-09-21,House,"House Third Reading: Given Immediate Effect Roll Call # 404",56,48,0,0,104
1624213,1217686,2022-06-22,House,"Reported With Recommendation Without Amendment",5,2,0,0,7
1624213,1226395,2022-09-21,House,"House Third Reading: Given Immediate Effect Roll Call # 406",58,44,0,0,102
1624216,1217640,2022-06-22,House,"Reported With Recommendation Without Amendment",6,1,0,0,7
1624216,1226432,2022-09-21,House,"House Third Reading: Given Immediate Effect Roll Call # 416",62,39,0,0,101
1624222,1217766,2022-06-22,House,"Reported With Recommendation Without Amendment",6,1,0,0,7
1624222,1226433,2022-09-21,House,"House Third Reading: Given Immediate Effect Roll Call # 414",62,39,0,0,101
1624223,1217662,2022-06-22,House,"Reported With Recommendation Without Amendment",5,2,0,0,7
1624223,1221704,2022-07-01,House,"House Third Reading: Given Immediate Effect Roll Call # 373",56,48,0,0,104
1624223,1226470,2022-09-21,Senate,"Reported Favorably Without Amendment",4,2,0,0,6
1624223,1228968,2022-09-28,Senate,"Senate Third Reading: Passed Roll Call # 448",22,14,0,2,38
1624227,1217836,2022-06-22,House,"Reported With Recommendation Without Amendment",6,1,0,0,7
1624227,1221721,2022-07-01,House,"House Third Reading: Given Immediate Effect Roll Call # 372",56,48,0,0,104
1624227,1226469,2022-09-21,Senate,"Reported Favorably Without Amendment",4,2,0,0,6
1624227,1228977,2022-09-28,Senate,"Senate Third Reading: Passed Roll Call # 447",22,14,0,2,38
1624230,1217653,2022-06-22,House,"Reported With Recommendation Without Amendment",6,1,0,0,7
1624230,1226392,2022-09-21,House,"House Third Reading: Given Immediate Effect Roll Call # 405",57,45,0,0,102
1624234,1217646,2022-06-22,House,"Reported With Recommendation Without Amendment",6,1,0,0,7
1624234,1226434,2022-09-21,House,"House Third Reading: Given Immediate Effect Roll Call # 410",60,39,0,0,99
1624237,1217926,2022-06-22,House,"Reported With Recommendation Without Amendment",6,1,0,0,7
1624237,1221732,2022-07-01,House,"House Third Reading: Given Immediate Effect Roll Call # 376",56,48,0,0,104
1624237,1226473,2022-09-21,Senate,"Reported Favorably Without Amendment",4,2,0,0,6
1624237,1228978,2022-09-28,Senate,"Senate Third Reading: Passed Roll Call # 452",22,14,0,2,38
1624238,1217643,2022-06-22,House,"Reported With Recommendation With Substitute H-1",5,2,0,0,7
1624545,1216829,2022-06-16,Senate,"Reported Favorably Without Amendment",6,0,0,0,6
1624545,1229664,2022-09-20,Senate,"Senate Third Reading: Passed Roll Call # 414",27,9,0,2,38
1624966,1226462,2022-09-21,Senate,"Reported Favorably Without Amendment",8,0,0,0,8
1624966,1228710,2022-09-28,Senate,"Senate Third Reading: Passed Roll Call # 443",36,0,0,2,38
1625336,1226426,2022-09-21,House,"Reported With Recommendation With Substitute H-2",10,0,0,0,10
1625340,1226421,2022-09-21,House,"Reported With Recommendation Without Amendment",15,0,0,0,15
1626088,1226427,2022-09-21,House,"Reported With Recommendation Without Amendment",10,0,0,0,10
1626094,1230632,2022-12-06,Senate,"Reported Favorably Without Amendment",8,0,0,0,8
1626100,1230505,2022-12-06,Senate,"Reported Favorably Without Amendment",8,0,0,0,8
1626115,1230507,2022-12-06,Senate,"Reported Favorably Without Amendment",8,0,0,0,8
1626118,1230631,2022-12-06,Senate,"Reported Favorably Without Amendment",8,0,0,0,8
1626120,1226418,2022-09-21,House,"Reported With Recommendation Without Amendment",10,0,0,0,10
1626120,1227463,2022-09-28,House,"House Third Reading: Given Immediate Effect Roll Call # 436",102,4,0,0,106
1626124,1226423,2022-09-21,House,"Reported With Recommendation Without Amendment",10,0,0,0,10
1626124,1228988,2022-09-28,House,"House Third Reading: Given Immediate Effect Roll Call # 438",102,4,0,0,106
1626126,1226477,2022-09-21,Senate,"Reported Favorably Without Amendment",9,0,0,0,9
1626126,1228948,2022-09-28,Senate,"Senate Third Reading: Passed Roll Call # 435",36,0,0,2,38
1626129,1226420,2022-09-21,House,"Reported With Recommendation Without Amendment",10,0,0,0,10
1626129,1228586,2022-09-28,House,"House Third Reading: Given Immediate Effect Roll Call # 441",103,3,0,0,106
1626130,1230633,2022-12-06,Senate,"Reported Favorably Without Amendment",8,0,0,0,8
1626139,1226417,2022-09-21,House,"Reported With Recommendation With Substitute H-1",10,0,0,0,10
1626140,1226428,2022-09-21,House,"Reported With Recommendation Without Amendment",10,0,0,0,10
1626144,1230629,2022-12-06,Senate,"Reported Favorably Without Amendment",8,0,0,0,8
1626145,1230628,2022-12-06,Senate,"Reported Favorably Without Amendment",8,0,0,0,8
1626148,1230504,2022-12-06,Senate,"Reported Favorably Without Amendment",8,0,0,0,8
1626152,1230630,2022-12-06,Senate,"Reported Favorably Without Amendment",8,0,0,0,8
1626156,1226425,2022-09-21,House,"Reported With Recommendation Without Amendment",10,0,0,0,10
1626156,1229012,2022-09-28,House,"House Third Reading: Given Immediate Effect Roll Call # 440",100,6,0,0,106
1626163,1229296,2022-10-11,Senate,"Reported Favorably With Substitute S-1",8,0,0,0,8
1626164,1226475,2022-09-21,Senate,"Reported Favorably Without Amendment",10,0,0,0,10
1626164,1228952,2022-09-28,Senate,"Senate Third Reading: Passed Roll Call # 433",35,1,0,2,38
1626167,1228985,2022-10-11,Senate,"Reported Favorably Without Amendment",8,0,0,0,8
1626170,1226416,2022-09-21,House,"Reported With Recommendation Without Amendment",10,0,0,0,10
1626170,1228587,2022-09-28,House,"House Third Reading: Given Immediate Effect Roll Call # 437",102,4,0,0,106
1626172,1226424,2022-09-21,House,"Reported With Recommendation Without Amendment",10,0,0,0,10
1626172,1228566,2022-09-28,House,"House Third Reading: Given Immediate Effect Roll Call # 442",100,6,0,0,106
1626173,1226476,2022-09-21,Senate,"Reported Favorably With Substitute S-1",10,0,0,0,10
1626173,1228949,2022-09-28,Senate,"Senate Third Reading: Passed Roll Call # 434",35,1,0,2,38
1626176,1228980,2022-10-11,Senate,"Reported Favorably With Substitute S-1",9,0,0,0,9
1626177,1230506,2022-12-06,Senate,"Reported Favorably Without Amendment",8,0,0,0,8
1628182,1226405,2022-09-21,House,"Reported With Recommendation Without Amendment",5,0,0,0,5
1628182,1229198,2022-09-21,House,"House Third Reading: Passed Roll Call # 380",73,33,0,0,106
1628182,1229199,2022-09-21,House,"House Third Reading: Given Immediate Effect Roll Call # 381",70,38,0,0,108
1628182,1229200,2022-09-28,Senate,"Senate Third Reading: Given Immediate Effect Roll Call # 440",26,10,0,2,38
1628188,1229284,2022-09-07,House,"Reported With Recommendation Without Amendment",28,0,0,0,28
1628188,1229285,2022-09-21,House,"House Third Reading: Given Immediate Effect Roll Call # 398",108,0,0,0,108
1628188,1229286,2022-09-28,Senate,"Senate Third Reading: Given Immediate Effect Roll Call # 431",36,0,0,2,38
1628480,1228567,2022-09-28,Senate,"Reported Favorably Without Amendment",8,0,0,0,8
1628480,1228957,2022-09-28,Senate,"Senate Third Reading: Passed Roll Call # 458",35,0,0,3,38
1628490,1229210,2022-10-11,Senate,"Reported Favorably Without Amendment",8,0,0,0,8
1628527,1226382,2022-09-21,House,"Reported With Recommendation Without Amendment",11,0,0,0,11
1628527,1226383,2022-09-21,House,"House Third Reading: Given Immediate Effect Roll Call # 401",106,2,0,0,108
1628542,1226419,2022-09-21,House,"Reported With Recommendation Without Amendment",15,0,0,0,15
1628856,1228983,2022-10-11,Senate,"Reported Favorably Without Amendment",8,0,0,0,8
1628856,1229875,2022-11-10,Senate,"Senate Third Reading: Passed Roll Call # 474",35,1,0,2,38
1628858,1228956,2022-09-28,Senate,"Reported Favorably Without Amendment",8,0,0,0,8
1628858,1230065,2022-11-10,Senate,"Senate Third Reading: Passed Roll Call # 472",36,0,0,2,38
1628944,1226431,2022-09-21,Senate,"Reported Favorably Without Amendment",5,0,0,0,5
1628945,1226322,2022-09-20,Senate,"Reported Favorably With Substitute S-1",7,1,0,0,8
1628945,1229678,2022-09-20,Senate,"Senate Third Reading: Passed Roll Call # 426",35,1,0,2,38
1628950,1226429,2022-09-21,House,"Reported With Recommendation Without Amendment",28,0,0,0,28
1628950,1226430,2022-09-21,House,"House Third Reading: Given Immediate Effect Roll Call # 400",108,0,0,0,108
1628950,1230099,2022-11-29,Senate,"Reported Favorably Without Amendment",5,0,0,0,5
1629054,1226422,2022-09-21,House,"Reported With Recommendation With Substitute H-2",15,0,0,0,15
1629364,1230595,2022-11-29,Senate,"Reported Favorably Without Amendment",8,0,0,0,8
1629366,1230577,2022-11-29,Senate,"Reported Favorably Without Amendment",8,0,0,0,8
1629370,1230582,2022-11-29,Senate,"Reported Favorably Without Amendment",8,0,0,0,8
1629371,1230094,2022-11-29,Senate,"Reported Favorably Without Amendment",5,0,0,0,5
1629373,1228585,2022-09-28,House,"Reported With Recommendation With Substitute H-1",16,6,0,0,22
1629380,1230084,2022-11-10,House,"Reported With Recommendation With Substitute H-1",19,0,0,0,19
1629832,1228565,2022-09-28,Senate,"Reported Favorably Without Amendment",8,0,0,0,8
1629832,1229874,2022-11-10,Senate,"Senate Third Reading: Passed Roll Call # 473",36,0,0,2,38
1630061,1230634,2022-12-06,Senate,"Reported Favorably With Substitute S-1",5,2,0,0,7
1631113,1230102,2022-11-29,Senate,"Reported Favorably Without Amendment",5,0,0,0,5
1631968,1230100,2022-11-29,Senate,"Reported Favorably Without Amendment",5,0,0,0,5
1631968,1230101,2022-11-29,Senate,"Senate Third Reading: Passed Roll Call # 478",37,0,0,1,38
