bill_id,roll_call_id,date,chamber,description,yea,nay,nv,absent,total
224252,74401,2011-04-26,House,"Reported With Recommendation For Referral To Committee On Families, Children, And Seniors",14,0,0,0,14
224252,83811,2011-05-24,House,"Reported With Recommendation Without Amendment",6,2,0,0,8
224252,90840,2011-06-08,House,"House Third Reading: Given Immediate Effect Roll Call # 166",63,46,0,0,109
224252,103802,2011-12-01,Senate,"Reported Favorably Without Amendment",5,2,0,0,7
224252,215183,2012-12-06,Senate,"Senate Third Reading: Passed Roll Call # 863",22,4,12,0,38
224252,215332,2012-12-11,House,"House Third Reading:  Roll Call # 721",58,51,0,0,109
224253,55102,2011-02-09,House,"Reported With Recommendation With Substitute H-2",15,0,0,0,15
224253,55103,2011-02-17,House,"House Third Reading: Given Immediate Effect Roll Call # 9",109,0,0,0,109
224253,66746,2011-04-13,Senate,"Reported Favorably Without Amendment",6,0,0,0,6
224253,76905,2011-05-04,Senate,"Senate Third Reading: Given Immediate Effect Roll Call # 122",36,0,1,1,38
224254,79258,2011-05-10,House,"Reported With Recommendation Without Amendment",5,4,0,0,9
224254,100735,2011-08-24,House,"House Third Reading: Given Immediate Effect Roll Call # 307",72,36,0,0,108
224254,102709,2011-10-04,Senate,"Reported Favorably With Substitute S-1",4,0,0,0,4
224254,103209,2011-11-03,Senate,"Senate Third Reading: Given Immediate Effect Roll Call # 649",24,14,0,0,38
224254,103313,2011-11-09,House,"House Third Reading: Senate Amendment(s) Concurred In Roll Call # 461",69,39,0,0,108
224255,79275,2011-05-10,House,"Reported With Recommendation Without Amendment",5,4,0,0,9
224255,100741,2011-08-24,House,"House Third Reading: Given Immediate Effect Roll Call # 308",72,36,0,0,108
224262,55400,2011-03-10,House,"Reported With Recommendation With Substitute H-1",15,1,0,0,16
224262,56141,2011-03-24,House,"House Third Reading: Given Immediate Effect Roll Call # 57",99,11,0,0,110
224262,86135,2011-05-25,Senate,"Reported Favorably Without Amendment",4,0,0,0,4
224265,80005,2011-05-11,House,"Reported With Recommendation With Substitute H-2",11,0,0,0,11
224265,93581,2011-06-16,House,"House Third Reading: Given Immediate Effect Roll Call # 197",100,8,0,0,108
224266,79936,2011-05-11,House,"Reported With Recommendation With Substitute H-1",11,0,0,0,11
224266,93520,2011-06-16,House,"House Third Reading: Given Immediate Effect Roll Call # 198",105,3,0,0,108
224266,103234,2011-11-03,Senate,"Reported Favorably Without Amendment",5,2,0,0,7
224266,103413,2011-11-10,Senate,"Senate Third Reading: Given Immediate Effect Roll Call # 682",27,9,0,2,38
224274,95117,2011-06-22,House,"Reported With Recommendation With Substitute H-3",13,3,0,0,16
224274,189833,2012-04-26,House,"House Third Reading: Given Immediate Effect Roll Call # 199",81,29,0,0,110
224274,201331,2012-06-06,Senate,"Reported Favorably With Substitute S-1",6,0,0,0,6
224274,202539,2012-06-14,Senate,"Senate Third Reading: Given Immediate Effect Roll Call # 542",37,1,0,0,38
224274,202540,2012-06-14,House,"House Third Reading:  Roll Call # 486",87,22,0,0,109
224278,97605,2011-06-29,House,"Reported With Recommendation Without Amendment",12,1,0,0,13
224278,103665,2011-11-30,House,"House Third Reading: Given Immediate Effect Roll Call # 510",73,33,0,0,106
224279,97614,2011-06-29,House,"Reported With Recommendation Without Amendment",12,1,0,0,13
224279,103781,2011-11-30,House,"House Third Reading: Given Immediate Effect Roll Call # 511",74,32,0,0,106
224280,97644,2011-06-29,House,"Reported With Recommendation Without Amendment",12,1,0,0,13
224280,104708,2011-11-30,House,"House Third Reading: Given Immediate Effect Roll Call # 512",75,31,0,0,106
224291,57181,2011-03-23,House,"Reported With Recommendation With Substitute H-1",14,0,0,0,14
224291,93454,2011-06-16,House,"House Third Reading: Given Immediate Effect Roll Call # 195",103,5,0,0,108
224291,103230,2011-11-03,Senate,"Reported Favorably With Substitute S-2",5,2,0,0,7
224291,103397,2011-11-10,Senate,"Senate Third Reading: Given Immediate Effect Roll Call # 683",25,11,0,2,38
224291,103398,2011-11-10,House,"House Third Reading:  Roll Call # 485",101,6,0,0,107
224292,57625,2011-03-23,House,"Reported With Recommendation With Substitute H-2",14,0,0,0,14
224292,93485,2011-06-16,House,"House Third Reading: Given Immediate Effect Roll Call # 196",105,3,0,0,108
224292,103232,2011-11-03,Senate,"Reported Favorably Without Amendment",7,0,0,0,7
224292,103405,2011-11-10,Senate,"Senate Third Reading: Given Immediate Effect Roll Call # 684",34,2,0,2,38
224301,102385,2011-09-20,House,"Reported With Recommendation With Substitute H-1",4,2,0,0,6
224303,215169,2012-12-06,House,"House Third Reading: Passed Roll Call # 693",64,42,0,0,106
224303,215307,2012-12-06,House,"House Third Reading: Passed Roll Call # 694",58,52,0,0,110
224308,54836,2011-03-15,House,"Reported With Recommendation With Substitute H-2",4,2,0,0,6
224308,67914,2011-04-14,House,"House Third Reading: Given Immediate Effect Roll Call # 76",59,47,0,0,106
224308,198606,2012-05-24,Senate,"Reported Favorably With Substitute S-7",5,2,0,0,7
224310,92478,2011-06-15,House,"Reported With Recommendation With Substitute H-2",12,0,0,0,12
224310,94425,2011-06-23,House,"House Third Reading: Given Immediate Effect Roll Call # 218",105,5,0,0,110
224310,100578,2011-08-24,Senate,"Reported Favorably Without Amendment",7,0,0,0,7
224310,103027,2011-10-26,Senate,"Senate Third Reading: Given Immediate Effect Roll Call # 593",38,0,0,0,38
224310,103050,2011-10-27,House,"House Third Reading: Senate Amendment(s) Concurred In Roll Call # 430",103,4,0,0,107
224316,149123,2012-01-31,House,"Reported With Recommendation For Referral To Committee On Judiciary",8,0,0,0,8
224317,149105,2012-01-31,House,"Reported With Recommendation For Referral To Committee On Judiciary",8,0,0,0,8
224318,149099,2012-01-31,House,"Reported With Recommendation For Referral To Committee On Judiciary",8,0,0,0,8
224320,96637,2011-06-30,House,"Reported With Recommendation Without Amendment",14,0,0,0,14
224320,102360,2011-09-20,House,"House Third Reading: Given Immediate Effect Roll Call # 336",93,15,0,0,108
224320,102727,2011-10-05,Senate,"Reported Favorably Without Amendment",4,0,0,0,4
224320,103017,2011-10-26,Senate,"Senate Third Reading: Given Immediate Effect Roll Call # 594",33,5,0,0,38
224321,143971,2012-01-19,House,"Reported With Recommendation With Substitute H-3",13,0,0,0,13
224322,143936,2012-01-19,House,"Reported With Recommendation With Amendment(s)",13,0,0,0,13
224323,102581,2011-09-22,House,"Reported With Recommendation With Substitute H-2",15,0,0,0,15
224323,103051,2011-10-27,House,"House Third Reading: Given Immediate Effect Roll Call # 431",107,0,0,0,107
224323,145929,2012-01-25,Senate,"Reported Favorably Without Amendment",4,0,0,0,4
224323,151903,2012-02-09,Senate,"Senate Third Reading: Given Immediate Effect Roll Call # 58",36,0,0,2,38
224324,102580,2011-09-22,House,"Reported With Recommendation With Substitute H-1",15,0,0,0,15
224324,103048,2011-10-27,House,"House Third Reading: Given Immediate Effect Roll Call # 433",108,0,0,0,108
224324,145895,2012-01-25,Senate,"Reported Favorably Without Amendment",4,0,0,0,4
224324,151882,2012-02-09,Senate,"Senate Third Reading: Given Immediate Effect Roll Call # 59",37,0,0,1,38
224325,102437,2011-09-22,House,"Reported With Recommendation With Substitute H-1",15,0,0,0,15
224325,103044,2011-10-27,House,"House Third Reading: Given Immediate Effect Roll Call # 432",107,0,0,0,107
224325,145812,2012-01-25,Senate,"Reported Favorably Without Amendment",4,0,0,0,4
224325,152308,2012-02-09,Senate,"Senate Third Reading: Given Immediate Effect Roll Call # 60",37,0,0,1,38
224326,102434,2011-09-22,House,"Reported With Recommendation With Substitute H-2",15,0,0,0,15
224326,103040,2011-10-27,House,"House Third Reading: Given Immediate Effect Roll Call # 434",108,0,0,0,108
224326,147325,2012-01-25,Senate,"Reported Favorably Without Amendment",4,0,0,0,4
224326,152195,2012-02-09,Senate,"Senate Third Reading: Given Immediate Effect Roll Call # 61",36,1,0,1,38
232441,92840,2011-06-15,House,"Reported With Recommendation With Substitute H-4",6,0,0,0,6
232441,94522,2011-06-23,House,"House Third Reading: Given Immediate Effect Roll Call # 217",107,3,0,0,110
232441,102792,2011-10-05,Senate,"Reported Favorably With Substitute S-2",6,0,0,0,6
232441,102793,2011-10-05,Senate,"Senate Third Reading: Given Immediate Effect Roll Call # 549",37,1,0,0,38
232441,102794,2011-10-06,House,"House Third Reading:  Roll Call # 391",96,11,0,0,107
232442,75206,2011-04-27,House,"Reported With Recommendation With Substitute H-4",16,0,0,0,16
232442,77397,2011-05-05,House,"House Third Reading: Given Immediate Effect Roll Call # 100",110,0,0,0,110
232447,57469,2011-01-25,House,"Reported With Recommendation For Referral To Committee On Natural Resources, Tourism, And Outdoor Recreation",9,0,0,0,9
232450,196167,2012-05-15,House,"Reported With Recommendation With Substitute H-3",4,0,0,0,4
232450,200555,2012-05-30,House,"House Third Reading: Given Immediate Effect Roll Call # 325",110,0,0,0,110
232450,212985,2012-10-17,Senate,"Reported Favorably Without Amendment",5,1,0,0,6
232450,215454,2012-12-12,Senate,"Senate Third Reading: Given Immediate Effect Roll Call # 887",32,6,0,0,38
232451,190482,2012-03-22,House,"Reported With Recommendation For Referral To Committee On Oversight, Reform, And Ethics",12,0,0,0,12
232460,79398,2011-05-12,House,"Reported With Recommendation With Substitute H-4",14,0,0,0,14
232463,94251,2011-06-21,House,"Reported With Recommendation Without Amendment",7,2,0,0,9
232463,102471,2011-09-21,House,"House Third Reading: Given Immediate Effect Roll Call # 341",75,33,0,0,108
232463,102719,2011-10-04,Senate,"Reported Favorably With Substitute S-1",4,0,0,0,4
232464,94332,2011-06-21,House,"Reported With Recommendation Without Amendment",7,2,0,0,9
232464,102473,2011-09-21,House,"House Third Reading: Given Immediate Effect Roll Call # 342",75,33,0,0,108
232464,102606,2011-09-28,Senate,"Reported Favorably Without Amendment",11,3,0,0,14
232464,102607,2011-09-28,Senate,"Senate Third Reading: Given Immediate Effect Roll Call # 536",29,9,0,0,38
232464,102687,2011-10-04,Senate,"Senate Third Reading: Passed Roll Call # 544",29,9,0,0,38
232464,102688,2011-10-04,House,"House Third Reading: Senate Amendment(s) Concurred In Roll Call # 375",75,34,0,0,109
232465,55039,2011-03-08,House,"Reported With Recommendation With Substitute H-1",9,0,0,0,9
232465,55040,2011-03-17,House,"House Third Reading: Given Immediate Effect Roll Call # 40",79,31,0,0,110
232465,73687,2011-04-26,Senate,"Reported Favorably With Substitute S-1",5,1,0,0,6
232465,86557,2011-05-31,Senate,"Senate Third Reading: Given Immediate Effect Roll Call # 263",33,3,0,2,38
232465,92409,2011-06-14,House,"House Third Reading:  Roll Call # 188",78,29,0,0,107
232467,56151,2011-02-23,House,"Reported With Recommendation With Substitute H-1",12,1,0,0,13
232467,56152,2011-03-02,House,"House Third Reading: Given Immediate Effect Roll Call # 26",100,9,0,0,109
232467,73293,2011-04-26,Senate,"Reported Favorably With Amendment(s)",7,0,0,0,7
232467,78713,2011-05-10,Senate,"Senate Third Reading: Given Immediate Effect Roll Call # 139",38,0,0,0,38
232467,81969,2011-05-17,House,"House Third Reading: Senate Amendment(s) Concurred In Roll Call # 130",105,3,0,0,108
232469,103088,2011-10-25,House,"Reported With Recommendation Without Amendment",8,0,0,0,8
232469,103268,2011-11-08,House,"House Third Reading: Given Immediate Effect Roll Call # 460",107,0,0,0,107
232469,215347,2012-12-11,Senate,"Reported Favorably Without Amendment",3,0,0,0,3
232469,215737,2012-12-13,Senate,"Senate Third Reading: Given Immediate Effect Roll Call # 968",38,0,0,0,38
232470,103286,2011-11-08,House,"Reported With Recommendation With Substitute H-2",4,0,0,0,4
232470,146293,2012-01-26,House,"House Third Reading: Given Immediate Effect Roll Call # 16",106,0,0,0,106
232470,198155,2012-05-23,Senate,"Reported Favorably Without Amendment",5,0,0,0,5
232470,202567,2012-06-14,Senate,"Senate Third Reading: Given Immediate Effect Roll Call # 529",38,0,0,0,38
232470,202568,2012-06-14,House,"House Third Reading:  Roll Call # 482",109,0,0,0,109
232472,54883,2011-03-16,House,"Reported With Recommendation For Referral To Committee On Banking And Financial Services",5,0,0,0,5
232475,148448,2012-01-31,House,"Reported With Recommendation With Substitute H-1",9,0,0,0,9
232475,150953,2012-02-07,House,"House Third Reading: Given Immediate Effect Roll Call # 30",104,0,0,0,104
232475,215689,2012-12-14,Senate,"Senate Third Reading: Given Immediate Effect Roll Call # 1088",38,0,0,0,38
232475,215858,2012-12-14,House,"House Third Reading: Senate Amendment(s) Concurred In Roll Call # 908",105,0,0,0,105
232476,149085,2012-01-31,House,"Reported With Recommendation With Substitute H-1",9,0,0,0,9
232476,150975,2012-02-07,House,"House Third Reading: Given Immediate Effect Roll Call # 31",104,0,0,0,104
232476,215691,2012-12-14,Senate,"Senate Third Reading: Given Immediate Effect Roll Call # 1089",38,0,0,0,38
232488,54867,2011-03-15,Senate,"Reported Favorably With Substitute S-2",4,2,0,0,6
232488,54868,2011-03-17,Senate,"Senate Third Reading: Passed Roll Call # 76",37,1,0,0,38
232488,55704,2011-03-23,House,"Reported With Recommendation Without Amendment",12,0,0,0,12
232488,56328,2011-03-24,House,"House Third Reading: Given Immediate Effect Roll Call # 68",107,3,0,0,110
232490,67549,2011-04-14,Senate,"Reported Favorably With Substitute S-3",4,2,0,0,6
232490,81301,2011-05-18,Senate,"Senate Third Reading: Passed Roll Call # 214",25,13,0,0,38
232490,96622,2011-06-30,House,"Reported With Recommendation With Substitute H-6",4,2,0,0,6
232490,96623,2011-06-30,House,"House Third Reading: Given Immediate Effect Roll Call # 298",56,52,0,0,108
232490,98889,2011-07-13,Senate,"Senate Third Reading:  Roll Call # 447",0,36,0,2,38
232490,100550,2011-08-24,Senate,"Senate Third Reading: Senate Adopted Conference Report With Immediate Effect Roll Call # 450",25,13,0,0,38
232490,100551,2011-08-24,House,"House Third Reading: Conference Report Adopted Roll Call # 316",59,48,0,0,107
232491,91186,2011-06-09,Senate,"Reported Favorably With Substitute S-3",4,2,0,0,6
232491,94250,2011-06-22,Senate,"Senate Third Reading: Passed Roll Call # 333",26,12,0,0,38
232491,95533,2011-06-28,House,"Reported With Recommendation Without Amendment",11,0,0,0,11
232491,103252,2011-11-03,House,"House Third Reading: Given Immediate Effect Roll Call # 449",72,35,0,0,107
232491,103253,2011-11-03,Senate,"Senate Third Reading:  Roll Call # 652",25,10,3,0,38
232491,103254,2011-11-03,Senate,"Senate Third Reading:  Roll Call # 653",26,11,0,1,38
232492,91189,2011-06-09,Senate,"Reported Favorably Without Amendment",5,2,0,0,7
232492,94262,2011-06-22,Senate,"Senate Third Reading: Passed Roll Call # 334",26,12,0,0,38
232492,95544,2011-06-28,House,"Reported With Recommendation Without Amendment",8,3,0,0,11
232492,103251,2011-11-03,House,"House Third Reading: Given Immediate Effect Roll Call # 450",72,35,0,0,107
232493,91252,2011-06-09,Senate,"Reported Favorably Without Amendment",5,2,0,0,7
232495,56283,2011-03-24,Senate,"Reported Favorably Without Amendment",4,0,0,0,4
232495,76400,2011-05-03,Senate,"Senate Third Reading: Passed Roll Call # 121",26,12,0,0,38
232495,93238,2011-06-14,House,"Reported With Recommendation With Amendment(s)",12,5,0,0,17
232500,55716,2011-03-08,Senate,"Reported Favorably With Substitute S-1",5,0,0,0,5
232502,55425,2011-01-26,Senate,"Reported Favorably Without Amendment",4,0,0,0,4
232502,55426,2011-02-09,Senate,"Senate Third Reading: Passed Roll Call # 11",34,2,0,2,38
232502,74879,2011-04-28,House,"Reported With Recommendation With Substitute H-3",11,0,0,0,11
232503,54912,2011-02-10,Senate,"Reported Favorably With Substitute S-1",5,2,0,0,7
232503,54913,2011-02-10,Senate,"Senate Third Reading: Passed Roll Call # 13",25,12,0,1,38
232503,54914,2011-02-16,House,"Reported With Recommendation With Substitute H-1",12,3,0,0,15
232503,54915,2011-02-24,House,"House Third Reading: Given Immediate Effect Roll Call # 22",69,38,0,0,107
232503,54916,2011-03-08,Senate,"Senate Third Reading:  Roll Call # 29",26,11,0,1,38
232504,154766,2012-02-14,Senate,"Reported Favorably With Recommendation For Referral To Committee On Reforms, Restructuring And Reinventing",11,2,0,0,13
232504,190464,2012-04-26,Senate,"Reported Favorably With Substitute S-3",5,2,0,0,7
232504,193099,2012-05-03,Senate,"Senate Third Reading: Passed Roll Call # 304",26,12,0,0,38
232504,215042,2012-12-04,House,"Reported With Recommendation Without Amendment",5,0,0,0,5
232504,215598,2012-12-12,House,"House Third Reading: Given Immediate Effect Roll Call # 758",109,0,0,0,109
232505,54809,2011-01-26,Senate,"Reported Favorably Without Amendment",4,0,0,0,4
232505,54810,2011-01-27,Senate,"Senate Third Reading: Passed Roll Call # 8",37,0,0,1,38
232505,54811,2011-02-17,House,"Reported With Recommendation Without Amendment",16,0,0,0,16
232505,54812,2011-03-08,House,"House Third Reading: Given Immediate Effect Roll Call # 29",109,1,0,0,110
232506,54854,2011-01-26,Senate,"Reported Favorably With Substitute S-1",4,0,0,0,4
232506,54855,2011-02-01,Senate,"Senate Third Reading: Passed Roll Call # 9",36,0,0,2,38
232506,54856,2011-02-17,House,"Reported With Recommendation Without Amendment",16,0,0,0,16
232506,54857,2011-03-08,House,"House Third Reading: Given Immediate Effect Roll Call # 30",109,1,0,0,110
232507,79762,2011-05-11,Senate,"Reported Favorably With Substitute S-1",6,0,0,0,6
232507,83912,2011-05-24,Senate,"Senate Third Reading: Passed Roll Call # 224",37,0,0,1,38
232507,94585,2011-06-23,House,"Reported With Recommendation Without Amendment",17,0,0,0,17
232507,96224,2011-06-29,House,"House Third Reading: Given Immediate Effect Roll Call # 250",109,0,0,0,109
232508,57999,2011-02-16,Senate,"Reported Favorably With Substitute S-1",4,0,0,0,4
232508,102919,2011-10-20,Senate,"Senate Third Reading: Passed Roll Call # 584",33,5,0,0,38
232509,90640,2011-06-07,Senate,"Reported Favorably With Substitute S-1",5,1,0,0,6
232510,83760,2011-05-24,Senate,"Reported Favorably With Substitute S-1",4,0,0,0,4
232511,73444,2011-04-26,Senate,"Reported Favorably With Substitute S-1",6,0,0,0,6
232511,78744,2011-05-10,Senate,"Senate Third Reading: Passed Roll Call # 138",38,0,0,0,38
232511,93080,2011-06-15,House,"Reported With Recommendation With Substitute H-3",17,0,0,0,17
232511,96178,2011-06-29,House,"House Third Reading: Given Immediate Effect Roll Call # 246",109,0,0,0,109
232511,96179,2011-06-29,Senate,"Senate Third Reading:  Roll Call # 378",38,0,0,0,38
232512,57918,2011-02-08,Senate,"Reported Favorably With Substitute S-2",4,0,0,0,4
232512,102723,2011-10-04,Senate,"Senate Third Reading: Passed Roll Call # 545",35,3,0,0,38
232512,177526,2012-03-22,House,"Reported With Recommendation Without Amendment",13,0,0,0,13
232512,187389,2012-04-19,House,"House Third Reading: Given Immediate Effect Roll Call # 182",106,4,0,0,110
232512,189464,2012-04-25,House,"House Third Reading: Passed Roll Call # 189",107,3,0,0,110
232512,189998,2012-04-26,Senate,"Senate Third Reading:  Roll Call # 259",35,3,0,0,38
232513,57904,2011-02-08,Senate,"Reported Favorably With Substitute S-1",4,0,0,0,4
232513,102721,2011-10-04,Senate,"Senate Third Reading: Passed Roll Call # 546",35,3,0,0,38
232513,177510,2012-03-22,House,"Reported With Recommendation With Substitute H-2",13,0,0,0,13
232513,187293,2012-04-19,House,"House Third Reading: Given Immediate Effect Roll Call # 183",106,4,0,0,110
232513,190570,2012-04-26,Senate,"Senate Third Reading:  Roll Call # 260",35,3,0,0,38
232518,102628,2011-09-28,Senate,"Reported Favorably With Substitute S-1",4,1,0,0,5
232518,103171,2011-11-02,Senate,"Senate Third Reading: Passed Roll Call # 618",37,0,0,1,38
232518,173280,2012-03-15,House,"Reported With Recommendation Without Amendment",16,0,0,0,16
232518,177273,2012-03-22,House,"House Third Reading: Given Immediate Effect Roll Call # 137",107,1,0,0,108
232518,179394,2012-03-28,Senate,"Senate Third Reading:  Roll Call # 167",37,0,0,1,38
232525,103152,2011-11-01,Senate,"Reported Favorably With Recommendation For Referral To Committee On Economic Development",6,0,0,0,6
232526,77758,2011-05-04,Senate,"Reported Favorably With Substitute S-1",7,0,0,0,7
232526,92104,2011-06-14,Senate,"Senate Third Reading: Passed Roll Call # 280",38,0,0,0,38
232526,101985,2011-09-08,House,"Reported With Recommendation For Referral To Committee On Banking And Financial Services",15,0,0,0,15
232526,102592,2011-09-28,House,"Reported With Recommendation With Substitute H-1",11,0,0,0,11
232526,102728,2011-10-05,House,"House Third Reading: Given Immediate Effect Roll Call # 384",109,0,0,0,109
232526,102836,2011-10-12,Senate,"Senate Third Reading:  Roll Call # 569",37,0,0,1,38
232527,77757,2011-05-04,Senate,"Reported Favorably With Substitute S-1",7,0,0,0,7
232527,92073,2011-06-14,Senate,"Senate Third Reading: Passed Roll Call # 281",38,0,0,0,38
232527,101984,2011-09-08,House,"Reported With Recommendation For Referral To Committee On Banking And Financial Services",15,0,0,0,15
232527,102574,2011-09-28,House,"Reported With Recommendation Without Amendment",11,0,0,0,11
232528,56253,2011-03-24,Senate,"Reported Favorably With Recommendation For Referral To Committee On Judiciary",3,0,0,0,3
232529,55898,2011-03-22,Senate,"Reported Favorably With Substitute S-7",5,0,0,0,5
232529,65561,2011-04-12,Senate,"Senate Third Reading: Passed Roll Call # 89",38,0,0,0,38
232529,95144,2011-06-22,House,"Reported With Recommendation Without Amendment",14,0,0,0,14
232529,95665,2011-06-28,House,"House Third Reading: Given Immediate Effect Roll Call # 243",101,7,0,0,108
232536,54886,2011-01-26,Senate,"Reported Favorably Without Amendment",4,0,0,0,4
232536,54887,2011-02-08,Senate,"Senate Third Reading: Passed Roll Call # 10",35,0,0,3,38
232536,54888,2011-02-24,House,"Reported With Recommendation Without Amendment",15,1,0,0,16
232536,54889,2011-03-17,House,"House Third Reading: Given Immediate Effect Roll Call # 39",108,1,0,0,109
232537,55061,2011-02-16,Senate,"Reported Favorably With Substitute S-1",3,0,0,0,3
232537,102927,2011-10-20,Senate,"Senate Third Reading: Passed Roll Call # 585",33,5,0,0,38
232538,55066,2011-02-16,Senate,"Reported Favorably With Substitute S-1",4,0,0,0,4
232542,69373,2011-04-14,Senate,"Reported Favorably Without Amendment",5,0,0,0,5
232542,81478,2011-05-18,Senate,"Senate Third Reading: Adopted By 2/3 Vote Roll Call # 215",26,12,0,0,38
232542,95131,2011-06-22,House,"Reported With Recommendation With Substitute H-2",4,1,0,0,5
232542,97146,2011-06-30,House,"House Third Reading: Defeated Roll Call # 299",61,47,0,0,108
232542,98169,2011-06-30,House,"House Third Reading: Not Adopted Roll Call # 299",61,47,0,0,108
232543,55668,2011-01-19,Senate,"Senate Third Reading:  Roll Call # 5",36,0,0,2,38
232544,55895,2011-01-20,Senate,"Senate Third Reading:  Roll Call # 6",38,0,0,0,38
242696,103694,2011-02-08,House,"Reported With Recommendation Without Amendment",10,0,0,0,10
242696,103695,2011-03-15,Senate,"Reported Favorably Without Amendment",4,0,0,0,4
242699,56076,2011-03-09,Senate,"Reported Favorably Without Amendment",6,0,0,0,6
242699,66666,2011-04-13,Senate,"Senate Third Reading: Passed Roll Call # 91",38,0,0,0,38
242699,215855,2012-12-14,House,"House Third Reading: Passed Roll Call # 910",83,22,0,0,105
242701,189450,2012-04-25,Senate,"Reported Favorably With Recommendation For Referral To Committee On Natural Resources, Environment And Great Lakes",3,0,0,0,3
242702,148428,2012-02-01,Senate,"Reported Favorably With Recommendation For Referral To Committee On Natural Resources, Environment And Great Lakes",4,0,0,0,4
242702,178592,2012-03-27,Senate,"Reported Favorably With Substitute S-3",5,1,0,0,6
242702,214244,2012-11-29,Senate,"Senate Third Reading: Passed Roll Call # 791",27,11,0,0,38
242702,215397,2012-12-12,House,"Reported With Recommendation With Substitute H-2",7,2,0,0,9
242702,215525,2012-12-13,House,"House Third Reading: Given Immediate Effect Roll Call # 821",68,41,0,0,109
242702,215666,2012-12-13,Senate,"Senate Third Reading:  Roll Call # 1052",27,11,0,0,38
242703,103627,2011-11-29,Senate,"Reported Favorably With Recommendation For Referral To Committee On Judiciary",7,0,0,0,7
242704,103623,2011-11-29,Senate,"Reported Favorably With Recommendation For Referral To Committee On Judiciary",7,0,0,0,7
242704,209818,2012-08-15,Senate,"Reported Favorably With Substitute S-1",4,0,0,0,4
242707,91877,2011-06-09,Senate,"Reported Favorably With Substitute S-3",4,0,0,0,4
242707,101773,2011-09-07,Senate,"Senate Third Reading: Passed Roll Call # 471",34,3,0,1,38
242707,176998,2012-03-22,House,"Reported With Recommendation Without Amendment",14,0,0,0,14
242707,192360,2012-05-02,House,"House Third Reading: Given Immediate Effect Roll Call # 216",109,1,0,0,110
242708,91845,2011-06-09,Senate,"Reported Favorably With Substitute S-1",4,0,0,0,4
242708,101750,2011-09-07,Senate,"Senate Third Reading: Passed Roll Call # 472",37,0,0,1,38
242708,177603,2012-03-22,House,"Reported With Recommendation Without Amendment",14,0,0,0,14
242708,192290,2012-05-02,House,"House Third Reading: Given Immediate Effect Roll Call # 217",110,0,0,0,110
243401,55200,2011-02-16,House,"Reported With Recommendation Without Amendment",12,0,0,0,12
243401,55201,2011-02-24,House,"House Third Reading: Given Immediate Effect Roll Call # 23",107,0,0,0,107
243401,75367,2011-04-27,Senate,"Reported Favorably Without Amendment",6,0,0,0,6
243401,78719,2011-05-10,Senate,"Senate Third Reading: Given Immediate Effect Roll Call # 141",38,0,0,0,38
243405,74614,2011-04-26,House,"Reported With Recommendation With Substitute H-2",9,0,0,0,9
243406,156771,2012-02-15,House,"Reported With Recommendation With Substitute H-1",10,5,0,0,15
243406,166432,2012-03-01,House,"House Third Reading: Given Immediate Effect Roll Call # 84",74,33,0,0,107
243406,215464,2012-12-12,Senate,"Senate Third Reading: Given Immediate Effect Roll Call # 893",22,15,1,0,38
243406,215588,2012-12-13,House,"House Third Reading:  Roll Call # 827",93,16,0,0,109
243407,55019,2011-02-08,House,"Reported With Recommendation Without Amendment",5,1,0,0,6
243407,55020,2011-02-10,House,"House Third Reading: Given Immediate Effect Roll Call # 5",84,24,0,0,108
243407,65564,2011-04-12,Senate,"Reported Favorably Without Amendment",12,0,0,0,12
243407,67670,2011-04-14,Senate,"Senate Third Reading: Given Immediate Effect Roll Call # 94",38,0,0,0,38
243407,73492,2011-04-26,House,"House Third Reading:  Roll Call # 78",84,24,0,0,108
244640,139982,2011-01-26,Senate,"Senate Third Reading:  Roll Call # 7",37,0,0,1,38
244640,139983,2011-01-27,House,"House Third Reading:  Roll Call # 3",45,63,0,0,108
245267,103375,2011-11-09,House,"Reported With Recommendation With Substitute H-1",14,0,0,0,14
245267,146282,2012-01-26,House,"House Third Reading: Given Immediate Effect Roll Call # 18",59,47,0,0,106
245267,202484,2012-06-13,Senate,"Reported Favorably Without Amendment",4,0,0,0,4
245267,202485,2012-06-14,Senate,"Senate Third Reading: Given Immediate Effect Roll Call # 539",30,8,0,0,38
245271,94847,2011-06-23,House,"Reported With Recommendation With Substitute H-2",11,0,0,0,11
245271,94848,2011-06-23,House,"House Third Reading: Given Immediate Effect Roll Call # 234",109,0,0,0,109
245272,68245,2011-04-13,House,"Reported With Recommendation With Substitute H-1",16,0,0,0,16
245273,54874,2011-02-01,House,"Reported With Recommendation For Referral To Committee On Education",5,0,0,0,5
245273,54875,2011-03-02,House,"Reported With Recommendation With Substitute H-2",12,7,0,0,19
245273,54876,2011-03-10,House,"House Third Reading: Given Immediate Effect Roll Call # 32",63,47,0,0,110
245273,54877,2011-03-17,Senate,"Reported Favorably Without Amendment",3,2,0,0,5
245273,81579,2011-05-18,Senate,"Senate Third Reading: Given Immediate Effect Roll Call # 208",21,17,0,0,38
245277,56177,2011-02-15,House,"Reported With Recommendation With Substitute H-2",5,0,0,0,5
245277,78389,2011-05-05,House,"Reported With Recommendation With Substitute H-7",6,0,0,0,6
245277,81588,2011-05-18,House,"House Third Reading: Given Immediate Effect Roll Call # 139",97,9,0,0,106
246343,54930,2011-02-15,House,"Reported With Recommendation With Substitute H-3",16,3,0,0,19
246343,54931,2011-02-16,House,"House Third Reading: Given Immediate Effect Roll Call # 7",69,41,0,0,110
246343,54932,2011-03-09,Senate,"Reported Favorably Without Amendment",5,1,0,0,6
246343,54933,2011-03-15,Senate,"Senate Third Reading: Passed Roll Call # 68",24,13,0,1,38
246343,54934,2011-03-17,Senate,"Senate Third Reading: Given Immediate Effect Roll Call # 74",25,13,0,0,38
246343,54935,2011-03-17,House,"House Third Reading: Senate Amendment(s) Concurred In Roll Call # 42",69,41,0,0,110
246344,55045,2011-02-22,House,"Reported With Recommendation Without Amendment",4,1,0,0,5
246345,103722,2011-02-08,House,"Reported With Recommendation With Substitute H-1",11,0,0,0,11
246345,103723,2011-02-10,House,"House Third Reading: Given Immediate Effect Roll Call # 4",95,13,0,0,108
246345,103724,2011-02-24,Senate,"Senate Third Reading: Given Immediate Effect Roll Call # 24",35,1,0,2,38
246347,103707,2011-02-22,House,"Reported With Recommendation With Substitute H-1",10,0,0,0,10
246348,103708,2011-02-22,House,"Reported With Recommendation Without Amendment",10,0,0,0,10
246349,103709,2011-02-22,House,"Reported With Recommendation Without Amendment",10,0,0,0,10
246350,55994,2011-02-09,Senate,"Reported Favorably With Substitute S-1",4,0,0,0,4
246350,55995,2011-02-24,Senate,"Senate Third Reading: Passed Roll Call # 22",35,1,0,2,38
246350,94619,2011-06-23,House,"Reported With Recommendation Without Amendment",11,1,0,0,12
246350,102379,2011-09-20,House,"House Third Reading: Given Immediate Effect Roll Call # 337",87,21,0,0,108
246350,102397,2011-09-21,Senate,"Senate Third Reading: House Amendment(s) Concurred In Roll Call # 502",36,0,0,2,38
246365,54966,2011-03-16,Senate,"Reported Favorably With Substitute S-1",4,0,0,0,4
246365,76305,2011-05-03,Senate,"Senate Third Reading: Passed Roll Call # 120",38,0,0,0,38
246365,157857,2012-02-16,House,"Reported With Recommendation With Substitute H-1",14,0,0,0,14
246365,192110,2012-05-01,House,"House Third Reading: Given Immediate Effect Roll Call # 212",109,0,0,0,109
246365,195408,2012-05-10,Senate,"Senate Third Reading:  Roll Call # 329",37,0,0,1,38
246366,57939,2011-02-08,Senate,"Reported Favorably With Substitute S-1",4,0,0,0,4
246366,102724,2011-10-04,Senate,"Senate Third Reading: Passed Roll Call # 547",35,3,0,0,38
246366,177545,2012-03-22,House,"Reported With Recommendation With Substitute H-1",13,0,0,0,13
246366,187401,2012-04-19,House,"House Third Reading: Given Immediate Effect Roll Call # 184",109,1,0,0,110
246366,189999,2012-04-26,Senate,"Senate Third Reading:  Roll Call # 261",35,3,0,0,38
250712,55796,2011-02-15,Senate,"Reported Favorably With Substitute S-3",5,0,0,0,5
250712,55797,2011-02-16,Senate,"Senate Third Reading: Passed Roll Call # 15",38,0,0,0,38
250712,55798,2011-03-02,House,"Reported With Recommendation Without Amendment",15,0,0,0,15
250712,67527,2011-04-14,House,"House Third Reading: Given Immediate Effect Roll Call # 75",107,0,0,0,107
250741,103710,2011-03-01,Senate,"Reported Favorably With Substitute S-1",5,0,0,0,5
250761,103692,2011-02-08,House,"Reported With Recommendation Without Amendment",10,0,0,0,10
250763,55697,2011-03-03,Senate,"Reported Favorably Without Amendment",3,0,0,0,3
250763,55698,2011-03-08,Senate,"Senate Third Reading: Passed Roll Call # 30",37,0,0,1,38
250825,55658,2011-02-15,Senate,"Reported Favorably Without Amendment",6,0,0,0,6
250825,55659,2011-02-17,Senate,"Senate Third Reading:  Roll Call # 18",38,0,0,0,38
250884,196257,2012-05-15,Senate,"Reported Favorably With Recommendation For Referral To Committee On Judiciary",5,0,0,0,5
250884,198555,2012-05-24,Senate,"Reported Favorably Without Amendment",3,0,0,0,3
250920,57139,2011-02-09,Senate,"Reported Favorably Without Amendment",4,0,0,0,4
250920,57140,2011-02-15,Senate,"Senate Third Reading: Passed Roll Call # 14",37,0,0,1,38
250920,75855,2011-04-28,House,"Reported With Recommendation Without Amendment",13,0,0,0,13
251170,72741,2011-04-21,House,"Reported With Recommendation Without Amendment",16,0,0,0,16
251255,55879,2011-02-24,House,"Reported With Recommendation With Amendment(s)",16,0,0,0,16
251255,55880,2011-03-03,House,"House Third Reading: Given Immediate Effect Roll Call # 28",103,5,0,0,108
251255,78245,2011-05-05,Senate,"Reported Favorably Without Amendment",4,0,0,0,4
251255,87899,2011-06-01,Senate,"Senate Third Reading: Given Immediate Effect Roll Call # 264",38,0,0,0,38
251415,102826,2011-10-12,House,"Reported With Recommendation Without Amendment",10,3,0,0,13
251589,103387,2011-11-10,House,"House Third Reading: Given Immediate Effect Roll Call # 489",88,18,0,0,106
251589,103805,2011-11-29,Senate,"Senate Third Reading: Given Immediate Effect Roll Call # 700",35,2,0,1,38
251639,55692,2011-02-24,House,"Reported With Recommendation With Amendment(s)",16,0,0,0,16
251639,55693,2011-03-03,House,"House Third Reading: Given Immediate Effect Roll Call # 27",105,3,0,0,108
251639,77919,2011-05-05,Senate,"Reported Favorably Without Amendment",4,0,0,0,4
251639,87595,2011-06-01,Senate,"Senate Third Reading: Given Immediate Effect Roll Call # 265",38,0,0,0,38
260665,55006,2011-02-15,Senate,"Reported Favorably With Substitute S-1",6,1,0,0,7
260665,55007,2011-02-22,Senate,"Senate Third Reading: Passed Roll Call # 19",36,1,0,1,38
261302,77020,2011-05-04,Senate,"Reported Favorably With Substitute S-3",6,0,0,0,6
261302,77368,2011-05-05,Senate,"Senate Third Reading: Passed Roll Call # 137",38,0,0,0,38
261302,81411,2011-05-18,House,"Reported With Recommendation Without Amendment",17,0,0,0,17
261302,84095,2011-05-24,House,"House Third Reading: Given Immediate Effect Roll Call # 147",108,0,0,0,108
261530,76147,2011-04-28,Senate,"Reported Favorably With Substitute S-1",5,2,0,0,7
261581,74237,2011-04-27,Senate,"Reported Favorably Without Amendment",6,0,0,0,6
261581,78735,2011-05-10,Senate,"Senate Third Reading: Passed Roll Call # 140",38,0,0,0,38
261581,78966,2011-05-11,House,"Reported With Recommendation With Substitute H-1",17,0,0,0,17
261581,90823,2011-06-08,House,"House Third Reading: Given Immediate Effect Roll Call # 163",109,0,0,0,109
261581,92089,2011-06-14,Senate,"Senate Third Reading:  Roll Call # 278",38,0,0,0,38
261839,55752,2011-03-08,Senate,"Reported Favorably With Substitute S-1",4,0,0,0,4
261839,68624,2011-04-14,Senate,"Senate Third Reading: Passed Roll Call # 93",38,0,0,0,38
261839,94419,2011-06-21,House,"Reported With Recommendation Without Amendment",9,0,0,0,9
261839,202463,2012-06-13,House,"House Third Reading: Given Immediate Effect Roll Call # 429",110,0,0,0,110
262059,103137,2011-11-01,Senate,"Reported Favorably Without Amendment",7,0,0,0,7
262101,103700,2011-02-22,Senate,"Reported Favorably With Substitute S-1",5,2,0,0,7
262359,103701,2011-02-22,Senate,"Reported Favorably With Substitute S-1",5,2,0,0,7
262359,103702,2011-05-17,House,"Reported With Recommendation Without Amendment",13,5,0,0,18
262642,103693,2011-02-09,House,"Reported With Recommendation Without Amendment",11,0,0,0,11
263053,103382,2011-11-10,House,"Reported With Recommendation With Substitute H-2",8,0,0,0,8
263053,138829,2011-12-15,House,"House Third Reading: Given Immediate Effect Roll Call # 614",105,1,0,0,106
263053,178667,2012-03-27,Senate,"Reported Favorably With Substitute S-1",5,2,0,0,7
263053,186290,2012-04-17,Senate,"Senate Third Reading: Given Immediate Effect Roll Call # 201",26,12,0,0,38
263053,186776,2012-04-18,House,"House Third Reading:  Roll Call # 173",87,22,0,0,109
263395,55653,2011-02-09,House,"Reported With Recommendation For Referral To Committee On Energy And Technology",14,0,0,0,14
263395,55654,2011-02-22,House,"Reported With Recommendation Without Amendment",14,7,0,0,21
263395,55655,2011-03-02,House,"House Third Reading:  Roll Call # 25",65,44,0,0,109
263428,55405,2011-03-10,House,"Reported With Recommendation Without Amendment",15,0,0,0,15
263428,65522,2011-04-12,House,"House Third Reading: Given Immediate Effect Roll Call # 69",107,1,0,0,108
263428,78725,2011-05-10,Senate,"Reported Favorably Without Amendment",8,0,0,0,8
263428,97542,2011-06-29,Senate,"Senate Third Reading: Given Immediate Effect Roll Call # 363",38,0,0,0,38
263781,103696,2011-02-15,Senate,"Reported Favorably Without Amendment",5,0,0,0,5
263868,56335,2011-03-03,Senate,"Reported Favorably Without Amendment",7,0,0,0,7
263868,196530,2012-05-16,Senate,"Senate Third Reading: Passed Roll Call # 337",37,1,0,0,38
263868,213778,2012-11-27,House,"Reported With Recommendation With Substitute H-2",14,0,0,0,14
263888,103698,2011-02-16,Senate,"Reported Favorably With Substitute S-1",8,0,0,0,8
263888,103699,2011-05-17,House,"Reported With Recommendation Without Amendment",18,0,0,0,18
263915,55136,2011-02-15,Senate,"Reported Favorably Without Amendment",5,0,0,0,5
263915,55137,2011-02-16,Senate,"Senate Third Reading: Passed Roll Call # 17",30,8,0,0,38
264226,103718,2011-02-15,Senate,"Reported Favorably Without Amendment",5,0,0,0,5
264226,103719,2011-02-16,Senate,"Senate Third Reading: Passed Roll Call # 16",31,7,0,0,38
264226,103720,2011-02-23,House,"Reported With Recommendation Without Amendment",16,0,0,0,16
264226,103721,2011-03-01,House,"House Third Reading: Given Immediate Effect Roll Call # 24",83,25,0,0,108
264390,56352,2011-03-03,Senate,"Reported Favorably Without Amendment",7,0,0,0,7
264390,196535,2012-05-16,Senate,"Senate Third Reading: Passed Roll Call # 336",37,1,0,0,38
264626,215266,2012-12-06,Senate,"Senate Third Reading: Passed Roll Call # 862",22,16,0,0,38
264626,215323,2012-12-11,House,"House Third Reading: Passed Roll Call # 724",58,52,0,0,110
264633,54993,2011-03-03,Senate,"Reported Favorably Without Amendment",6,0,0,0,6
264633,54994,2011-03-16,Senate,"Senate Third Reading: Passed Roll Call # 73",38,0,0,0,38
264633,86374,2011-05-25,House,"Reported With Recommendation Without Amendment",17,0,0,0,17
264633,92880,2011-06-15,House,"House Third Reading: Given Immediate Effect Roll Call # 194",108,0,0,0,108
264633,93868,2011-06-21,Senate,"Senate Third Reading:  Roll Call # 317",38,0,0,0,38
264841,103732,2011-02-17,House,"Reported With Recommendation Without Amendment",9,6,0,0,15
264841,103733,2011-02-23,House,"House Third Reading: Given Immediate Effect Roll Call # 19",62,47,0,0,109
264841,103734,2011-03-03,Senate,"Reported Favorably Without Amendment",3,2,0,0,5
264841,103735,2011-03-09,Senate,"Senate Third Reading: Given Immediate Effect Roll Call # 54",26,12,0,0,38
264939,55849,2011-02-17,House,"Reported With Recommendation Without Amendment",9,6,0,0,15
264939,55850,2011-02-23,House,"House Third Reading: Given Immediate Effect Roll Call # 17",62,47,0,0,109
265117,55446,2011-02-16,House,"Reported With Recommendation With Substitute H-1",16,0,0,0,16
265117,55447,2011-02-22,House,"House Third Reading: Given Immediate Effect Roll Call # 11",85,24,0,0,109
265319,103744,2011-02-17,House,"Reported With Recommendation Without Amendment",9,6,0,0,15
265319,103745,2011-02-23,House,"House Third Reading: Given Immediate Effect Roll Call # 20",62,47,0,0,109
265319,103746,2011-03-03,Senate,"Reported Favorably Without Amendment",3,2,0,0,5
265319,103747,2011-03-09,Senate,"Senate Third Reading: Given Immediate Effect Roll Call # 55",26,12,0,0,38
265337,103728,2011-02-17,House,"Reported With Recommendation Without Amendment",9,6,0,0,15
265337,103729,2011-02-23,House,"House Third Reading: Given Immediate Effect Roll Call # 18",62,47,0,0,109
265337,103730,2011-03-03,Senate,"Reported Favorably Without Amendment",3,2,0,0,5
265337,103731,2011-03-09,Senate,"Senate Third Reading: Given Immediate Effect Roll Call # 53",26,12,0,0,38
265392,103714,2011-02-16,House,"Reported With Recommendation With Substitute H-2",16,0,0,0,16
265392,103715,2011-02-22,House,"House Third Reading: Given Immediate Effect Roll Call # 10",91,18,0,0,109
265392,103716,2011-02-24,Senate,"Reported Favorably Without Amendment",3,2,0,0,5
265392,103717,2011-03-01,Senate,"Senate Third Reading: Given Immediate Effect Roll Call # 25",28,8,0,2,38
265563,103736,2011-02-17,House,"Reported With Recommendation With Substitute H-2",9,6,0,0,15
265563,103737,2011-02-23,House,"House Third Reading: Given Immediate Effect Roll Call # 16",62,47,0,0,109
265563,103738,2011-03-03,Senate,"Reported Favorably With Substitute S-2",4,1,0,0,5
265563,103739,2011-03-09,Senate,"Senate Third Reading: Given Immediate Effect Roll Call # 52",26,12,0,0,38
265563,103740,2011-03-15,House,"House Third Reading:  Roll Call # 34",62,48,0,0,110
265890,90477,2011-06-07,Senate,"Reported Favorably Without Amendment",6,0,0,0,6
265918,102706,2011-10-04,Senate,"Reported Favorably Without Amendment",3,0,0,0,3
265918,180850,2012-03-29,Senate,"Senate Third Reading: Passed Roll Call # 177",28,10,0,0,38
266052,103748,2011-02-22,House,"Reported With Recommendation Without Amendment",21,0,0,0,21
266052,103749,2011-03-16,Senate,"Reported Favorably Without Amendment",6,0,0,0,6
266141,90547,2011-06-07,Senate,"Reported Favorably Without Amendment",6,0,0,0,6
266350,79824,2011-05-11,Senate,"Reported Favorably Without Amendment",4,1,0,0,5
266350,85335,2011-05-26,Senate,"Senate Third Reading: Passed Roll Call # 261",26,12,0,0,38
266350,91144,2011-06-09,House,"Reported With Recommendation Without Amendment",11,3,0,0,14
266350,147266,2012-01-26,House,"House Third Reading: Given Immediate Effect Roll Call # 14",58,48,0,0,106
266350,147738,2012-01-31,Senate,"Senate Third Reading: House Amendment(s) Concurred In Roll Call # 25",27,11,0,0,38
266359,54880,2011-03-17,Senate,"Reported Favorably With Recommendation For Referral To Committee On Judiciary",3,1,0,0,4
266359,77393,2011-05-05,Senate,"Reported Favorably With Substitute S-1",4,0,0,0,4
266359,103178,2011-11-02,Senate,"Senate Third Reading: Passed Roll Call # 617",26,11,0,1,38
266432,56107,2011-03-09,House,"Reported With Recommendation With Substitute H-3",13,0,0,0,13
266432,56108,2011-03-23,House,"House Third Reading: Given Immediate Effect Roll Call # 47",109,0,0,0,109
266432,73634,2011-04-26,Senate,"Reported Favorably Without Amendment",7,0,0,0,7
266432,80846,2011-05-17,Senate,"Senate Third Reading: Given Immediate Effect Roll Call # 196",38,0,0,0,38
266466,56005,2011-02-17,House,"Reported With Recommendation Without Amendment",9,6,0,0,15
266466,56006,2011-02-23,House,"House Third Reading: Given Immediate Effect Roll Call # 21",62,47,0,0,109
266466,169038,2012-03-07,Senate,"Senate Third Reading: Given Immediate Effect Roll Call # 123",26,12,0,0,38
266466,169039,2012-03-07,House,"House Third Reading:  Roll Call # 97",63,47,0,0,110
266473,55043,2011-03-09,House,"Reported With Recommendation Without Amendment",18,0,0,0,18
266473,55244,2011-03-22,House,"House Third Reading: Given Immediate Effect Roll Call # 44",110,0,0,0,110
266473,91799,2011-06-09,Senate,"Reported Favorably Without Amendment",4,0,0,0,4
266473,96260,2011-06-29,Senate,"Senate Third Reading: Given Immediate Effect Roll Call # 365",36,1,1,0,38
266521,55054,2011-03-09,House,"Reported With Recommendation Without Amendment",18,0,0,0,18
266521,55249,2011-03-22,House,"House Third Reading: Given Immediate Effect Roll Call # 43",110,0,0,0,110
266521,91804,2011-06-09,Senate,"Reported Favorably Without Amendment",4,0,0,0,4
266521,96744,2011-06-30,Senate,"Senate Third Reading: Given Immediate Effect Roll Call # 411",36,2,0,0,38
266521,96745,2011-06-30,Senate,"Senate Third Reading: Passed Roll Call # 411",36,2,0,0,38
266521,96746,2011-06-30,House,"House Third Reading:  Roll Call # 293",106,2,0,0,108
266552,55083,2011-03-09,House,"Reported With Recommendation Without Amendment",18,0,0,0,18
266552,55273,2011-03-22,House,"House Third Reading: Given Immediate Effect Roll Call # 45",110,0,0,0,110
266552,91813,2011-06-09,Senate,"Reported Favorably Without Amendment",4,0,0,0,4
266552,96355,2011-06-29,Senate,"Senate Third Reading: Given Immediate Effect Roll Call # 366",35,3,0,0,38
266637,196735,2012-05-16,House,"Reported With Recommendation Without Amendment",12,0,0,0,12
266637,198584,2012-05-24,House,"House Third Reading: Given Immediate Effect Roll Call # 304",106,2,0,0,108
266711,54944,2011-03-09,House,"Reported With Recommendation With Substitute H-3",13,0,0,0,13
266711,55744,2011-03-23,House,"House Third Reading: Given Immediate Effect Roll Call # 49",109,0,0,0,109
266711,73318,2011-04-26,Senate,"Reported Favorably Without Amendment",7,0,0,0,7
266711,80974,2011-05-17,Senate,"Senate Third Reading: Given Immediate Effect Roll Call # 197",38,0,0,0,38
266821,196693,2012-05-16,House,"Reported With Recommendation Without Amendment",12,0,0,0,12
266821,198547,2012-05-24,House,"House Third Reading: Given Immediate Effect Roll Call # 303",106,2,0,0,108
266846,86355,2011-05-25,House,"Reported With Recommendation With Substitute H-2",9,0,0,0,9
266846,92603,2011-06-16,House,"House Third Reading: Given Immediate Effect Roll Call # 199",63,45,0,0,108
266846,103227,2011-11-03,Senate,"Reported Favorably With Substitute S-1",4,2,0,0,6
266846,104364,2011-12-06,Senate,"Senate Third Reading: Given Immediate Effect Roll Call # 739",26,9,0,3,38
266846,105516,2011-12-07,House,"House Third Reading:  Roll Call # 525",62,46,0,0,108
266926,84046,2011-05-24,House,"Reported With Recommendation For Referral To Committee On Oversight, Reform, And Ethics",13,2,0,0,15
267152,55013,2011-03-03,House,"Reported With Recommendation With Amendment(s)",16,0,0,0,16
267152,55014,2011-03-16,House,"House Third Reading: Given Immediate Effect Roll Call # 37",110,0,0,0,110
267152,77309,2011-05-05,Senate,"Reported Favorably With Substitute S-1",4,0,0,0,4
267152,87669,2011-06-01,Senate,"Senate Third Reading: Given Immediate Effect Roll Call # 266",38,0,0,0,38
267152,90644,2011-06-07,House,"House Third Reading:  Roll Call # 159",109,0,0,0,109
271170,55085,2011-03-01,Senate,"Reported Favorably Without Amendment",5,0,0,0,5
271170,55086,2011-03-03,Senate,"Senate Third Reading: Passed Roll Call # 27",36,0,0,2,38
271170,55087,2011-03-03,Senate,"Senate Third Reading: Passed Roll Call # 28",36,0,0,2,38
271170,55088,2011-03-16,House,"Reported With Recommendation Without Amendment",25,0,0,0,25
271170,56628,2011-03-24,House,"House Third Reading: Given Immediate Effect Roll Call # 60",109,1,0,0,110
271348,54949,2011-03-01,Senate,"Reported Favorably Without Amendment",5,0,0,0,5
271348,54950,2011-03-02,Senate,"Senate Third Reading: Passed Roll Call # 26",36,0,0,2,38
271348,54951,2011-03-15,House,"Reported With Recommendation Without Amendment",19,0,0,0,19
271348,55753,2011-03-23,House,"House Third Reading: Given Immediate Effect Roll Call # 50",104,5,0,0,109
271601,103697,2011-02-17,Senate,"Reported Favorably With Substitute S-1",16,0,0,0,16
271690,54996,2011-02-17,Senate,"Reported Favorably With Substitute S-1",16,0,0,0,16
271690,54997,2011-02-22,Senate,"Senate Third Reading: Passed Roll Call # 20",37,0,0,1,38
271690,80696,2011-05-11,House,"Reported With Recommendation With Substitute H-2",24,0,0,0,24
271690,81460,2011-05-18,House,"House Third Reading: Given Immediate Effect Roll Call # 141",106,0,0,0,106
271690,82074,2011-05-19,Senate,"Senate Third Reading:  Roll Call # 216",38,0,0,0,38
271765,92055,2011-06-14,Senate,"Reported Favorably With Substitute S-1",14,0,0,0,14
271765,92699,2011-06-16,Senate,"Senate Third Reading: Passed Roll Call # 299",36,2,0,0,38
271765,94305,2011-06-22,House,"Reported With Recommendation With Substitute H-1",22,2,0,0,24
271765,96164,2011-06-29,House,"House Third Reading: Given Immediate Effect Roll Call # 254",66,43,0,0,109
271765,96655,2011-06-30,Senate,"Senate Third Reading:  Roll Call # 393",25,13,0,0,38
271765,96656,2011-06-30,House,"House Third Reading:  Roll Call # 278",58,50,0,0,108
272045,55010,2011-02-17,Senate,"Reported Favorably With Substitute S-1",16,0,0,0,16
272045,55011,2011-02-23,Senate,"Senate Third Reading: Passed Roll Call # 21",36,1,0,1,38
272045,55012,2011-03-16,House,"Reported With Recommendation Without Amendment",23,2,0,0,25
272045,55764,2011-03-23,House,"House Third Reading: Given Immediate Effect Roll Call # 48",99,10,0,0,109
272253,55090,2011-02-22,House,"Reported With Recommendation Without Amendment",16,1,0,0,17
272253,55624,2011-03-23,House,"House Third Reading: Given Immediate Effect Roll Call # 46",102,7,0,0,109
272253,67798,2011-04-14,Senate,"Reported Favorably Without Amendment",6,0,0,0,6
272253,73923,2011-04-26,Senate,"Senate Third Reading: Given Immediate Effect Roll Call # 104",37,1,0,0,38
272826,55266,2011-03-22,House,"Reported With Recommendation Without Amendment",9,0,0,0,9
272826,56224,2011-03-24,House,"House Third Reading: Given Immediate Effect Roll Call # 67",110,0,0,0,110
272826,77518,2011-05-05,Senate,"Reported Favorably Without Amendment",3,0,0,0,3
272826,78987,2011-05-11,Senate,"Senate Third Reading: Given Immediate Effect Roll Call # 143",37,0,0,1,38
273502,103725,2011-02-24,Senate,"Reported Favorably Without Amendment",3,2,0,0,5
273502,103726,2011-03-09,Senate,"Senate Third Reading: Passed Roll Call # 32",26,12,0,0,38
273502,103727,2011-03-15,House,"House Third Reading: Given Immediate Effect Roll Call # 35",63,47,0,0,110
273589,55883,2011-02-24,Senate,"Reported Favorably Without Amendment",3,2,0,0,5
273705,54942,2011-03-16,House,"Reported With Recommendation Without Amendment",3,1,0,0,4
273705,159197,2012-02-22,Senate,"Reported Favorably Without Amendment",3,0,0,0,3
273736,103741,2011-02-24,Senate,"Reported Favorably Without Amendment",3,2,0,0,5
273736,103742,2011-03-09,Senate,"Senate Third Reading: Passed Roll Call # 31",26,12,0,0,38
273736,103743,2011-03-15,House,"House Third Reading: Given Immediate Effect Roll Call # 36",63,47,0,0,110
273740,55901,2011-02-24,Senate,"Reported Favorably Without Amendment",3,2,0,0,5
273803,54902,2011-02-23,Senate,"Reported Favorably Without Amendment",6,0,0,0,6
273803,54903,2011-02-24,Senate,"Senate Third Reading: Passed Roll Call # 23",35,1,0,2,38
273803,54904,2011-03-02,House,"Reported With Recommendation With Amendment(s)",11,4,0,0,15
273803,54905,2011-03-09,House,"House Third Reading: Given Immediate Effect Roll Call # 31",86,23,0,0,109
273803,54906,2011-03-10,Senate,"Senate Third Reading: House Amendment(s) Concurred In Roll Call # 56",32,2,0,4,38
273845,55931,2011-02-24,Senate,"Reported Favorably With Substitute S-2",3,2,0,0,5
273858,54964,2011-03-03,Senate,"Reported Favorably Without Amendment",3,0,0,0,3
273858,66023,2011-04-12,Senate,"Senate Third Reading: Passed Roll Call # 87",37,1,0,0,38
273858,79787,2011-05-12,House,"Reported With Recommendation Without Amendment",13,0,0,0,13
273858,90788,2011-06-08,House,"House Third Reading: Given Immediate Effect Roll Call # 164",109,0,0,0,109
273858,92053,2011-06-14,Senate,"Senate Third Reading: House Amendment(s) Concurred In Roll Call # 279",38,0,0,0,38
273899,54842,2011-03-09,Senate,"Reported Favorably Without Amendment",4,0,0,0,4
273899,67776,2011-04-14,Senate,"Senate Third Reading: Passed Roll Call # 92",38,0,0,0,38
273899,213666,2012-11-08,House,"Reported With Recommendation With Substitute H-3",10,0,0,0,10
273899,214060,2012-11-28,House,"House Third Reading: Passed Roll Call # 625",109,0,0,0,109
273899,215305,2012-12-06,Senate,"Senate Third Reading:  Roll Call # 836",37,0,1,0,38
273986,55928,2011-02-24,Senate,"Reported Favorably Without Amendment",3,2,0,0,5
274404,212366,2012-09-27,House,"Reported With Recommendation With Substitute H-2",15,0,0,0,15
274404,213804,2012-11-28,House,"House Third Reading: Passed Roll Call # 617",103,6,0,0,109
274404,215207,2012-12-06,Senate,"Reported Favorably With Amendment(s)",4,0,0,0,4
274404,215722,2012-12-13,Senate,"Senate Third Reading: Given Immediate Effect Roll Call # 955",38,0,0,0,38
274404,215723,2012-12-13,House,"House Third Reading: Senate Amendment(s) Concurred In Roll Call # 847",103,6,0,0,109
275170,169037,2012-03-06,House,"Reported With Recommendation With Substitute H-2",14,4,0,0,18
275170,173226,2012-03-15,House,"House Third Reading: Passed Roll Call # 120",66,41,0,0,107
275310,169050,2012-03-06,House,"Reported With Recommendation With Substitute H-3",14,4,0,0,18
275310,173237,2012-03-15,House,"House Third Reading: Passed Roll Call # 121",67,40,0,0,107
276278,80170,2011-05-11,House,"Reported With Recommendation With Substitute H-1",15,0,0,0,15
276278,95561,2011-06-28,House,"House Third Reading: Given Immediate Effect Roll Call # 240",71,37,0,0,108
276361,55070,2011-03-16,House,"Reported With Recommendation With Substitute H-1",25,0,0,0,25
276361,66914,2011-04-13,House,"House Third Reading: Given Immediate Effect Roll Call # 72",110,0,0,0,110
276361,78654,2011-05-10,Senate,"Reported Favorably Without Amendment",14,1,0,0,15
276361,80790,2011-05-17,Senate,"Senate Third Reading: Given Immediate Effect Roll Call # 199",36,2,0,0,38
276502,102787,2011-10-05,House,"Reported With Recommendation For Referral To Committee On Natural Resources, Tourism, And Outdoor Recreation",16,0,0,0,16
276502,154360,2012-02-14,House,"Reported With Recommendation With Substitute H-3",7,0,0,0,7
276502,159573,2012-02-22,House,"House Third Reading: Given Immediate Effect Roll Call # 69",107,1,0,0,108
276502,215340,2012-12-11,Senate,"Reported Favorably With Substitute S-1",6,0,0,0,6
276529,96787,2011-06-30,Senate,"Senate Third Reading: Passed Roll Call # 434",38,0,0,0,38
276529,103112,2011-10-26,House,"Reported With Recommendation With Substitute H-5",17,0,0,0,17
276529,103437,2011-11-10,House,"House Third Reading: Given Immediate Effect Roll Call # 483",107,0,0,0,107
276529,104721,2011-12-01,Senate,"Senate Third Reading:  Roll Call # 719",37,0,0,1,38
276561,55023,2011-03-03,Senate,"Reported Favorably Without Amendment",4,0,0,0,4
276561,55024,2011-03-16,Senate,"Senate Third Reading: Passed Roll Call # 71",38,0,0,0,38
276611,173068,2012-03-15,House,"Reported With Recommendation With Substitute H-1",25,1,0,0,26
276611,175993,2012-03-20,House,"House Third Reading: Given Immediate Effect Roll Call # 127",105,4,0,0,109
276611,179177,2012-03-27,Senate,"Reported Favorably With Substitute S-1",15,0,0,0,15
276611,180832,2012-03-29,Senate,"Senate Third Reading: Given Immediate Effect Roll Call # 182",32,6,0,0,38
276611,180833,2012-03-29,House,"House Third Reading:  Roll Call # 165",108,2,0,0,110
276615,103703,2011-02-22,House,"Reported With Recommendation Without Amendment",10,0,0,0,10
276615,103704,2011-04-26,Senate,"Reported Favorably Without Amendment",6,0,0,0,6
276648,94371,2011-06-21,House,"Reported With Recommendation With Substitute H-1",9,2,0,0,11
276648,96270,2011-06-29,House,"House Third Reading: Given Immediate Effect Roll Call # 247",108,1,0,0,109
276648,105510,2011-12-07,Senate,"Reported Favorably With Substitute S-2",3,0,0,0,3
276648,148534,2012-02-01,Senate,"Senate Third Reading: Given Immediate Effect Roll Call # 32",36,1,0,1,38
276648,149104,2012-02-02,House,"House Third Reading:  Roll Call # 25",104,1,0,0,105
276678,54833,2011-03-15,Senate,"Reported Favorably With Substitute S-1",4,2,0,0,6
276678,92703,2011-06-16,Senate,"Senate Third Reading: Passed Roll Call # 293",26,12,0,0,38
276678,94309,2011-06-21,House,"Reported With Recommendation Without Amendment",11,7,0,0,18
276678,96599,2011-06-29,House,"House Third Reading: Given Immediate Effect Roll Call # 255",62,47,0,0,109
276693,56341,2011-03-03,Senate,"Reported Favorably Without Amendment",3,0,0,0,3
276693,102388,2011-09-21,Senate,"Senate Third Reading: Passed Roll Call # 497",29,8,0,1,38
276693,102545,2011-09-27,House,"Reported With Recommendation Without Amendment",7,2,0,0,9
276727,103705,2011-02-22,House,"Reported With Recommendation Without Amendment",10,0,0,0,10
276727,103706,2011-04-26,Senate,"Reported Favorably Without Amendment",6,0,0,0,6
276736,56346,2011-03-03,Senate,"Reported Favorably Without Amendment",3,1,0,0,4
276736,102389,2011-09-21,Senate,"Senate Third Reading: Passed Roll Call # 496",29,8,0,1,38
276736,102546,2011-09-27,House,"Reported With Recommendation With Amendment(s)",7,2,0,0,9
276736,102621,2011-09-28,House,"House Third Reading: Given Immediate Effect Roll Call # 374",75,34,0,0,109
276736,102622,2011-09-28,Senate,"Senate Third Reading: House Amendment(s) Concurred In Roll Call # 531",29,9,0,0,38
276767,93548,2011-06-15,House,"Reported With Recommendation With Substitute H-1",12,2,0,0,14
276767,96938,2011-06-30,House,"House Third Reading: Given Immediate Effect Roll Call # 262",101,7,0,0,108
276767,102897,2011-10-18,Senate,"Reported Favorably Without Amendment",7,0,0,0,7
276778,93489,2011-06-15,House,"Reported With Recommendation With Substitute H-2",12,2,0,0,14
276778,96838,2011-06-30,House,"House Third Reading: Given Immediate Effect Roll Call # 261",101,6,0,0,107
276778,102884,2011-10-18,Senate,"Reported Favorably With Substitute S-1",7,0,0,0,7
276823,78351,2011-05-04,House,"Reported With Recommendation With Substitute H-1",14,1,0,0,15
276823,102953,2011-10-19,House,"House Third Reading: Given Immediate Effect Roll Call # 421",107,1,0,0,108
276848,54838,2011-02-22,House,"Reported With Recommendation For Referral To Committee On Commerce",6,0,0,0,6
276848,54839,2011-03-15,House,"Reported With Recommendation With Amendment(s)",12,7,0,0,19
276890,92706,2011-06-15,Senate,"Reported Favorably Without Amendment",6,0,0,0,6
276891,55444,2011-02-23,House,"Reported With Recommendation Without Amendment",25,2,0,0,27
276954,94260,2011-06-21,House,"Reported With Recommendation With Substitute H-4",8,1,0,0,9
276954,97003,2011-06-30,House,"House Third Reading: Given Immediate Effect Roll Call # 263",99,9,0,0,108
276954,103145,2011-11-01,Senate,"Reported Favorably With Substitute S-1",4,1,0,0,5
276954,103352,2011-11-09,Senate,"Senate Third Reading: Passed Roll Call # 661",25,12,0,1,38
276954,138740,2011-12-15,House,"House Third Reading:  Roll Call # 612",98,9,0,0,107
276978,54967,2011-03-03,Senate,"Reported Favorably With Substitute S-1",4,0,0,0,4
276978,54968,2011-03-16,Senate,"Senate Third Reading: Passed Roll Call # 72",38,0,0,0,38
277014,78448,2011-05-04,House,"Reported With Recommendation With Substitute H-4",14,1,0,0,15
277014,102935,2011-10-19,House,"House Third Reading: Given Immediate Effect Roll Call # 420",98,10,0,0,108
277014,103262,2011-11-08,Senate,"Reported Favorably With Substitute S-1",7,0,0,0,7
277014,103340,2011-11-09,Senate,"Senate Third Reading: Given Immediate Effect Roll Call # 662",33,1,3,1,38
277014,103383,2011-11-10,House,"House Third Reading:  Roll Call # 471",97,10,0,0,107
277014,103384,2011-11-10,Senate,"Senate Third Reading:  Roll Call # 696",34,1,0,3,38
285443,74214,2011-04-27,Senate,"Reported Favorably With Substitute S-1",11,5,0,0,16
285443,74215,2011-04-27,Senate,"Senate Third Reading: Passed Roll Call # 108",19,19,0,0,38
285443,79431,2011-05-12,House,"House Third Reading: Given Immediate Effect Roll Call # 119",62,46,0,0,108
285443,79432,2011-05-12,Senate,"Senate Third Reading:  Roll Call # 191",0,37,1,0,38
285443,85204,2011-05-25,Senate,"Senate Third Reading: Senate Adopted Conference Report With Immediate Effect Roll Call # 232",21,16,0,1,38
285453,54918,2011-03-16,Senate,"Reported Favorably Without Amendment",4,0,0,0,4
285453,55165,2011-03-22,Senate,"Senate Third Reading: Passed Roll Call # 78",36,0,0,2,38
285453,213644,2012-11-08,House,"Reported With Recommendation With Substitute H-1",9,0,0,0,9
285453,215405,2012-12-12,House,"House Third Reading: Passed Roll Call # 739",108,0,0,0,108
285453,215717,2012-12-13,Senate,"Senate Third Reading:  Roll Call # 1010",38,0,0,0,38
285474,74179,2011-04-27,Senate,"Reported Favorably With Substitute S-1",11,5,0,0,16
285474,74180,2011-04-27,Senate,"Senate Third Reading: Passed Roll Call # 109",25,13,0,0,38
285474,79435,2011-05-12,House,"House Third Reading: Given Immediate Effect Roll Call # 121",62,46,0,0,108
285474,79436,2011-05-12,Senate,"Senate Third Reading:  Roll Call # 193",0,38,0,0,38
285474,85226,2011-05-25,Senate,"Senate Third Reading: Senate Adopted Conference Report With Immediate Effect Roll Call # 242",26,11,0,1,38
285504,73448,2011-04-26,Senate,"Reported Favorably With Substitute S-1",6,0,0,0,6
285504,73449,2011-04-26,Senate,"Senate Third Reading: Passed Roll Call # 101",23,15,0,0,38
285504,79394,2011-05-12,House,"House Third Reading: Given Immediate Effect Roll Call # 109",62,46,0,0,108
285504,79395,2011-05-12,Senate,"Senate Third Reading:  Roll Call # 152",0,38,0,0,38
285504,85139,2011-05-25,Senate,"Senate Third Reading: Senate Adopted Conference Report With Immediate Effect Roll Call # 248",22,15,0,1,38
285517,55062,2011-03-09,Senate,"Reported Favorably With Substitute S-3",4,0,0,0,4
285517,55063,2011-03-10,Senate,"Senate Third Reading: Passed Roll Call # 58",36,0,0,2,38
285517,55064,2011-03-17,House,"Reported With Recommendation With Amendment(s)",17,0,0,0,17
285517,55597,2011-03-23,House,"House Third Reading: Given Immediate Effect Roll Call # 52",105,4,0,0,109
285517,56215,2011-03-24,Senate,"Senate Third Reading:  Roll Call # 85",36,0,0,2,38
285559,54845,2011-03-09,Senate,"Reported Favorably With Substitute S-3",4,0,0,0,4
285559,54846,2011-03-10,Senate,"Senate Third Reading: Passed Roll Call # 57",36,0,0,2,38
285559,54847,2011-03-17,House,"Reported With Recommendation With Amendment(s)",14,2,0,0,16
285559,55689,2011-03-23,House,"House Third Reading: Given Immediate Effect Roll Call # 51",103,6,0,0,109
285559,56318,2011-03-24,Senate,"Senate Third Reading: House Amendment(s) Concurred In As Amended Roll Call # 83",35,0,1,2,38
285559,56319,2011-03-24,Senate,"Senate Third Reading: House Amendment(s) Concurred In As Amended Roll Call # 84",36,0,0,2,38
285559,56320,2011-03-24,House,"House Third Reading:  Roll Call # 56",104,6,0,0,110
285569,85944,2011-05-26,Senate,"Reported Favorably With Substitute S-2",6,0,0,0,6
285580,73967,2011-04-27,Senate,"Reported Favorably With Substitute S-1",11,5,0,0,16
285580,73968,2011-04-27,Senate,"Senate Third Reading: Passed Roll Call # 111",20,18,0,0,38
285580,79485,2011-05-12,House,"House Third Reading: Given Immediate Effect Roll Call # 114",63,45,0,0,108
285580,79486,2011-05-12,Senate,"Senate Third Reading:  Roll Call # 186",0,38,0,0,38
285580,84987,2011-05-24,Senate,"Senate Third Reading: Senate Adopted Conference Report With Immediate Effect Roll Call # 229",21,16,0,1,38
285596,73945,2011-04-27,Senate,"Reported Favorably With Substitute S-1",11,5,0,0,16
285596,73946,2011-04-27,Senate,"Senate Third Reading: Passed Roll Call # 114",21,17,0,0,38
285596,79479,2011-05-12,House,"House Third Reading: Given Immediate Effect Roll Call # 112",62,46,0,0,108
285596,79480,2011-05-12,Senate,"Senate Third Reading:  Roll Call # 184",0,38,0,0,38
285596,85245,2011-05-25,Senate,"Senate Third Reading: Senate Adopted Conference Report With Immediate Effect Roll Call # 240",22,15,0,1,38
285603,73457,2011-04-26,Senate,"Reported Favorably With Substitute S-1",6,0,0,0,6
285603,73458,2011-04-26,Senate,"Senate Third Reading: Passed Roll Call # 97",26,12,0,0,38
285603,79443,2011-05-12,House,"House Third Reading: Given Immediate Effect Roll Call # 108",62,46,0,0,108
285603,79444,2011-05-12,Senate,"Senate Third Reading:  Roll Call # 151",0,38,0,0,38
285603,85232,2011-05-25,Senate,"Senate Third Reading: Senate Adopted Conference Report With Immediate Effect Roll Call # 246",25,12,0,1,38
285645,201618,2012-06-06,Senate,"Reported Favorably With Substitute S-2",5,0,0,0,5
285645,201619,2012-06-06,Senate,"Senate Third Reading: Passed Roll Call # 461",38,0,0,0,38
285645,202362,2012-06-13,House,"House Third Reading: Given Immediate Effect Roll Call # 444",93,17,0,0,110
285645,202363,2012-06-13,Senate,"Senate Third Reading: House Amendment(s) Concurred In Roll Call # 517",35,1,1,1,38
285680,74017,2011-04-27,Senate,"Reported Favorably With Substitute S-1",11,5,0,0,16
285680,74018,2011-04-27,Senate,"Senate Third Reading: Passed Roll Call # 113",25,13,0,0,38
285680,79494,2011-05-12,House,"House Third Reading: Given Immediate Effect Roll Call # 117",62,46,0,0,108
285680,79495,2011-05-12,Senate,"Senate Third Reading:  Roll Call # 189",0,38,0,0,38
285680,85006,2011-05-24,Senate,"Senate Third Reading: Senate Adopted Conference Report With Immediate Effect Roll Call # 227",25,12,0,1,38
285684,73419,2011-04-26,Senate,"Reported Favorably With Substitute S-1",6,0,0,0,6
285684,73420,2011-04-26,Senate,"Senate Third Reading: Passed Roll Call # 96",28,10,0,0,38
285684,79441,2011-05-12,House,"House Third Reading: Given Immediate Effect Roll Call # 106",62,45,0,0,107
285684,79442,2011-05-12,Senate,"Senate Third Reading:  Roll Call # 149",0,38,0,0,38
285684,83703,2011-05-24,Senate,"Senate Third Reading: Senate Adopted Conference Report With Immediate Effect Roll Call # 226",33,4,0,1,38
285740,74091,2011-04-27,Senate,"Reported Favorably With Substitute S-1",11,5,0,0,16
285740,74092,2011-04-27,Senate,"Senate Third Reading: Passed Roll Call # 110",21,17,0,0,38
285740,79389,2011-05-12,House,"House Third Reading: Given Immediate Effect Roll Call # 107",62,46,0,0,108
285740,79390,2011-05-12,Senate,"Senate Third Reading:  Roll Call # 150",0,38,0,0,38
285740,85131,2011-05-25,Senate,"Senate Third Reading: Senate Adopted Conference Report With Immediate Effect Roll Call # 238",21,16,0,1,38
285750,75362,2011-04-26,Senate,"Reported Favorably With Substitute S-1",6,0,0,0,6
285750,75363,2011-04-26,Senate,"Senate Third Reading: Passed Roll Call # 99",24,14,0,0,38
285750,79358,2011-05-12,House,"House Third Reading: Given Immediate Effect Roll Call # 113",62,46,0,0,108
285750,79359,2011-05-12,Senate,"Senate Third Reading:  Roll Call # 185",0,38,0,0,38
285750,85065,2011-05-25,Senate,"Senate Third Reading: Senate Adopted Conference Report With Immediate Effect Roll Call # 243",23,14,0,1,38
285777,75358,2011-04-27,Senate,"Reported Favorably With Substitute S-1",11,5,0,0,16
285777,75359,2011-04-27,Senate,"Senate Third Reading: Passed Roll Call # 107",26,12,0,0,38
285777,79352,2011-05-12,House,"House Third Reading: Given Immediate Effect Roll Call # 116",62,46,0,0,108
285777,79353,2011-05-12,Senate,"Senate Third Reading:  Roll Call # 188",0,38,0,0,38
285777,85068,2011-05-25,Senate,"Senate Third Reading: Senate Adopted Conference Report With Immediate Effect Roll Call # 234",26,11,0,1,38
285785,73645,2011-04-26,Senate,"Reported Favorably With Substitute S-1",6,0,0,0,6
285785,73646,2011-04-26,Senate,"Senate Third Reading: Passed Roll Call # 103",25,13,0,0,38
285785,79396,2011-05-12,House,"House Third Reading: Given Immediate Effect Roll Call # 111",62,46,0,0,108
285785,79397,2011-05-12,Senate,"Senate Third Reading:  Roll Call # 183",0,38,0,0,38
285785,85171,2011-05-25,Senate,"Senate Third Reading: Senate Adopted Conference Report With Immediate Effect Roll Call # 241",26,11,0,1,38
285800,73364,2011-04-26,Senate,"Reported Favorably With Substitute S-1",6,0,0,0,6
285800,73365,2011-04-26,Senate,"Senate Third Reading: Passed Roll Call # 102",24,14,0,0,38
285800,79371,2011-05-12,House,"House Third Reading: Given Immediate Effect Roll Call # 120",62,46,0,0,108
285800,79372,2011-05-12,Senate,"Senate Third Reading:  Roll Call # 192",0,37,0,1,38
285800,83966,2011-05-24,Senate,"Senate Third Reading: Senate Adopted Conference Report With Immediate Effect Roll Call # 228",24,13,0,1,38
285811,73346,2011-04-26,Senate,"Reported Favorably With Substitute S-1",6,0,0,0,6
285811,73347,2011-04-26,Senate,"Senate Third Reading: Passed Roll Call # 100",26,11,1,0,38
285811,79466,2011-05-12,House,"House Third Reading: Given Immediate Effect Roll Call # 118",62,46,0,0,108
285811,79467,2011-05-12,Senate,"Senate Third Reading:  Roll Call # 190",0,38,0,0,38
285811,85242,2011-05-25,Senate,"Senate Third Reading: Senate Adopted Conference Report With Immediate Effect Roll Call # 239",26,11,0,1,38
285818,73723,2011-04-26,Senate,"Reported Favorably With Substitute S-1",6,0,0,0,6
285818,73724,2011-04-26,Senate,"Senate Third Reading: Passed Roll Call # 98",26,12,0,0,38
285818,79455,2011-05-12,House,"House Third Reading: Given Immediate Effect Roll Call # 115",62,46,0,0,108
285818,79456,2011-05-12,Senate,"Senate Third Reading:  Roll Call # 187",0,38,0,0,38
285818,83733,2011-05-24,Senate,"Senate Third Reading: Senate Adopted Conference Report With Immediate Effect Roll Call # 231",26,11,0,1,38
285871,74224,2011-04-27,Senate,"Reported Favorably With Substitute S-1",11,5,0,0,16
285871,74225,2011-04-27,Senate,"Senate Third Reading: Passed Roll Call # 112",26,12,0,0,38
285871,79461,2011-05-12,House,"House Third Reading: Given Immediate Effect Roll Call # 110",62,46,0,0,108
285871,79462,2011-05-12,Senate,"Senate Third Reading:  Roll Call # 182",0,37,1,0,38
285871,85243,2011-05-25,Senate,"Senate Third Reading: Senate Adopted Conference Report With Immediate Effect Roll Call # 236",26,11,0,1,38
285878,103219,2011-11-03,Senate,"Reported Favorably With Substitute S-5",5,0,0,0,5
285878,103220,2011-11-03,Senate,"Senate Third Reading: Passed Roll Call # 654",37,1,0,0,38
285878,103345,2011-11-09,House,"Reported With Recommendation Without Amendment",14,0,0,0,14
285878,103400,2011-11-10,House,"House Third Reading: Given Immediate Effect Roll Call # 472",106,1,0,0,107
285974,55645,2011-03-23,House,"Reported With Recommendation With Substitute H-4",10,8,0,0,18
286056,74143,2011-04-27,House,"Reported With Recommendation Without Amendment",16,0,0,0,16
286056,77544,2011-05-05,House,"House Third Reading: Given Immediate Effect Roll Call # 101",110,0,0,0,110
286056,93081,2011-06-15,Senate,"Reported Favorably With Substitute S-1",6,0,0,0,6
286056,96180,2011-06-29,Senate,"Senate Third Reading: Given Immediate Effect Roll Call # 368",38,0,0,0,38
286056,96657,2011-06-30,House,"House Third Reading:  Roll Call # 256",107,0,0,0,107
286072,81512,2011-05-18,House,"Reported With Recommendation With Substitute H-2",13,0,0,0,13
286072,90559,2011-06-07,House,"House Third Reading: Given Immediate Effect Roll Call # 160",109,0,0,0,109
286149,54822,2011-03-17,House,"Reported With Recommendation Without Amendment",9,0,0,0,9
286149,56307,2011-03-24,House,"House Third Reading: Given Immediate Effect Roll Call # 63",63,47,0,0,110
286149,95162,2011-06-22,Senate,"Reported Favorably With Substitute S-1",3,0,0,0,3
286149,97303,2011-06-30,Senate,"Senate Third Reading: Given Immediate Effect Roll Call # 426",26,12,0,0,38
286149,97304,2011-06-30,House,"House Third Reading:  Roll Call # 301",61,47,0,0,108
286149,103240,2011-11-02,Senate,"Senate Third Reading: Passed Roll Call # 630",26,11,0,1,38
286149,103241,2011-11-03,House,"House Third Reading:  Roll Call # 452",77,30,0,0,107
286149,103662,2011-11-30,Senate,"Senate Third Reading:  Roll Call # 706",26,12,0,0,38
286149,103663,2011-11-30,House,"House Third Reading:  Roll Call # 501",73,33,0,0,106
286207,55094,2011-03-17,House,"Reported With Recommendation Without Amendment",9,0,0,0,9
286207,56247,2011-03-24,House,"House Third Reading: Given Immediate Effect Roll Call # 65",63,47,0,0,110
286207,95235,2011-06-22,Senate,"Reported Favorably With Substitute S-2",3,0,0,0,3
286207,97445,2011-06-30,Senate,"Senate Third Reading: Passed Roll Call # 407",24,14,0,0,38
286207,97446,2011-06-30,Senate,"Senate Third Reading: Given Immediate Effect Roll Call # 409",26,12,0,0,38
286207,97447,2011-06-30,House,"House Third Reading:  Roll Call # 302",61,47,0,0,108
286207,103236,2011-11-02,Senate,"Senate Third Reading: Passed Roll Call # 631",26,11,0,1,38
286207,103237,2011-11-03,House,"House Third Reading:  Roll Call # 453",79,28,0,0,107
286207,103794,2011-11-30,Senate,"Senate Third Reading:  Roll Call # 707",26,12,0,0,38
286207,103795,2011-11-30,House,"House Third Reading:  Roll Call # 502",77,29,0,0,106
286401,54827,2011-03-17,House,"Reported With Recommendation Without Amendment",9,0,0,0,9
286401,56309,2011-03-24,House,"House Third Reading: Given Immediate Effect Roll Call # 62",64,46,0,0,110
286401,56310,2011-03-24,House,"House Third Reading: Passed Roll Call # 64",63,47,0,0,110
286401,95231,2011-06-22,Senate,"Reported Favorably Without Amendment",3,0,0,0,3
286696,65697,2011-04-12,House,"Reported With Recommendation With Substitute H-2",17,2,0,0,19
286696,73711,2011-04-26,House,"House Third Reading: Given Immediate Effect Roll Call # 79",102,6,0,0,108
286696,84713,2011-05-25,Senate,"Reported Favorably With Substitute S-2",9,0,0,0,9
286696,85145,2011-05-26,Senate,"Senate Third Reading: Passed Roll Call # 255",32,1,4,1,38
286696,85146,2011-05-26,Senate,"Senate Third Reading: Given Immediate Effect Roll Call # 256",37,1,0,0,38
286696,85147,2011-05-26,House,"House Third Reading:  Roll Call # 155",105,3,0,0,108
286813,54788,2011-03-17,House,"Reported With Recommendation Without Amendment",9,0,0,0,9
286813,56271,2011-03-24,House,"House Third Reading: Given Immediate Effect Roll Call # 61",63,47,0,0,110
286813,95125,2011-06-22,Senate,"Reported Favorably With Substitute S-1",3,0,0,0,3
286813,97096,2011-06-30,Senate,"Senate Third Reading: Given Immediate Effect Roll Call # 406",24,14,0,0,38
286813,97097,2011-06-30,Senate,"Senate Third Reading: Passed Roll Call # 408",25,12,1,0,38
286813,97098,2011-06-30,House,"House Third Reading:  Roll Call # 300",61,47,0,0,108
286813,103238,2011-11-02,Senate,"Senate Third Reading: Passed Roll Call # 629",26,11,0,1,38
286813,103239,2011-11-03,House,"House Third Reading:  Roll Call # 451",75,33,0,0,108
286813,103797,2011-11-30,Senate,"Senate Third Reading:  Roll Call # 705",26,11,0,1,38
286813,103798,2011-11-30,House,"House Third Reading:  Roll Call # 500",72,34,0,0,106
287859,74537,2011-04-28,House,"Reported With Recommendation With Substitute H-1",16,10,0,0,26
287859,77336,2011-05-05,House,"House Third Reading: Given Immediate Effect Roll Call # 102",57,53,0,0,110
287859,79080,2011-05-11,Senate,"Senate Third Reading: Passed Roll Call # 145",23,14,0,1,38
287859,79346,2011-05-12,House,"House Third Reading:  Roll Call # 124",0,108,0,0,108
287859,85123,2011-05-26,House,"House Third Reading: Conference Report Adopted Roll Call # 154",59,50,0,0,109
287859,85124,2011-05-26,Senate,"Senate Third Reading: Senate Adopted Conference Report Roll Call # 257",20,17,1,0,38
287859,85125,2011-05-26,Senate,"Senate Third Reading: Senate Adopted Conference Report With Immediate Effect Roll Call # 258",21,17,0,0,38
288202,85174,2011-05-25,House,"Reported With Recommendation With Substitute H-2",10,0,0,0,10
288202,92641,2011-06-16,House,"House Third Reading: Given Immediate Effect Roll Call # 200",60,48,0,0,108
288202,103233,2011-11-03,Senate,"Reported Favorably Without Amendment",5,2,0,0,7
288202,103409,2011-11-10,Senate,"Senate Third Reading: Given Immediate Effect Roll Call # 685",25,11,0,2,38
288202,103410,2011-11-10,House,"House Third Reading:  Roll Call # 486",59,48,0,0,107
288482,82080,2011-05-18,House,"Reported With Recommendation Without Amendment",17,0,0,0,17
288482,90556,2011-06-07,House,"House Third Reading: Given Immediate Effect Roll Call # 161",109,0,0,0,109
288482,94584,2011-06-23,Senate,"Reported Favorably Without Amendment",5,0,0,0,5
288482,102072,2011-09-13,Senate,"Senate Third Reading: Given Immediate Effect Roll Call # 477",38,0,0,0,38
288682,92682,2011-06-16,Senate,"Reported Favorably With Substitute S-4",4,0,0,0,4
288682,94268,2011-06-22,Senate,"Senate Third Reading: Passed Roll Call # 330",32,6,0,0,38
288812,105101,2011-12-06,Senate,"Senate Third Reading: Passed Roll Call # 738",35,0,0,3,38
288812,105828,2011-12-14,House,"Reported With Recommendation With Amendment(s)",21,0,0,0,21
288812,105829,2011-12-14,House,"House Third Reading: Given Immediate Effect Roll Call # 598",105,2,0,0,107
288812,105830,2011-12-15,Senate,"Senate Third Reading: House Amendment(s) Concurred In Roll Call # 821",37,0,1,0,38
288812,105831,2011-12-15,Senate,"Senate Third Reading: House Amendment(s) Concurred In Roll Call # 822",37,0,1,0,38
288812,105832,2011-12-15,Senate,"Senate Third Reading: House Amendment(s) Concurred In Roll Call # 823",38,0,0,0,38
288864,93700,2011-06-21,Senate,"Reported Favorably Without Amendment",5,0,0,0,5
288939,103711,2011-03-03,Senate,"Reported Favorably With Substitute S-2",4,2,0,0,6
288939,103712,2011-03-15,House,"Reported With Recommendation Without Amendment",4,2,0,0,6
288939,103713,2011-04-14,House,"House Third Reading: Not Adopted Roll Call # 77",66,41,0,0,107
291531,103796,2011-12-01,House,"Reported With Recommendation With Substitute H-1",17,0,0,0,17
291531,147191,2012-01-25,House,"House Third Reading: Given Immediate Effect Roll Call # 8",106,0,0,0,106
291531,160598,2012-02-23,Senate,"Reported Favorably With Substitute S-1",7,0,0,0,7
291531,187317,2012-04-19,Senate,"Senate Third Reading: Given Immediate Effect Roll Call # 213",38,0,0,0,38
291531,188964,2012-04-24,House,"House Third Reading:  Roll Call # 187",108,0,0,0,108
291535,212116,2012-09-19,House,"Reported With Recommendation With Substitute H-1",16,0,0,0,16
291637,54992,2011-03-15,Senate,"Reported Favorably With Substitute S-2",6,0,0,0,6
291637,75866,2011-04-27,Senate,"Senate Third Reading: Passed Roll Call # 106",30,6,0,2,38
291637,76423,2011-05-03,House,"Reported With Recommendation With Substitute H-1",8,1,0,0,9
291637,95532,2011-06-28,House,"House Third Reading: Given Immediate Effect Roll Call # 239",86,22,0,0,108
291637,96125,2011-06-29,Senate,"Senate Third Reading:  Roll Call # 361",31,4,3,0,38
291637,96126,2011-06-29,Senate,"Senate Third Reading:  Roll Call # 371",33,5,0,0,38
291816,55069,2011-03-17,House,"Reported With Recommendation With Substitute H-1",13,3,0,0,16
291816,73937,2011-04-26,House,"House Third Reading: Given Immediate Effect Roll Call # 80",69,38,0,0,107
291816,91975,2011-06-14,Senate,"Reported Favorably Without Amendment",5,1,0,0,6
291816,95494,2011-06-28,Senate,"Senate Third Reading: Given Immediate Effect Roll Call # 354",26,12,0,0,38
291816,96036,2011-06-29,House,"House Third Reading: Senate Amendment(s) Concurred In Roll Call # 245",68,40,0,0,108
291904,76957,2011-05-04,House,"Reported With Recommendation Without Amendment",16,0,0,0,16
291904,81001,2011-05-17,House,"House Third Reading: Given Immediate Effect Roll Call # 133",105,3,0,0,108
291904,96096,2011-06-29,Senate,"Reported Favorably Without Amendment",6,0,0,0,6
291904,102344,2011-09-14,Senate,"Senate Third Reading: Given Immediate Effect Roll Call # 482",38,0,0,0,38
292028,76267,2011-04-27,House,"Reported With Recommendation With Substitute H-1",10,7,0,0,17
292028,76268,2011-04-28,House,"House Third Reading: Given Immediate Effect Roll Call # 89",57,52,0,0,109
292028,79753,2011-05-12,Senate,"Reported Favorably Without Amendment",3,0,0,0,3
292028,79754,2011-05-12,Senate,"Senate Third Reading: Given Immediate Effect Roll Call # 174",27,10,1,0,38
292028,79755,2011-05-12,House,"House Third Reading:  Roll Call # 127",57,51,0,0,108
292081,54784,2011-03-17,House,"Reported With Recommendation Without Amendment",11,0,0,0,11
292081,56266,2011-03-24,House,"House Third Reading: Given Immediate Effect Roll Call # 66",110,0,0,0,110
292081,93262,2011-06-16,Senate,"Reported Favorably Without Amendment",4,0,0,0,4
292081,96918,2011-06-30,Senate,"Senate Third Reading: Given Immediate Effect Roll Call # 397",38,0,0,0,38
292192,102272,2011-09-15,Senate,"Reported Favorably Without Amendment",4,0,0,0,4
292192,145968,2012-01-25,Senate,"Senate Third Reading: Passed Roll Call # 13",26,12,0,0,38
292192,214983,2012-12-04,House,"Reported With Recommendation Without Amendment",5,3,0,0,8
292219,73931,2011-04-27,House,"Reported With Recommendation With Substitute H-2",16,0,0,0,16
292219,82092,2011-05-19,House,"House Third Reading: Given Immediate Effect Roll Call # 143",108,0,0,0,108
292219,97551,2011-06-29,Senate,"Reported Favorably With Substitute S-1",3,0,0,0,3
292219,97552,2011-06-30,Senate,"Senate Third Reading: Given Immediate Effect Roll Call # 405",38,0,0,0,38
292219,97553,2011-06-30,House,"House Third Reading:  Roll Call # 270",108,0,0,0,108
292318,86673,2011-05-31,House,"Reported With Recommendation With Substitute H-1",17,0,0,0,17
292356,55097,2011-03-09,Senate,"Reported Favorably Without Amendment",4,0,0,0,4
292356,55098,2011-03-10,Senate,"Senate Third Reading: Passed Roll Call # 59",36,0,0,2,38
292356,55099,2011-03-17,House,"Reported With Recommendation Without Amendment",17,0,0,0,17
292356,55641,2011-03-23,House,"House Third Reading: Given Immediate Effect Roll Call # 53",106,3,0,0,109
292404,73972,2011-04-27,House,"Reported With Recommendation With Substitute H-1",10,7,0,0,17
292404,74595,2011-04-28,House,"House Third Reading: Given Immediate Effect Roll Call # 88",56,53,0,0,109
292404,79772,2011-05-12,Senate,"Reported Favorably Without Amendment",3,0,0,0,3
292404,79773,2011-05-12,Senate,"Senate Third Reading: Given Immediate Effect Roll Call # 170",19,19,0,0,38
292404,79774,2011-05-12,House,"House Third Reading:  Roll Call # 126",56,52,0,0,108
292428,56166,2011-03-24,House,"Reported With Recommendation With Substitute H-2",11,5,0,0,16
292428,96901,2011-06-30,House,"House Third Reading: Given Immediate Effect Roll Call # 259",81,26,0,0,107
292428,101640,2011-09-07,Senate,"Reported Favorably Without Amendment",4,0,0,0,4
292428,102392,2011-09-21,Senate,"Senate Third Reading: Given Immediate Effect Roll Call # 499",34,2,0,2,38
292492,67627,2011-04-14,Senate,"Reported Favorably Without Amendment",3,0,0,0,3
292492,76912,2011-05-04,Senate,"Senate Third Reading: Passed Roll Call # 125",37,0,0,1,38
292512,56338,2011-03-24,Senate,"Reported Favorably Without Amendment",4,0,0,0,4
292512,75171,2011-04-28,Senate,"Senate Third Reading: Passed Roll Call # 117",37,0,0,1,38
292519,98994,2011-07-13,Senate,"Reported Favorably With Substitute S-1",5,0,0,0,5
292519,102802,2011-10-11,Senate,"Senate Third Reading: Passed Roll Call # 565",38,0,0,0,38
292519,214255,2012-11-28,House,"Reported With Recommendation Without Amendment",13,5,0,0,18
292521,67720,2011-04-14,Senate,"Reported Favorably Without Amendment",3,0,0,0,3
292521,76888,2011-05-04,Senate,"Senate Third Reading: Passed Roll Call # 124",37,0,0,1,38
292521,91816,2011-06-09,House,"Reported With Recommendation Without Amendment",13,0,0,0,13
292521,95574,2011-06-28,House,"House Third Reading: Given Immediate Effect Roll Call # 242",106,2,0,0,108
292547,56122,2011-03-24,Senate,"Reported Favorably Without Amendment",4,0,0,0,4
292547,75177,2011-04-28,Senate,"Senate Third Reading: Passed Roll Call # 118",37,0,0,1,38
292547,80815,2011-05-17,House,"Reported With Recommendation Without Amendment",9,0,0,0,9
292547,81564,2011-05-18,House,"House Third Reading: Given Immediate Effect Roll Call # 142",103,3,0,0,106
292580,67518,2011-04-14,Senate,"Reported Favorably With Substitute S-1",3,0,0,0,3
292580,77000,2011-05-04,Senate,"Senate Third Reading: Passed Roll Call # 123",37,0,0,1,38
292580,85177,2011-05-26,House,"Reported With Recommendation Without Amendment",14,0,0,0,14
292580,102341,2011-09-14,House,"House Third Reading: Given Immediate Effect Roll Call # 329",109,0,0,0,109
292580,102342,2011-09-15,Senate,"Senate Third Reading: House Amendment(s) Concurred In Roll Call # 483",37,0,0,1,38
292612,66785,2011-04-13,Senate,"Reported Favorably Without Amendment",4,0,0,0,4
292612,67739,2011-04-14,Senate,"Senate Third Reading: Passed Roll Call # 95",38,0,0,0,38
292612,77579,2011-05-04,House,"Reported With Recommendation For Referral To Committee On Transportation",9,0,0,0,9
292612,91823,2011-06-08,House,"Reported With Recommendation Without Amendment",16,0,0,0,16
292612,93769,2011-06-21,House,"House Third Reading: Given Immediate Effect Roll Call # 205",109,0,0,0,109
292636,56185,2011-03-24,Senate,"Reported Favorably Without Amendment",4,0,0,0,4
292636,75196,2011-04-28,Senate,"Senate Third Reading: Passed Roll Call # 116",37,0,0,1,38
292638,78691,2011-05-10,Senate,"Reported Favorably Without Amendment",8,0,0,0,8
292638,79482,2011-05-12,Senate,"Senate Third Reading: Passed Roll Call # 146",38,0,0,0,38
292638,97793,2011-06-30,House,"Reported With Recommendation Without Amendment",13,0,0,0,13
292638,102079,2011-09-13,House,"House Third Reading: Given Immediate Effect Roll Call # 327",109,0,0,0,109
292662,93869,2011-06-21,Senate,"Reported Favorably With Substitute S-1",5,0,0,0,5
292931,56356,2011-03-15,House,"Reported With Recommendation With Substitute H-2",8,0,0,0,8
292931,83759,2011-05-24,House,"House Third Reading: Given Immediate Effect Roll Call # 146",85,23,0,0,108
292931,93803,2011-06-21,Senate,"Reported Favorably With Substitute S-1",5,0,0,0,5
292931,96811,2011-06-30,Senate,"Senate Third Reading: Given Immediate Effect Roll Call # 399",32,6,0,0,38
292931,96812,2011-06-30,House,"House Third Reading:  Roll Call # 271",85,23,0,0,108
292950,55297,2011-03-10,House,"Reported With Recommendation Without Amendment",16,0,0,0,16
292950,65670,2011-04-12,House,"House Third Reading: Given Immediate Effect Roll Call # 70",97,11,0,0,108
292950,102819,2011-10-11,Senate,"Reported Favorably With Substitute S-2",7,0,0,0,7
292950,102878,2011-10-18,Senate,"Senate Third Reading: Given Immediate Effect Roll Call # 578",37,0,0,1,38
292950,103210,2011-11-03,House,"House Third Reading:  Roll Call # 448",102,6,0,0,108
292950,157087,2012-02-15,Senate,"Senate Third Reading:  Roll Call # 79",38,0,0,0,38
292950,158313,2012-02-21,House,"House Third Reading: Senate Amendment(s) To House Amendment(s) Concurred In Roll Call # 63",96,10,0,0,106
293055,55124,2011-03-16,House,"Reported With Recommendation Without Amendment",15,0,0,0,15
293055,56278,2011-03-24,House,"House Third Reading: Given Immediate Effect Roll Call # 58",106,4,0,0,110
293055,86129,2011-05-26,Senate,"Reported Favorably Without Amendment",6,0,0,0,6
293055,96142,2011-06-29,Senate,"Senate Third Reading: Given Immediate Effect Roll Call # 379",38,0,0,0,38
293055,96619,2011-06-30,House,"House Third Reading:  Roll Call # 257",100,7,0,0,107
293239,55126,2011-03-16,House,"Reported With Recommendation Without Amendment",15,0,0,0,15
293239,56299,2011-03-24,House,"House Third Reading: Given Immediate Effect Roll Call # 59",106,4,0,0,110
293239,86179,2011-05-26,Senate,"Reported Favorably Without Amendment",6,0,0,0,6
293239,93906,2011-06-21,Senate,"Senate Third Reading: Given Immediate Effect Roll Call # 318",37,1,0,0,38
293398,82978,2011-05-17,House,"Reported With Recommendation With Substitute H-1",9,0,0,0,9
293398,85042,2011-05-25,House,"House Third Reading: Given Immediate Effect Roll Call # 149",109,0,0,0,109
293400,81902,2011-05-12,Senate,"Reported Favorably With Substitute S-1",4,0,0,0,4
293400,82096,2011-05-19,Senate,"Senate Third Reading: Passed Roll Call # 218",38,0,0,0,38
293400,90554,2011-06-07,House,"Reported With Recommendation Without Amendment",8,0,0,0,8
293400,92340,2011-06-15,House,"House Third Reading: Given Immediate Effect Roll Call # 192",108,0,0,0,108
293434,79334,2011-05-12,Senate,"Reported Favorably With Substitute S-1",4,0,0,0,4
293434,81965,2011-05-19,Senate,"Senate Third Reading: Passed Roll Call # 221",38,0,0,0,38
293434,95624,2011-06-28,House,"Reported With Recommendation With Substitute H-1",9,0,0,0,9
293434,96718,2011-06-30,House,"House Third Reading: Given Immediate Effect Roll Call # 264",108,0,0,0,108
293434,96719,2011-06-30,Senate,"Senate Third Reading:  Roll Call # 427",38,0,0,0,38
293482,82914,2011-05-17,House,"Reported With Recommendation With Substitute H-1",9,0,0,0,9
293482,84593,2011-05-25,House,"House Third Reading: Given Immediate Effect Roll Call # 150",109,0,0,0,109
293482,91159,2011-06-09,Senate,"Reported Favorably Without Amendment",3,0,0,0,3
293482,93829,2011-06-21,Senate,"Senate Third Reading: Given Immediate Effect Roll Call # 319",38,0,0,0,38
293504,82994,2011-05-17,House,"Reported With Recommendation With Substitute H-1",8,0,0,0,8
293504,84648,2011-05-25,House,"House Third Reading: Given Immediate Effect Roll Call # 148",103,6,0,0,109
293504,93620,2011-06-21,Senate,"Reported Favorably Without Amendment",5,0,0,0,5
293504,96586,2011-06-30,Senate,"Senate Third Reading: Given Immediate Effect Roll Call # 400",38,0,0,0,38
293523,68670,2011-04-13,House,"Reported With Recommendation Without Amendment",8,0,0,0,8
293523,76240,2011-05-03,House,"House Third Reading: Given Immediate Effect Roll Call # 98",109,1,0,0,110
293530,79350,2011-05-12,Senate,"Reported Favorably Without Amendment",4,0,0,0,4
293530,81972,2011-05-19,Senate,"Senate Third Reading: Passed Roll Call # 220",38,0,0,0,38
293530,90594,2011-06-07,House,"Reported With Recommendation Without Amendment",8,0,0,0,8
293530,92411,2011-06-15,House,"House Third Reading: Given Immediate Effect Roll Call # 193",108,0,0,0,108
293537,79381,2011-05-12,Senate,"Reported Favorably With Substitute S-1",4,0,0,0,4
293537,82013,2011-05-19,Senate,"Senate Third Reading: Passed Roll Call # 219",37,0,1,0,38
293544,68684,2011-04-13,House,"Reported With Recommendation Without Amendment",7,0,0,0,7
293544,76382,2011-05-03,House,"House Third Reading: Given Immediate Effect Roll Call # 96",109,1,0,0,110
293544,82130,2011-05-19,Senate,"Reported Favorably Without Amendment",4,0,0,0,4
293544,82131,2011-05-19,Senate,"Senate Third Reading: Given Immediate Effect Roll Call # 222",38,0,0,0,38
293572,83052,2011-05-17,House,"Reported With Recommendation Without Amendment",9,0,0,0,9
293572,85005,2011-05-25,House,"House Third Reading: Given Immediate Effect Roll Call # 151",109,0,0,0,109
293708,68698,2011-04-13,House,"Reported With Recommendation Without Amendment",6,0,0,0,6
293708,76389,2011-05-03,House,"House Third Reading: Given Immediate Effect Roll Call # 97",109,1,0,0,110
293708,82134,2011-05-19,Senate,"Reported Favorably Without Amendment",4,0,0,0,4
293708,82135,2011-05-19,Senate,"Senate Third Reading: Given Immediate Effect Roll Call # 223",38,0,0,0,38
293765,54982,2011-03-09,Senate,"Reported Favorably Without Amendment",7,0,0,0,7
293765,54983,2011-03-17,Senate,"Senate Third Reading: Passed Roll Call # 77",37,1,0,0,38
293765,76486,2011-05-03,House,"Reported With Recommendation Without Amendment",17,1,0,0,18
293765,97554,2011-06-30,House,"House Third Reading: Given Immediate Effect Roll Call # 280",88,20,0,0,108
293765,97555,2011-06-30,Senate,"Senate Third Reading:  Roll Call # 441",35,3,0,0,38
293803,83140,2011-05-17,House,"Reported With Recommendation With Substitute H-1",9,0,0,0,9
293803,85118,2011-05-25,House,"House Third Reading: Given Immediate Effect Roll Call # 152",109,0,0,0,109
293803,91239,2011-06-09,Senate,"Reported Favorably Without Amendment",3,0,0,0,3
293803,93838,2011-06-21,Senate,"Senate Third Reading: Given Immediate Effect Roll Call # 320",38,0,0,0,38
296178,82538,2011-05-19,Senate,"Reported Favorably With Substitute S-2",4,0,0,0,4
296178,90632,2011-06-07,Senate,"Senate Third Reading: Passed Roll Call # 269",38,0,0,0,38
296178,214246,2012-11-29,House,"Reported With Recommendation With Substitute H-2",15,0,0,0,15
296178,215402,2012-12-12,House,"House Third Reading: Given Immediate Effect Roll Call # 742",101,7,0,0,108
296178,215716,2012-12-13,Senate,"Senate Third Reading:  Roll Call # 1011",38,0,0,0,38
296214,82553,2011-05-19,Senate,"Reported Favorably Without Amendment",4,0,0,0,4
296250,102463,2011-09-22,Senate,"Reported Favorably With Substitute S-1",5,2,0,0,7
296250,102464,2011-09-22,Senate,"Senate Third Reading: Passed Roll Call # 503",30,6,0,2,38
296250,102575,2011-09-28,House,"Reported With Recommendation With Substitute H-1",25,0,0,0,25
296250,102576,2011-09-28,House,"House Third Reading: Given Immediate Effect Roll Call # 370",101,8,0,0,109
296250,102577,2011-09-28,Senate,"Senate Third Reading:  Roll Call # 532",33,5,0,0,38
296288,79927,2011-05-12,Senate,"Reported Favorably With Substitute S-1",3,0,0,0,3
296370,55035,2011-03-17,Senate,"Reported Favorably With Substitute S-1",7,0,0,0,7
296370,67092,2011-04-12,Senate,"Senate Third Reading: Passed Roll Call # 88",38,0,0,0,38
296370,76704,2011-05-04,House,"Reported With Recommendation Without Amendment",8,2,0,0,10
296370,81547,2011-05-18,House,"House Third Reading: Given Immediate Effect Roll Call # 138",76,30,0,0,106
296397,82616,2011-05-19,Senate,"Reported Favorably With Substitute S-1",4,0,0,0,4
296409,82665,2011-05-19,Senate,"Reported Favorably Without Amendment",4,0,0,0,4
296409,92653,2011-06-16,Senate,"Senate Third Reading: Passed Roll Call # 296",38,0,0,0,38
296409,102864,2011-10-13,House,"Reported With Recommendation Without Amendment",14,0,0,0,14
296409,103180,2011-11-02,House,"House Third Reading: Given Immediate Effect Roll Call # 444",108,0,0,0,108
296561,55118,2011-03-17,House,"Reported With Recommendation Without Amendment",15,0,0,0,15
296561,65507,2011-04-12,House,"House Third Reading: Given Immediate Effect Roll Call # 71",91,17,0,0,108
296561,78714,2011-05-10,Senate,"Reported Favorably Without Amendment",8,0,0,0,8
296561,83814,2011-05-24,Senate,"Senate Third Reading: Given Immediate Effect Roll Call # 225",37,0,0,1,38
296620,145493,2012-01-19,House,"Reported With Recommendation With Substitute H-4",14,1,0,0,15
296620,168452,2012-03-06,House,"House Third Reading: Given Immediate Effect Roll Call # 93",105,4,0,0,109
296620,172828,2012-03-14,Senate,"Reported Favorably Without Amendment",3,0,0,0,3
296620,187068,2012-04-18,Senate,"Senate Third Reading: Given Immediate Effect Roll Call # 205",38,0,0,0,38
296620,189296,2012-04-24,House,"House Third Reading: Senate Amendment(s) Concurred In Roll Call # 186",105,3,0,0,108
296776,92180,2011-06-14,House,"Reported With Recommendation Without Amendment",14,0,0,0,14
296776,94406,2011-06-22,House,"House Third Reading: Given Immediate Effect Roll Call # 209",92,18,0,0,110
296776,102800,2011-10-06,Senate,"Reported Favorably Without Amendment",5,0,0,0,5
296776,104421,2011-12-01,Senate,"Senate Third Reading: Passed Roll Call # 728",25,11,1,1,38
296776,105528,2011-12-07,House,"House Third Reading:  Roll Call # 526",91,17,0,0,108
297341,78906,2011-05-05,House,"Reported With Recommendation Without Amendment",16,0,0,0,16
297341,96870,2011-06-30,House,"House Third Reading: Given Immediate Effect Roll Call # 260",107,0,0,0,107
297341,102487,2011-09-21,Senate,"Reported Favorably Without Amendment",4,0,0,0,4
297341,143985,2012-01-19,Senate,"Senate Third Reading: Given Immediate Effect Roll Call # 1",35,0,0,3,38
297509,54924,2011-03-15,House,"Reported With Recommendation Without Amendment",11,1,0,0,12
297509,54925,2011-03-17,House,"House Third Reading: Given Immediate Effect Roll Call # 41",79,31,0,0,110
297509,55736,2011-03-23,Senate,"Reported Favorably Without Amendment",4,0,0,0,4
297509,55737,2011-03-23,Senate,"Senate Third Reading: Given Immediate Effect Roll Call # 82",24,13,0,1,38
297509,55738,2011-03-23,House,"House Third Reading: Senate Amendment(s) Concurred In Roll Call # 55",65,44,0,0,109
297553,77021,2011-05-04,Senate,"Reported Favorably With Substitute S-1",7,0,0,0,7
297553,92148,2011-06-14,Senate,"Senate Third Reading: Passed Roll Call # 283",38,0,0,0,38
297553,101978,2011-09-08,House,"Reported With Recommendation For Referral To Committee On Banking And Financial Services",15,0,0,0,15
297553,102633,2011-09-28,House,"Reported With Recommendation Without Amendment",11,0,0,0,11
297553,102738,2011-10-05,House,"House Third Reading: Given Immediate Effect Roll Call # 386",109,0,0,0,109
297553,102824,2011-10-12,Senate,"Senate Third Reading:  Roll Call # 571",37,0,0,1,38
297580,54948,2011-03-16,House,"Reported With Recommendation With Substitute H-1",17,0,0,0,17
297580,66849,2011-04-13,House,"House Third Reading: Given Immediate Effect Roll Call # 73",110,0,0,0,110
297580,78568,2011-05-10,Senate,"Reported Favorably With Substitute S-1",14,1,0,0,15
297580,78569,2011-05-10,Senate,"Senate Third Reading: Given Immediate Effect Roll Call # 142",30,8,0,0,38
297580,81019,2011-05-17,House,"House Third Reading:  Roll Call # 131",104,4,0,0,108
297589,90639,2011-06-07,Senate,"Reported Favorably With Substitute S-1",5,1,0,0,6
297589,94176,2011-06-22,Senate,"Senate Third Reading: Passed Roll Call # 324",24,14,0,0,38
297589,201116,2012-06-05,House,"Reported With Recommendation With Substitute H-4",6,2,0,0,8
297589,202184,2012-06-13,House,"House Third Reading: Given Immediate Effect Roll Call # 441",58,52,0,0,110
297589,202185,2012-06-13,Senate,"Senate Third Reading:  Roll Call # 518",24,12,0,2,38
297689,76702,2011-05-04,Senate,"Reported Favorably With Substitute S-3",7,0,0,0,7
297689,92033,2011-06-14,Senate,"Senate Third Reading: Passed Roll Call # 285",38,0,0,0,38
297689,101981,2011-09-08,House,"Reported With Recommendation For Referral To Committee On Banking And Financial Services",15,0,0,0,15
297689,102642,2011-09-28,House,"Reported With Recommendation Without Amendment",11,0,0,0,11
297689,102725,2011-10-05,House,"House Third Reading: Given Immediate Effect Roll Call # 388",109,0,0,0,109
297689,102831,2011-10-12,Senate,"Senate Third Reading: House Amendment(s) Concurred In Roll Call # 572",37,0,0,1,38
297698,76791,2011-05-04,Senate,"Reported Favorably Without Amendment",7,0,0,0,7
297698,93301,2011-06-14,Senate,"Senate Third Reading: Passed Roll Call # 282",38,0,0,0,38
297698,101982,2011-09-08,House,"Reported With Recommendation For Referral To Committee On Banking And Financial Services",15,0,0,0,15
297698,102643,2011-09-28,House,"Reported With Recommendation Without Amendment",11,0,0,0,11
297698,102729,2011-10-05,House,"House Third Reading: Given Immediate Effect Roll Call # 385",109,0,0,0,109
297698,102835,2011-10-12,Senate,"Senate Third Reading: House Amendment(s) Concurred In Roll Call # 570",37,0,0,1,38
297699,200274,2012-05-30,Senate,"Reported Favorably With Substitute S-1",4,0,0,0,4
297699,201312,2012-06-06,Senate,"Senate Third Reading: Passed Roll Call # 450",38,0,0,0,38
297699,212038,2012-09-13,House,"Reported With Recommendation For Referral To Committee On Families, Children, And Seniors",13,0,0,0,13
297702,76909,2011-05-04,Senate,"Reported Favorably With Substitute S-1",7,0,0,0,7
297702,92103,2011-06-14,Senate,"Senate Third Reading: Passed Roll Call # 286",38,0,0,0,38
297702,101986,2011-09-08,House,"Reported With Recommendation For Referral To Committee On Banking And Financial Services",15,0,0,0,15
297708,76812,2011-05-04,Senate,"Reported Favorably Without Amendment",7,0,0,0,7
297708,91936,2011-06-14,Senate,"Senate Third Reading: Passed Roll Call # 284",38,0,0,0,38
297708,101979,2011-09-08,House,"Reported With Recommendation For Referral To Committee On Banking And Financial Services",15,0,0,0,15
297708,102632,2011-09-28,House,"Reported With Recommendation Without Amendment",11,0,0,0,11
297708,102736,2011-10-05,House,"House Third Reading: Given Immediate Effect Roll Call # 387",109,0,0,0,109
297718,200348,2012-05-30,Senate,"Reported Favorably With Substitute S-1",4,0,0,0,4
297718,201332,2012-06-06,Senate,"Senate Third Reading: Passed Roll Call # 449",38,0,0,0,38
297718,212019,2012-09-13,House,"Reported With Recommendation For Referral To Committee On Families, Children, And Seniors",14,0,0,0,14
297718,213735,2012-11-27,House,"Reported With Recommendation With Substitute H-2",9,0,0,0,9
297718,215206,2012-12-06,House,"House Third Reading: Passed Roll Call # 706",69,39,0,0,108
297718,215411,2012-12-12,Senate,"Senate Third Reading:  Roll Call # 871",36,0,0,2,38
297890,82109,2011-05-19,Senate,"Reported Favorably Without Amendment",4,0,0,0,4
297891,67717,2011-04-14,Senate,"Reported Favorably Without Amendment",4,0,0,0,4
297925,54960,2011-03-16,Senate,"Reported Favorably With Substitute S-1",4,0,0,0,4
297925,66813,2011-04-13,Senate,"Senate Third Reading: Passed Roll Call # 90",37,0,0,1,38
297931,77945,2011-05-03,House,"Reported With Recommendation With Substitute H-2",7,1,0,0,8
297931,79542,2011-05-12,House,"House Third Reading: Given Immediate Effect Roll Call # 123",72,36,0,0,108
297931,98909,2011-07-13,Senate,"Senate Third Reading: Passed Roll Call # 446",24,12,0,2,38
297931,100906,2011-08-24,House,"House Third Reading:  Roll Call # 318",73,34,0,0,107
297946,77940,2011-05-05,House,"Reported With Recommendation Without Amendment",15,0,0,0,15
297946,80860,2011-05-17,House,"House Third Reading: Given Immediate Effect Roll Call # 134",108,0,0,0,108
297946,91177,2011-06-09,Senate,"Reported Favorably With Substitute S-1",4,0,0,0,4
297946,103248,2011-11-03,Senate,"Senate Third Reading: Given Immediate Effect Roll Call # 634",38,0,0,0,38
297946,103358,2011-11-09,House,"House Third Reading:  Roll Call # 462",108,0,0,0,108
297977,77985,2011-05-05,House,"Reported With Recommendation Without Amendment",16,0,0,0,16
297977,80919,2011-05-17,House,"House Third Reading: Given Immediate Effect Roll Call # 136",108,0,0,0,108
297984,77984,2011-05-03,House,"Reported With Recommendation With Substitute H-2",7,1,0,0,8
297984,79344,2011-05-12,House,"House Third Reading: Given Immediate Effect Roll Call # 122",72,36,0,0,108
297984,79345,2011-05-12,House,"House Third Reading:  Roll Call # 129",62,46,0,0,108
297984,98926,2011-07-13,Senate,"Senate Third Reading: Passed Roll Call # 445",24,12,0,2,38
297984,100908,2011-08-24,House,"House Third Reading:  Roll Call # 317",73,34,0,0,107
298014,78000,2011-05-05,House,"Reported With Recommendation With Substitute H-1",15,0,0,0,15
298014,81050,2011-05-17,House,"House Third Reading: Given Immediate Effect Roll Call # 135",108,0,0,0,108
298014,91133,2011-06-09,Senate,"Reported Favorably With Substitute S-1",4,0,0,0,4
298014,103242,2011-11-03,Senate,"Senate Third Reading: Given Immediate Effect Roll Call # 635",38,0,0,0,38
298014,103328,2011-11-09,House,"House Third Reading:  Roll Call # 463",108,0,0,0,108
298039,55335,2011-03-22,Senate,"Reported Favorably With Substitute S-1",7,0,0,0,7
298039,56323,2011-03-24,Senate,"Senate Third Reading: Passed Roll Call # 86",36,0,0,2,38
298039,67900,2011-04-13,House,"Reported With Recommendation Without Amendment",14,0,0,0,14
298039,73839,2011-04-26,House,"House Third Reading: Given Immediate Effect Roll Call # 81",108,0,0,0,108
298039,74204,2011-04-27,Senate,"Senate Third Reading: House Amendment(s) Concurred In Roll Call # 105",35,0,0,3,38
300701,69764,2011-04-14,House,"Reported With Recommendation Without Amendment",9,6,0,0,15
300701,78686,2011-05-10,House,"House Third Reading: Given Immediate Effect Roll Call # 103",63,47,0,0,110
300701,94544,2011-06-22,Senate,"Reported Favorably Without Amendment",3,0,0,0,3
300701,97035,2011-06-30,Senate,"Senate Third Reading: Given Immediate Effect Roll Call # 410",26,12,0,0,38
301541,102712,2011-10-04,Senate,"Reported Favorably Without Amendment",4,0,0,0,4
301541,195125,2012-05-08,Senate,"Senate Third Reading: Passed Roll Call # 311",35,2,0,1,38
301541,214619,2012-11-29,House,"Reported With Recommendation With Substitute H-1",9,3,0,0,12
301541,215434,2012-12-12,House,"House Third Reading: Given Immediate Effect Roll Call # 744",75,33,0,0,108
301541,215769,2012-12-13,Senate,"Senate Third Reading:  Roll Call # 1019",38,0,0,0,38
301699,79547,2011-05-12,House,"Reported With Recommendation Without Amendment",16,0,0,0,16
301719,101921,2011-09-08,House,"Reported With Recommendation For Referral To Committee On Banking And Financial Services",15,0,0,0,15
301792,74659,2011-04-28,Senate,"Reported Favorably Without Amendment",6,0,0,0,6
302161,76980,2011-05-04,Senate,"Reported Favorably With Substitute S-1",6,0,0,0,6
302161,81344,2011-05-18,Senate,"Senate Third Reading: Passed Roll Call # 200",35,3,0,0,38
302161,102795,2011-10-04,House,"Reported With Recommendation Without Amendment",13,2,0,0,15
302161,215842,2012-12-14,House,"House Third Reading: Defeated Roll Call # 909",54,50,0,0,104
302324,85341,2011-05-25,House,"Reported With Recommendation With Substitute H-2",9,0,0,0,9
302324,92714,2011-06-16,House,"House Third Reading: Given Immediate Effect Roll Call # 202",75,33,0,0,108
302324,103225,2011-11-03,Senate,"Reported Favorably With Substitute S-1",7,0,0,0,7
302324,103435,2011-11-10,Senate,"Senate Third Reading: Given Immediate Effect Roll Call # 687",27,9,0,2,38
302324,103436,2011-11-10,House,"House Third Reading:  Roll Call # 487",77,30,0,0,107
302511,69966,2011-04-14,House,"Reported With Recommendation Without Amendment",17,0,0,0,17
302574,165232,2012-02-29,House,"Reported With Recommendation For Referral To Committee On Education",25,0,0,0,25
302574,186987,2012-04-18,House,"Reported With Recommendation With Substitute H-3",11,5,0,0,16
302576,74675,2011-04-28,Senate,"Reported Favorably Without Amendment",5,1,0,0,6
302576,77388,2011-05-05,Senate,"Senate Third Reading: Passed Roll Call # 127",27,11,0,0,38
302576,103181,2011-11-02,House,"Reported With Recommendation With Substitute H-3",15,0,0,0,15
302576,103415,2011-11-10,House,"House Third Reading: Given Immediate Effect Roll Call # 474",100,7,0,0,107
302576,103681,2011-11-30,Senate,"Senate Third Reading:  Roll Call # 709",26,11,1,0,38
302583,71949,2011-04-21,House,"Reported With Recommendation Without Amendment",13,0,0,0,13
302583,198712,2012-05-24,House,"House Third Reading: Given Immediate Effect Roll Call # 295",107,1,0,0,108
302583,214361,2012-11-29,Senate,"Reported Favorably Without Amendment",5,0,0,0,5
302599,95107,2011-06-22,House,"Reported With Recommendation With Substitute H-7",4,1,0,0,5
302599,95108,2011-06-23,House,"House Third Reading: Given Immediate Effect Roll Call # 236",58,51,0,0,109
302841,102014,2011-09-08,House,"Reported With Recommendation For Referral To Committee On Banking And Financial Services",13,0,0,0,13
302841,102595,2011-09-28,House,"Reported With Recommendation Without Amendment",11,0,0,0,11
302841,102731,2011-10-05,House,"House Third Reading: Given Immediate Effect Roll Call # 382",109,0,0,0,109
302841,102815,2011-10-11,Senate,"Reported Favorably Without Amendment",4,2,0,0,6
302841,102837,2011-10-12,Senate,"Senate Third Reading: Given Immediate Effect Roll Call # 574",37,0,0,1,38
302886,102013,2011-09-08,House,"Reported With Recommendation For Referral To Committee On Banking And Financial Services",15,0,0,0,15
302886,102596,2011-09-28,House,"Reported With Recommendation With Substitute H-1",11,0,0,0,11
302886,102732,2011-10-05,House,"House Third Reading: Given Immediate Effect Roll Call # 383",109,0,0,0,109
302886,102816,2011-10-11,Senate,"Reported Favorably Without Amendment",4,2,0,0,6
302886,102838,2011-10-12,Senate,"Senate Third Reading: Given Immediate Effect Roll Call # 575",37,0,0,1,38
302887,73943,2011-04-27,House,"Reported With Recommendation Without Amendment",10,7,0,0,17
302887,74575,2011-04-28,House,"House Third Reading: Given Immediate Effect Roll Call # 91",56,52,0,0,108
302887,79767,2011-05-12,Senate,"Reported Favorably Without Amendment",3,0,0,0,3
302887,79768,2011-05-12,Senate,"Senate Third Reading: Defeated Roll Call # 176",19,18,1,0,38
302887,79769,2011-05-12,Senate,"Senate Third Reading: Defeated Roll Call # 181",19,18,1,0,38
302887,79770,2011-05-12,Senate,"Senate Third Reading: Given Immediate Effect Roll Call # 195",19,19,0,0,38
303057,85774,2011-05-25,House,"Reported With Recommendation With Substitute H-2",13,0,0,0,13
303057,92716,2011-06-16,House,"House Third Reading: Given Immediate Effect Roll Call # 201",99,9,0,0,108
303057,103226,2011-11-03,Senate,"Reported Favorably Without Amendment",5,2,0,0,7
303057,103429,2011-11-10,Senate,"Senate Third Reading: Given Immediate Effect Roll Call # 686",27,9,0,2,38
303277,102798,2011-10-05,Senate,"Reported Favorably With Substitute S-1",6,0,0,0,6
303277,103685,2011-11-30,Senate,"Senate Third Reading: Passed Roll Call # 713",38,0,0,0,38
303277,149292,2012-02-02,House,"Reported With Recommendation Without Amendment",16,0,0,0,16
303277,158617,2012-02-21,House,"House Third Reading: Given Immediate Effect Roll Call # 68",101,5,0,0,106
303431,95113,2011-06-22,House,"Reported With Recommendation Without Amendment",14,0,0,0,14
303431,95114,2011-06-23,House,"House Third Reading: Given Immediate Effect Roll Call # 235",109,0,0,0,109
303431,96681,2011-06-30,Senate,"Reported Favorably With Amendment(s)",6,0,0,0,6
303431,96682,2011-06-30,Senate,"Senate Third Reading: Given Immediate Effect Roll Call # 432",38,0,0,0,38
303431,96683,2011-06-30,House,"House Third Reading: Senate Amendment(s) Concurred In Roll Call # 291",108,0,0,0,108
303802,73438,2011-04-26,Senate,"Reported Favorably Without Amendment",6,0,0,0,6
303934,192385,2012-05-02,House,"Reported With Recommendation With Substitute H-3",16,0,0,0,16
304109,70178,2011-04-14,House,"Reported With Recommendation With Substitute H-5",17,0,0,0,17
304109,74019,2011-04-27,House,"House Third Reading: Given Immediate Effect Roll Call # 84",104,4,0,0,108
304109,84897,2011-05-25,Senate,"Reported Favorably Without Amendment",9,0,0,0,9
304109,84898,2011-05-25,Senate,"Senate Third Reading: Given Immediate Effect Roll Call # 250",37,0,0,1,38
304193,74042,2011-04-27,House,"Reported With Recommendation Without Amendment",10,7,0,0,17
304193,74646,2011-04-28,House,"House Third Reading: Given Immediate Effect Roll Call # 94",56,53,0,0,109
304193,79775,2011-05-12,Senate,"Reported Favorably Without Amendment",3,0,0,0,3
304193,79776,2011-05-12,Senate,"Senate Third Reading: Given Immediate Effect Roll Call # 179",19,19,0,0,38
304338,74069,2011-04-27,House,"Reported With Recommendation With Substitute H-1",10,6,0,0,16
304338,74673,2011-04-28,House,"House Third Reading: Given Immediate Effect Roll Call # 95",57,52,0,0,109
304338,79778,2011-05-12,Senate,"Reported Favorably Without Amendment",3,0,0,0,3
304338,79779,2011-05-12,Senate,"Senate Third Reading: Given Immediate Effect Roll Call # 180",19,19,0,0,38
304384,102038,2011-09-08,House,"Reported With Recommendation For Referral To Committee On Banking And Financial Services",14,0,0,0,14
304416,212084,2012-09-20,Senate,"Reported Favorably With Substitute S-1",5,0,0,0,5
304416,212295,2012-09-27,Senate,"Senate Third Reading: Passed Roll Call # 677",38,0,0,0,38
304416,213717,2012-11-27,House,"Reported With Recommendation Without Amendment",14,0,0,0,14
304416,215215,2012-12-06,House,"House Third Reading: Passed Roll Call # 708",66,43,0,0,109
304441,70227,2011-04-14,House,"Reported With Recommendation With Substitute H-1",17,0,0,0,17
304441,74088,2011-04-27,House,"House Third Reading: Given Immediate Effect Roll Call # 85",104,4,0,0,108
304441,84749,2011-05-25,Senate,"Reported Favorably Without Amendment",9,0,0,0,9
304441,84750,2011-05-25,Senate,"Senate Third Reading: Given Immediate Effect Roll Call # 251",37,0,0,1,38
304480,91097,2011-06-09,House,"Reported With Recommendation With Amendment(s)",13,0,0,0,13
304480,94252,2011-06-22,House,"House Third Reading: Given Immediate Effect Roll Call # 208",110,0,0,0,110
304508,149013,2012-02-02,House,"Reported With Recommendation Without Amendment",13,1,0,0,14
304508,176594,2012-03-21,House,"House Third Reading: Given Immediate Effect Roll Call # 128",99,9,0,0,108
304508,213641,2012-11-08,Senate,"Reported Favorably With Substitute S-1",3,0,0,0,3
305065,79037,2011-05-10,House,"Reported With Recommendation With Substitute H-2",16,0,0,0,16
305065,90569,2011-06-07,House,"House Third Reading: Given Immediate Effect Roll Call # 162",109,0,0,0,109
305065,102376,2011-09-20,Senate,"Reported Favorably With Substitute S-1",7,0,0,0,7
305065,103032,2011-10-26,Senate,"Senate Third Reading: Given Immediate Effect Roll Call # 592",38,0,0,0,38
305065,103131,2011-11-01,House,"House Third Reading:  Roll Call # 437",109,0,0,0,109
305071,85148,2011-05-26,House,"Reported With Recommendation For Referral To Committee On Education",6,0,0,0,6
305331,74778,2011-04-28,House,"Reported With Recommendation Without Amendment",12,1,0,0,13
305331,81399,2011-05-18,House,"House Third Reading: Given Immediate Effect Roll Call # 137",99,7,0,0,106
305331,91161,2011-06-09,Senate,"Reported Favorably Without Amendment",3,0,0,0,3
305331,96099,2011-06-29,Senate,"Senate Third Reading: Given Immediate Effect Roll Call # 367",38,0,0,0,38
305570,104511,2011-12-01,House,"Reported With Recommendation With Substitute H-5",10,0,0,0,10
305570,105566,2011-12-08,House,"House Third Reading: Given Immediate Effect Roll Call # 559",108,0,0,0,108
305570,138705,2011-12-14,Senate,"Reported Favorably With Substitute S-1",9,0,0,0,9
305570,138706,2011-12-14,Senate,"Senate Third Reading: Given Immediate Effect Roll Call # 811",38,0,0,0,38
305570,138707,2011-12-15,House,"House Third Reading:  Roll Call # 606",106,0,0,0,106
305610,169950,2012-03-08,Senate,"Reported Favorably With Substitute S-1",6,0,0,0,6
305610,192486,2012-05-02,Senate,"Senate Third Reading: Passed Roll Call # 279",36,1,0,1,38
305610,195495,2012-05-10,House,"Reported With Recommendation Without Amendment",17,0,0,0,17
305610,197961,2012-05-22,House,"House Third Reading: Given Immediate Effect Roll Call # 281",103,4,0,0,107
305610,200729,2012-05-31,Senate,"Senate Third Reading: House Amendment(s) Concurred In Roll Call # 412",35,1,0,2,38
305658,74113,2011-04-27,House,"Reported With Recommendation Without Amendment",16,0,0,0,16
305658,74722,2011-04-28,House,"House Third Reading: Given Immediate Effect Roll Call # 93",109,0,0,0,109
305658,79702,2011-05-12,Senate,"Reported Favorably Without Amendment",3,0,0,0,3
305658,79703,2011-05-12,Senate,"Senate Third Reading: Given Immediate Effect Roll Call # 178",30,8,0,0,38
305658,79704,2011-05-12,Senate,"Senate Third Reading: Passed Roll Call # 194",30,8,0,0,38
305711,77593,2011-05-05,Senate,"Reported Favorably Without Amendment",4,0,0,0,4
306040,76946,2011-05-03,House,"Reported With Recommendation With Substitute H-1",21,0,0,0,21
306040,103751,2011-06-08,Senate,"Reported Favorably With Substitute S-1",6,2,0,0,8
306291,94067,2011-06-21,Senate,"Reported Favorably With Substitute S-1",3,1,0,0,4
306409,91420,2011-06-08,House,"Reported With Recommendation Without Amendment",14,2,0,0,16
306409,94418,2011-06-23,House,"House Third Reading: Given Immediate Effect Roll Call # 214",67,43,0,0,110
306409,215656,2012-12-13,Senate,"Senate Third Reading: Given Immediate Effect Roll Call # 1036",20,16,1,0,37
306409,215657,2012-12-13,House,"House Third Reading: Senate Amendment(s) Concurred In Roll Call # 863",65,44,0,0,109
306412,74497,2011-04-28,Senate,"Reported Favorably With Substitute S-1",5,1,0,0,6
306412,77322,2011-05-05,Senate,"Senate Third Reading: Passed Roll Call # 129",27,11,0,0,38
306412,103167,2011-11-02,House,"Reported With Recommendation Without Amendment",14,0,0,0,14
306412,103407,2011-11-10,House,"House Third Reading: Given Immediate Effect Roll Call # 476",100,7,0,0,107
306466,212027,2012-09-13,House,"Reported With Recommendation For Referral To Committee On Families, Children, And Seniors",14,0,0,0,14
306578,70480,2011-04-14,House,"Reported With Recommendation With Substitute H-1",17,0,0,0,17
306578,74178,2011-04-27,House,"House Third Reading: Given Immediate Effect Roll Call # 86",104,4,0,0,108
306578,84795,2011-05-25,Senate,"Reported Favorably Without Amendment",9,0,0,0,9
306578,84796,2011-05-25,Senate,"Senate Third Reading: Given Immediate Effect Roll Call # 252",37,0,0,1,38
306597,102686,2011-09-28,House,"Reported With Recommendation With Substitute H-1",10,2,0,0,12
306597,104383,2011-12-01,House,"House Third Reading: Passed Roll Call # 518",68,38,0,0,106
306597,104384,2011-12-01,House,"House Third Reading: Passed Roll Call # 519",68,39,0,0,107
306597,212933,2012-10-17,Senate,"Reported Favorably With Substitute S-1",6,1,0,0,7
306597,215461,2012-12-12,Senate,"Senate Third Reading: Given Immediate Effect Roll Call # 919",26,11,0,1,38
306597,215572,2012-12-13,House,"House Third Reading:  Roll Call # 845",70,39,0,0,109
306779,74510,2011-04-28,Senate,"Reported Favorably With Substitute S-1",6,0,0,0,6
306779,77331,2011-05-05,Senate,"Senate Third Reading: Passed Roll Call # 128",33,5,0,0,38
306779,103174,2011-11-02,House,"Reported With Recommendation With Substitute H-1",15,0,0,0,15
306779,103412,2011-11-10,House,"House Third Reading: Given Immediate Effect Roll Call # 473",104,3,0,0,107
306779,103678,2011-11-30,Senate,"Senate Third Reading:  Roll Call # 708",34,4,0,0,38
307506,102078,2011-09-08,House,"Reported With Recommendation For Referral To Committee On Banking And Financial Services",15,0,0,0,15
307543,196427,2012-05-16,House,"Reported With Recommendation Without Amendment",12,0,0,0,12
307543,198701,2012-05-24,House,"House Third Reading: Given Immediate Effect Roll Call # 298",106,2,0,0,108
307877,79034,2011-05-10,House,"Reported With Recommendation With Substitute H-1",11,0,0,0,11
307877,82082,2011-05-19,House,"House Third Reading: Given Immediate Effect Roll Call # 144",99,9,0,0,108
307877,95394,2011-06-28,Senate,"Reported Favorably Without Amendment",6,0,0,0,6
307877,96760,2011-06-30,Senate,"Senate Third Reading: Given Immediate Effect Roll Call # 401",38,0,0,0,38
308355,211949,2012-09-13,House,"Reported With Recommendation For Referral To Committee On Families, Children, And Seniors",14,0,0,0,14
308355,213719,2012-11-27,House,"Reported With Recommendation With Substitute H-3",9,0,0,0,9
308355,215083,2012-12-05,House,"House Third Reading: Passed Roll Call # 679",106,0,0,0,106
308355,215389,2012-12-12,Senate,"Senate Third Reading: Given Immediate Effect Roll Call # 876",38,0,0,0,38
308379,102085,2011-09-08,House,"Reported With Recommendation For Referral To Committee On Banking And Financial Services",14,0,0,0,14
308861,81440,2011-05-18,House,"Reported With Recommendation Without Amendment",12,0,0,0,12
308861,92087,2011-06-14,House,"House Third Reading: Given Immediate Effect Roll Call # 189",103,4,0,0,107
308861,98940,2011-07-13,Senate,"Reported Favorably Without Amendment",5,0,0,0,5
309195,75350,2011-04-27,House,"Reported With Recommendation With Substitute H-2",11,6,0,0,17
309234,93026,2011-06-14,House,"Reported With Recommendation With Substitute H-5",3,2,0,0,5
309234,94457,2011-06-23,House,"House Third Reading: Given Immediate Effect Roll Call # 237",107,1,0,0,108
309234,95946,2011-06-29,Senate,"Senate Third Reading: Given Immediate Effect Roll Call # 372",27,10,1,0,38
309234,95947,2011-06-29,House,"House Third Reading: Senate Amendment(s) Concurred In Roll Call # 252",109,0,0,0,109
309236,173410,2012-03-15,Senate,"Reported Favorably With Substitute S-3",3,1,0,0,4
309236,193007,2012-05-03,Senate,"Senate Third Reading: Passed Roll Call # 308",36,2,0,0,38
309236,201458,2012-06-07,House,"Reported With Recommendation With Substitute H-2",13,3,0,0,16
309236,202352,2012-06-13,House,"House Third Reading: Given Immediate Effect Roll Call # 443",66,44,0,0,110
309236,202353,2012-06-13,Senate,"Senate Third Reading:  Roll Call # 519",25,11,0,2,38
309469,93689,2011-06-21,Senate,"Reported Favorably With Substitute S-1",3,1,0,0,4
309896,79117,2011-05-10,House,"Reported With Recommendation With Substitute H-1",10,0,0,0,10
309896,82125,2011-05-19,House,"House Third Reading: Given Immediate Effect Roll Call # 145",101,7,0,0,108
309896,95526,2011-06-28,Senate,"Reported Favorably With Substitute S-1",6,0,0,0,6
309896,96571,2011-06-30,Senate,"Senate Third Reading: Given Immediate Effect Roll Call # 402",38,0,0,0,38
309896,96994,2011-06-30,House,"House Third Reading:  Roll Call # 290",101,7,0,0,108
310050,91480,2011-06-09,Senate,"Reported Favorably Without Amendment",5,1,0,0,6
310050,94160,2011-06-22,Senate,"Senate Third Reading: Passed Roll Call # 328",35,3,0,0,38
310050,196667,2012-05-16,House,"Reported With Recommendation Without Amendment",16,0,0,0,16
310050,200637,2012-05-30,House,"House Third Reading: Given Immediate Effect Roll Call # 327",100,10,0,0,110
310087,102465,2011-09-22,House,"Reported With Recommendation With Substitute H-1",16,1,0,0,17
310087,151559,2012-02-08,House,"House Third Reading: Given Immediate Effect Roll Call # 41",103,1,0,0,104
310087,202137,2012-06-13,Senate,"Reported Favorably With Amendment(s)",4,0,0,0,4
310087,202456,2012-06-14,Senate,"Senate Third Reading: Given Immediate Effect Roll Call # 541",35,3,0,0,38
310087,202457,2012-06-14,House,"House Third Reading: Senate Amendment(s) Concurred In Roll Call # 489",108,1,0,0,109
310422,70956,2011-04-13,House,"Reported With Recommendation Without Amendment",14,0,0,0,14
310422,74094,2011-04-26,House,"House Third Reading: Given Immediate Effect Roll Call # 82",108,0,0,0,108
310422,86934,2011-06-01,Senate,"Reported Favorably With Substitute S-1",5,0,0,0,5
310422,94206,2011-06-22,Senate,"Senate Third Reading: Given Immediate Effect Roll Call # 325",38,0,0,0,38
310422,95485,2011-06-28,House,"House Third Reading:  Roll Call # 238",108,0,0,0,108
310431,103163,2011-11-02,Senate,"Reported Favorably With Substitute S-2",7,0,0,0,7
310431,146158,2012-01-26,Senate,"Senate Third Reading: Passed Roll Call # 24",38,0,0,0,38
310566,102470,2011-09-22,House,"Reported With Recommendation With Substitute H-1",15,0,0,0,15
310566,102594,2011-09-28,House,"House Third Reading: Given Immediate Effect Roll Call # 372",108,1,0,0,109
310855,77120,2011-05-04,Senate,"Reported Favorably With Substitute S-1",6,0,0,0,6
310855,77431,2011-05-05,Senate,"Senate Third Reading: Passed Roll Call # 135",29,9,0,0,38
310855,103249,2011-11-02,House,"Reported With Recommendation Without Amendment",15,0,0,0,15
310855,103417,2011-11-10,House,"House Third Reading: Passed Roll Call # 479",94,12,0,0,106
310855,103418,2011-11-10,House,"House Third Reading: Given Immediate Effect Roll Call # 480",93,14,0,0,107
310987,102202,2011-09-15,Senate,"Reported Favorably With Substitute S-1",3,1,0,0,4
310987,102922,2011-10-19,Senate,"Senate Third Reading: Passed Roll Call # 583",31,7,0,0,38
310987,187905,2012-04-19,House,"Reported With Recommendation With Substitute H-1",15,1,0,0,16
310987,191689,2012-05-01,House,"House Third Reading: Given Immediate Effect Roll Call # 214",107,2,0,0,109
310987,194414,2012-05-08,Senate,"Senate Third Reading:  Roll Call # 309",37,0,0,1,38
311057,92492,2011-06-15,House,"Reported With Recommendation With Substitute H-4",11,0,0,0,11
311057,104362,2011-12-01,House,"Reported With Recommendation With Substitute H-6",10,0,0,0,10
311057,105514,2011-12-08,House,"House Third Reading: Given Immediate Effect Roll Call # 560",108,0,0,0,108
311057,138663,2011-12-14,Senate,"Reported Favorably With Substitute S-1",9,0,0,0,9
311057,138664,2011-12-14,Senate,"Senate Third Reading: Given Immediate Effect Roll Call # 812",38,0,0,0,38
311057,138665,2011-12-15,House,"House Third Reading:  Roll Call # 607",107,0,0,0,107
311714,71135,2011-04-14,Senate,"Reported Favorably With Substitute S-2",5,0,0,0,5
311714,74479,2011-04-28,Senate,"Senate Third Reading: Passed Roll Call # 119",37,0,0,1,38
311714,77308,2011-05-05,House,"Reported With Recommendation With Substitute H-1",14,0,0,0,14
311714,81669,2011-05-18,House,"House Third Reading: Given Immediate Effect Roll Call # 140",106,0,0,0,106
311714,81955,2011-05-19,Senate,"Senate Third Reading:  Roll Call # 217",37,1,0,0,38
312120,77152,2011-05-04,Senate,"Reported Favorably With Substitute S-1",6,0,0,0,6
312120,77465,2011-05-05,Senate,"Senate Third Reading: Passed Roll Call # 134",28,10,0,0,38
312421,102204,2011-09-13,House,"Reported With Recommendation Without Amendment",9,1,0,0,10
312421,102700,2011-10-04,House,"House Third Reading: Given Immediate Effect Roll Call # 376",69,40,0,0,109
312421,154563,2012-02-14,Senate,"Reported Favorably Without Amendment",4,1,0,0,5
312421,159868,2012-02-22,Senate,"Senate Third Reading: Given Immediate Effect Roll Call # 92",25,12,1,0,38
312421,159869,2012-02-22,Senate,"Senate Third Reading: Passed Roll Call # 96",24,14,0,0,38
312555,71230,2011-04-12,House,"Reported With Recommendation Without Amendment",10,0,0,0,10
312753,79483,2011-05-12,Senate,"Reported Favorably With Substitute S-1",5,2,0,0,7
312753,81573,2011-05-18,Senate,"Senate Third Reading: Passed Roll Call # 201",26,12,0,0,38
312753,103235,2011-11-02,House,"Reported With Recommendation With Substitute H-2",10,0,0,0,10
312753,103427,2011-11-10,House,"House Third Reading: Given Immediate Effect Roll Call # 477",66,41,0,0,107
312753,103684,2011-11-30,Senate,"Senate Third Reading:  Roll Call # 710",26,12,0,0,38
312782,79493,2011-05-12,House,"Reported With Recommendation With Substitute H-1",15,0,0,0,15
312782,86486,2011-05-31,House,"House Third Reading: Given Immediate Effect Roll Call # 156",105,0,0,0,105
312782,92316,2011-06-15,Senate,"Reported Favorably Without Amendment",4,0,0,0,4
312782,96612,2011-06-30,Senate,"Senate Third Reading: Given Immediate Effect Roll Call # 396",38,0,0,0,38
312875,93888,2011-06-21,Senate,"Reported Favorably With Substitute S-1",3,0,0,0,3
313133,104947,2011-12-01,House,"Reported With Recommendation With Substitute H-3",10,0,0,0,10
313133,105732,2011-12-08,House,"House Third Reading: Given Immediate Effect Roll Call # 561",108,0,0,0,108
313133,105733,2011-12-14,Senate,"Reported Favorably Without Amendment",9,0,0,0,9
313133,105734,2011-12-14,Senate,"Senate Third Reading: Given Immediate Effect Roll Call # 814",38,0,0,0,38
313240,84034,2011-05-24,Senate,"Reported Favorably Without Amendment",7,0,0,0,7
313240,87273,2011-06-01,Senate,"Senate Third Reading: Passed Roll Call # 267",38,0,0,0,38
313240,94234,2011-06-22,House,"Reported With Recommendation Without Amendment",11,2,0,0,13
313240,102375,2011-09-20,House,"House Third Reading: Given Immediate Effect Roll Call # 334",79,29,0,0,108
313240,102391,2011-09-21,Senate,"Senate Third Reading: House Amendment(s) Concurred In Roll Call # 491",37,0,0,1,38
313291,196528,2012-05-16,House,"Reported With Recommendation Without Amendment",12,0,0,0,12
313291,198721,2012-05-24,House,"House Third Reading: Given Immediate Effect Roll Call # 297",106,2,0,0,108
313484,93167,2011-06-14,House,"Reported With Recommendation With Substitute H-3",6,2,0,0,8
313484,94604,2011-06-23,House,"House Third Reading: Given Immediate Effect Roll Call # 215",109,1,0,0,110
313484,102807,2011-10-11,Senate,"Reported Favorably With Substitute S-1",4,2,0,0,6
313484,103046,2011-10-27,Senate,"Senate Third Reading: Given Immediate Effect Roll Call # 606",29,9,0,0,38
313484,103183,2011-11-02,House,"House Third Reading:  Roll Call # 443",107,1,0,0,108
314054,93192,2011-06-15,Senate,"Reported Favorably With Substitute S-1",4,0,0,0,4
314054,103378,2011-11-10,Senate,"Senate Third Reading: Passed Roll Call # 676",36,0,0,2,38
314054,190434,2012-04-26,House,"Reported With Recommendation Without Amendment",16,0,0,0,16
314054,197900,2012-05-22,House,"House Third Reading: Given Immediate Effect Roll Call # 280",106,1,0,0,107
314054,199393,2012-05-29,Senate,"Senate Third Reading:  Roll Call # 386",35,0,0,3,38
314323,71414,2011-04-13,House,"Reported With Recommendation With Substitute H-2",12,0,0,0,12
314323,81507,2011-05-17,House,"House Third Reading: Given Immediate Effect Roll Call # 132",106,2,0,0,108
314323,92150,2011-06-14,Senate,"Reported Favorably With Substitute S-1",6,0,0,0,6
314323,95769,2011-06-29,Senate,"Senate Third Reading: Given Immediate Effect Roll Call # 369",38,0,0,0,38
314323,96857,2011-06-30,House,"House Third Reading:  Roll Call # 281",108,0,0,0,108
314516,71805,2011-04-21,House,"Reported With Recommendation With Substitute H-1",16,0,0,0,16
314516,196541,2012-05-16,House,"Reported With Recommendation Without Amendment",12,0,0,0,12
314516,198740,2012-05-24,House,"House Third Reading: Given Immediate Effect Roll Call # 296",107,1,0,0,108
314516,214402,2012-11-29,Senate,"Reported Favorably With Substitute S-1",5,0,0,0,5
314524,201357,2012-06-06,House,"Reported With Recommendation With Substitute H-3",14,0,0,0,14
314524,212350,2012-09-27,House,"House Third Reading: Given Immediate Effect Roll Call # 578",107,0,0,0,107
314524,215617,2012-12-13,Senate,"Senate Third Reading: Given Immediate Effect Roll Call # 972",34,0,4,0,38
314524,215618,2012-12-13,Senate,"Senate Third Reading: Passed Roll Call # 973",38,0,0,0,38
314524,215827,2012-12-14,House,"House Third Reading:  Roll Call # 876",107,0,0,0,107
314858,95055,2011-06-22,House,"Reported With Recommendation With Substitute H-3",14,2,0,0,16
315469,95044,2011-06-22,House,"Reported With Recommendation Without Amendment",5,0,0,0,5
315469,100959,2011-08-24,House,"House Third Reading: Passed Roll Call # 305",85,22,0,0,107
315469,100960,2011-08-24,House,"House Third Reading: Given Immediate Effect Roll Call # 306",87,21,0,0,108
315469,102426,2011-09-22,Senate,"Reported Favorably Without Amendment",3,0,0,0,3
315469,102810,2011-10-11,Senate,"Senate Third Reading: Given Immediate Effect Roll Call # 567",38,0,0,0,38
315605,90526,2011-06-07,Senate,"Reported Favorably Without Amendment",7,0,0,0,7
315605,96543,2011-06-30,Senate,"Senate Third Reading: Passed Roll Call # 394",37,0,1,0,38
315605,196918,2012-05-16,House,"Reported With Recommendation Without Amendment",12,0,0,0,12
315665,93200,2011-06-14,House,"Reported With Recommendation Without Amendment",11,0,0,0,11
315665,96794,2011-06-30,House,"House Third Reading: Passed Roll Call # 279",106,1,0,0,107
315734,77313,2011-05-04,Senate,"Reported Favorably With Substitute S-1",6,0,0,0,6
315734,77314,2011-05-05,Senate,"Senate Third Reading: Passed Roll Call # 136",28,10,0,0,38
315740,96969,2011-06-30,House,"House Third Reading: Given Immediate Effect Roll Call # 273",61,47,0,0,108
315804,101983,2011-09-08,House,"Reported With Recommendation For Referral To Committee On Banking And Financial Services",14,0,0,0,14
315822,74658,2011-04-28,House,"Reported With Recommendation With Substitute H-1",17,9,0,0,26
315822,75470,2011-04-28,House,"Reported With Recommendation With Substitute H-1 And Amendment(s)",17,9,0,0,26
315822,77028,2011-05-04,House,"House Third Reading: Given Immediate Effect Roll Call # 99",62,48,0,0,110
315822,79153,2011-05-11,Senate,"Senate Third Reading: Passed Roll Call # 144",25,12,0,1,38
315822,79401,2011-05-12,House,"House Third Reading:  Roll Call # 125",0,108,0,0,108
315822,85259,2011-05-26,House,"House Third Reading: Conference Report Adopted Roll Call # 153",62,47,0,0,109
315822,85260,2011-05-26,Senate,"Senate Third Reading: Senate Adopted Conference Report With Immediate Effect Roll Call # 260",23,15,0,0,38
315907,77317,2011-05-05,Senate,"Reported Favorably Without Amendment",3,1,0,0,4
315907,90970,2011-06-08,Senate,"Senate Third Reading: Passed Roll Call # 276",30,8,0,0,38
315907,102895,2011-10-18,House,"Reported With Recommendation With Substitute H-2",13,2,0,0,15
315907,103143,2011-11-01,House,"House Third Reading: Given Immediate Effect Roll Call # 439",90,19,0,0,109
315907,103204,2011-11-03,Senate,"Senate Third Reading:  Roll Call # 651",28,10,0,0,38
316009,77325,2011-05-04,Senate,"Reported Favorably Without Amendment",6,0,0,0,6
316009,77326,2011-05-05,Senate,"Senate Third Reading: Passed Roll Call # 130",37,0,1,0,38
316009,77327,2011-05-05,Senate,"Senate Third Reading: Passed Roll Call # 131",38,0,0,0,38
316009,103168,2011-11-02,House,"Reported With Recommendation Without Amendment",15,0,0,0,15
316009,103408,2011-11-10,House,"House Third Reading: Given Immediate Effect Roll Call # 475",102,5,0,0,107
316149,78009,2011-05-04,Senate,"Reported Favorably Without Amendment",3,0,0,0,3
316149,80761,2011-05-17,Senate,"Senate Third Reading: Passed Roll Call # 198",38,0,0,0,38
316159,102645,2011-09-27,House,"Reported With Recommendation With Substitute H-1",18,1,0,0,19
316159,164914,2012-02-29,House,"House Third Reading: Given Immediate Effect Roll Call # 76",106,0,0,0,106
316159,178602,2012-03-27,Senate,"Reported Favorably With Recommendation For Referral To Committee On Reforms, Restructuring And Reinventing",6,0,0,0,6
316159,179433,2012-03-28,Senate,"Reported Favorably Without Amendment",7,0,0,0,7
316159,179434,2012-03-28,Senate,"Senate Third Reading: Given Immediate Effect Roll Call # 171",38,0,0,0,38
316306,101987,2011-09-08,House,"Reported With Recommendation For Referral To Committee On Banking And Financial Services",14,0,0,0,14
316577,81604,2011-05-17,House,"Reported With Recommendation With Substitute H-1",18,0,0,0,18
316577,90992,2011-06-08,House,"House Third Reading: Given Immediate Effect Roll Call # 165",108,1,0,0,109
316577,96696,2011-06-30,Senate,"Reported Favorably With Substitute S-1",6,0,0,0,6
316577,193134,2012-05-03,Senate,"Senate Third Reading: Given Immediate Effect Roll Call # 302",37,1,0,0,38
316577,194589,2012-05-08,House,"House Third Reading:  Roll Call # 253",108,0,0,0,108
317142,93837,2011-06-21,Senate,"Reported Favorably With Substitute S-1",3,1,0,0,4
317208,74702,2011-04-28,House,"Reported With Recommendation With Substitute H-1",16,10,0,0,26
317544,91621,2011-06-08,Senate,"Reported Favorably Without Amendment",5,1,0,0,6
317544,96378,2011-06-28,Senate,"Senate Third Reading: Passed Roll Call # 360",24,14,0,0,38
317544,103070,2011-10-26,House,"Reported With Recommendation With Substitute H-2",13,4,0,0,17
317544,103177,2011-11-02,House,"House Third Reading: Given Immediate Effect Roll Call # 446",69,39,0,0,108
317544,180880,2012-03-28,Senate,"Senate Third Reading:  Roll Call # 172",24,14,0,0,38
317551,97074,2011-06-30,House,"House Third Reading: Given Immediate Effect Roll Call # 274",62,45,0,0,107
317558,80154,2011-05-11,Senate,"Reported Favorably Without Amendment",6,0,0,0,6
317558,84781,2011-05-25,Senate,"Senate Third Reading: Passed Roll Call # 253",37,0,0,1,38
317558,90789,2011-06-08,House,"Reported With Recommendation With Amendment(s)",16,0,0,0,16
317558,95613,2011-06-28,House,"House Third Reading: Given Immediate Effect Roll Call # 241",90,18,0,0,108
317558,96241,2011-06-29,Senate,"Senate Third Reading: House Amendment(s) Concurred In Roll Call # 362",38,0,0,0,38
317558,96242,2011-06-29,Senate,"Senate Third Reading: House Amendment(s) Concurred In Roll Call # 370",37,0,1,0,38
318095,74480,2011-04-28,House,"Reported With Recommendation With Substitute H-1",17,9,0,0,26
318179,97040,2011-06-30,House,"House Third Reading: Given Immediate Effect Roll Call # 272",61,47,0,0,108
318230,74503,2011-04-28,House,"Reported With Recommendation With Substitute H-1",17,8,0,0,25
318515,75743,2011-04-27,House,"Reported With Recommendation Without Amendment",10,7,0,0,17
318515,75744,2011-04-28,House,"House Third Reading: Given Immediate Effect Roll Call # 90",56,53,0,0,109
318515,79757,2011-05-12,Senate,"Reported Favorably Without Amendment",3,0,0,0,3
318515,79758,2011-05-12,Senate,"Senate Third Reading: Given Immediate Effect Roll Call # 175",29,9,0,0,38
318515,79759,2011-05-12,House,"House Third Reading:  Roll Call # 128",56,52,0,0,108
318523,71956,2011-04-12,House,"Reported With Recommendation With Substitute H-1",11,0,0,0,11
318523,74526,2011-04-27,House,"House Third Reading: Given Immediate Effect Roll Call # 83",108,0,0,0,108
318698,166495,2012-02-29,House,"Reported With Recommendation For Referral To Committee On Education",24,0,0,0,24
318698,187056,2012-04-18,House,"Reported With Recommendation With Substitute H-4",11,5,0,0,16
318698,200723,2012-05-31,House,"House Third Reading: Given Immediate Effect Roll Call # 340",64,45,0,0,109
318698,201600,2012-06-07,Senate,"Reported Favorably Without Amendment",3,1,0,0,4
318698,202299,2012-06-13,Senate,"Senate Third Reading: Given Immediate Effect Roll Call # 501",36,1,0,1,38
319097,97048,2011-06-30,House,"House Third Reading: Given Immediate Effect Roll Call # 275",61,47,0,0,108
319205,74682,2011-04-28,House,"Reported With Recommendation Without Amendment",15,0,0,0,15
319205,78443,2011-05-10,House,"House Third Reading: Given Immediate Effect Roll Call # 104",110,0,0,0,110
319205,95731,2011-06-29,Senate,"Reported Favorably Without Amendment",6,0,0,0,6
319205,96813,2011-06-30,Senate,"Senate Third Reading: Passed Roll Call # 415",37,0,1,0,38
319205,96814,2011-06-30,Senate,"Senate Third Reading: Given Immediate Effect Roll Call # 416",38,0,0,0,38
319279,101993,2011-09-08,House,"Reported With Recommendation For Referral To Committee On Banking And Financial Services",14,0,0,0,14
319279,102634,2011-09-28,House,"Reported With Recommendation Without Amendment",11,0,0,0,11
319279,102726,2011-10-05,House,"House Third Reading: Given Immediate Effect Roll Call # 381",109,0,0,0,109
319279,102809,2011-10-11,Senate,"Reported Favorably Without Amendment",4,2,0,0,6
319279,102832,2011-10-12,Senate,"Senate Third Reading: Given Immediate Effect Roll Call # 573",37,0,0,1,38
319346,72056,2011-03-16,House,"Reported With Recommendation Without Amendment",26,0,0,0,26
319346,72057,2011-04-13,House,"House Third Reading: Given Immediate Effect Roll Call # 74",86,24,0,0,110
319346,78733,2011-05-10,Senate,"Reported Favorably Without Amendment",9,0,0,0,9
319346,103259,2011-11-08,Senate,"Reported Favorably With Substitute S-1",3,0,0,0,3
319346,103380,2011-11-10,Senate,"Senate Third Reading: Given Immediate Effect Roll Call # 672",33,3,0,2,38
319346,160929,2012-02-23,House,"House Third Reading:  Roll Call # 72",63,45,0,0,108
319346,160930,2012-02-23,Senate,"Senate Third Reading:  Roll Call # 99",23,13,1,1,38
319504,75765,2011-04-27,House,"Reported With Recommendation Without Amendment",10,7,0,0,17
319504,75766,2011-04-28,House,"House Third Reading: Given Immediate Effect Roll Call # 92",56,50,0,0,106
319504,79765,2011-05-12,Senate,"Reported Favorably Without Amendment",3,0,0,0,3
319504,79766,2011-05-12,Senate,"Senate Third Reading: Given Immediate Effect Roll Call # 177",19,19,0,0,38
319761,173008,2012-03-15,Senate,"Reported Favorably With Substitute S-3",3,1,0,0,4
319761,193174,2012-05-03,Senate,"Senate Third Reading: Passed Roll Call # 306",38,0,0,0,38
319948,78585,2011-05-10,Senate,"Reported Favorably Without Amendment",7,0,0,0,7
319948,79403,2011-05-12,Senate,"Senate Third Reading: Passed Roll Call # 147",38,0,0,0,38
319948,93774,2011-06-16,House,"Reported With Recommendation With Substitute H-1",14,0,0,0,14
319948,96770,2011-06-29,House,"House Third Reading: Given Immediate Effect Roll Call # 251",105,4,0,0,109
319948,96771,2011-06-29,Senate,"Senate Third Reading:  Roll Call # 377",38,0,0,0,38
320254,72156,2011-04-13,Senate,"Reported Favorably With Substitute S-1",4,0,0,0,4
320254,74584,2011-04-28,Senate,"Senate Third Reading: Passed Roll Call # 115",25,12,0,1,38
320254,215416,2012-12-12,House,"House Third Reading: Given Immediate Effect Roll Call # 747",80,29,0,0,109
320254,215724,2012-12-13,Senate,"Senate Third Reading:  Roll Call # 1012",26,12,0,0,38
320254,215884,2012-12-14,House,"House Third Reading:  Roll Call # 883",79,28,0,0,107
320269,81022,2011-05-17,Senate,"Reported Favorably Without Amendment",5,2,0,0,7
320421,73595,2011-04-26,Senate,"Reported Favorably Without Amendment",6,0,0,0,6
320482,72175,2011-04-13,Senate,"Reported Favorably Without Amendment",4,0,0,0,4
320922,91731,2011-06-09,Senate,"Reported Favorably Without Amendment",5,1,0,0,6
320922,94316,2011-06-22,Senate,"Senate Third Reading: Passed Roll Call # 327",35,3,0,0,38
320922,196613,2012-05-16,House,"Reported With Recommendation With Substitute H-1",13,0,0,0,13
320922,200565,2012-05-30,House,"House Third Reading: Given Immediate Effect Roll Call # 326",100,10,0,0,110
320922,201131,2012-06-05,Senate,"Senate Third Reading:  Roll Call # 434",33,5,0,0,38
320940,77471,2011-05-04,Senate,"Reported Favorably With Substitute S-1",6,0,0,0,6
320940,77472,2011-05-05,Senate,"Senate Third Reading: Passed Roll Call # 132",28,10,0,0,38
320940,77473,2011-05-05,Senate,"Senate Third Reading: Passed Roll Call # 133",28,10,0,0,38
320940,103260,2011-11-02,House,"Reported With Recommendation With Substitute H-1",14,0,0,0,14
320940,103395,2011-11-10,House,"House Third Reading: Given Immediate Effect Roll Call # 478",103,4,0,0,107
320940,103688,2011-11-30,Senate,"Senate Third Reading:  Roll Call # 711",27,11,0,0,38
320946,90537,2011-06-07,Senate,"Reported Favorably Without Amendment",7,0,0,0,7
320946,96685,2011-06-30,Senate,"Senate Third Reading: Passed Roll Call # 395",38,0,0,0,38
320946,196948,2012-05-16,House,"Reported With Recommendation Without Amendment",12,0,0,0,12
325668,93257,2011-06-16,House,"Reported With Recommendation With Substitute H-2",14,0,0,0,14
325723,83857,2011-05-24,House,"Reported With Recommendation With Substitute H-1",17,0,0,0,17
325723,92136,2011-06-14,House,"House Third Reading: Given Immediate Effect Roll Call # 190",104,3,0,0,107
325723,94635,2011-06-23,Senate,"Reported Favorably With Substitute S-1",6,1,0,0,7
325723,96362,2011-06-29,Senate,"Senate Third Reading: Given Immediate Effect Roll Call # 380",38,0,0,0,38
325723,96790,2011-06-30,House,"House Third Reading:  Roll Call # 258",104,3,0,0,107
325754,90483,2011-06-07,Senate,"Reported Favorably Without Amendment",7,0,0,0,7
325754,92643,2011-06-16,Senate,"Senate Third Reading: Passed Roll Call # 295",38,0,0,0,38
325754,211933,2012-09-12,House,"Reported With Recommendation Without Amendment",10,3,0,0,13
325758,81495,2011-05-18,House,"Reported With Recommendation For Referral To Committee On Agriculture",17,0,0,0,17
325758,102474,2011-09-21,House,"Reported With Recommendation With Substitute H-1",14,2,0,0,16
325758,103030,2011-10-26,House,"House Third Reading: Given Immediate Effect Roll Call # 429",104,4,0,0,108
325908,81552,2011-05-18,House,"Reported With Recommendation For Referral To Committee On Agriculture",17,0,0,0,17
325908,102478,2011-09-21,House,"Reported With Recommendation With Substitute H-2",13,2,0,0,15
325908,103029,2011-10-26,House,"House Third Reading: Given Immediate Effect Roll Call # 428",103,5,0,0,108
325908,105592,2011-12-08,Senate,"Reported Favorably Without Amendment",7,1,0,0,8
325908,105593,2011-12-13,Senate,"Senate Third Reading: Given Immediate Effect Roll Call # 770",37,1,0,0,38
325917,79487,2011-05-12,Senate,"Reported Favorably Without Amendment",4,0,0,0,4
325917,85067,2011-05-25,Senate,"Senate Third Reading: Passed Roll Call # 254",36,1,0,1,38
325917,97694,2011-06-30,House,"Reported With Recommendation Without Amendment",14,0,0,0,14
325917,97695,2011-06-30,House,"House Third Reading: Given Immediate Effect Roll Call # 269",107,1,0,0,108
325918,90601,2011-06-07,Senate,"Reported Favorably Without Amendment",7,0,0,0,7
325918,92640,2011-06-16,Senate,"Senate Third Reading: Passed Roll Call # 294",38,0,0,0,38
325918,211900,2012-09-12,House,"Reported With Recommendation Without Amendment",10,3,0,0,13
326090,94147,2011-06-16,House,"Reported With Recommendation With Substitute H-2",9,2,0,0,11
326090,94625,2011-06-23,House,"House Third Reading: Given Immediate Effect Roll Call # 221",102,8,0,0,110
326090,149766,2012-02-01,Senate,"Reported Favorably With Substitute S-2",4,0,0,0,4
326090,158257,2012-02-21,Senate,"Senate Third Reading: Given Immediate Effect Roll Call # 88",36,0,0,2,38
326090,166129,2012-02-29,House,"House Third Reading:  Roll Call # 77",104,2,0,0,106
326218,97676,2011-06-30,Senate,"Senate Third Reading: Passed Roll Call # 391",26,9,3,0,38
326218,100566,2011-08-24,House,"Reported With Recommendation With Substitute H-1",22,1,0,0,23
326218,100567,2011-08-24,House,"House Third Reading: Given Immediate Effect Roll Call # 310",65,42,0,0,107
326218,100568,2011-08-24,Senate,"Senate Third Reading:  Roll Call # 465",31,7,0,0,38
326247,193278,2012-05-03,House,"Reported With Recommendation With Substitute H-1",15,1,0,0,16
326247,196799,2012-05-17,House,"House Third Reading: Given Immediate Effect Roll Call # 273",96,11,0,0,107
326247,215187,2012-12-06,Senate,"Reported Favorably With Substitute S-2",4,0,0,0,4
326325,97687,2011-06-29,Senate,"Senate Third Reading: Defeated Roll Call # 383",19,13,6,0,38
326325,97688,2011-06-30,Senate,"Senate Third Reading: Passed Roll Call # 384",24,9,3,2,38
326325,100574,2011-08-24,House,"Reported With Recommendation Without Amendment",24,1,0,0,25
326325,100575,2011-08-24,House,"House Third Reading: Given Immediate Effect Roll Call # 311",65,42,0,0,107
326325,101783,2011-09-07,House,"House Third Reading: Passed Roll Call # 324",66,42,0,0,108
326325,101784,2011-09-07,Senate,"Senate Third Reading:  Roll Call # 475",28,9,0,1,38
326383,102268,2011-09-15,House,"Reported With Recommendation With Substitute H-1",16,0,0,0,16
326383,102850,2011-10-13,House,"House Third Reading: Given Immediate Effect Roll Call # 415",103,5,0,0,108
326383,169833,2012-03-08,Senate,"Reported Favorably With Substitute S-1",6,0,0,0,6
326383,192140,2012-05-02,Senate,"Senate Third Reading: Passed Roll Call # 281",36,1,0,1,38
326383,201592,2012-06-07,House,"House Third Reading:  Roll Call # 372",98,10,0,0,108
326383,202579,2012-06-14,Senate,"Senate Third Reading:  Roll Call # 550",36,2,0,0,38
326386,102198,2011-09-15,House,"Reported With Recommendation Without Amendment",16,0,0,0,16
326386,102846,2011-10-13,House,"House Third Reading: Given Immediate Effect Roll Call # 417",104,4,0,0,108
326386,169774,2012-03-08,Senate,"Reported Favorably With Amendment(s)",7,0,0,0,7
326386,192800,2012-05-02,Senate,"Senate Third Reading: Passed Roll Call # 283",36,1,0,1,38
326386,202475,2012-06-14,House,"House Third Reading: Senate Amendment(s) Concurred In Roll Call # 480",105,4,0,0,109
326387,102205,2011-09-15,House,"Reported With Recommendation With Substitute H-1",16,0,0,0,16
326387,102848,2011-10-13,House,"House Third Reading: Given Immediate Effect Roll Call # 414",103,5,0,0,108
326387,169791,2012-03-08,Senate,"Reported Favorably With Substitute S-1",6,0,0,0,6
326387,192724,2012-05-02,Senate,"Senate Third Reading: Passed Roll Call # 280",36,1,0,1,38
326387,201588,2012-06-07,House,"House Third Reading:  Roll Call # 371",103,5,0,0,108
326387,202577,2012-06-14,Senate,"Senate Third Reading:  Roll Call # 549",37,1,0,0,38
326408,78465,2011-05-10,Senate,"Reported Favorably Without Amendment",7,0,0,0,7
326408,79558,2011-05-12,Senate,"Senate Third Reading: Passed Roll Call # 148",38,0,0,0,38
326408,94044,2011-06-16,House,"Reported With Recommendation Without Amendment",15,0,0,0,15
326408,96300,2011-06-29,House,"House Third Reading: Given Immediate Effect Roll Call # 253",108,1,0,0,109
326419,102206,2011-09-15,House,"Reported With Recommendation Without Amendment",16,0,0,0,16
326419,102849,2011-10-13,House,"House Third Reading: Given Immediate Effect Roll Call # 416",103,5,0,0,108
326419,169835,2012-03-08,Senate,"Reported Favorably With Amendment(s)",7,0,0,0,7
326419,192837,2012-05-02,Senate,"Senate Third Reading: Passed Roll Call # 282",36,1,0,1,38
326419,202492,2012-06-14,House,"House Third Reading: Senate Amendment(s) Concurred In Roll Call # 479",105,4,0,0,109
326428,103633,2011-11-29,Senate,"Reported Favorably Without Amendment",4,0,0,0,4
326428,180017,2012-03-28,Senate,"Senate Third Reading: Passed Roll Call # 174",38,0,0,0,38
326428,187260,2012-04-18,House,"Reported With Recommendation Without Amendment",14,0,0,0,14
326428,189368,2012-04-25,House,"House Third Reading: Given Immediate Effect Roll Call # 197",109,1,0,0,110
327246,102261,2011-09-15,Senate,"Reported Favorably With Substitute S-1",4,0,0,0,4
327246,214242,2012-11-29,Senate,"Senate Third Reading: Passed Roll Call # 777",38,0,0,0,38
327246,215553,2012-12-12,House,"Reported With Recommendation With Amendment(s)",13,2,0,0,15
327246,215554,2012-12-13,House,"House Third Reading: Given Immediate Effect Roll Call # 804",101,9,0,0,110
327246,215712,2012-12-13,Senate,"Senate Third Reading: House Amendment(s) Concurred In Roll Call # 1020",38,0,0,0,38
327308,81954,2011-05-19,Senate,"Reported Favorably With Substitute S-1",4,0,0,0,4
327308,92034,2011-06-14,Senate,"Senate Third Reading: Passed Roll Call # 287",38,0,0,0,38
327317,93186,2011-06-15,Senate,"Reported Favorably With Substitute S-1",6,0,0,0,6
327317,178752,2012-03-27,Senate,"Senate Third Reading: Passed Roll Call # 158",26,11,0,1,38
327317,193024,2012-05-02,House,"Reported With Recommendation With Substitute H-3",12,4,0,0,16
327317,201538,2012-06-07,House,"House Third Reading: Given Immediate Effect Roll Call # 376",71,37,0,0,108
327317,201895,2012-06-12,Senate,"Senate Third Reading:  Roll Call # 475",26,11,0,1,38
327559,103779,2011-12-01,House,"Reported With Recommendation With Amendment(s)",11,5,0,0,16
327559,158063,2012-02-16,House,"House Third Reading: Given Immediate Effect Roll Call # 57",62,46,0,0,108
327559,173052,2012-03-15,Senate,"Reported Favorably With Substitute S-1",5,2,0,0,7
327559,180752,2012-03-29,Senate,"Senate Third Reading: Given Immediate Effect Roll Call # 181",25,13,0,0,38
327631,102330,2011-09-14,House,"Reported With Recommendation With Substitute H-1",17,0,0,0,17
327828,90963,2011-06-08,House,"Reported With Recommendation Without Amendment",26,0,0,0,26
327828,92022,2011-06-14,House,"House Third Reading:  Roll Call # 182",107,0,0,0,107
327828,103760,2011-06-16,Senate,"Senate Third Reading:  Roll Call # 311",38,0,0,0,38
327839,90985,2011-06-08,House,"Reported With Recommendation Without Amendment",26,0,0,0,26
327839,92038,2011-06-14,House,"House Third Reading:  Roll Call # 179",107,0,0,0,107
327839,103764,2011-06-16,Senate,"Senate Third Reading:  Roll Call # 308",38,0,0,0,38
327884,90980,2011-06-08,House,"Reported With Recommendation Without Amendment",26,0,0,0,26
327884,92030,2011-06-14,House,"House Third Reading:  Roll Call # 181",107,0,0,0,107
327884,103761,2011-06-16,Senate,"Senate Third Reading:  Roll Call # 310",38,0,0,0,38
327888,90981,2011-06-08,House,"Reported With Recommendation Without Amendment",26,0,0,0,26
327888,92031,2011-06-14,House,"House Third Reading:  Roll Call # 184",107,0,0,0,107
327888,103762,2011-06-16,Senate,"Senate Third Reading:  Roll Call # 313",38,0,0,0,38
327906,90986,2011-06-08,House,"Reported With Recommendation Without Amendment",26,0,0,0,26
327906,92035,2011-06-14,House,"House Third Reading:  Roll Call # 185",106,0,0,0,106
327906,103763,2011-06-16,Senate,"Senate Third Reading:  Roll Call # 314",38,0,0,0,38
327917,79440,2011-05-12,Senate,"Reported Favorably Without Amendment",3,0,0,0,3
327917,102007,2011-09-07,Senate,"Senate Third Reading: Passed Roll Call # 468",37,0,0,1,38
327917,147924,2012-01-26,House,"Reported With Recommendation Without Amendment",13,0,0,0,13
327917,213779,2012-11-27,House,"House Third Reading: Given Immediate Effect Roll Call # 596",104,4,0,0,108
327917,214076,2012-11-28,House,"House Third Reading: Passed Roll Call # 606",104,5,0,0,109
327917,214979,2012-12-04,Senate,"Senate Third Reading:  Roll Call # 798",38,0,0,0,38
327918,79463,2011-05-12,Senate,"Reported Favorably Without Amendment",4,0,0,0,4
327918,102008,2011-09-07,Senate,"Senate Third Reading: Passed Roll Call # 467",37,0,0,1,38
327918,148018,2012-01-26,House,"Reported With Recommendation Without Amendment",14,0,0,0,14
327937,90987,2011-06-08,House,"Reported With Recommendation Without Amendment",26,0,0,0,26
327937,92042,2011-06-14,House,"House Third Reading:  Roll Call # 175",107,0,0,0,107
327937,103765,2011-06-16,Senate,"Senate Third Reading:  Roll Call # 304",38,0,0,0,38
327996,103118,2011-10-26,House,"Reported With Recommendation With Substitute H-1",13,4,0,0,17
328033,90990,2011-06-08,House,"Reported With Recommendation Without Amendment",26,0,0,0,26
328033,92046,2011-06-14,House,"House Third Reading:  Roll Call # 186",107,0,0,0,107
328033,103766,2011-06-16,Senate,"Senate Third Reading:  Roll Call # 315",38,0,0,0,38
328053,84745,2011-05-25,House,"Reported With Recommendation Without Amendment",10,6,0,0,16
328097,91615,2011-06-08,House,"Reported With Recommendation Without Amendment",26,0,0,0,26
328097,92060,2011-06-14,House,"House Third Reading:  Roll Call # 173",107,0,0,0,107
328097,103767,2011-06-16,Senate,"Senate Third Reading:  Roll Call # 302",38,0,0,0,38
328125,79509,2011-05-12,Senate,"Reported Favorably Without Amendment",4,0,0,0,4
328125,102009,2011-09-07,Senate,"Senate Third Reading: Passed Roll Call # 466",37,0,0,1,38
328125,147488,2012-01-26,House,"Reported With Recommendation Without Amendment",13,0,0,0,13
328125,213722,2012-11-27,House,"House Third Reading: Given Immediate Effect Roll Call # 594",101,7,0,0,108
328150,91620,2011-06-08,House,"Reported With Recommendation Without Amendment",26,0,0,0,26
328150,92063,2011-06-14,House,"House Third Reading:  Roll Call # 178",107,0,0,0,107
328150,103768,2011-06-16,Senate,"Senate Third Reading:  Roll Call # 307",38,0,0,0,38
328155,91641,2011-06-08,House,"Reported With Recommendation Without Amendment",26,0,0,0,26
328155,92124,2011-06-14,House,"House Third Reading:  Roll Call # 180",107,0,0,0,107
328155,103755,2011-06-16,Senate,"Senate Third Reading:  Roll Call # 309",38,0,0,0,38
328163,84770,2011-05-25,House,"Reported With Recommendation Without Amendment",10,6,0,0,16
328173,91630,2011-06-08,House,"Reported With Recommendation Without Amendment",26,0,0,0,26
328173,92072,2011-06-14,House,"House Third Reading:  Roll Call # 177",107,0,0,0,107
328173,103754,2011-06-16,Senate,"Senate Third Reading:  Roll Call # 306",38,0,0,0,38
328220,212051,2012-09-19,House,"Reported With Recommendation With Substitute H-2",15,0,0,0,15
328220,213792,2012-11-28,House,"House Third Reading: Given Immediate Effect Roll Call # 612",104,5,0,0,109
328220,215081,2012-12-05,Senate,"Reported Favorably With Amendment(s)",7,0,0,0,7
328220,215384,2012-12-12,Senate,"Senate Third Reading: Given Immediate Effect Roll Call # 902",38,0,0,0,38
328220,215530,2012-12-13,House,"House Third Reading: Senate Amendment(s) Concurred In Roll Call # 828",104,5,0,0,109
328265,91651,2011-06-08,House,"Reported With Recommendation Without Amendment",26,0,0,0,26
328265,92149,2011-06-14,House,"House Third Reading:  Roll Call # 174",107,0,0,0,107
328265,103759,2011-06-16,Senate,"Senate Third Reading:  Roll Call # 303",38,0,0,0,38
328280,157018,2012-02-14,House,"Reported With Recommendation Without Amendment",8,0,0,0,8
328280,202046,2012-06-12,House,"House Third Reading:  Roll Call # 410",71,39,0,0,110
328298,91649,2011-06-08,House,"Reported With Recommendation Without Amendment",26,0,0,0,26
328298,92142,2011-06-14,House,"House Third Reading:  Roll Call # 176",107,0,0,0,107
328298,103758,2011-06-16,Senate,"Senate Third Reading:  Roll Call # 305",38,0,0,0,38
328321,91646,2011-06-08,House,"Reported With Recommendation Without Amendment",26,0,0,0,26
328321,92131,2011-06-14,House,"House Third Reading:  Roll Call # 183",107,0,0,0,107
328321,103756,2011-06-16,Senate,"Senate Third Reading:  Roll Call # 312",38,0,0,0,38
328357,105302,2011-12-07,Senate,"Senate Third Reading: Passed Roll Call # 743",34,2,0,2,38
328357,138487,2011-12-15,House,"House Third Reading: Given Immediate Effect Roll Call # 617",106,1,0,0,107
328357,138488,2011-12-15,Senate,"Senate Third Reading:  Roll Call # 843",35,2,1,0,38
328361,84843,2011-05-25,Senate,"Reported Favorably Without Amendment",4,0,0,0,4
328361,91969,2011-06-14,Senate,"Senate Third Reading: Passed Roll Call # 288",38,0,0,0,38
328361,101980,2011-09-08,House,"Reported With Recommendation Without Amendment",15,0,0,0,15
328361,102808,2011-10-11,House,"House Third Reading: Given Immediate Effect Roll Call # 404",108,0,0,0,108
328361,102882,2011-10-18,Senate,"Senate Third Reading: House Amendment(s) Concurred In Roll Call # 577",37,0,0,1,38
328396,96644,2011-06-30,Senate,"Reported Favorably With Substitute S-1",3,0,0,0,3
328404,90869,2011-06-08,House,"Reported With Recommendation Without Amendment",26,0,0,0,26
328404,92143,2011-06-14,House,"House Third Reading:  Roll Call # 187",107,0,0,0,107
328404,103757,2011-06-16,Senate,"Senate Third Reading:  Roll Call # 316",38,0,0,0,38
328472,146820,2012-01-25,House,"Reported With Recommendation With Substitute H-1",17,0,0,0,17
328472,148462,2012-02-01,House,"House Third Reading: Given Immediate Effect Roll Call # 24",106,0,0,0,106
328472,160168,2012-02-23,Senate,"Reported Favorably Without Amendment",7,0,0,0,7
328472,173051,2012-03-15,Senate,"Senate Third Reading: Given Immediate Effect Roll Call # 137",37,1,0,0,38
329203,86488,2011-05-31,Senate,"Reported Favorably With Substitute S-2",7,0,0,0,7
329203,90576,2011-06-07,Senate,"Senate Third Reading: Passed Roll Call # 275",36,2,0,0,38
329203,94066,2011-06-22,House,"Reported With Recommendation Without Amendment",13,2,0,0,15
329203,96210,2011-06-29,House,"House Third Reading: Given Immediate Effect Roll Call # 249",81,28,0,0,109
329220,103147,2011-11-01,Senate,"Reported Favorably With Substitute S-1",7,0,0,0,7
329220,103367,2011-11-09,Senate,"Senate Third Reading: Passed Roll Call # 659",37,0,0,1,38
329220,104924,2011-12-07,House,"Reported With Recommendation Without Amendment",13,0,0,0,13
329220,105726,2011-12-13,House,"House Third Reading: Given Immediate Effect Roll Call # 577",108,0,0,0,108
329247,103151,2011-11-01,Senate,"Reported Favorably With Substitute S-1",7,0,0,0,7
329247,103368,2011-11-09,Senate,"Senate Third Reading: Passed Roll Call # 660",37,0,0,1,38
329247,104912,2011-12-07,House,"Reported With Recommendation With Substitute H-2",12,0,0,0,12
329247,105721,2011-12-13,House,"House Third Reading: Given Immediate Effect Roll Call # 581",108,0,0,0,108
329247,105722,2011-12-14,Senate,"Senate Third Reading:  Roll Call # 777",37,0,0,1,38
329284,82376,2011-05-19,House,"Reported With Recommendation With Substitute H-3",11,6,0,0,17
329284,91202,2011-06-09,House,"House Third Reading: Given Immediate Effect Roll Call # 172",59,48,0,0,107
329284,95510,2011-06-28,Senate,"Reported Favorably With Substitute S-1",3,1,0,0,4
329284,96939,2011-06-30,Senate,"Senate Third Reading: Given Immediate Effect Roll Call # 443",20,18,0,0,38
329284,96940,2011-06-30,House,"House Third Reading:  Roll Call # 297",58,50,0,0,108
329297,85276,2011-05-25,House,"Reported With Recommendation With Substitute H-2",9,1,0,0,10
329297,87393,2011-06-01,House,"House Third Reading: Passed Roll Call # 158",57,52,0,0,109
329297,90586,2011-06-07,Senate,"Senate Third Reading: Given Immediate Effect Roll Call # 273",20,18,0,0,38
329304,196777,2012-05-16,House,"Reported With Recommendation Without Amendment",12,0,0,0,12
329328,82380,2011-05-19,House,"Reported With Recommendation With Substitute H-2",11,3,0,0,14
329328,91212,2011-06-09,House,"House Third Reading: Given Immediate Effect Roll Call # 170",61,46,0,0,107
329328,95520,2011-06-28,Senate,"Reported Favorably With Substitute S-1",3,1,0,0,4
329328,96963,2011-06-30,Senate,"Senate Third Reading: Given Immediate Effect Roll Call # 440",25,13,0,0,38
329328,96964,2011-06-30,House,"House Third Reading:  Roll Call # 295",60,48,0,0,108
329350,82386,2011-05-19,House,"Reported With Recommendation With Substitute H-4",11,4,0,0,15
329350,91222,2011-06-09,House,"House Third Reading: Given Immediate Effect Roll Call # 169",70,37,0,0,107
329350,95524,2011-06-28,Senate,"Reported Favorably With Substitute S-1",3,1,0,0,4
329350,96568,2011-06-30,Senate,"Senate Third Reading: Given Immediate Effect Roll Call # 438",25,13,0,0,38
329350,96971,2011-06-30,House,"House Third Reading:  Roll Call # 294",66,42,0,0,108
329366,196796,2012-05-16,House,"Reported With Recommendation Without Amendment",12,0,0,0,12
329366,198628,2012-05-24,House,"House Third Reading: Given Immediate Effect Roll Call # 299",106,2,0,0,108
329366,199942,2012-05-30,Senate,"Senate Third Reading: Given Immediate Effect Roll Call # 403",36,0,0,2,38
329366,199943,2012-05-30,Senate,"Senate Third Reading: Passed Roll Call # 404",36,0,0,2,38
329366,199944,2012-05-30,House,"House Third Reading:  Roll Call # 323",108,2,0,0,110
329369,85323,2011-05-25,House,"Reported With Recommendation With Substitute H-2",9,1,0,0,10
329369,87532,2011-06-01,House,"House Third Reading: Given Immediate Effect Roll Call # 157",56,53,0,0,109
329369,90625,2011-06-07,Senate,"Senate Third Reading: Given Immediate Effect Roll Call # 272",21,17,0,0,38
329373,82385,2011-05-19,House,"Reported With Recommendation With Substitute H-2",11,5,0,0,16
329373,91218,2011-06-09,House,"House Third Reading: Given Immediate Effect Roll Call # 171",68,39,0,0,107
329373,95525,2011-06-28,Senate,"Reported Favorably With Substitute S-1",3,1,0,0,4
329373,96570,2011-06-30,Senate,"Senate Third Reading: Given Immediate Effect Roll Call # 442",20,17,1,0,38
329373,96992,2011-06-30,House,"House Third Reading:  Roll Call # 296",64,44,0,0,108
329690,92026,2011-06-14,Senate,"Reported Favorably With Substitute S-1",5,0,0,0,5
329690,94516,2011-06-22,Senate,"Senate Third Reading: Passed Roll Call # 329",38,0,0,0,38
329690,102480,2011-09-22,House,"Reported With Recommendation Without Amendment",15,0,0,0,15
329690,102749,2011-10-06,House,"House Third Reading: Given Immediate Effect Roll Call # 389",108,0,0,0,108
329856,102812,2011-10-11,House,"Reported With Recommendation With Substitute H-1",9,0,0,0,9
329856,159832,2012-02-22,Senate,"Reported Favorably Without Amendment",4,0,0,0,4
329858,102814,2011-10-11,House,"Reported With Recommendation With Substitute H-1",9,0,0,0,9
329870,96185,2011-06-29,House,"Reported With Recommendation With Substitute H-1",15,0,0,0,15
329870,102354,2011-09-20,House,"House Third Reading: Given Immediate Effect Roll Call # 335",107,0,0,0,107
329870,102900,2011-10-19,Senate,"Reported Favorably Without Amendment",6,0,0,0,6
329870,103332,2011-11-09,Senate,"Senate Third Reading: Given Immediate Effect Roll Call # 658",37,0,0,1,38
329881,102718,2011-10-04,House,"Reported With Recommendation With Substitute H-1",19,0,0,0,19
329881,157525,2012-02-16,House,"House Third Reading: Given Immediate Effect Roll Call # 58",100,8,0,0,108
329881,215290,2012-12-06,Senate,"Reported Favorably Without Amendment",5,0,0,0,5
329942,92115,2011-06-14,House,"Reported With Recommendation With Substitute H-1",11,0,0,0,11
329942,94330,2011-06-22,House,"House Third Reading: Given Immediate Effect Roll Call # 211",110,0,0,0,110
329942,160280,2012-02-22,Senate,"Reported Favorably Without Amendment",4,0,0,0,4
329942,172717,2012-03-13,Senate,"Senate Third Reading: Given Immediate Effect Roll Call # 128",37,0,0,1,38
329976,94135,2011-06-22,Senate,"Reported Favorably With Substitute S-2",3,0,0,0,3
330089,86914,2011-06-01,Senate,"Reported Favorably Without Amendment",5,0,0,0,5
330089,86915,2011-06-01,Senate,"Senate Third Reading: Passed Roll Call # 268",37,1,0,0,38
330089,92655,2011-06-15,House,"Reported With Recommendation With Substitute H-3",12,0,0,0,12
330089,92656,2011-06-16,House,"House Third Reading: Given Immediate Effect Roll Call # 203",104,4,0,0,108
330089,94200,2011-06-22,Senate,"Senate Third Reading:  Roll Call # 323",35,3,0,0,38
330092,91178,2011-06-09,Senate,"Reported Favorably With Substitute S-1",6,0,0,0,6
330536,90557,2011-06-07,Senate,"Reported Favorably Without Amendment",6,0,0,0,6
330536,92712,2011-06-16,Senate,"Senate Third Reading: Passed Roll Call # 298",38,0,0,0,38
330536,196625,2012-05-16,House,"Reported With Recommendation Without Amendment",12,0,0,0,12
330554,90565,2011-06-07,Senate,"Reported Favorably Without Amendment",6,0,0,0,6
330554,92723,2011-06-16,Senate,"Senate Third Reading: Passed Roll Call # 297",38,0,0,0,38
330554,196627,2012-05-16,House,"Reported With Recommendation Without Amendment",12,0,0,0,12
330554,200574,2012-05-30,House,"House Third Reading: Given Immediate Effect Roll Call # 322",108,2,0,0,110
330554,200575,2012-05-30,Senate,"Senate Third Reading:  Roll Call # 406",36,0,0,2,38
330555,81947,2011-05-19,Senate,"Reported Favorably With Substitute S-1",4,0,0,0,4
330555,90574,2011-06-07,Senate,"Senate Third Reading: Passed Roll Call # 270",38,0,0,0,38
330555,214223,2012-11-29,House,"Reported With Recommendation With Amendment(s)",14,0,0,0,14
330555,215396,2012-12-12,House,"House Third Reading: Given Immediate Effect Roll Call # 743",94,14,0,0,108
330555,215706,2012-12-13,Senate,"Senate Third Reading: House Amendment(s) Concurred In Roll Call # 1021",38,0,0,0,38
330759,102936,2011-10-20,House,"Reported With Recommendation With Substitute H-1",12,0,0,0,12
330759,138736,2011-12-14,House,"House Third Reading: Given Immediate Effect Roll Call # 597",108,0,0,0,108
330759,145560,2012-01-25,Senate,"Reported Favorably With Substitute S-1",4,0,0,0,4
330759,173873,2012-03-14,Senate,"Senate Third Reading: Given Immediate Effect Roll Call # 134",38,0,0,0,38
330759,177582,2012-03-22,House,"House Third Reading:  Roll Call # 134",108,0,0,0,108
330854,83907,2011-05-24,Senate,"Reported Favorably With Substitute S-1",6,0,0,0,6
330854,90896,2011-06-08,Senate,"Senate Third Reading: Passed Roll Call # 277",38,0,0,0,38
330854,102323,2011-09-15,House,"Reported With Recommendation Without Amendment",12,0,0,0,12
330854,102880,2011-10-18,House,"House Third Reading: Given Immediate Effect Roll Call # 418",108,0,0,0,108
330944,104407,2011-12-06,House,"Reported With Recommendation With Substitute H-1",8,0,0,0,8
330944,145601,2012-01-25,House,"House Third Reading: Given Immediate Effect Roll Call # 6",106,0,0,0,106
330944,197706,2012-05-22,Senate,"Reported Favorably Without Amendment",3,0,0,0,3
330944,198033,2012-05-23,Senate,"Senate Third Reading: Given Immediate Effect Roll Call # 380",35,1,1,1,38
330955,104523,2011-12-01,House,"Reported With Recommendation Without Amendment",11,0,0,0,11
330955,146452,2012-01-26,House,"House Third Reading: Given Immediate Effect Roll Call # 17",93,13,0,0,106
330955,172903,2012-03-15,Senate,"Reported Favorably Without Amendment",6,1,0,0,7
330955,187643,2012-04-19,Senate,"Senate Third Reading: Given Immediate Effect Roll Call # 214",30,8,0,0,38
330976,104505,2011-12-06,House,"Reported With Recommendation With Substitute H-2",8,0,0,0,8
330976,145922,2012-01-25,House,"House Third Reading: Given Immediate Effect Roll Call # 7",106,0,0,0,106
330976,197852,2012-05-22,Senate,"Reported Favorably Without Amendment",3,0,0,0,3
330976,201854,2012-06-12,Senate,"Senate Third Reading: Passed Roll Call # 481",33,4,1,0,38
331024,102785,2011-10-05,House,"Reported With Recommendation Without Amendment",18,0,0,0,18
331024,103115,2011-11-01,House,"House Third Reading: Given Immediate Effect Roll Call # 438",109,0,0,0,109
331024,172804,2012-03-13,Senate,"Reported Favorably Without Amendment",5,0,0,0,5
331024,178651,2012-03-27,Senate,"Senate Third Reading: Given Immediate Effect Roll Call # 159",37,0,0,1,38
331030,144500,2012-01-18,Senate,"Reported Favorably With Substitute S-3",4,0,0,0,4
331039,91115,2011-06-08,Senate,"Reported Favorably Without Amendment",4,0,0,0,4
331039,96299,2011-06-29,Senate,"Senate Third Reading: Passed Roll Call # 364",37,0,1,0,38
331040,90961,2011-06-08,House,"Reported With Recommendation Without Amendment",15,0,0,0,15
331040,92012,2011-06-14,House,"House Third Reading: Given Immediate Effect Roll Call # 191",102,5,0,0,107
331040,93921,2011-06-21,Senate,"Reported Favorably Without Amendment",5,0,0,0,5
331040,96563,2011-06-30,Senate,"Senate Third Reading: Given Immediate Effect Roll Call # 398",35,1,2,0,38
331071,85251,2011-05-26,Senate,"Reported Favorably Without Amendment",6,0,0,0,6
331079,211931,2012-09-12,Senate,"Reported Favorably With Substitute S-3",7,0,0,0,7
331079,212000,2012-09-13,Senate,"Senate Third Reading: Passed Roll Call # 627",38,0,0,0,38
331079,212090,2012-09-20,House,"Reported With Recommendation Without Amendment",14,0,0,0,14
331079,212309,2012-09-27,House,"House Third Reading: Given Immediate Effect Roll Call # 559",107,1,0,0,108
331864,92315,2011-06-15,Senate,"Reported Favorably Without Amendment",4,1,0,0,5
331920,91166,2011-06-09,Senate,"Reported Favorably Without Amendment",4,0,0,0,4
331920,94230,2011-06-22,Senate,"Senate Third Reading: Passed Roll Call # 326",38,0,0,0,38
331920,102981,2011-10-19,House,"Reported With Recommendation Without Amendment",19,0,0,0,19
331920,103135,2011-11-01,House,"House Third Reading: Given Immediate Effect Roll Call # 440",109,0,0,0,109
331934,92686,2011-06-16,Senate,"Senate Third Reading: Passed Roll Call # 300",38,0,0,0,38
331934,94267,2011-06-22,House,"Reported With Recommendation Without Amendment",11,0,0,0,11
331934,96627,2011-06-30,House,"House Third Reading: Given Immediate Effect Roll Call # 277",108,0,0,0,108
331935,88239,2011-06-01,Senate,"Reported Favorably Without Amendment",3,0,0,0,3
331935,101842,2011-09-07,Senate,"Senate Third Reading: Passed Roll Call # 470",37,0,0,1,38
331935,177110,2012-03-22,House,"Reported With Recommendation Without Amendment",13,1,0,0,14
331935,190435,2012-04-26,House,"House Third Reading: Given Immediate Effect Roll Call # 200",108,1,0,0,109
331935,191785,2012-05-01,Senate,"Senate Third Reading:  Roll Call # 270",36,0,0,2,38
332507,105165,2011-12-07,House,"Reported With Recommendation With Substitute H-2",15,0,0,0,15
332507,152807,2012-02-09,House,"House Third Reading: Given Immediate Effect Roll Call # 42",104,0,0,0,104
332507,160632,2012-02-23,Senate,"Reported Favorably With Substitute S-1",7,0,0,0,7
332507,169223,2012-03-07,Senate,"Senate Third Reading: Given Immediate Effect Roll Call # 113",38,0,0,0,38
332507,169965,2012-03-08,House,"House Third Reading:  Roll Call # 99",110,0,0,0,110
332564,105170,2011-12-07,House,"Reported With Recommendation With Substitute H-1",16,0,0,0,16
332564,152829,2012-02-09,House,"House Third Reading: Given Immediate Effect Roll Call # 43",105,0,0,0,105
332564,160771,2012-02-23,Senate,"Reported Favorably Without Amendment",7,0,0,0,7
332564,169476,2012-03-07,Senate,"Senate Third Reading: Given Immediate Effect Roll Call # 114",38,0,0,0,38
332964,94285,2011-06-21,House,"Reported With Recommendation With Substitute H-1",20,0,0,0,20
332964,102297,2011-09-15,House,"House Third Reading: Given Immediate Effect Roll Call # 330",108,0,0,0,108
332964,103801,2011-11-30,Senate,"Reported Favorably Without Amendment",9,0,0,0,9
332964,138460,2011-12-13,Senate,"Senate Third Reading: Given Immediate Effect Roll Call # 775",38,0,0,0,38
333352,176183,2012-03-20,House,"Reported With Recommendation With Substitute H-5",8,0,0,0,8
333391,95760,2011-06-29,Senate,"Reported Favorably Without Amendment",6,1,0,0,7
334096,103769,2011-06-22,House,"Reported With Recommendation Without Amendment",12,0,0,0,12
334258,102481,2011-09-21,House,"Reported With Recommendation With Substitute H-1",23,0,0,0,23
334258,102588,2011-09-28,House,"House Third Reading: Given Immediate Effect Roll Call # 371",109,0,0,0,109
334258,173327,2012-03-15,Senate,"Reported Favorably Without Amendment",12,1,0,0,13
334258,177289,2012-03-22,Senate,"Senate Third Reading: Given Immediate Effect Roll Call # 153",27,11,0,0,38
334258,181101,2012-03-29,House,"House Third Reading: Senate Amendment(s) Concurred In Roll Call # 148",108,0,0,0,108
334262,102881,2011-10-18,House,"Reported With Recommendation With Substitute H-1",14,0,0,0,14
334262,103261,2011-11-08,House,"House Third Reading: Given Immediate Effect Roll Call # 459",102,5,0,0,107
334262,146441,2012-01-25,Senate,"Reported Favorably With Substitute S-1",4,0,0,0,4
334262,173829,2012-03-15,Senate,"Senate Third Reading: Given Immediate Effect Roll Call # 136",36,0,1,1,38
334262,177574,2012-03-22,House,"House Third Reading:  Roll Call # 135",103,5,0,0,108
334267,103041,2011-10-27,House,"Reported With Recommendation With Substitute H-6",17,10,0,0,27
334267,103196,2011-11-03,House,"House Third Reading: Given Immediate Effect Roll Call # 455",63,45,0,0,108
334267,104953,2011-12-07,Senate,"Senate Third Reading: Given Immediate Effect Roll Call # 746",23,13,0,2,38
334267,105735,2011-12-08,House,"House Third Reading:  Roll Call # 532",62,46,0,0,108
334267,105736,2011-12-13,Senate,"Senate Third Reading:  Roll Call # 769",23,15,0,0,38
334270,103037,2011-10-27,House,"Reported With Recommendation Without Amendment",17,10,0,0,27
334270,103206,2011-11-03,House,"House Third Reading: Given Immediate Effect Roll Call # 456",63,44,0,0,107
334270,104926,2011-12-07,Senate,"Senate Third Reading: Given Immediate Effect Roll Call # 747",23,13,0,2,38
334281,97122,2011-06-30,House,"House Third Reading: Given Immediate Effect Roll Call # 276",62,46,0,0,108
334288,94367,2011-06-22,House,"Reported With Recommendation With Substitute H-3",14,0,0,0,14
334288,94603,2011-06-23,House,"House Third Reading: Given Immediate Effect Roll Call # 223",80,30,0,0,110
334288,96717,2011-06-30,Senate,"Senate Third Reading: Given Immediate Effect Roll Call # 403",26,12,0,0,38
334319,91152,2011-06-09,House,"Reported With Recommendation Without Amendment",16,0,0,0,16
334319,93816,2011-06-21,House,"House Third Reading: Given Immediate Effect Roll Call # 206",105,4,0,0,109
334319,102006,2011-09-08,Senate,"Reported Favorably Without Amendment",4,0,0,0,4
334319,102393,2011-09-21,Senate,"Senate Third Reading: Given Immediate Effect Roll Call # 500",36,0,0,2,38
334325,201407,2012-06-06,Senate,"Reported Favorably With Substitute S-1",5,0,0,0,5
334325,202547,2012-06-14,Senate,"Senate Third Reading: Passed Roll Call # 530",23,15,0,0,38
334325,212352,2012-09-27,House,"Reported With Recommendation Without Amendment",11,3,0,0,14
334325,214401,2012-11-29,House,"House Third Reading: Given Immediate Effect Roll Call # 633",56,52,0,0,108
334333,92719,2011-06-16,Senate,"Reported Favorably With Substitute S-2",3,2,0,0,5
334333,94326,2011-06-22,Senate,"Senate Third Reading: Passed Roll Call # 331",26,12,0,0,38
334338,201422,2012-06-06,Senate,"Reported Favorably With Substitute S-1",5,0,0,0,5
334338,202563,2012-06-14,Senate,"Senate Third Reading: Passed Roll Call # 531",23,15,0,0,38
334338,212357,2012-09-27,House,"Reported With Recommendation Without Amendment",11,3,0,0,14
334338,214446,2012-11-29,House,"House Third Reading: Given Immediate Effect Roll Call # 634",57,51,0,0,108
335166,92090,2011-06-14,Senate,"Senate Third Reading: Passed Roll Call # 292",35,2,1,0,38
335166,202508,2012-06-14,House,"House Third Reading: Given Immediate Effect Roll Call # 494",108,1,0,0,109
335166,215208,2012-12-06,Senate,"Senate Third Reading:  Roll Call # 839",37,0,1,0,38
335166,215209,2012-12-06,Senate,"Senate Third Reading:  Roll Call # 864",28,0,10,0,38
335166,215385,2012-12-12,Senate,"Senate Third Reading:  Roll Call # 928",25,12,0,1,38
335166,215517,2012-12-12,Senate,"Senate Third Reading:  Roll Call # 930",35,1,1,1,38
335166,215823,2012-12-14,House,"House Third Reading:  Roll Call # 913",104,1,0,0,105
335187,102803,2011-10-11,Senate,"Reported Favorably With Substitute S-1",7,0,0,0,7
335187,103033,2011-10-26,Senate,"Senate Third Reading: Passed Roll Call # 595",38,0,0,0,38
335187,168700,2012-03-06,House,"Reported With Recommendation With Substitute H-1",10,0,0,0,10
335187,179476,2012-03-28,House,"House Third Reading: Given Immediate Effect Roll Call # 143",109,0,0,0,109
335187,180405,2012-03-29,Senate,"Senate Third Reading:  Roll Call # 175",37,0,1,0,38
335197,198418,2012-05-24,House,"Reported With Recommendation Without Amendment",16,0,0,0,16
335197,215147,2012-12-05,House,"House Third Reading: Passed Roll Call # 675",95,10,0,0,105
335218,198419,2012-05-24,House,"Reported With Recommendation Without Amendment",16,0,0,0,16
335218,215150,2012-12-05,House,"House Third Reading: Passed Roll Call # 676",96,10,0,0,106
335236,102856,2011-10-13,Senate,"Reported Favorably With Substitute S-1",15,0,0,0,15
335271,171618,2012-03-13,Senate,"Reported Favorably With Substitute S-3",5,0,0,0,5
335271,171619,2012-03-13,Senate,"Senate Third Reading: Passed Roll Call # 130",29,9,0,0,38
335271,179735,2012-03-27,House,"Reported With Recommendation With Substitute H-3",7,0,0,0,7
335271,180602,2012-03-29,House,"House Third Reading: Given Immediate Effect Roll Call # 159",91,19,0,0,110
335271,180603,2012-03-29,Senate,"Senate Third Reading:  Roll Call # 187",30,8,0,0,38
335274,92161,2011-06-14,House,"Reported With Recommendation Without Amendment",9,0,0,0,9
335276,171666,2012-03-13,Senate,"Reported Favorably With Substitute S-3",5,0,0,0,5
335276,171667,2012-03-13,Senate,"Senate Third Reading: Passed Roll Call # 131",29,9,0,0,38
335276,179809,2012-03-27,House,"Reported With Recommendation With Substitute H-3",7,0,0,0,7
335276,180634,2012-03-29,House,"House Third Reading: Given Immediate Effect Roll Call # 160",91,19,0,0,110
335276,180635,2012-03-29,Senate,"Senate Third Reading:  Roll Call # 188",29,9,0,0,38
335283,94468,2011-06-22,Senate,"Reported Favorably Without Amendment",4,0,0,0,4
335306,96961,2011-06-30,Senate,"Reported Favorably Without Amendment",6,0,0,0,6
335306,96962,2011-06-30,Senate,"Senate Third Reading: Passed Roll Call # 431",33,5,0,0,38
335310,95538,2011-06-28,Senate,"Reported Favorably Without Amendment",5,2,0,0,7
335395,215185,2012-12-06,Senate,"Reported Favorably Without Amendment",5,0,0,0,5
335406,92701,2011-06-16,Senate,"Reported Favorably With Substitute S-1",4,0,0,0,4
335406,92702,2011-06-16,Senate,"Senate Third Reading: Passed Roll Call # 301",38,0,0,0,38
335406,96199,2011-06-29,House,"Reported With Recommendation Without Amendment",17,0,0,0,17
335406,96675,2011-06-30,House,"House Third Reading: Given Immediate Effect Roll Call # 265",59,49,0,0,108
335418,102711,2011-10-04,Senate,"Reported Favorably With Substitute S-1",4,0,0,0,4
335418,102750,2011-10-06,Senate,"Senate Third Reading: Passed Roll Call # 550",23,15,0,0,38
335418,102999,2011-10-25,House,"Reported With Recommendation Without Amendment",6,2,0,0,8
335418,103213,2011-11-03,House,"House Third Reading: Given Immediate Effect Roll Call # 454",70,37,0,0,107
335419,160210,2012-02-23,Senate,"Reported Favorably With Substitute S-2",7,0,0,0,7
335419,166033,2012-03-01,Senate,"Senate Third Reading: Passed Roll Call # 109",36,0,0,2,38
335419,180027,2012-03-28,House,"Reported With Recommendation With Substitute H-1",17,0,0,0,17
335419,187271,2012-04-19,House,"House Third Reading: Passed Roll Call # 185",110,0,0,0,110
335419,187756,2012-04-19,House,"House Third Reading: Given Immediate Effect Roll Call # 185",110,0,0,0,110
335419,188919,2012-04-24,Senate,"Senate Third Reading:  Roll Call # 215",37,0,0,1,38
335421,102484,2011-09-22,Senate,"Reported Favorably Without Amendment",5,2,0,0,7
335421,102552,2011-09-27,Senate,"Senate Third Reading: Passed Roll Call # 506",25,12,0,1,38
335427,103770,2011-06-21,House,"Reported With Recommendation Without Amendment",9,0,0,0,9
335436,103771,2011-06-21,House,"Reported With Recommendation Without Amendment",9,0,0,0,9
335462,94384,2011-06-21,House,"Reported With Recommendation Without Amendment",8,0,0,0,8
335462,101995,2011-09-07,House,"House Third Reading: Given Immediate Effect Roll Call # 321",97,11,0,0,108
335462,102720,2011-10-04,Senate,"Reported Favorably Without Amendment",4,0,0,0,4
335462,102733,2011-10-05,Senate,"Senate Third Reading: Given Immediate Effect Roll Call # 548",36,2,0,0,38
335482,190247,2012-04-26,House,"Reported With Recommendation With Substitute H-2",15,0,0,0,15
335482,193253,2012-05-03,House,"House Third Reading: Passed Roll Call # 246",109,0,0,0,109
335482,193254,2012-05-03,House,"House Third Reading:  Roll Call # 247",108,1,0,0,109
335482,202404,2012-06-14,Senate,"Reported Favorably Without Amendment",8,0,0,0,8
335482,207211,2012-07-18,Senate,"Senate Third Reading: Given Immediate Effect Roll Call # 572",37,0,0,1,38
335483,94394,2011-06-22,House,"Reported With Recommendation Without Amendment",14,0,0,0,14
335483,94624,2011-06-23,House,"House Third Reading: Given Immediate Effect Roll Call # 222",110,0,0,0,110
335483,102025,2011-09-07,Senate,"Senate Third Reading: Given Immediate Effect Roll Call # 473",37,0,0,1,38
335491,94378,2011-06-22,House,"Reported With Recommendation Without Amendment",25,0,0,0,25
335491,94613,2011-06-23,House,"House Third Reading: Given Immediate Effect Roll Call # 229",94,16,0,0,110
335491,100846,2011-08-24,Senate,"Reported Favorably With Substitute S-2",7,0,0,0,7
335491,100847,2011-08-24,Senate,"Senate Third Reading: Given Immediate Effect Roll Call # 454",37,1,0,0,38
335491,102143,2011-09-13,House,"House Third Reading:  Roll Call # 325",94,15,0,0,109
335493,94392,2011-06-21,House,"Reported With Recommendation Without Amendment",17,0,0,0,17
335493,102026,2011-09-07,House,"House Third Reading: Given Immediate Effect Roll Call # 320",108,0,0,0,108
335493,102548,2011-09-27,Senate,"Reported Favorably Without Amendment",6,0,0,0,6
335493,102818,2011-10-11,Senate,"Senate Third Reading: Given Immediate Effect Roll Call # 568",38,0,0,0,38
335509,95989,2011-06-28,House,"Reported With Recommendation With Substitute H-2",9,0,0,0,9
335509,102322,2011-09-13,House,"House Third Reading: Given Immediate Effect Roll Call # 328",100,9,0,0,109
335509,201611,2012-06-07,Senate,"Reported Favorably Without Amendment",3,0,0,0,3
335509,202331,2012-06-13,Senate,"Senate Third Reading: Given Immediate Effect Roll Call # 498",27,10,0,1,38
335513,102638,2011-09-28,House,"Reported With Recommendation With Substitute H-1",13,0,0,0,13
335516,94401,2011-06-21,House,"Reported With Recommendation Without Amendment",18,0,0,0,18
335516,102028,2011-09-07,House,"House Third Reading: Given Immediate Effect Roll Call # 319",107,0,0,0,107
335516,215239,2012-12-06,Senate,"Reported Favorably With Substitute S-2",5,0,0,0,5
335516,215621,2012-12-13,Senate,"Senate Third Reading: Given Immediate Effect Roll Call # 957",38,0,0,0,38
335516,215622,2012-12-13,House,"House Third Reading:  Roll Call # 848",109,0,0,0,109
335519,96006,2011-06-28,House,"Reported With Recommendation With Substitute H-1",9,0,0,0,9
335519,101994,2011-09-07,House,"House Third Reading: Given Immediate Effect Roll Call # 323",108,0,0,0,108
335519,201560,2012-06-07,Senate,"Reported Favorably With Substitute S-1",3,0,0,0,3
335519,202205,2012-06-13,Senate,"Senate Third Reading: Given Immediate Effect Roll Call # 497",35,1,1,1,38
335519,202536,2012-06-14,House,"House Third Reading:  Roll Call # 468",110,0,0,0,110
335520,91960,2011-06-14,House,"Reported With Recommendation Without Amendment",17,0,0,0,17
335520,94397,2011-06-22,House,"House Third Reading: Given Immediate Effect Roll Call # 210",110,0,0,0,110
335520,96764,2011-06-30,Senate,"Reported Favorably Without Amendment",6,0,0,0,6
335520,96765,2011-06-30,Senate,"Senate Third Reading: Given Immediate Effect Roll Call # 417",38,0,0,0,38
335532,94481,2011-06-22,House,"Reported With Recommendation Without Amendment",24,1,0,0,25
335532,94482,2011-06-23,House,"House Third Reading: Given Immediate Effect Roll Call # 228",65,45,0,0,110
335532,100819,2011-08-24,Senate,"Reported Favorably Without Amendment",7,0,0,0,7
335532,100820,2011-08-24,Senate,"Senate Third Reading: Given Immediate Effect Roll Call # 453",28,10,0,0,38
335540,94461,2011-06-21,House,"Reported With Recommendation With Substitute H-2",9,0,0,0,9
335540,101999,2011-09-07,House,"House Third Reading: Given Immediate Effect Roll Call # 322",108,0,0,0,108
335558,144145,2012-01-19,House,"Reported With Recommendation With Substitute H-1",15,0,0,0,15
335558,211918,2012-09-12,House,"House Third Reading: Given Immediate Effect Roll Call # 520",108,0,0,0,108
335558,212341,2012-09-27,Senate,"Reported Favorably Without Amendment",4,0,0,0,4
335558,215742,2012-12-13,Senate,"Senate Third Reading: Given Immediate Effect Roll Call # 995",38,0,0,0,38
335734,96724,2011-06-30,Senate,"Reported Favorably Without Amendment",6,0,0,0,6
335734,96725,2011-06-30,Senate,"Senate Third Reading: Passed Roll Call # 419",38,0,0,0,38
335734,103142,2011-11-01,House,"Reported With Recommendation With Substitute H-1",9,0,0,0,9
335734,103350,2011-11-09,House,"House Third Reading: Given Immediate Effect Roll Call # 465",106,2,0,0,108
335734,103401,2011-11-10,Senate,"Senate Third Reading:  Roll Call # 690",35,0,0,3,38
335735,96694,2011-06-30,Senate,"Reported Favorably Without Amendment",6,0,0,0,6
335735,96695,2011-06-30,Senate,"Senate Third Reading: Passed Roll Call # 423",38,0,0,0,38
335735,103138,2011-11-01,House,"Reported With Recommendation With Substitute H-1",9,0,0,0,9
335735,103348,2011-11-09,House,"House Third Reading: Given Immediate Effect Roll Call # 469",105,3,0,0,108
335735,103399,2011-11-10,Senate,"Senate Third Reading:  Roll Call # 694",35,0,0,3,38
335752,96677,2011-06-30,Senate,"Reported Favorably Without Amendment",6,0,0,0,6
335752,96678,2011-06-30,Senate,"Senate Third Reading: Passed Roll Call # 421",38,0,0,0,38
335752,103136,2011-11-01,House,"Reported With Recommendation With Substitute H-1",9,0,0,0,9
335752,103336,2011-11-09,House,"House Third Reading: Given Immediate Effect Roll Call # 467",105,3,0,0,108
335752,103381,2011-11-10,Senate,"Senate Third Reading:  Roll Call # 692",35,0,0,3,38
335754,194919,2012-05-09,Senate,"Reported Favorably With Substitute S-1",7,0,0,0,7
335754,213803,2012-11-27,Senate,"Senate Third Reading: Passed Roll Call # 750",23,15,0,0,38
335754,215242,2012-12-05,House,"Reported With Recommendation Without Amendment",10,0,0,0,10
335754,215243,2012-12-06,House,"House Third Reading: Given Immediate Effect Roll Call # 692",56,52,0,0,108
335756,96749,2011-06-30,Senate,"Reported Favorably Without Amendment",6,0,0,0,6
335756,96750,2011-06-30,Senate,"Senate Third Reading: Passed Roll Call # 420",38,0,0,0,38
335756,103141,2011-11-01,House,"Reported With Recommendation With Substitute H-1",9,0,0,0,9
335756,103349,2011-11-09,House,"House Third Reading: Given Immediate Effect Roll Call # 466",106,2,0,0,108
335756,103406,2011-11-10,Senate,"Senate Third Reading:  Roll Call # 691",35,0,0,3,38
335761,97521,2011-06-30,Senate,"Reported Favorably Without Amendment",6,0,0,0,6
335761,97522,2011-06-30,Senate,"Senate Third Reading: Passed Roll Call # 424",38,0,0,0,38
335761,103154,2011-11-01,House,"Reported With Recommendation With Substitute H-1",9,0,0,0,9
335761,103370,2011-11-09,House,"House Third Reading: Given Immediate Effect Roll Call # 470",105,3,0,0,108
335761,103385,2011-11-10,Senate,"Senate Third Reading:  Roll Call # 695",35,0,0,3,38
335764,92598,2011-06-16,Senate,"Reported Favorably With Substitute S-1",4,0,0,0,4
335764,93707,2011-06-21,Senate,"Senate Third Reading: Passed Roll Call # 322",38,0,0,0,38
335764,97060,2011-06-29,House,"Reported With Recommendation With Substitute H-1",22,0,0,0,22
335764,97061,2011-06-30,House,"House Third Reading: Given Immediate Effect Roll Call # 267",108,0,0,0,108
335764,97062,2011-06-30,Senate,"Senate Third Reading:  Roll Call # 429",38,0,0,0,38
335768,92599,2011-06-16,Senate,"Reported Favorably With Substitute S-1",4,0,0,0,4
335768,93704,2011-06-21,Senate,"Senate Third Reading: Passed Roll Call # 321",38,0,0,0,38
335768,97051,2011-06-29,House,"Reported With Recommendation With Substitute H-1",22,0,0,0,22
335768,97052,2011-06-30,House,"House Third Reading: Given Immediate Effect Roll Call # 266",107,1,0,0,108
335768,97053,2011-06-30,Senate,"Senate Third Reading:  Roll Call # 428",38,0,0,0,38
335776,102692,2011-10-04,Senate,"Reported Favorably With Substitute S-2",4,0,0,0,4
335781,96803,2011-06-30,Senate,"Reported Favorably Without Amendment",6,0,0,0,6
335781,96804,2011-06-30,Senate,"Senate Third Reading: Passed Roll Call # 422",38,0,0,0,38
335781,103146,2011-11-01,House,"Reported With Recommendation With Substitute H-1",9,0,0,0,9
335781,103365,2011-11-09,House,"House Third Reading: Given Immediate Effect Roll Call # 468",105,3,0,0,108
335781,103379,2011-11-10,Senate,"Senate Third Reading:  Roll Call # 693",35,0,0,3,38
335782,172889,2012-03-15,Senate,"Reported Favorably With Substitute S-1",7,0,0,0,7
335782,180994,2012-03-29,Senate,"Senate Third Reading: Passed Roll Call # 197",38,0,0,0,38
335795,173510,2012-03-15,Senate,"Reported Favorably Without Amendment",7,0,0,0,7
335795,180969,2012-03-29,Senate,"Senate Third Reading: Passed Roll Call # 198",38,0,0,0,38
335798,94238,2011-06-22,House,"Reported With Recommendation With Amendment(s)",17,2,0,0,19
335798,94523,2011-06-23,House,"House Third Reading: Given Immediate Effect Roll Call # 231",67,42,0,0,109
335798,98838,2011-07-13,Senate,"Reported Favorably With Substitute S-2",5,0,0,0,5
335798,98839,2011-07-13,Senate,"Senate Third Reading: Given Immediate Effect Roll Call # 449",34,2,0,2,38
335798,100558,2011-08-24,House,"House Third Reading:  Roll Call # 304",68,39,0,0,107
335798,102139,2011-09-13,Senate,"Senate Third Reading:  Roll Call # 476",35,3,0,0,38
335800,94243,2011-06-22,House,"Reported With Recommendation Without Amendment",14,1,0,0,15
335816,92672,2011-06-16,House,"Reported With Recommendation Without Amendment",15,0,0,0,15
335816,94517,2011-06-23,House,"House Third Reading: Given Immediate Effect Roll Call # 220",105,5,0,0,110
335816,96955,2011-06-30,Senate,"Senate Third Reading: Given Immediate Effect Roll Call # 414",38,0,0,0,38
335825,102786,2011-10-05,House,"Reported With Recommendation Without Amendment",18,0,0,0,18
335825,102828,2011-10-12,House,"House Third Reading: Given Immediate Effect Roll Call # 412",109,0,0,0,109
335825,178725,2012-03-27,Senate,"Reported Favorably Without Amendment",5,0,0,0,5
335825,187086,2012-04-18,Senate,"Senate Third Reading: Given Immediate Effect Roll Call # 203",38,0,0,0,38
335830,152804,2012-02-08,House,"Reported With Recommendation With Substitute H-1",14,0,0,0,14
335830,164970,2012-02-29,House,"House Third Reading: Given Immediate Effect Roll Call # 78",106,0,0,0,106
335832,94626,2011-06-22,House,"Reported With Recommendation Without Amendment",14,0,0,0,14
335832,94627,2011-06-23,House,"House Third Reading: Given Immediate Effect Roll Call # 224",79,31,0,0,110
335837,92678,2011-06-16,House,"Reported With Recommendation Without Amendment",6,0,0,0,6
335837,94249,2011-06-22,House,"House Third Reading: Given Immediate Effect Roll Call # 212",85,25,0,0,110
335837,96989,2011-06-30,Senate,"Reported Favorably With Substitute S-4",6,0,0,0,6
335837,96990,2011-06-30,Senate,"Senate Third Reading: Given Immediate Effect Roll Call # 433",26,12,0,0,38
335837,96991,2011-06-30,House,"House Third Reading:  Roll Call # 292",85,23,0,0,108
335856,92679,2011-06-16,House,"Reported With Recommendation Without Amendment",15,0,0,0,15
335856,94527,2011-06-23,House,"House Third Reading: Given Immediate Effect Roll Call # 219",105,5,0,0,110
335856,96569,2011-06-30,Senate,"Senate Third Reading: Given Immediate Effect Roll Call # 413",38,0,0,0,38
335873,94646,2011-06-22,House,"Reported With Recommendation Without Amendment",17,4,0,0,21
335873,94647,2011-06-23,House,"House Third Reading: Given Immediate Effect Roll Call # 230",70,40,0,0,110
335873,99694,2011-07-13,Senate,"Reported Favorably With Substitute S-2",5,0,0,0,5
335873,99695,2011-07-13,Senate,"Senate Third Reading: Given Immediate Effect Roll Call # 448",32,3,1,2,38
335911,94261,2011-06-21,House,"Reported With Recommendation Without Amendment",9,2,0,0,11
335911,96572,2011-06-29,House,"House Third Reading: Given Immediate Effect Roll Call # 248",107,2,0,0,109
335911,105379,2011-12-07,Senate,"Reported Favorably Without Amendment",3,0,0,0,3
335911,148818,2012-02-01,Senate,"Senate Third Reading: Given Immediate Effect Roll Call # 33",36,1,0,1,38
335925,94641,2011-06-23,Senate,"Reported Favorably Without Amendment",5,0,0,0,5
335925,94642,2011-06-23,Senate,"Senate Third Reading: Passed Roll Call # 348",32,5,0,1,38
335925,100556,2011-08-24,House,"Reported With Recommendation Without Amendment",19,1,0,0,20
335925,100557,2011-08-24,House,"House Third Reading: Given Immediate Effect Roll Call # 313",64,43,0,0,107
335930,102696,2011-10-04,Senate,"Reported Favorably With Substitute S-1",4,0,0,0,4
335930,103188,2011-11-02,Senate,"Senate Third Reading: Passed Roll Call # 623",37,0,0,1,38
335930,171848,2012-03-13,House,"Reported With Recommendation With Amendment(s)",8,0,0,0,8
335930,200246,2012-05-29,House,"House Third Reading: Given Immediate Effect Roll Call # 309",110,0,0,0,110
335930,200247,2012-05-31,Senate,"Senate Third Reading: House Amendment(s) Concurred In Roll Call # 418",36,0,0,2,38
335934,102694,2011-10-04,Senate,"Reported Favorably With Substitute S-2",4,0,0,0,4
335934,103187,2011-11-02,Senate,"Senate Third Reading: Passed Roll Call # 622",37,0,0,1,38
335934,176808,2012-03-20,House,"Reported With Recommendation With Substitute H-1",9,0,0,0,9
335934,199512,2012-05-29,House,"House Third Reading: Given Immediate Effect Roll Call # 311",110,0,0,0,110
335934,200550,2012-05-31,Senate,"Senate Third Reading:  Roll Call # 417",36,0,0,2,38
335935,103122,2011-11-01,Senate,"Reported Favorably With Substitute S-2",6,0,0,0,6
335935,103164,2011-11-02,Senate,"Senate Third Reading: Passed Roll Call # 626",37,0,0,1,38
335935,214990,2012-12-04,House,"Reported With Recommendation With Amendment(s)",7,0,0,0,7
335935,215548,2012-12-12,House,"House Third Reading: Given Immediate Effect Roll Call # 754",109,0,0,0,109
335935,215701,2012-12-13,Senate,"Senate Third Reading: House Amendment(s) Concurred In Roll Call # 1022",38,0,0,0,38
335939,102324,2011-09-15,Senate,"Reported Favorably Without Amendment",7,0,0,0,7
335939,103674,2011-11-30,Senate,"Senate Third Reading: Passed Roll Call # 712",38,0,0,0,38
335939,104910,2011-12-07,House,"Reported With Recommendation With Substitute H-1",16,0,0,0,16
335939,105723,2011-12-14,House,"House Third Reading: Given Immediate Effect Roll Call # 596",108,0,0,0,108
335939,138795,2011-12-15,Senate,"Senate Third Reading:  Roll Call # 817",36,0,2,0,38
335939,138796,2011-12-15,Senate,"Senate Third Reading:  Roll Call # 818",38,0,0,0,38
335944,94657,2011-06-23,Senate,"Reported Favorably With Substitute S-2",5,0,0,0,5
335944,94658,2011-06-23,Senate,"Senate Third Reading: Passed Roll Call # 349",31,6,0,1,38
335944,100559,2011-08-24,House,"Reported With Recommendation With Amendment(s)",17,2,0,0,19
335944,100560,2011-08-24,House,"House Third Reading: Given Immediate Effect Roll Call # 314",57,49,0,0,106
335946,93880,2011-06-21,Senate,"Reported Favorably Without Amendment",5,0,0,0,5
335946,102015,2011-09-07,Senate,"Senate Third Reading: Passed Roll Call # 469",28,9,0,1,38
335947,103128,2011-11-01,Senate,"Reported Favorably With Substitute S-1",4,0,0,0,4
335947,103198,2011-11-03,Senate,"Senate Third Reading: Passed Roll Call # 638",38,0,0,0,38
335953,102701,2011-10-04,Senate,"Reported Favorably Without Amendment",4,0,0,0,4
335953,103190,2011-11-02,Senate,"Senate Third Reading: Passed Roll Call # 621",37,0,0,1,38
335953,176591,2012-03-20,House,"Reported With Recommendation Without Amendment",9,0,0,0,9
335953,200172,2012-05-29,House,"House Third Reading: Given Immediate Effect Roll Call # 310",110,0,0,0,110
335955,103129,2011-11-01,Senate,"Reported Favorably With Substitute S-1",4,0,0,0,4
335955,103199,2011-11-03,Senate,"Senate Third Reading: Passed By 2/3 Vote Roll Call # 637",38,0,0,0,38
335968,103132,2011-11-01,Senate,"Reported Favorably With Substitute S-1",4,0,0,0,4
335968,103202,2011-11-03,Senate,"Senate Third Reading: Passed Roll Call # 639",38,0,0,0,38
335970,94473,2011-06-23,Senate,"Reported Favorably Without Amendment",5,0,0,0,5
335970,94474,2011-06-23,Senate,"Senate Third Reading: Passed Roll Call # 347",31,5,1,1,38
335970,100564,2011-08-24,House,"Reported With Recommendation Without Amendment",19,1,0,0,20
335970,100565,2011-08-24,House,"House Third Reading: Given Immediate Effect Roll Call # 312",62,44,0,0,106
335972,94660,2011-06-23,Senate,"Reported Favorably Without Amendment",5,0,0,0,5
335972,94661,2011-06-23,Senate,"Senate Third Reading: Passed Roll Call # 350",22,15,0,1,38
335972,100562,2011-08-24,House,"Reported With Recommendation Without Amendment",17,7,0,0,24
335972,100563,2011-08-24,House,"House Third Reading: Given Immediate Effect Roll Call # 315",63,44,0,0,107
335973,102984,2011-10-25,Senate,"Reported Favorably With Substitute S-2",4,0,0,0,4
335973,103189,2011-11-02,Senate,"Senate Third Reading: Passed Roll Call # 627",37,0,0,1,38
335973,189345,2012-04-24,House,"Reported With Recommendation With Substitute H-2",7,0,0,0,7
335973,200249,2012-05-30,House,"House Third Reading: Given Immediate Effect Roll Call # 316",109,0,0,0,109
335973,200250,2012-05-31,Senate,"Senate Third Reading:  Roll Call # 409",35,0,0,3,38
335974,92662,2011-06-16,Senate,"Reported Favorably Without Amendment",3,2,0,0,5
335974,94215,2011-06-22,Senate,"Senate Third Reading: Passed Roll Call # 332",26,12,0,0,38
335974,96014,2011-06-29,House,"Reported With Recommendation With Substitute H-1",17,0,0,0,17
335974,96911,2011-06-30,House,"House Third Reading: Given Immediate Effect Roll Call # 268",78,30,0,0,108
335974,96912,2011-06-30,Senate,"Senate Third Reading:  Roll Call # 430",26,12,0,0,38
335982,102983,2011-10-25,Senate,"Reported Favorably With Substitute S-1",3,0,0,0,3
335982,103200,2011-11-02,Senate,"Senate Third Reading: Passed Roll Call # 628",37,0,0,1,38
335982,196221,2012-05-15,House,"Reported With Recommendation With Substitute H-2",9,0,0,0,9
335982,200098,2012-05-29,House,"House Third Reading: Given Immediate Effect Roll Call # 313",110,0,0,0,110
335982,200564,2012-05-31,Senate,"Senate Third Reading:  Roll Call # 416",36,0,0,2,38
335984,102704,2011-10-04,Senate,"Reported Favorably Without Amendment",4,0,0,0,4
335984,103170,2011-11-02,Senate,"Senate Third Reading: Passed Roll Call # 624",37,0,0,1,38
335984,196287,2012-05-15,House,"Reported With Recommendation Without Amendment",9,0,0,0,9
335984,200143,2012-05-30,House,"House Third Reading: Given Immediate Effect Roll Call # 319",110,0,0,0,110
335989,102986,2011-10-25,Senate,"Reported Favorably With Substitute S-2",3,0,0,0,3
335989,103169,2011-11-02,Senate,"Senate Third Reading: Passed Roll Call # 625",37,0,0,1,38
335989,196284,2012-05-15,House,"Reported With Recommendation Without Amendment",9,0,0,0,9
335989,200115,2012-05-30,House,"House Third Reading: Given Immediate Effect Roll Call # 318",110,0,0,0,110
335998,102703,2011-10-04,Senate,"Reported Favorably With Substitute S-2",4,0,0,0,4
335998,103166,2011-11-02,Senate,"Senate Third Reading: Passed Roll Call # 620",37,0,0,1,38
335998,176683,2012-03-20,House,"Reported With Recommendation With Substitute H-1",9,0,0,0,9
335998,200285,2012-05-29,House,"House Third Reading: Given Immediate Effect Roll Call # 308",110,0,0,0,110
335998,200286,2012-05-31,Senate,"Senate Third Reading:  Roll Call # 415",36,0,0,2,38
336008,102707,2011-10-04,Senate,"Reported Favorably With Substitute S-1",4,0,0,0,4
336008,103173,2011-11-02,Senate,"Senate Third Reading: Passed Roll Call # 619",37,0,0,1,38
336008,196285,2012-05-15,House,"Reported With Recommendation With Substitute H-1",9,0,0,0,9
336008,200077,2012-05-29,House,"House Third Reading: Given Immediate Effect Roll Call # 312",110,0,0,0,110
336008,200558,2012-05-31,Senate,"Senate Third Reading:  Roll Call # 414",36,0,0,2,38
336011,102987,2011-10-25,Senate,"Reported Favorably With Substitute S-2",3,0,0,0,3
336011,103207,2011-11-03,Senate,"Senate Third Reading: Passed Roll Call # 636",38,0,0,0,38
336011,196787,2012-05-15,House,"Reported With Recommendation Without Amendment",9,0,0,0,9
336011,200237,2012-05-30,House,"House Third Reading: Given Immediate Effect Roll Call # 317",108,2,0,0,110
336019,94310,2011-06-22,House,"Reported With Recommendation With Substitute H-1",19,0,0,0,19
336019,94564,2011-06-23,House,"House Third Reading: Given Immediate Effect Roll Call # 226",103,7,0,0,110
336019,96642,2011-06-30,Senate,"Reported Favorably Without Amendment",6,0,0,0,6
336019,96643,2011-06-30,Senate,"Senate Third Reading: Given Immediate Effect Roll Call # 418",36,2,0,0,38
336035,103069,2011-10-26,House,"Reported With Recommendation With Substitute H-1",17,0,0,0,17
336035,103341,2011-11-09,House,"House Third Reading: Given Immediate Effect Roll Call # 464",108,0,0,0,108
336035,148451,2012-02-01,Senate,"Reported Favorably With Substitute S-1",7,0,0,0,7
336035,158195,2012-02-21,Senate,"Senate Third Reading: Given Immediate Effect Roll Call # 87",36,0,0,2,38
336035,166068,2012-02-28,House,"House Third Reading:  Roll Call # 73",105,0,0,0,105
336054,200026,2012-05-30,House,"Reported With Recommendation With Substitute H-1",11,1,0,0,12
336054,201242,2012-06-06,House,"House Third Reading: Given Immediate Effect Roll Call # 361",105,4,0,0,109
336054,202597,2012-06-14,Senate,"Reported Favorably Without Amendment",6,1,0,0,7
336054,215381,2012-12-12,Senate,"Senate Third Reading: Given Immediate Effect Roll Call # 915",32,5,0,1,38
336054,215864,2012-12-14,House,"House Third Reading:  Roll Call # 891",101,5,0,0,106
336054,215865,2012-12-14,Senate,"Senate Third Reading:  Roll Call # 1091",32,6,0,0,38
336104,103216,2011-11-03,Senate,"Reported Favorably With Recommendation For Referral To Committee On Finance",7,0,0,0,7
336104,103604,2011-11-29,Senate,"Reported Favorably With Substitute S-1",7,0,0,0,7
336104,104893,2011-12-01,Senate,"Senate Third Reading: Passed Roll Call # 729",35,1,1,1,38
336104,105711,2011-12-13,House,"Reported With Recommendation With Substitute H-1",12,7,0,0,19
336104,105712,2011-12-14,House,"House Third Reading: Given Immediate Effect Roll Call # 592",64,44,0,0,108
336104,105713,2011-12-14,Senate,"Senate Third Reading:  Roll Call # 806",36,1,0,1,38
336108,102057,2011-09-13,Senate,"Reported Favorably Without Amendment",4,1,0,0,5
336108,102189,2011-09-15,Senate,"Senate Third Reading: Passed Roll Call # 484",24,13,0,1,38
336119,103221,2011-11-03,Senate,"Reported Favorably With Recommendation For Referral To Committee On Finance",7,0,0,0,7
336119,103619,2011-11-29,Senate,"Reported Favorably With Substitute S-1",7,0,0,0,7
336119,104906,2011-12-01,Senate,"Senate Third Reading: Passed Roll Call # 730",34,2,1,1,38
336119,105718,2011-12-13,House,"Reported With Recommendation Without Amendment",12,7,0,0,19
336119,105719,2011-12-14,House,"House Third Reading: Given Immediate Effect Roll Call # 593",64,44,0,0,108
336134,94294,2011-06-22,Senate,"Reported Favorably With Substitute S-1",3,0,0,0,3
336134,94295,2011-06-22,Senate,"Senate Third Reading: Passed Roll Call # 336",26,12,0,0,38
336134,95553,2011-06-28,House,"Reported With Recommendation Without Amendment",8,3,0,0,11
336134,96626,2011-06-30,House,"House Third Reading: Given Immediate Effect Roll Call # 283",62,46,0,0,108
336134,100958,2011-08-24,Senate,"Senate Third Reading: House Amendment(s) Concurred In Roll Call # 457",26,12,0,0,38
336135,94306,2011-06-22,Senate,"Reported Favorably With Substitute S-1",3,0,0,0,3
336135,94307,2011-06-22,Senate,"Senate Third Reading: Passed Roll Call # 335",26,12,0,0,38
336135,95556,2011-06-28,House,"Reported With Recommendation Without Amendment",8,3,0,0,11
336135,96647,2011-06-30,House,"House Third Reading: Given Immediate Effect Roll Call # 282",62,46,0,0,108
336135,100961,2011-08-24,Senate,"Senate Third Reading: House Amendment(s) Concurred In Roll Call # 456",26,12,0,0,38
336138,94059,2011-06-22,Senate,"Reported Favorably With Substitute S-1",3,0,0,0,3
336138,94060,2011-06-22,Senate,"Senate Third Reading: Passed Roll Call # 338",26,12,0,0,38
336138,95595,2011-06-28,House,"Reported With Recommendation Without Amendment",8,3,0,0,11
336138,96684,2011-06-30,House,"House Third Reading: Given Immediate Effect Roll Call # 285",62,46,0,0,108
336138,100963,2011-08-24,Senate,"Senate Third Reading: House Amendment(s) Concurred In Roll Call # 459",26,12,0,0,38
336139,94052,2011-06-22,Senate,"Reported Favorably With Substitute S-1",3,0,0,0,3
336139,94053,2011-06-22,Senate,"Senate Third Reading: Passed Roll Call # 340",26,12,0,0,38
336139,97067,2011-06-29,House,"Reported With Recommendation Without Amendment",8,6,0,0,14
336139,97068,2011-06-30,House,"House Third Reading: Given Immediate Effect Roll Call # 289",62,46,0,0,108
336139,100964,2011-08-24,Senate,"Senate Third Reading: House Amendment(s) Concurred In Roll Call # 461",26,12,0,0,38
336141,94054,2011-06-22,Senate,"Reported Favorably With Substitute S-1",3,0,0,0,3
336141,94055,2011-06-22,Senate,"Senate Third Reading: Passed Roll Call # 341",26,12,0,0,38
336141,95583,2011-06-28,House,"Reported With Recommendation Without Amendment",8,3,0,0,11
336141,96674,2011-06-30,House,"House Third Reading: Given Immediate Effect Roll Call # 287",62,46,0,0,108
336141,100962,2011-08-24,Senate,"Senate Third Reading: House Amendment(s) Concurred In Roll Call # 462",26,12,0,0,38
336144,103777,2011-11-30,House,"Reported With Recommendation Without Amendment",12,1,0,0,13
336145,93762,2011-06-21,House,"Reported With Recommendation With Substitute H-2",6,3,0,0,9
336145,94347,2011-06-22,House,"House Third Reading: Passed Roll Call # 213",63,47,0,0,110
336145,96213,2011-06-29,Senate,"Reported Favorably Without Amendment",3,0,0,0,3
336145,96214,2011-06-29,Senate,"Senate Third Reading: Passed Roll Call # 375",25,13,0,0,38
336160,94085,2011-06-22,House,"Reported With Recommendation Without Amendment",24,0,0,0,24
336160,94599,2011-06-23,House,"House Third Reading: Given Immediate Effect Roll Call # 233",57,52,0,0,109
336160,100840,2011-08-24,Senate,"Reported Favorably With Substitute S-1",7,0,0,0,7
336160,100841,2011-08-24,Senate,"Senate Third Reading: Given Immediate Effect Roll Call # 455",26,12,0,0,38
336160,102122,2011-09-13,House,"House Third Reading:  Roll Call # 326",58,51,0,0,109
336175,94069,2011-06-22,House,"Reported With Recommendation Without Amendment",5,0,0,0,5
336175,94592,2011-06-23,House,"House Third Reading: Given Immediate Effect Roll Call # 225",99,11,0,0,110
336175,96693,2011-06-30,Senate,"Senate Third Reading: Given Immediate Effect Roll Call # 404",38,0,0,0,38
336180,122385,2011-12-14,Senate,"Reported Favorably With Substitute S-2",9,0,0,0,9
336180,148717,2012-02-01,Senate,"Senate Third Reading: Passed Roll Call # 36",36,1,0,1,38
336180,168712,2012-03-06,House,"Reported With Recommendation With Substitute H-2",18,1,0,0,19
336180,192494,2012-05-02,House,"House Third Reading: Given Immediate Effect Roll Call # 215",100,9,0,0,109
336180,195361,2012-05-10,Senate,"Senate Third Reading:  Roll Call # 330",37,0,0,1,38
336182,94086,2011-06-22,House,"Reported With Recommendation With Substitute H-1",4,2,0,0,6
336182,102326,2011-09-15,House,"House Third Reading: Given Immediate Effect Roll Call # 332",64,44,0,0,108
336182,102917,2011-10-20,Senate,"Reported Favorably Without Amendment",5,2,0,0,7
336182,104948,2011-12-07,Senate,"Senate Third Reading: Given Immediate Effect Roll Call # 741",27,9,0,2,38
336184,94090,2011-06-22,Senate,"Reported Favorably With Substitute S-1",3,0,0,0,3
336184,94091,2011-06-22,Senate,"Senate Third Reading: Passed Roll Call # 339",26,10,2,0,38
336184,95620,2011-06-28,House,"Reported With Recommendation Without Amendment",8,3,0,0,11
336184,96720,2011-06-30,House,"House Third Reading: Given Immediate Effect Roll Call # 286",62,46,0,0,108
336184,100966,2011-08-24,Senate,"Senate Third Reading: House Amendment(s) Concurred In Roll Call # 460",26,12,0,0,38
336190,94095,2011-06-22,House,"Reported With Recommendation Without Amendment",26,0,0,0,26
336190,94607,2011-06-23,House,"House Third Reading: Given Immediate Effect Roll Call # 232",109,0,0,0,109
336196,94098,2011-06-22,House,"Reported With Recommendation Without Amendment",16,1,0,0,17
336196,94606,2011-06-23,House,"House Third Reading: Given Immediate Effect Roll Call # 227",88,22,0,0,110
336196,102327,2011-09-15,Senate,"Reported Favorably Without Amendment",4,0,0,0,4
336196,102358,2011-09-20,Senate,"Senate Third Reading: Given Immediate Effect Roll Call # 490",34,2,0,2,38
336198,94121,2011-06-22,House,"Reported With Recommendation Without Amendment",4,2,0,0,6
336198,102328,2011-09-15,House,"House Third Reading: Given Immediate Effect Roll Call # 331",64,44,0,0,108
336198,102916,2011-10-20,Senate,"Reported Favorably Without Amendment",5,2,0,0,7
336198,104932,2011-12-07,Senate,"Senate Third Reading: Given Immediate Effect Roll Call # 744",27,9,0,2,38
336198,105728,2011-12-08,House,"House Third Reading: Senate Amendment(s) Concurred In Roll Call # 531",63,45,0,0,108
336202,94100,2011-06-22,House,"Reported With Recommendation Without Amendment",14,2,0,0,16
336202,94608,2011-06-23,House,"House Third Reading: Given Immediate Effect Roll Call # 216",94,16,0,0,110
336202,202495,2012-06-13,Senate,"Reported Favorably With Substitute S-4",5,1,0,0,6
336206,94125,2011-06-22,Senate,"Reported Favorably With Substitute S-1",3,0,0,0,3
336206,94126,2011-06-22,Senate,"Senate Third Reading: Passed Roll Call # 344",27,11,0,0,38
336206,102329,2011-09-14,House,"Reported With Recommendation With Substitute H-1",13,1,0,0,14
336206,102563,2011-09-27,House,"House Third Reading: Given Immediate Effect Roll Call # 366",77,32,0,0,109
336206,102604,2011-09-28,Senate,"Senate Third Reading:  Roll Call # 533",27,11,0,0,38
336211,94114,2011-06-22,Senate,"Reported Favorably With Substitute S-1",3,0,0,0,3
336211,94115,2011-06-22,Senate,"Senate Third Reading: Passed Roll Call # 342",26,12,0,0,38
336211,95385,2011-06-28,House,"Reported With Recommendation Without Amendment",8,3,0,0,11
336211,96741,2011-06-30,House,"House Third Reading: Given Immediate Effect Roll Call # 288",62,46,0,0,108
336211,100968,2011-08-24,Senate,"Senate Third Reading: House Amendment(s) Concurred In Roll Call # 463",26,12,0,0,38
336212,94130,2011-06-22,House,"Reported With Recommendation Without Amendment",12,7,0,0,19
336217,94139,2011-06-22,Senate,"Reported Favorably With Substitute S-1",3,0,0,0,3
336217,94140,2011-06-22,Senate,"Senate Third Reading: Passed Roll Call # 345",24,14,0,0,38
336217,102331,2011-09-14,House,"Reported With Recommendation With Substitute H-1",13,1,0,0,14
336217,102608,2011-09-28,House,"House Third Reading: Given Immediate Effect Roll Call # 369",78,31,0,0,109
336217,102609,2011-09-28,Senate,"Senate Third Reading:  Roll Call # 535",24,14,0,0,38
336218,94614,2011-06-23,Senate,"Reported Favorably With Substitute S-1",5,0,0,0,5
336218,94615,2011-06-23,Senate,"Senate Third Reading: Passed Roll Call # 353",29,8,0,1,38
336218,95387,2011-06-28,House,"House Third Reading: Passed Roll Call # 244",65,42,0,0,107
336218,95656,2011-06-28,House,"Reported With Recommendation With Amendment(s)",6,3,0,0,9
336218,96305,2011-06-29,Senate,"Senate Third Reading: House Amendment(s) Concurred In Roll Call # 376",29,9,0,0,38
336227,94618,2011-06-23,House,"Reported With Recommendation Without Amendment",9,4,0,0,13
336233,94145,2011-06-22,Senate,"Reported Favorably Without Amendment",3,0,0,0,3
336233,94146,2011-06-22,Senate,"Senate Third Reading: Passed Roll Call # 346",25,13,0,0,38
336233,102332,2011-09-14,House,"Reported With Recommendation Without Amendment",14,1,0,0,15
336233,102544,2011-09-27,House,"House Third Reading: Given Immediate Effect Roll Call # 367",108,1,0,0,109
336233,102617,2011-09-28,Senate,"Senate Third Reading:  Roll Call # 534",26,12,0,0,38
336237,94143,2011-06-22,House,"Reported With Recommendation Without Amendment",12,7,0,0,19
336245,94156,2011-06-22,Senate,"Reported Favorably Without Amendment",3,0,0,0,3
336245,94157,2011-06-22,Senate,"Senate Third Reading: Passed Roll Call # 343",24,14,0,0,38
336245,95420,2011-06-28,House,"Reported With Recommendation Without Amendment",8,3,0,0,11
336245,96773,2011-06-30,House,"House Third Reading: Given Immediate Effect Roll Call # 303",60,48,0,0,108
336245,103319,2011-11-03,Senate,"Senate Third Reading:  Roll Call # 650",27,11,0,0,38
336250,94150,2011-06-22,Senate,"Reported Favorably With Substitute S-1",3,0,0,0,3
336250,94151,2011-06-22,Senate,"Senate Third Reading: Passed Roll Call # 337",26,12,0,0,38
336250,95416,2011-06-28,House,"Reported With Recommendation Without Amendment",8,3,0,0,11
336250,96782,2011-06-30,House,"House Third Reading: Given Immediate Effect Roll Call # 284",62,46,0,0,108
336250,100970,2011-08-24,Senate,"Senate Third Reading: House Amendment(s) Concurred In Roll Call # 458",26,12,0,0,38
336537,94579,2011-06-23,Senate,"Reported Favorably Without Amendment",5,0,0,0,5
336537,95569,2011-06-28,Senate,"Senate Third Reading: Passed Roll Call # 355",38,0,0,0,38
336537,102325,2011-09-14,House,"Reported With Recommendation Without Amendment",23,0,0,0,23
336537,102468,2011-09-22,House,"House Third Reading: Given Immediate Effect Roll Call # 360",107,0,0,0,107
336543,96658,2011-06-29,Senate,"Reported Favorably Without Amendment",3,0,0,0,3
336547,102542,2011-09-27,Senate,"Reported Favorably With Substitute S-1",6,0,0,0,6
336547,102753,2011-10-06,Senate,"Senate Third Reading: Passed Roll Call # 551",38,0,0,0,38
336547,103641,2011-11-29,House,"Reported With Recommendation Without Amendment",11,0,0,0,11
336547,105706,2011-12-14,House,"House Third Reading: Given Immediate Effect Roll Call # 582",107,0,0,0,107
336561,144156,2012-01-19,House,"Reported With Recommendation With Substitute H-1",13,0,0,0,13
336570,102543,2011-09-27,Senate,"Reported Favorably With Substitute S-1",6,0,0,0,6
336570,102752,2011-10-06,Senate,"Senate Third Reading: Passed Roll Call # 552",38,0,0,0,38
336570,103640,2011-11-29,House,"Reported With Recommendation Without Amendment",11,0,0,0,11
336570,105704,2011-12-14,House,"House Third Reading: Given Immediate Effect Roll Call # 583",107,0,0,0,107
336575,96691,2011-06-29,Senate,"Reported Favorably Without Amendment",3,0,0,0,3
336575,194477,2012-05-08,Senate,"Senate Third Reading: Passed By 3/4 Vote Roll Call # 313",35,2,0,1,38
336597,100577,2011-08-24,Senate,"Reported Favorably With Substitute S-1",7,0,0,0,7
336597,102427,2011-09-21,Senate,"Senate Third Reading: Passed Roll Call # 498",37,0,0,1,38
336597,102840,2011-10-12,House,"Reported With Recommendation With Substitute H-1",10,0,0,0,10
336597,103035,2011-10-27,House,"House Third Reading: Given Immediate Effect Roll Call # 435",105,3,0,0,108
336597,103263,2011-11-08,Senate,"Senate Third Reading:  Roll Call # 655",38,0,0,0,38
336597,103386,2011-11-10,House,"House Third Reading:  Roll Call # 484",79,28,0,0,107
336622,144154,2012-01-19,House,"Reported With Recommendation With Substitute H-1",13,0,0,0,13
336632,102547,2011-09-27,Senate,"Reported Favorably With Substitute S-1",6,0,0,0,6
336632,102759,2011-10-06,Senate,"Senate Third Reading: Passed Roll Call # 553",38,0,0,0,38
336632,103642,2011-11-29,House,"Reported With Recommendation Without Amendment",11,0,0,0,11
336632,105738,2011-12-14,House,"House Third Reading: Given Immediate Effect Roll Call # 584",107,0,0,0,107
336707,154864,2012-02-14,House,"Reported With Recommendation With Substitute H-1",6,2,0,0,8
336707,172019,2012-03-13,House,"House Third Reading: Passed Roll Call # 101",72,37,0,0,109
336707,192133,2012-05-02,Senate,"Reported Favorably Without Amendment",3,0,0,0,3
336707,204126,2012-03-13,House,"House Third Reading:  Roll Call # 102",70,39,0,0,109
336707,215460,2012-12-12,Senate,"Senate Third Reading: Passed Roll Call # 878",29,8,1,0,38
336708,153915,2012-02-09,Senate,"Reported Favorably With Substitute S-6",14,0,0,0,14
336708,161520,2012-02-23,Senate,"Senate Third Reading: Passed By 2/3 Vote Roll Call # 97",32,5,0,1,38
336708,179741,2012-03-28,House,"Reported With Recommendation With Substitute H-4",25,0,0,0,25
336708,180613,2012-03-28,House,"Reported With Recommendation With Substitute H-1",25,0,0,0,25
336708,180614,2012-03-29,House,"House Third Reading: Given Immediate Effect Roll Call # 167",105,5,0,0,110
336708,180615,2012-03-29,Senate,"Senate Third Reading:  Roll Call # 199",33,3,2,0,38
336708,180616,2012-03-29,Senate,"Senate Third Reading:  Roll Call # 200",32,6,0,0,38
337055,201937,2012-06-12,House,"Reported With Recommendation Without Amendment",6,0,0,0,6
337055,214032,2012-11-28,House,"House Third Reading: Passed Roll Call # 608",106,3,0,0,109
337062,102957,2011-10-19,Senate,"Reported Favorably With Substitute S-2",5,1,0,0,6
337062,103621,2011-11-29,Senate,"Senate Third Reading: Passed Roll Call # 702",35,3,0,0,38
337096,154993,2012-02-14,House,"Reported With Recommendation With Substitute H-1",6,2,0,0,8
337096,172068,2012-03-13,House,"House Third Reading: Passed Roll Call # 103",72,37,0,0,109
337096,192281,2012-05-02,Senate,"Reported Favorably With Substitute S-1",3,0,0,0,3
337096,204181,2012-03-13,House,"House Third Reading:  Roll Call # 104",70,39,0,0,109
337096,215462,2012-12-12,Senate,"Senate Third Reading: Passed Roll Call # 879",29,9,0,0,38
337191,152880,2012-02-08,House,"Reported With Recommendation With Substitute H-4",23,0,0,0,23
337191,177073,2012-03-22,House,"House Third Reading: Passed By 2/3 Vote Roll Call # 139",101,7,0,0,108
337191,180636,2012-03-29,Senate,"Reported Favorably With Substitute S-1",3,0,0,0,3
337191,180637,2012-03-29,Senate,"Senate Third Reading: Passed By 2/3 Vote Roll Call # 195",34,4,0,0,38
337191,180638,2012-03-29,House,"House Third Reading:  Roll Call # 168",103,6,0,0,109
337191,180639,2012-03-29,House,"House Third Reading:  Roll Call # 169",49,60,0,0,109
337195,96924,2011-06-30,Senate,"Reported Favorably Without Amendment",6,0,0,0,6
337195,96925,2011-06-30,Senate,"Senate Third Reading: Passed Roll Call # 425",38,0,0,0,38
337195,102353,2011-09-14,House,"Reported With Recommendation Without Amendment",21,0,0,0,21
337195,102467,2011-09-22,House,"House Third Reading: Given Immediate Effect Roll Call # 361",98,9,0,0,107
337232,102647,2011-09-27,House,"Reported With Recommendation With Substitute H-1",13,7,0,0,20
337232,102855,2011-10-13,House,"House Third Reading: Given Immediate Effect Roll Call # 413",62,46,0,0,108
337270,103778,2011-12-01,House,"Reported With Recommendation With Substitute H-2",17,0,0,0,17
337270,146879,2012-01-25,House,"House Third Reading: Given Immediate Effect Roll Call # 9",106,0,0,0,106
337270,212134,2012-09-20,Senate,"Reported Favorably With Substitute S-1",5,0,0,0,5
337270,215476,2012-12-12,Senate,"Senate Third Reading: Given Immediate Effect Roll Call # 916",37,0,0,1,38
337270,215509,2012-12-13,House,"House Third Reading:  Roll Call # 829",98,11,0,0,109
337277,96092,2011-06-29,Senate,"Reported Favorably Without Amendment",8,0,0,0,8
337621,120212,2011-12-13,Senate,"Reported Favorably With Substitute S-1",5,1,0,0,6
337621,144889,2012-01-24,Senate,"Senate Third Reading: Passed Roll Call # 9",26,12,0,0,38
337621,176911,2012-03-22,House,"Reported With Recommendation With Substitute H-2",7,1,0,0,8
337621,186733,2012-04-18,House,"House Third Reading: Given Immediate Effect Roll Call # 176",72,37,0,0,109
337621,187403,2012-04-19,Senate,"Senate Third Reading:  Roll Call # 208",26,12,0,0,38
337634,121721,2011-12-13,Senate,"Reported Favorably With Substitute S-1",5,1,0,0,6
337634,145051,2012-01-24,Senate,"Senate Third Reading: Passed Roll Call # 10",26,12,0,0,38
337634,177107,2012-03-22,House,"Reported With Recommendation With Substitute H-1",7,1,0,0,8
337634,187146,2012-04-18,House,"House Third Reading: Given Immediate Effect Roll Call # 177",73,36,0,0,109
337634,187663,2012-04-19,Senate,"Senate Third Reading:  Roll Call # 209",26,11,1,0,38
337634,187664,2012-04-19,Senate,"Senate Third Reading:  Roll Call # 212",26,12,0,0,38
337635,120643,2011-12-13,Senate,"Reported Favorably With Substitute S-1",5,1,0,0,6
337635,145036,2012-01-24,Senate,"Senate Third Reading: Passed Roll Call # 12",26,12,0,0,38
337635,177077,2012-03-22,House,"Reported With Recommendation With Substitute H-1",7,1,0,0,8
337635,187033,2012-04-18,House,"House Third Reading: Given Immediate Effect Roll Call # 179",71,38,0,0,109
337635,187595,2012-04-19,Senate,"Senate Third Reading:  Roll Call # 211",26,12,0,0,38
337638,123130,2011-12-13,Senate,"Reported Favorably With Substitute S-1",5,1,0,0,6
337638,145053,2012-01-24,Senate,"Senate Third Reading: Passed Roll Call # 8",26,12,0,0,38
337638,177098,2012-03-22,House,"Reported With Recommendation With Substitute H-1",7,1,0,0,8
337638,187148,2012-04-18,House,"House Third Reading: Given Immediate Effect Roll Call # 175",73,36,0,0,109
337638,187662,2012-04-19,Senate,"Senate Third Reading:  Roll Call # 207",26,12,0,0,38
337642,103780,2011-11-29,House,"Reported With Recommendation With Substitute H-1",11,0,0,0,11
337650,101741,2011-09-07,Senate,"Reported Favorably Without Amendment",3,0,0,0,3
337650,102386,2011-09-21,Senate,"Senate Third Reading: Passed Roll Call # 501",35,1,0,2,38
337650,150853,2012-02-02,House,"Reported With Recommendation Without Amendment",16,0,0,0,16
337650,154768,2012-02-14,House,"House Third Reading: Given Immediate Effect Roll Call # 51",108,0,0,0,108
337682,102646,2011-09-28,Senate,"Reported Favorably With Substitute S-1",5,0,0,0,5
337682,138662,2011-12-15,Senate,"Senate Third Reading: Passed Roll Call # 839",38,0,0,0,38
337682,145908,2012-01-25,House,"Reported With Recommendation With Substitute H-1",15,0,0,0,15
337682,148133,2012-01-31,House,"House Third Reading: Given Immediate Effect Roll Call # 20",105,0,0,0,105
337682,156136,2012-02-15,Senate,"Senate Third Reading:  Roll Call # 80",38,0,0,0,38
337682,158634,2012-02-21,House,"House Third Reading:  Roll Call # 65",106,0,0,0,106
337689,103782,2011-11-29,House,"Reported With Recommendation With Substitute H-1",11,0,0,0,11
337699,105887,2011-12-13,Senate,"Reported Favorably With Substitute S-1",5,1,0,0,6
337699,145026,2012-01-24,Senate,"Senate Third Reading: Passed Roll Call # 11",26,12,0,0,38
337699,177063,2012-03-22,House,"Reported With Recommendation With Substitute H-1",7,1,0,0,8
337699,187013,2012-04-18,House,"House Third Reading: Given Immediate Effect Roll Call # 178",72,37,0,0,109
337699,187587,2012-04-19,Senate,"Senate Third Reading:  Roll Call # 210",25,12,1,0,38
337703,103071,2011-10-25,House,"Reported With Recommendation With Substitute H-1",18,0,0,0,18
337703,103432,2011-11-10,House,"House Third Reading: Given Immediate Effect Roll Call # 482",103,4,0,0,107
337703,105636,2011-12-13,Senate,"Reported Favorably Without Amendment",5,1,0,0,6
337703,105637,2011-12-13,Senate,"Senate Third Reading: Given Immediate Effect Roll Call # 776",37,1,0,0,38
337726,212109,2012-09-20,House,"Reported With Recommendation Without Amendment",9,0,0,0,9
337731,105886,2011-12-13,Senate,"Reported Favorably With Substitute S-1",5,1,0,0,6
337731,145043,2012-01-24,Senate,"Senate Third Reading: Passed Roll Call # 7",26,12,0,0,38
337731,177087,2012-03-22,House,"Reported With Recommendation With Substitute H-2",7,1,0,0,8
337731,187034,2012-04-18,House,"House Third Reading: Given Immediate Effect Roll Call # 174",72,37,0,0,109
337731,187604,2012-04-19,Senate,"Senate Third Reading:  Roll Call # 206",26,12,0,0,38
337748,103783,2011-11-29,House,"Reported With Recommendation With Substitute H-1",11,0,0,0,11
337823,103393,2011-11-10,Senate,"Reported Favorably With Substitute S-1",6,0,0,0,6
337823,138549,2011-12-14,Senate,"Senate Third Reading: Passed Roll Call # 784",35,0,3,0,38
337823,138550,2011-12-14,Senate,"Senate Third Reading: Passed Roll Call # 785",37,0,1,0,38
337838,101743,2011-09-07,Senate,"Reported Favorably With Substitute S-1",3,0,0,0,3
337838,102096,2011-09-14,Senate,"Senate Third Reading: Passed Roll Call # 479",38,0,0,0,38
337838,104099,2011-12-01,House,"Reported With Recommendation Without Amendment",15,1,0,0,16
337838,138568,2011-12-13,House,"House Third Reading: Given Immediate Effect Roll Call # 573",104,4,0,0,108
337838,138569,2011-12-14,Senate,"Senate Third Reading:  Roll Call # 779",38,0,0,0,38
337843,101746,2011-09-07,Senate,"Reported Favorably Without Amendment",3,0,0,0,3
337843,102097,2011-09-14,Senate,"Senate Third Reading: Passed Roll Call # 480",38,0,0,0,38
337843,104120,2011-12-01,House,"Reported With Recommendation Without Amendment",15,1,0,0,16
337843,138574,2011-12-13,House,"House Third Reading: Given Immediate Effect Roll Call # 574",104,4,0,0,108
337843,138575,2011-12-14,Senate,"Senate Third Reading:  Roll Call # 780",37,1,0,0,38
337844,101654,2011-09-07,Senate,"Reported Favorably Without Amendment",3,0,0,0,3
337844,102102,2011-09-14,Senate,"Senate Third Reading: Passed Roll Call # 478",38,0,0,0,38
337844,104143,2011-12-01,House,"Reported With Recommendation Without Amendment",15,1,0,0,16
337844,138582,2011-12-13,House,"House Third Reading: Given Immediate Effect Roll Call # 572",105,3,0,0,108
337844,138583,2011-12-14,Senate,"Senate Third Reading:  Roll Call # 778",37,0,0,1,38
337855,181029,2012-03-29,House,"Reported With Recommendation With Substitute H-4",13,0,0,0,13
337855,193123,2012-05-03,House,"House Third Reading: Given Immediate Effect Roll Call # 242",87,22,0,0,109
337855,211878,2012-09-11,Senate,"Reported Favorably With Substitute S-2",4,0,0,0,4
337855,215650,2012-12-13,Senate,"Senate Third Reading: Defeated Roll Call # 1001",26,12,0,0,38
337855,215651,2012-12-14,Senate,"Senate Third Reading: Given Immediate Effect Roll Call # 1095",30,8,0,0,38
337855,215833,2012-12-14,House,"House Third Reading:  Roll Call # 911",98,7,0,0,105
337860,102343,2011-09-15,Senate,"Reported Favorably Without Amendment",4,0,0,0,4
337860,103634,2011-11-29,Senate,"Senate Third Reading: Passed Roll Call # 701",38,0,0,0,38
337860,214583,2012-11-29,House,"Reported With Recommendation With Substitute H-1",15,0,0,0,15
337860,215427,2012-12-12,House,"House Third Reading: Given Immediate Effect Roll Call # 746",109,0,0,0,109
337860,215746,2012-12-13,Senate,"Senate Third Reading:  Roll Call # 1023",38,0,0,0,38
337861,157077,2012-02-15,Senate,"Reported Favorably With Substitute S-3",4,0,0,0,4
337861,169085,2012-03-07,Senate,"Senate Third Reading: Passed Roll Call # 112",36,2,0,0,38
337872,101747,2011-09-07,Senate,"Reported Favorably Without Amendment",3,0,0,0,3
337872,102098,2011-09-14,Senate,"Senate Third Reading: Passed Roll Call # 481",38,0,0,0,38
337872,104109,2011-12-01,House,"Reported With Recommendation Without Amendment",15,1,0,0,16
337872,138572,2011-12-13,House,"House Third Reading: Given Immediate Effect Roll Call # 575",107,1,0,0,108
337872,138573,2011-12-14,Senate,"Senate Third Reading:  Roll Call # 781",38,0,0,0,38
337873,103461,2011-11-10,Senate,"Reported Favorably With Substitute S-1",6,0,0,0,6
337873,138636,2011-12-14,Senate,"Senate Third Reading: Passed Roll Call # 786",37,0,0,1,38
337874,173095,2012-03-15,House,"Reported With Recommendation Without Amendment",12,6,0,0,18
337874,201922,2012-06-12,House,"House Third Reading:  Roll Call # 411",62,48,0,0,110
337883,173062,2012-03-15,House,"Reported With Recommendation Without Amendment",12,6,0,0,18
338664,102018,2011-09-08,Senate,"Reported Favorably Without Amendment",4,0,0,0,4
338664,104355,2011-12-01,Senate,"Senate Third Reading: Passed Roll Call # 725",36,0,1,1,38
338664,177133,2012-03-22,House,"Reported With Recommendation Without Amendment",13,0,0,0,13
338664,198552,2012-05-24,House,"House Third Reading: Given Immediate Effect Roll Call # 292",102,6,0,0,108
338673,102019,2011-09-08,Senate,"Reported Favorably Without Amendment",4,0,0,0,4
338673,104322,2011-12-01,Senate,"Senate Third Reading: Passed Roll Call # 723",37,0,0,1,38
338683,102693,2011-10-04,Senate,"Reported Favorably With Substitute S-1",7,0,0,0,7
338683,102758,2011-10-06,Senate,"Senate Third Reading: Passed Roll Call # 554",33,5,0,0,38
338683,103192,2011-11-02,House,"Reported With Recommendation With Substitute H-1",18,1,0,0,19
338683,103648,2011-11-30,House,"House Third Reading: Given Immediate Effect Roll Call # 513",95,11,0,0,106
338683,104745,2011-12-06,Senate,"Senate Third Reading:  Roll Call # 734",34,1,0,3,38
338684,103344,2011-11-09,Senate,"Reported Favorably Without Amendment",3,0,0,0,3
338684,103390,2011-11-10,Senate,"Senate Third Reading: Passed Roll Call # 677",36,0,0,2,38
338684,196864,2012-05-16,House,"Reported With Recommendation For Referral To Committee On Military And Veterans Affairs And Homeland Security",5,0,0,0,5
338684,199497,2012-05-29,House,"Reported With Recommendation Without Amendment",12,0,0,0,12
338684,202512,2012-06-14,House,"House Third Reading: Given Immediate Effect Roll Call # 451",110,0,0,0,110
338684,202513,2012-06-14,Senate,"Senate Third Reading: House Amendment(s) Concurred In Roll Call # 553",38,0,0,0,38
338685,145571,2012-01-25,Senate,"Reported Favorably Without Amendment",7,0,0,0,7
338687,102347,2011-09-15,Senate,"Reported Favorably Without Amendment",4,0,0,0,4
338687,102560,2011-09-27,Senate,"Senate Third Reading: Passed Roll Call # 504",34,3,0,1,38
338687,200182,2012-05-31,House,"Reported With Recommendation With Substitute H-4",16,0,0,0,16
338687,202050,2012-06-13,House,"House Third Reading: Given Immediate Effect Roll Call # 431",104,4,0,0,108
338687,202051,2012-06-13,Senate,"Senate Third Reading:  Roll Call # 520",34,2,0,2,38
338688,102348,2011-09-15,Senate,"Reported Favorably Without Amendment",4,0,0,0,4
338688,102566,2011-09-27,Senate,"Senate Third Reading: Passed Roll Call # 505",34,3,0,1,38
338688,200238,2012-05-31,House,"Reported With Recommendation With Substitute H-4",16,0,0,0,16
338693,102022,2011-09-08,Senate,"Reported Favorably Without Amendment",4,0,0,0,4
338693,103806,2011-12-01,Senate,"Senate Third Reading: Passed Roll Call # 724",36,0,1,1,38
338694,102023,2011-09-08,Senate,"Reported Favorably With Substitute S-1",4,0,0,0,4
338694,104179,2011-12-01,Senate,"Senate Third Reading: Passed Roll Call # 722",37,0,0,1,38
338694,176995,2012-03-22,House,"Reported With Recommendation Without Amendment",13,0,0,0,13
338694,198661,2012-05-24,House,"House Third Reading: Given Immediate Effect Roll Call # 291",102,6,0,0,108
338694,200536,2012-05-31,Senate,"Senate Third Reading: House Amendment(s) Concurred In Roll Call # 413",36,0,0,2,38
338706,181004,2012-03-29,House,"Reported With Recommendation With Substitute H-2",13,3,0,0,16
338706,192963,2012-05-03,House,"House Third Reading: Given Immediate Effect Roll Call # 245",93,16,0,0,109
338706,211879,2012-09-11,Senate,"Reported Favorably Without Amendment",4,0,0,0,4
338706,215654,2012-12-13,Senate,"Senate Third Reading: Given Immediate Effect Roll Call # 1000",38,0,0,0,38
338706,215834,2012-12-14,House,"House Third Reading: Senate Amendment(s) Concurred In Roll Call # 895",96,10,0,0,106
338711,103119,2011-11-01,House,"Reported With Recommendation With Substitute H-1",11,0,0,0,11
338711,103811,2011-11-29,House,"House Third Reading: Given Immediate Effect Roll Call # 491",94,11,0,0,105
338711,154849,2012-02-14,Senate,"Reported Favorably Without Amendment",5,0,0,0,5
338711,164783,2012-02-29,Senate,"Senate Third Reading: Given Immediate Effect Roll Call # 101",36,1,0,1,38
338711,168198,2012-03-06,House,"House Third Reading:  Roll Call # 88",98,11,0,0,109
338723,103120,2011-11-01,House,"Reported With Recommendation With Substitute H-1",11,0,0,0,11
338723,103372,2011-11-01,House,"Reported With Recommendation With Substitute H-2",11,0,0,0,11
338723,103624,2011-11-29,House,"House Third Reading: Given Immediate Effect Roll Call # 492",94,11,0,0,105
338723,103625,2011-11-29,House,"House Third Reading: Passed Roll Call # 493",95,10,0,0,105
338723,154932,2012-02-14,Senate,"Reported Favorably Without Amendment",5,0,0,0,5
338723,164913,2012-02-29,Senate,"Senate Third Reading: Given Immediate Effect Roll Call # 102",36,1,0,1,38
338723,168553,2012-03-06,House,"House Third Reading: Senate Amendment(s) Concurred In Roll Call # 89",103,6,0,0,109
338724,103133,2011-11-01,House,"Reported With Recommendation With Substitute H-2",11,0,0,0,11
338724,103626,2011-11-29,House,"House Third Reading: Given Immediate Effect Roll Call # 490",93,12,0,0,105
338724,154963,2012-02-14,Senate,"Reported Favorably With Substitute S-1",4,1,0,0,5
338724,164959,2012-02-29,Senate,"Senate Third Reading: Given Immediate Effect Roll Call # 100",34,3,0,1,38
338724,168614,2012-03-06,House,"House Third Reading:  Roll Call # 87",95,14,0,0,109
338724,186397,2012-04-17,House,"House Third Reading:  Roll Call # 171",98,11,0,0,109
338724,186955,2012-04-18,Senate,"Senate Third Reading:  Roll Call # 202",35,3,0,0,38
338727,181009,2012-03-29,House,"Reported With Recommendation With Substitute H-7",13,1,0,0,14
338727,193035,2012-05-03,House,"House Third Reading: Given Immediate Effect Roll Call # 243",105,4,0,0,109
338727,211855,2012-09-11,Senate,"Reported Favorably With Substitute S-1",3,1,0,0,4
338727,215647,2012-12-13,Senate,"Senate Third Reading: Defeated Roll Call # 1037",28,10,0,0,38
338727,215648,2012-12-14,Senate,"Senate Third Reading: Given Immediate Effect Roll Call # 1094",29,9,0,0,38
338727,215820,2012-12-14,House,"House Third Reading:  Roll Call # 912",100,5,0,0,105
338732,103125,2011-11-01,House,"Reported With Recommendation With Substitute H-1",10,0,0,0,10
338732,103613,2011-11-29,House,"House Third Reading: Given Immediate Effect Roll Call # 494",98,7,0,0,105
338732,154618,2012-02-14,Senate,"Reported Favorably Without Amendment",5,0,0,0,5
338732,165640,2012-02-29,Senate,"Senate Third Reading: Given Immediate Effect Roll Call # 103",37,0,0,1,38
338732,168822,2012-03-06,House,"House Third Reading: Senate Amendment(s) Concurred In Roll Call # 90",101,8,0,0,109
338737,198412,2012-05-24,House,"Reported With Recommendation For Referral To Committee On Oversight, Reform, And Ethics",12,0,0,0,12
338741,102799,2011-10-06,House,"Reported With Recommendation With Substitute H-1",10,0,0,0,10
338741,146506,2012-01-26,House,"House Third Reading: Given Immediate Effect Roll Call # 15",106,0,0,0,106
338741,215349,2012-12-11,Senate,"Reported Favorably Without Amendment",3,0,0,0,3
338741,215738,2012-12-13,Senate,"Senate Third Reading: Given Immediate Effect Roll Call # 969",38,0,0,0,38
338744,181012,2012-03-29,House,"Reported With Recommendation With Substitute H-1",15,1,0,0,16
338744,193360,2012-05-03,House,"House Third Reading: Given Immediate Effect Roll Call # 244",100,9,0,0,109
338744,211881,2012-09-11,Senate,"Reported Favorably Without Amendment",4,0,0,0,4
338744,215661,2012-12-13,Senate,"Senate Third Reading: Given Immediate Effect Roll Call # 999",36,2,0,0,38
338744,215838,2012-12-14,House,"House Third Reading: Senate Amendment(s) Concurred In Roll Call # 894",101,5,0,0,106
338750,102350,2011-09-14,House,"Reported With Recommendation Without Amendment",16,0,0,0,16
338750,102557,2011-09-27,House,"House Third Reading: Given Immediate Effect Roll Call # 365",109,0,0,0,109
338750,180029,2012-03-28,Senate,"Reported Favorably Without Amendment",7,0,0,0,7
338750,180740,2012-03-29,Senate,"Senate Third Reading: Given Immediate Effect Roll Call # 194",38,0,0,0,38
339133,102337,2011-09-15,Senate,"Reported Favorably With Substitute S-2",4,0,0,0,4
339133,102365,2011-09-20,Senate,"Senate Third Reading: Passed Roll Call # 489",35,1,0,2,38
339133,103243,2011-11-02,House,"Reported With Recommendation With Substitute H-1",17,1,0,0,18
339133,103664,2011-11-30,House,"House Third Reading: Given Immediate Effect Roll Call # 516",96,10,0,0,106
339133,104837,2011-12-06,Senate,"Senate Third Reading:  Roll Call # 737",33,2,0,3,38
339135,102796,2011-10-05,Senate,"Reported Favorably Without Amendment",6,0,0,0,6
339135,102853,2011-10-13,Senate,"Senate Third Reading: Passed Roll Call # 576",26,9,0,3,38
339138,194679,2012-05-08,Senate,"Reported Favorably Without Amendment",6,0,0,0,6
339138,198021,2012-05-23,Senate,"Senate Third Reading: Passed Roll Call # 370",36,0,0,2,38
339138,201384,2012-06-06,House,"Reported With Recommendation Without Amendment",13,0,0,0,13
339138,202266,2012-06-13,House,"House Third Reading: Given Immediate Effect Roll Call # 430",108,1,0,0,109
339139,102338,2011-09-15,Senate,"Reported Favorably With Substitute S-2",4,0,0,0,4
339139,102366,2011-09-20,Senate,"Senate Third Reading: Passed Roll Call # 487",36,0,0,2,38
339139,103244,2011-11-02,House,"Reported With Recommendation Without Amendment",18,1,0,0,19
339139,103667,2011-11-30,House,"House Third Reading: Given Immediate Effect Roll Call # 514",96,10,0,0,106
339139,104850,2011-12-06,Senate,"Senate Third Reading:  Roll Call # 735",35,0,0,3,38
339145,103246,2011-11-03,Senate,"Reported Favorably With Substitute S-1",5,0,0,0,5
339145,103247,2011-11-03,Senate,"Senate Third Reading: Passed Roll Call # 644",34,4,0,0,38
339145,103792,2011-12-01,House,"Reported With Recommendation With Substitute H-1",16,1,0,0,17
339145,137024,2011-12-15,House,"House Third Reading: Given Immediate Effect Roll Call # 615",92,15,0,0,107
339145,137025,2011-12-15,Senate,"Senate Third Reading:  Roll Call # 841",35,3,0,0,38
339149,211988,2012-09-13,Senate,"Reported Favorably Without Amendment",15,0,0,0,15
339149,212085,2012-09-20,Senate,"Senate Third Reading: Passed Roll Call # 650",38,0,0,0,38
339149,213640,2012-11-08,House,"Reported With Recommendation Without Amendment",26,0,0,0,26
339149,214372,2012-11-29,House,"House Third Reading: Passed Roll Call # 648",108,0,0,0,108
339160,105293,2011-12-08,Senate,"Reported Favorably With Substitute S-1",7,1,0,0,8
339160,105294,2011-12-08,Senate,"Senate Third Reading: Passed Roll Call # 764",34,1,0,3,38
339160,138470,2011-12-14,House,"Reported With Recommendation Without Amendment",13,0,0,0,13
339160,138471,2011-12-14,House,"House Third Reading: Given Immediate Effect Roll Call # 595",103,5,0,0,108
339160,138472,2011-12-15,Senate,"Senate Third Reading:  Roll Call # 819",37,1,0,0,38
339162,102340,2011-09-15,Senate,"Reported Favorably With Substitute S-2",4,0,0,0,4
339162,102387,2011-09-20,Senate,"Senate Third Reading: Passed Roll Call # 488",35,1,0,2,38
339162,103245,2011-11-02,House,"Reported With Recommendation With Substitute H-1",16,1,0,0,17
339162,103670,2011-11-30,House,"House Third Reading: Given Immediate Effect Roll Call # 515",95,11,0,0,106
339162,104882,2011-12-06,Senate,"Senate Third Reading:  Roll Call # 736",34,1,0,3,38
339577,172887,2012-03-15,House,"Reported With Recommendation For Referral To Committee On Agriculture",12,0,0,0,12
339577,195263,2012-05-09,House,"Reported With Recommendation Without Amendment",10,6,0,0,16
339577,215099,2012-12-05,House,"House Third Reading: Passed Roll Call # 674",65,41,0,0,106
339586,195376,2012-05-09,House,"Reported With Recommendation With Substitute H-1",15,0,0,0,15
339586,198337,2012-05-23,House,"House Third Reading: Given Immediate Effect Roll Call # 287",106,2,0,0,108
339586,214322,2012-11-29,Senate,"Reported Favorably Without Amendment",6,0,0,0,6
339586,215471,2012-12-12,Senate,"Senate Third Reading: Given Immediate Effect Roll Call # 894",38,0,0,0,38
339588,157888,2012-02-16,House,"Reported With Recommendation With Substitute H-2",11,1,0,0,12
339588,201567,2012-06-07,House,"House Third Reading: Given Immediate Effect Roll Call # 375",71,37,0,0,108
339588,214411,2012-11-29,Senate,"Reported Favorably Without Amendment",10,3,0,0,13
339588,215477,2012-12-12,Senate,"Senate Third Reading: Given Immediate Effect Roll Call # 921",26,11,0,1,38
339588,215516,2012-12-13,House,"House Third Reading: Senate Amendment(s) Concurred In Roll Call # 831",78,31,0,0,109
339595,149081,2012-02-02,House,"Reported With Recommendation With Substitute H-2",14,0,0,0,14
339595,169235,2012-03-07,House,"House Third Reading: Given Immediate Effect Roll Call # 94",90,20,0,0,110
339602,172151,2012-03-13,House,"Reported With Recommendation For Referral To Committee On Commerce",10,0,0,0,10
339606,158012,2012-02-16,House,"Reported With Recommendation With Substitute H-2",12,1,0,0,13
339606,201488,2012-06-07,House,"House Third Reading: Given Immediate Effect Roll Call # 374",72,36,0,0,108
339606,214323,2012-11-29,Senate,"Reported Favorably With Substitute S-2",10,3,0,0,13
339606,215466,2012-12-12,Senate,"Senate Third Reading: Given Immediate Effect Roll Call # 920",25,12,0,1,38
339606,215597,2012-12-13,House,"House Third Reading:  Roll Call # 830",79,30,0,0,109
339608,105581,2011-12-08,House,"Reported With Recommendation With Substitute H-2",14,0,0,0,14
339608,105582,2011-12-08,House,"House Third Reading: Given Immediate Effect Roll Call # 565",107,0,0,0,107
339608,138713,2011-12-14,Senate,"Reported Favorably Without Amendment",9,0,0,0,9
339608,138714,2011-12-14,Senate,"Senate Third Reading: Given Immediate Effect Roll Call # 802",27,9,1,1,38
339608,138715,2011-12-14,Senate,"Senate Third Reading: Passed Roll Call # 815",29,9,0,0,38
339615,195221,2012-05-09,House,"Reported With Recommendation With Substitute H-1",15,0,0,0,15
339615,198149,2012-05-23,House,"House Third Reading: Given Immediate Effect Roll Call # 288",108,0,0,0,108
339624,172209,2012-03-13,House,"Reported With Recommendation For Referral To Committee On Agriculture",10,0,0,0,10
339625,172230,2012-03-13,House,"Reported With Recommendation For Referral To Committee On Commerce",10,0,0,0,10
339631,102675,2011-09-27,House,"Reported With Recommendation Without Amendment",7,2,0,0,9
339631,102829,2011-10-12,House,"House Third Reading: Given Immediate Effect Roll Call # 410",63,45,0,0,108
339631,102988,2011-10-25,Senate,"Reported Favorably Without Amendment",5,2,0,0,7
339631,103148,2011-11-01,Senate,"Senate Third Reading: Given Immediate Effect Roll Call # 613",25,13,0,0,38
340047,101863,2011-09-08,House,"Reported With Recommendation Without Amendment",15,0,0,0,15
340047,102572,2011-09-28,House,"House Third Reading: Given Immediate Effect Roll Call # 368",109,0,0,0,109
340047,102843,2011-10-12,Senate,"Reported Favorably Without Amendment",3,0,0,0,3
340047,103034,2011-10-27,Senate,"Senate Third Reading: Given Immediate Effect Roll Call # 610",38,0,0,0,38
340060,102466,2011-09-22,House,"Reported With Recommendation Without Amendment",15,0,0,0,15
340060,102713,2011-10-04,House,"House Third Reading: Given Immediate Effect Roll Call # 377",109,0,0,0,109
340060,102830,2011-10-12,Senate,"Reported Favorably With Substitute S-1",7,0,0,0,7
340060,102985,2011-10-25,Senate,"Senate Third Reading: Given Immediate Effect Roll Call # 590",35,0,0,3,38
340060,103031,2011-10-26,House,"House Third Reading:  Roll Call # 427",108,0,0,0,108
340065,102969,2011-10-19,Senate,"Reported Favorably With Substitute S-2",6,0,0,0,6
340065,105468,2011-12-07,Senate,"Senate Third Reading: Passed Roll Call # 740",36,0,0,2,38
340065,173003,2012-03-15,House,"Reported With Recommendation Without Amendment",16,0,0,0,16
340065,200711,2012-05-30,House,"Reported With Recommendation With Substitute H-1",17,0,0,0,17
340065,202298,2012-06-13,House,"House Third Reading: Given Immediate Effect Roll Call # 428",110,0,0,0,110
340065,202585,2012-06-14,Senate,"Senate Third Reading:  Roll Call # 554",38,0,0,0,38
340066,102197,2011-09-15,Senate,"Senate Third Reading: Passed Roll Call # 486",25,12,0,1,38
340066,102368,2011-09-20,House,"Reported With Recommendation Without Amendment",6,3,0,0,9
340066,102369,2011-09-20,House,"House Third Reading: Given Immediate Effect Roll Call # 340",63,45,0,0,108
340067,102690,2011-10-04,Senate,"Reported Favorably With Substitute S-1",4,0,0,0,4
340067,102990,2011-10-25,Senate,"Senate Third Reading: Passed Roll Call # 588",35,0,0,3,38
340070,201952,2012-06-12,Senate,"Reported Favorably Without Amendment",6,0,0,0,6
340070,202560,2012-06-14,Senate,"Senate Third Reading: Passed Roll Call # 545",38,0,0,0,38
340070,215227,2012-12-05,House,"Reported With Recommendation Without Amendment",12,0,0,0,12
340070,215584,2012-12-12,House,"House Third Reading: Given Immediate Effect Roll Call # 771",104,5,0,0,109
340070,215748,2012-12-13,Senate,"Senate Third Reading:  Roll Call # 1024",38,0,0,0,38
340074,103256,2011-11-01,Senate,"Reported Favorably With Recommendation For Referral To Committee On Finance",4,0,0,0,4
340075,102555,2011-09-27,Senate,"Reported Favorably With Substitute S-2",6,0,0,0,6
340076,103121,2011-11-01,Senate,"Reported Favorably With Recommendation For Referral To Committee On Finance",4,0,0,0,4
340249,102956,2011-10-20,Senate,"Reported Favorably With Substitute S-4",3,1,0,0,4
340249,103045,2011-10-27,Senate,"Senate Third Reading: Passed Roll Call # 596",26,12,0,0,38
340249,151484,2012-02-08,House,"Reported With Recommendation With Substitute H-2",13,1,0,0,14
340249,190702,2012-04-26,House,"House Third Reading: Given Immediate Effect Roll Call # 206",67,43,0,0,110
340249,192662,2012-05-02,Senate,"Senate Third Reading:  Roll Call # 275",26,11,0,1,38
340251,148116,2012-01-31,Senate,"Reported Favorably Without Amendment",7,0,0,0,7
340251,156318,2012-02-16,Senate,"Senate Third Reading: Passed Roll Call # 84",34,4,0,0,38
340252,105316,2011-12-08,Senate,"Reported Favorably With Substitute S-2",7,1,0,0,8
340252,215234,2012-12-06,Senate,"Senate Third Reading: Passed Roll Call # 831",27,10,1,0,38
340253,105322,2011-12-08,Senate,"Reported Favorably With Substitute S-2",7,1,0,0,8
340253,215235,2012-12-06,Senate,"Senate Third Reading: Passed Roll Call # 830",27,11,0,0,38
340255,102959,2011-10-20,Senate,"Reported Favorably With Substitute S-4",3,1,0,0,4
340255,103047,2011-10-27,Senate,"Senate Third Reading: Passed Roll Call # 597",26,12,0,0,38
340255,151504,2012-02-08,House,"Reported With Recommendation With Substitute H-2",13,1,0,0,14
340255,190351,2012-04-26,House,"House Third Reading: Given Immediate Effect Roll Call # 207",67,43,0,0,110
340255,192404,2012-05-02,Senate,"Senate Third Reading:  Roll Call # 276",26,11,0,1,38
340257,102961,2011-10-19,Senate,"Reported Favorably With Substitute S-1",4,0,0,0,4
340257,176212,2012-03-20,Senate,"Senate Third Reading: Passed Roll Call # 143",36,2,0,0,38
340257,215300,2012-12-06,House,"Reported With Recommendation With Amendment(s)",12,0,0,0,12
340258,102762,2011-10-06,Senate,"Reported Favorably With Substitute S-1",3,0,0,0,3
340258,103059,2011-10-27,Senate,"Senate Third Reading: Passed Roll Call # 605",20,18,0,0,38
340258,151665,2012-02-08,House,"Reported With Recommendation With Substitute H-3",10,8,0,0,18
340258,190539,2012-04-26,House,"House Third Reading: Passed Roll Call # 201",56,54,0,0,110
340258,191960,2012-05-01,House,"House Third Reading:  Roll Call # 211",57,52,0,0,109
340258,192663,2012-05-02,Senate,"Senate Third Reading:  Roll Call # 273",23,14,0,1,38
340261,102820,2011-10-11,Senate,"Reported Favorably With Recommendation For Referral To Committee On Families, Seniors And Human Services",6,0,0,0,6
340261,103114,2011-11-01,Senate,"Reported Favorably With Substitute S-1",4,0,0,0,4
340261,103208,2011-11-03,Senate,"Senate Third Reading: Passed By 2/3 Vote Roll Call # 640",38,0,0,0,38
340263,102748,2011-10-06,Senate,"Reported Favorably With Substitute S-1",3,0,0,0,3
340263,103060,2011-10-27,Senate,"Senate Third Reading: Passed Roll Call # 607",26,12,0,0,38
340263,151670,2012-02-08,House,"Reported With Recommendation With Substitute H-2",12,3,0,0,15
340263,190546,2012-04-26,House,"House Third Reading: Given Immediate Effect Roll Call # 203",60,50,0,0,110
340263,192675,2012-05-02,Senate,"Senate Third Reading:  Roll Call # 274",26,11,0,1,38
340264,145556,2012-01-25,Senate,"Reported Favorably With Substitute S-2",7,0,0,0,7
340265,105368,2011-12-08,Senate,"Reported Favorably With Substitute S-2",7,1,0,0,8
340265,215246,2012-12-06,Senate,"Senate Third Reading: Passed Roll Call # 832",28,10,0,0,38
340267,191740,2012-05-01,Senate,"Reported Favorably Without Amendment",5,0,0,0,5
340267,196830,2012-05-17,Senate,"Senate Third Reading: Passed Roll Call # 355",38,0,0,0,38
340268,102872,2011-10-13,Senate,"Reported Favorably With Substitute S-4",3,2,0,0,5
340268,201247,2012-06-06,Senate,"Senate Third Reading: Passed Roll Call # 440",20,18,0,0,38
340268,201248,2012-06-06,Senate,"Senate Third Reading: Passed Roll Call # 452",20,18,0,0,38
340268,215121,2012-12-05,House,"Reported With Recommendation With Substitute H-3",11,7,0,0,18
340272,101718,2011-09-07,Senate,"Senate Third Reading:  Roll Call # 474",37,0,0,1,38
340277,102888,2011-10-18,Senate,"Reported Favorably With Substitute S-1",6,0,0,0,6
340277,103134,2011-11-01,Senate,"Senate Third Reading: Passed Roll Call # 612",38,0,0,0,38
340277,176414,2012-03-21,House,"Reported With Recommendation Without Amendment",5,0,0,0,5
340277,186581,2012-04-17,House,"House Third Reading: Given Immediate Effect Roll Call # 172",109,0,0,0,109
340279,102801,2011-10-11,Senate,"Reported Favorably With Recommendation For Referral To Committee On Appropriations",7,0,0,0,7
340279,102851,2011-10-13,Senate,"Reported Favorably Without Amendment",15,0,0,0,15
340279,102918,2011-10-20,Senate,"Senate Third Reading: Passed Roll Call # 586",38,0,0,0,38
340279,151706,2012-02-08,House,"Reported With Recommendation Without Amendment",22,0,0,0,22
340279,165160,2012-02-29,House,"House Third Reading: Given Immediate Effect Roll Call # 82",106,0,0,0,106
340283,102804,2011-10-11,Senate,"Reported Favorably With Recommendation For Referral To Committee On Families, Seniors And Human Services",6,0,0,0,6
340283,103116,2011-11-01,Senate,"Reported Favorably With Substitute S-1",4,0,0,0,4
340283,103211,2011-11-03,Senate,"Senate Third Reading: Passed By 2/3 Vote Roll Call # 641",38,0,0,0,38
340285,147920,2012-01-31,Senate,"Reported Favorably Without Amendment",7,0,0,0,7
340285,156425,2012-02-16,Senate,"Senate Third Reading: Passed Roll Call # 83",38,0,0,0,38
340290,158968,2012-02-21,Senate,"Reported Favorably With Substitute S-3",6,0,0,0,6
340290,169760,2012-03-08,Senate,"Senate Third Reading: Passed Roll Call # 126",38,0,0,0,38
340290,189982,2012-04-25,House,"Reported With Recommendation With Substitute H-1",12,1,0,0,13
340290,207203,2012-07-18,House,"House Third Reading: Given Immediate Effect Roll Call # 501",79,31,0,0,110
340290,207204,2012-07-18,Senate,"Senate Third Reading:  Roll Call # 592",37,0,0,1,38
340291,102697,2011-10-04,Senate,"Reported Favorably With Substitute S-1",3,2,0,0,5
340291,102760,2011-10-06,Senate,"Senate Third Reading: Passed Roll Call # 564",20,18,0,0,38
340291,103680,2011-11-30,House,"Reported With Recommendation With Substitute H-4",11,7,0,0,18
340291,105739,2011-12-14,House,"House Third Reading: Passed Roll Call # 603",58,49,0,0,107
340291,138855,2011-12-15,Senate,"Senate Third Reading:  Roll Call # 824",22,16,0,0,38
340291,204039,2011-12-14,House,"House Third Reading:  Roll Call # 604",56,51,0,0,107
340293,103165,2011-11-01,House,"Reported With Recommendation With Substitute H-1",8,0,0,0,8
340293,103689,2011-11-30,House,"House Third Reading: Given Immediate Effect Roll Call # 504",105,1,0,0,106
340295,103162,2011-11-01,House,"Reported With Recommendation With Substitute H-1",8,0,0,0,8
340295,103675,2011-11-30,House,"House Third Reading: Given Immediate Effect Roll Call # 506",105,1,0,0,106
340300,102082,2011-09-13,House,"Reported With Recommendation Without Amendment",9,0,0,0,9
340300,102737,2011-10-05,House,"House Third Reading: Given Immediate Effect Roll Call # 380",109,0,0,0,109
340300,201223,2012-06-05,Senate,"Reported Favorably Without Amendment",6,0,0,0,6
340300,202079,2012-06-13,Senate,"Senate Third Reading: Given Immediate Effect Roll Call # 494",35,2,0,1,38
340302,102477,2011-09-22,House,"Reported With Recommendation With Substitute H-1",14,1,0,0,15
340302,102618,2011-09-28,House,"House Third Reading: Given Immediate Effect Roll Call # 373",91,18,0,0,109
340302,103264,2011-11-08,Senate,"Reported Favorably Without Amendment",8,0,0,0,8
340302,144006,2012-01-19,Senate,"Senate Third Reading: Given Immediate Effect Roll Call # 3",36,0,0,2,38
340306,103172,2011-11-01,House,"Reported With Recommendation With Substitute H-1",8,0,0,0,8
340306,103660,2011-11-30,House,"House Third Reading: Given Immediate Effect Roll Call # 505",105,1,0,0,106
340318,103176,2011-11-01,House,"Reported With Recommendation With Substitute H-1",8,0,0,0,8
340318,103807,2011-11-30,House,"House Third Reading: Given Immediate Effect Roll Call # 507",105,1,0,0,106
340330,103186,2011-11-01,House,"Reported With Recommendation With Substitute H-1",8,0,0,0,8
340330,103812,2011-11-30,House,"House Third Reading: Given Immediate Effect Roll Call # 503",105,1,0,0,106
340330,209754,2012-08-15,House,"House Third Reading: Passed Roll Call # 512",106,0,0,0,106
340350,146525,2012-01-26,Senate,"Reported Favorably Without Amendment",7,0,0,0,7
340350,154557,2012-02-14,Senate,"Senate Third Reading: Passed Roll Call # 62",38,0,0,0,38
340350,165474,2012-02-29,House,"Reported With Recommendation Without Amendment",16,0,0,0,16
340350,168798,2012-03-07,House,"House Third Reading: Given Immediate Effect Roll Call # 96",110,0,0,0,110
340354,102744,2011-10-05,Senate,"Reported Favorably With Substitute S-1",4,0,0,0,4
340354,145685,2012-01-25,Senate,"Senate Third Reading: Passed Roll Call # 14",38,0,0,0,38
340354,214376,2012-11-29,House,"Reported With Recommendation With Substitute H-2",15,0,0,0,15
340354,215446,2012-12-12,House,"House Third Reading: Passed Roll Call # 748",109,0,0,0,109
340354,215779,2012-12-13,Senate,"Senate Third Reading:  Roll Call # 1025",38,0,0,0,38
340357,102745,2011-10-05,Senate,"Reported Favorably With Substitute S-1",4,0,0,0,4
340357,145684,2012-01-25,Senate,"Senate Third Reading: Passed Roll Call # 16",38,0,0,0,38
340357,214379,2012-11-29,House,"Reported With Recommendation With Substitute H-1",15,0,0,0,15
340357,215608,2012-12-12,House,"House Third Reading: Passed Roll Call # 750",109,0,0,0,109
340357,215778,2012-12-13,Senate,"Senate Third Reading:  Roll Call # 1027",38,0,0,0,38
340367,102746,2011-10-05,Senate,"Reported Favorably With Substitute S-1",4,0,0,0,4
340367,145709,2012-01-25,Senate,"Senate Third Reading: Passed Roll Call # 15",38,0,0,0,38
340367,214377,2012-11-29,House,"Reported With Recommendation With Substitute H-1",15,0,0,0,15
340367,215607,2012-12-12,House,"House Third Reading: Passed Roll Call # 749",109,0,0,0,109
340367,215777,2012-12-13,Senate,"Senate Third Reading:  Roll Call # 1026",38,0,0,0,38
340368,102747,2011-10-05,Senate,"Reported Favorably With Substitute S-1",4,0,0,0,4
340368,145723,2012-01-25,Senate,"Senate Third Reading: Passed Roll Call # 17",38,0,0,0,38
340368,214383,2012-11-29,House,"Reported With Recommendation With Substitute H-1",15,0,0,0,15
340368,215609,2012-12-12,House,"House Third Reading: Passed Roll Call # 751",109,0,0,0,109
340368,215780,2012-12-13,Senate,"Senate Third Reading:  Roll Call # 1028",38,0,0,0,38
340370,102695,2011-10-04,Senate,"Reported Favorably With Substitute S-1",4,0,0,0,4
340370,102991,2011-10-25,Senate,"Senate Third Reading: Passed Roll Call # 589",35,0,0,3,38
340378,102455,2011-09-22,House,"Reported With Recommendation Without Amendment",16,0,0,0,16
340378,102822,2011-10-11,House,"House Third Reading: Given Immediate Effect Roll Call # 407",109,0,0,0,109
340378,103658,2011-11-30,Senate,"Reported Favorably Without Amendment",4,0,0,0,4
340378,147904,2012-01-31,Senate,"Senate Third Reading: Given Immediate Effect Roll Call # 28",38,0,0,0,38
340380,102460,2011-09-22,House,"Reported With Recommendation Without Amendment",16,0,0,0,16
340380,102806,2011-10-11,House,"House Third Reading: Given Immediate Effect Roll Call # 409",109,0,0,0,109
340380,103666,2011-11-30,Senate,"Reported Favorably Without Amendment",4,0,0,0,4
340380,147983,2012-01-31,Senate,"Senate Third Reading: Given Immediate Effect Roll Call # 30",38,0,0,0,38
340382,102064,2011-09-13,House,"Reported With Recommendation Without Amendment",4,2,0,0,6
340382,102192,2011-09-15,House,"House Third Reading: Given Immediate Effect Roll Call # 333",55,53,0,0,108
340382,169818,2012-03-07,Senate,"Reported Favorably With Substitute S-3",4,3,0,0,7
340382,169819,2012-03-07,Senate,"Senate Third Reading: Given Immediate Effect Roll Call # 119",20,18,0,0,38
340382,169820,2012-03-07,House,"House Third Reading:  Roll Call # 95",56,54,0,0,110
340384,102459,2011-09-22,House,"Reported With Recommendation Without Amendment",16,0,0,0,16
340384,102823,2011-10-11,House,"House Third Reading: Given Immediate Effect Roll Call # 405",109,0,0,0,109
340384,103659,2011-11-30,Senate,"Reported Favorably Without Amendment",4,0,0,0,4
340384,147900,2012-01-31,Senate,"Senate Third Reading: Given Immediate Effect Roll Call # 26",38,0,0,0,38
340387,102462,2011-09-22,House,"Reported With Recommendation Without Amendment",16,0,0,0,16
340387,102813,2011-10-11,House,"House Third Reading: Given Immediate Effect Roll Call # 408",109,0,0,0,109
340387,103810,2011-11-30,Senate,"Reported Favorably Without Amendment",4,0,0,0,4
340387,147990,2012-01-31,Senate,"Senate Third Reading: Given Immediate Effect Roll Call # 29",38,0,0,0,38
340388,102461,2011-09-22,House,"Reported With Recommendation Without Amendment",16,0,0,0,16
340388,102811,2011-10-11,House,"House Third Reading: Given Immediate Effect Roll Call # 406",109,0,0,0,109
340388,103808,2011-11-30,Senate,"Reported Favorably Without Amendment",4,0,0,0,4
340388,147931,2012-01-31,Senate,"Senate Third Reading: Given Immediate Effect Roll Call # 27",38,0,0,0,38
340395,187877,2012-04-19,House,"Reported With Recommendation Without Amendment",16,0,0,0,16
340395,192123,2012-05-01,House,"House Third Reading: Given Immediate Effect Roll Call # 213",108,1,0,0,109
340395,202646,2012-06-06,Senate,"Reported Favorably With Amendment(s)",4,0,0,0,4
340395,211914,2012-09-12,Senate,"Senate Third Reading: Given Immediate Effect Roll Call # 618",38,0,0,0,38
340395,212244,2012-09-27,House,"House Third Reading: Senate Amendment(s) Concurred In Roll Call # 548",107,1,0,0,108
340398,102196,2011-09-15,House,"Reported With Recommendation With Substitute H-1",17,3,0,0,20
340398,102428,2011-09-22,House,"House Third Reading: Given Immediate Effect Roll Call # 362",61,44,0,0,105
340398,102429,2011-09-22,House,"House Third Reading: Given Immediate Effect Roll Call # 363",63,44,0,0,107
340398,102602,2011-09-28,Senate,"Reported Favorably Without Amendment",11,3,0,0,14
340398,102603,2011-09-28,Senate,"Senate Third Reading: Given Immediate Effect Roll Call # 530",26,12,0,0,38
340400,102805,2011-10-11,House,"Reported With Recommendation Without Amendment",9,0,0,0,9
340403,189222,2012-04-24,House,"Reported With Recommendation With Substitute H-1",7,0,0,0,7
340403,192917,2012-05-02,House,"House Third Reading: Given Immediate Effect Roll Call # 220",84,26,0,0,110
340404,102095,2011-09-14,House,"Reported With Recommendation Without Amendment",17,4,0,0,21
340404,102431,2011-09-22,House,"House Third Reading: Given Immediate Effect Roll Call # 359",70,37,0,0,107
340404,102852,2011-10-13,Senate,"Reported Favorably Without Amendment",11,3,0,0,14
340404,102910,2011-10-19,Senate,"Senate Third Reading: Given Immediate Effect Roll Call # 581",27,11,0,0,38
340404,102989,2011-10-25,House,"House Third Reading: Senate Amendment(s) Concurred In Roll Call # 424",72,35,0,0,107
340507,102109,2011-09-14,House,"Reported With Recommendation Without Amendment",10,0,0,0,10
340508,102114,2011-09-14,House,"Reported With Recommendation Without Amendment",10,0,0,0,10
340508,102399,2011-09-21,House,"House Third Reading: Given Immediate Effect Roll Call # 350",68,40,0,0,108
340508,102573,2011-09-28,Senate,"Senate Third Reading: Given Immediate Effect Roll Call # 522",26,12,0,0,38
340509,102115,2011-09-14,House,"Reported With Recommendation Without Amendment",10,0,0,0,10
340509,102396,2011-09-21,House,"House Third Reading: Given Immediate Effect Roll Call # 344",63,45,0,0,108
340510,102119,2011-09-14,House,"Reported With Recommendation Without Amendment",10,0,0,0,10
340510,102394,2011-09-21,House,"House Third Reading: Given Immediate Effect Roll Call # 354",68,40,0,0,108
340510,102571,2011-09-28,Senate,"Senate Third Reading: Given Immediate Effect Roll Call # 526",26,12,0,0,38
340511,102110,2011-09-14,House,"Reported With Recommendation Without Amendment",10,0,0,0,10
340512,102118,2011-09-14,House,"Reported With Recommendation Without Amendment",10,0,0,0,10
340514,102121,2011-09-14,House,"Reported With Recommendation Without Amendment",10,0,0,0,10
340515,102123,2011-09-14,House,"Reported With Recommendation Without Amendment",10,0,0,0,10
340515,102400,2011-09-21,House,"House Third Reading: Given Immediate Effect Roll Call # 343",64,44,0,0,108
340517,102120,2011-09-14,House,"Reported With Recommendation Without Amendment",10,0,0,0,10
340517,102398,2011-09-21,House,"House Third Reading: Given Immediate Effect Roll Call # 352",64,44,0,0,108
340517,102578,2011-09-28,Senate,"Senate Third Reading: Given Immediate Effect Roll Call # 524",26,12,0,0,38
340520,102124,2011-09-14,House,"Reported With Recommendation Without Amendment",10,0,0,0,10
340520,102401,2011-09-21,House,"House Third Reading: Given Immediate Effect Roll Call # 346",62,46,0,0,108
340520,102784,2011-10-06,Senate,"Senate Third Reading: Given Immediate Effect Roll Call # 556",26,12,0,0,38
340520,102891,2011-10-18,House,"House Third Reading: Senate Amendment(s) Concurred In Roll Call # 419",63,45,0,0,108
340521,102125,2011-09-14,House,"Reported With Recommendation Without Amendment",10,0,0,0,10
340521,102402,2011-09-21,House,"House Third Reading: Given Immediate Effect Roll Call # 348",63,45,0,0,108
340521,102582,2011-09-28,Senate,"Senate Third Reading: Given Immediate Effect Roll Call # 520",26,12,0,0,38
340522,102127,2011-09-14,House,"Reported With Recommendation Without Amendment",10,0,0,0,10
340522,105326,2011-12-08,House,"House Third Reading: Given Immediate Effect Roll Call # 557",67,41,0,0,108
340522,138554,2011-12-15,Senate,"Reported Favorably Without Amendment",6,0,0,0,6
340522,138555,2011-12-15,Senate,"Senate Third Reading: Given Immediate Effect Roll Call # 827",38,0,0,0,38
340525,102126,2011-09-14,House,"Reported With Recommendation Without Amendment",10,0,0,0,10
340526,102689,2011-10-04,Senate,"Reported Favorably Without Amendment",7,0,0,0,7
340526,102757,2011-10-06,Senate,"Senate Third Reading: Passed Roll Call # 555",35,3,0,0,38
340526,103191,2011-11-02,House,"Reported With Recommendation Without Amendment",18,1,0,0,19
340526,103686,2011-11-30,House,"House Third Reading: Given Immediate Effect Roll Call # 517",96,10,0,0,106
340527,102128,2011-09-14,House,"Reported With Recommendation Without Amendment",10,0,0,0,10
340527,105331,2011-12-07,House,"Reported With Recommendation With Substitute H-1",10,0,0,0,10
340527,105332,2011-12-08,House,"House Third Reading: Given Immediate Effect Roll Call # 556",66,42,0,0,108
340527,138560,2011-12-15,Senate,"Reported Favorably Without Amendment",6,0,0,0,6
340527,138561,2011-12-15,Senate,"Senate Third Reading: Given Immediate Effect Roll Call # 826",38,0,0,0,38
340528,102129,2011-09-14,House,"Reported With Recommendation Without Amendment",10,0,0,0,10
340528,102403,2011-09-21,House,"House Third Reading: Given Immediate Effect Roll Call # 351",63,45,0,0,108
340528,102586,2011-09-28,Senate,"Senate Third Reading: Given Immediate Effect Roll Call # 523",26,12,0,0,38
340529,102132,2011-09-14,House,"Reported With Recommendation Without Amendment",10,0,0,0,10
340529,102405,2011-09-21,House,"House Third Reading: Given Immediate Effect Roll Call # 349",68,40,0,0,108
340529,102583,2011-09-28,Senate,"Senate Third Reading: Given Immediate Effect Roll Call # 521",26,12,0,0,38
340530,201584,2012-06-06,House,"Reported With Recommendation With Substitute H-2",14,1,0,0,15
340530,211895,2012-09-12,House,"House Third Reading: Given Immediate Effect Roll Call # 517",103,5,0,0,108
340530,212111,2012-09-20,Senate,"Senate Third Reading: Given Immediate Effect Roll Call # 651",36,2,0,0,38
340531,102130,2011-09-14,House,"Reported With Recommendation Without Amendment",10,0,0,0,10
340531,102404,2011-09-21,House,"House Third Reading: Given Immediate Effect Roll Call # 357",69,39,0,0,108
340531,102585,2011-09-28,Senate,"Senate Third Reading: Given Immediate Effect Roll Call # 528",26,12,0,0,38
340532,102131,2011-09-14,House,"Reported With Recommendation Without Amendment",10,0,0,0,10
340534,102133,2011-09-14,House,"Reported With Recommendation Without Amendment",10,0,0,0,10
340535,102135,2011-09-14,House,"Reported With Recommendation Without Amendment",10,0,0,0,10
340536,102844,2011-10-13,House,"Reported With Recommendation With Substitute H-2",9,8,0,0,17
340537,102134,2011-09-14,House,"Reported With Recommendation Without Amendment",10,0,0,0,10
340538,102138,2011-09-14,House,"Reported With Recommendation Without Amendment",10,0,0,0,10
340538,102407,2011-09-21,House,"House Third Reading: Given Immediate Effect Roll Call # 347",77,31,0,0,108
340538,102587,2011-09-28,Senate,"Senate Third Reading: Given Immediate Effect Roll Call # 519",26,12,0,0,38
340540,102137,2011-09-14,House,"Reported With Recommendation Without Amendment",10,0,0,0,10
340542,103772,2011-09-20,House,"Reported With Recommendation Without Amendment",10,0,0,0,10
340543,102136,2011-09-14,House,"Reported With Recommendation Without Amendment",10,0,0,0,10
340543,102406,2011-09-21,House,"House Third Reading: Given Immediate Effect Roll Call # 358",66,42,0,0,108
340543,102584,2011-09-28,Senate,"Senate Third Reading: Given Immediate Effect Roll Call # 529",26,12,0,0,38
340543,102739,2011-10-05,House,"House Third Reading:  Roll Call # 378",66,43,0,0,109
340544,103448,2011-11-10,Senate,"Reported Favorably With Substitute S-1",6,0,0,0,6
340544,103449,2011-11-10,Senate,"Senate Third Reading: Passed Roll Call # 689",31,5,0,2,38
340544,201551,2012-06-06,House,"Reported With Recommendation With Substitute H-1",13,2,0,0,15
340544,211917,2012-09-12,House,"House Third Reading: Passed Roll Call # 518",102,6,0,0,108
340544,212143,2012-09-20,Senate,"Senate Third Reading:  Roll Call # 638",32,6,0,0,38
340545,102141,2011-09-14,House,"Reported With Recommendation Without Amendment",10,0,0,0,10
340546,102140,2011-09-14,House,"Reported With Recommendation Without Amendment",10,0,0,0,10
340547,102409,2011-09-21,Senate,"Reported Favorably With Substitute S-1",4,0,0,0,4
340547,102902,2011-10-19,Senate,"Senate Third Reading: Passed Roll Call # 580",38,0,0,0,38
340549,103450,2011-11-10,Senate,"Reported Favorably Without Amendment",6,0,0,0,6
340549,103451,2011-11-10,Senate,"Senate Third Reading: Passed Roll Call # 680",36,0,0,2,38
340549,196887,2012-05-16,House,"Reported With Recommendation With Substitute H-2",4,0,0,0,4
340549,200045,2012-05-30,House,"House Third Reading: Given Immediate Effect Roll Call # 314",107,2,0,0,109
340549,200547,2012-05-31,Senate,"Senate Third Reading:  Roll Call # 410",36,0,0,2,38
340550,102144,2011-09-14,House,"Reported With Recommendation Without Amendment",10,0,0,0,10
340550,102408,2011-09-21,House,"House Third Reading: Given Immediate Effect Roll Call # 356",66,42,0,0,108
340550,102589,2011-09-28,Senate,"Senate Third Reading: Given Immediate Effect Roll Call # 543",27,11,0,0,38
340551,102145,2011-09-14,House,"Reported With Recommendation Without Amendment",10,0,0,0,10
340552,102146,2011-09-14,House,"Reported With Recommendation Without Amendment",10,0,0,0,10
340552,102382,2011-09-21,House,"House Third Reading: Given Immediate Effect Roll Call # 353",63,45,0,0,108
340552,102591,2011-09-28,Senate,"Senate Third Reading: Given Immediate Effect Roll Call # 525",26,12,0,0,38
340553,102147,2011-09-14,House,"Reported With Recommendation Without Amendment",10,0,0,0,10
340553,102410,2011-09-21,House,"House Third Reading: Given Immediate Effect Roll Call # 345",63,45,0,0,108
340553,102593,2011-09-28,Senate,"Senate Third Reading: Given Immediate Effect Roll Call # 538",26,12,0,0,38
340553,102730,2011-10-05,House,"House Third Reading: Senate Amendment(s) Concurred In Roll Call # 379",63,46,0,0,109
340554,102383,2011-09-21,Senate,"Reported Favorably With Substitute S-1",4,0,0,0,4
340554,102904,2011-10-19,Senate,"Senate Third Reading: Passed Roll Call # 579",38,0,0,0,38
340555,102148,2011-09-14,House,"Reported With Recommendation Without Amendment",10,0,0,0,10
340555,102384,2011-09-21,House,"House Third Reading: Given Immediate Effect Roll Call # 355",66,42,0,0,108
340555,102590,2011-09-28,Senate,"Senate Third Reading: Given Immediate Effect Roll Call # 527",26,12,0,0,38
340559,102980,2011-10-20,House,"Reported With Recommendation Without Amendment",14,0,0,0,14
340559,105564,2011-12-08,House,"House Third Reading: Passed Roll Call # 568",102,5,0,0,107
340559,138700,2011-12-14,Senate,"Reported Favorably Without Amendment",9,0,0,0,9
340559,138701,2011-12-14,Senate,"Senate Third Reading: Given Immediate Effect Roll Call # 805",30,7,0,1,38
340559,138702,2011-12-14,Senate,"Senate Third Reading: Passed Roll Call # 816",31,7,0,0,38
340560,102149,2011-09-14,House,"Reported With Recommendation Without Amendment",10,0,0,0,10
340560,105441,2011-12-07,House,"Reported With Recommendation With Substitute H-1",10,0,0,0,10
340560,105442,2011-12-08,House,"House Third Reading: Given Immediate Effect Roll Call # 558",66,42,0,0,108
340560,138622,2011-12-15,Senate,"Reported Favorably Without Amendment",6,0,0,0,6
340560,138623,2011-12-15,Senate,"Senate Third Reading: Given Immediate Effect Roll Call # 828",38,0,0,0,38
340579,103255,2011-11-03,Senate,"Reported Favorably Without Amendment",4,0,0,0,4
340579,105233,2011-12-08,Senate,"Senate Third Reading: Passed Roll Call # 761",35,0,0,3,38
340579,214197,2012-11-29,House,"Reported With Recommendation With Substitute H-2",12,0,0,0,12
340579,215544,2012-12-12,House,"House Third Reading: Passed Roll Call # 752",109,0,0,0,109
340579,215705,2012-12-13,Senate,"Senate Third Reading:  Roll Call # 1029",38,0,0,0,38
340584,164499,2012-02-28,Senate,"Reported Favorably With Substitute S-2",7,0,0,0,7
340597,102763,2011-10-05,House,"Reported With Recommendation For Referral To Committee On Banking And Financial Services",9,0,0,0,9
340597,176422,2012-03-21,House,"Reported With Recommendation With Substitute H-2",9,0,0,0,9
340597,180644,2012-03-29,House,"House Third Reading: Passed Roll Call # 156",105,5,0,0,110
340597,202003,2012-06-12,Senate,"Reported Favorably With Substitute S-1",5,0,0,0,5
340597,215710,2012-12-13,Senate,"Senate Third Reading: Given Immediate Effect Roll Call # 939",38,0,0,0,38
340597,215711,2012-12-13,House,"House Third Reading:  Roll Call # 846",105,4,0,0,109
340598,155779,2012-02-14,House,"Reported With Recommendation With Substitute H-1",10,0,0,0,10
340598,160247,2012-02-22,House,"House Third Reading: Given Immediate Effect Roll Call # 71",106,2,0,0,108
340598,215336,2012-12-11,Senate,"Reported Favorably With Substitute S-22",6,0,0,0,6
340598,229713,2012-12-11,Senate,"Reported Favorably With Substitute S-2",6,0,0,0,6
340606,102390,2011-09-21,House,"Reported With Recommendation Without Amendment",15,0,0,0,15
340606,102425,2011-09-22,House,"House Third Reading: Given Immediate Effect Roll Call # 364",107,0,0,0,107
340606,180252,2012-03-28,Senate,"Reported Favorably Without Amendment",7,0,0,0,7
340606,186843,2012-04-18,Senate,"Senate Third Reading: Given Immediate Effect Roll Call # 204",38,0,0,0,38
340609,105612,2011-12-07,House,"Reported With Recommendation With Substitute H-1",16,0,0,0,16
340609,144022,2012-01-19,House,"House Third Reading: Given Immediate Effect Roll Call # 2",106,0,0,0,106
340609,151165,2012-02-08,Senate,"Reported Favorably Without Amendment",7,0,0,0,7
340609,155051,2012-02-15,Senate,"Senate Third Reading: Given Immediate Effect Roll Call # 82",38,0,0,0,38
340609,158367,2012-02-21,House,"House Third Reading: Senate Amendment(s) Concurred In Roll Call # 64",106,0,0,0,106
340609,169934,2012-03-08,Senate,"Senate Third Reading: Passed Roll Call # 125",38,0,0,0,38
340609,169935,2012-03-08,House,"House Third Reading:  Roll Call # 100",110,0,0,0,110
340616,155862,2012-02-14,House,"Reported With Recommendation With Substitute H-3",9,0,0,0,9
340616,160304,2012-02-22,House,"House Third Reading: Given Immediate Effect Roll Call # 70",106,2,0,0,108
340616,215337,2012-12-11,Senate,"Reported Favorably With Substitute S-2",6,0,0,0,6
340642,102430,2011-09-22,Senate,"Reported Favorably Without Amendment",5,2,0,0,7
340642,102601,2011-09-28,Senate,"Senate Third Reading: Passed Roll Call # 509",26,12,0,0,38
340642,102764,2011-10-05,House,"Reported With Recommendation Without Amendment",10,0,0,0,10
340642,102765,2011-10-06,House,"House Third Reading: Given Immediate Effect Roll Call # 393",63,45,0,0,108
340644,102432,2011-09-22,Senate,"Reported Favorably Without Amendment",5,2,0,0,7
340644,103635,2011-11-29,Senate,"Reported Favorably With Substitute S-1",7,0,0,0,7
340644,103643,2011-11-30,Senate,"Senate Third Reading: Passed Roll Call # 716",38,0,0,0,38
340644,105638,2011-12-07,House,"Reported With Recommendation Without Amendment",10,0,0,0,10
340644,105639,2011-12-14,House,"House Third Reading: Given Immediate Effect Roll Call # 587",66,40,0,0,106
340646,102435,2011-09-22,Senate,"Reported Favorably Without Amendment",5,2,0,0,7
340646,102605,2011-09-28,Senate,"Senate Third Reading: Passed Roll Call # 515",26,12,0,0,38
340646,102768,2011-10-05,House,"Reported With Recommendation Without Amendment",10,0,0,0,10
340646,102769,2011-10-06,House,"House Third Reading: Given Immediate Effect Roll Call # 400",63,45,0,0,108
340647,102433,2011-09-22,Senate,"Reported Favorably Without Amendment",5,2,0,0,7
340649,102436,2011-09-22,Senate,"Reported Favorably Without Amendment",5,2,0,0,7
340650,102438,2011-09-22,Senate,"Reported Favorably Without Amendment",5,2,0,0,7
340651,102439,2011-09-22,Senate,"Reported Favorably Without Amendment",5,2,0,0,7
340651,102611,2011-09-28,Senate,"Senate Third Reading: Passed Roll Call # 517",26,12,0,0,38
340651,102766,2011-10-05,House,"Reported With Recommendation Without Amendment",10,0,0,0,10
340651,102767,2011-10-06,House,"House Third Reading: Given Immediate Effect Roll Call # 402",63,45,0,0,108
340652,102440,2011-09-22,Senate,"Reported Favorably Without Amendment",5,2,0,0,7
340652,102610,2011-09-28,Senate,"Senate Third Reading: Passed Roll Call # 540",26,12,0,0,38
340652,102734,2011-10-05,House,"Reported With Recommendation Without Amendment",10,1,0,0,11
340652,102756,2011-10-06,House,"House Third Reading: Given Immediate Effect Roll Call # 398",63,45,0,0,108
340653,102442,2011-09-22,Senate,"Reported Favorably Without Amendment",5,2,0,0,7
340653,103620,2011-11-29,Senate,"Reported Favorably With Substitute S-1",7,0,0,0,7
340653,103676,2011-11-30,Senate,"Senate Third Reading: Passed Roll Call # 717",38,0,0,0,38
340653,104917,2011-12-07,House,"Reported With Recommendation Without Amendment",9,0,0,0,9
340653,105725,2011-12-14,House,"House Third Reading: Given Immediate Effect Roll Call # 588",67,39,0,0,106
340654,102441,2011-09-22,Senate,"Reported Favorably Without Amendment",5,2,0,0,7
340654,102612,2011-09-28,Senate,"Senate Third Reading: Passed Roll Call # 511",26,12,0,0,38
340654,102770,2011-10-05,House,"Reported With Recommendation Without Amendment",10,0,0,0,10
340654,102771,2011-10-06,House,"House Third Reading: Given Immediate Effect Roll Call # 395",64,44,0,0,108
340655,102444,2011-09-22,Senate,"Reported Favorably Without Amendment",5,2,0,0,7
340657,102443,2011-09-22,Senate,"Reported Favorably Without Amendment",5,2,0,0,7
340657,103618,2011-11-29,Senate,"Reported Favorably With Substitute S-1",7,0,0,0,7
340657,103671,2011-11-30,Senate,"Senate Third Reading: Passed Roll Call # 715",38,0,0,0,38
340657,104883,2011-12-07,House,"Reported With Recommendation Without Amendment",9,0,0,0,9
340657,105701,2011-12-14,House,"House Third Reading: Given Immediate Effect Roll Call # 586",67,39,0,0,106
340658,102447,2011-09-22,Senate,"Reported Favorably Without Amendment",5,2,0,0,7
340659,102445,2011-09-22,Senate,"Reported Favorably Without Amendment",5,2,0,0,7
340660,102448,2011-09-22,Senate,"Reported Favorably Without Amendment",5,2,0,0,7
340661,102446,2011-09-22,Senate,"Reported Favorably Without Amendment",5,2,0,0,7
340661,102613,2011-09-28,Senate,"Senate Third Reading: Passed Roll Call # 510",26,12,0,0,38
340661,102774,2011-10-05,House,"Reported With Recommendation Without Amendment",10,0,0,0,10
340661,102775,2011-10-06,House,"House Third Reading: Given Immediate Effect Roll Call # 394",64,44,0,0,108
340662,102454,2011-09-22,Senate,"Reported Favorably Without Amendment",5,2,0,0,7
340663,102450,2011-09-22,Senate,"Reported Favorably Without Amendment",5,2,0,0,7
340663,102614,2011-09-28,Senate,"Senate Third Reading: Passed Roll Call # 508",26,12,0,0,38
340663,102778,2011-10-05,House,"Reported With Recommendation Without Amendment",10,0,0,0,10
340663,102779,2011-10-06,House,"House Third Reading: Given Immediate Effect Roll Call # 392",63,45,0,0,108
340664,102453,2011-09-22,Senate,"Reported Favorably Without Amendment",5,2,0,0,7
340664,102616,2011-09-28,Senate,"Senate Third Reading: Passed Roll Call # 514",26,12,0,0,38
340664,102776,2011-10-05,House,"Reported With Recommendation Without Amendment",10,0,0,0,10
340664,102777,2011-10-06,House,"House Third Reading: Given Immediate Effect Roll Call # 399",63,45,0,0,108
340665,102449,2011-09-22,Senate,"Reported Favorably Without Amendment",5,2,0,0,7
340666,102451,2011-09-22,Senate,"Reported Favorably Without Amendment",5,2,0,0,7
340666,102615,2011-09-28,Senate,"Senate Third Reading: Passed Roll Call # 518",26,12,0,0,38
340666,102772,2011-10-05,House,"Reported With Recommendation Without Amendment",10,0,0,0,10
340666,102773,2011-10-06,House,"House Third Reading: Given Immediate Effect Roll Call # 403",72,36,0,0,108
340667,102457,2011-09-22,Senate,"Reported Favorably Without Amendment",5,2,0,0,7
340667,102458,2011-09-22,Senate,"Reported Favorably Without Amendment",5,2,0,0,7
340668,102452,2011-09-22,Senate,"Reported Favorably Without Amendment",5,2,0,0,7
340669,102456,2011-09-22,Senate,"Reported Favorably Without Amendment",5,2,0,0,7
340671,102417,2011-09-22,Senate,"Reported Favorably Without Amendment",5,2,0,0,7
340671,103622,2011-11-29,Senate,"Reported Favorably With Substitute S-1",7,0,0,0,7
340671,103677,2011-11-30,Senate,"Senate Third Reading: Passed Roll Call # 714",38,0,0,0,38
340671,104928,2011-12-07,House,"Reported With Recommendation Without Amendment",9,0,0,0,9
340671,105727,2011-12-14,House,"House Third Reading: Given Immediate Effect Roll Call # 585",66,40,0,0,106
340672,102419,2011-09-22,Senate,"Reported Favorably Without Amendment",5,2,0,0,7
340672,102619,2011-09-28,Senate,"Senate Third Reading: Passed Roll Call # 512",26,12,0,0,38
340672,102782,2011-10-05,House,"Reported With Recommendation Without Amendment",10,0,0,0,10
340672,102783,2011-10-06,House,"House Third Reading: Given Immediate Effect Roll Call # 396",63,45,0,0,108
340674,102418,2011-09-22,Senate,"Reported Favorably Without Amendment",5,2,0,0,7
340675,102421,2011-09-22,Senate,"Reported Favorably Without Amendment",5,2,0,0,7
340677,102424,2011-09-22,Senate,"Reported Favorably Without Amendment",5,2,0,0,7
340677,102623,2011-09-28,Senate,"Senate Third Reading: Passed Roll Call # 516",26,12,0,0,38
340677,102735,2011-10-05,House,"Reported With Recommendation Without Amendment",10,0,0,0,10
340677,102761,2011-10-06,House,"House Third Reading: Given Immediate Effect Roll Call # 401",67,41,0,0,108
340678,102423,2011-09-22,Senate,"Reported Favorably Without Amendment",5,2,0,0,7
340679,102422,2011-09-22,Senate,"Reported Favorably Without Amendment",5,2,0,0,7
340680,102420,2011-09-22,Senate,"Reported Favorably Without Amendment",5,2,0,0,7
340680,102620,2011-09-28,Senate,"Senate Third Reading: Passed Roll Call # 513",26,12,0,0,38
340680,102780,2011-10-05,House,"Reported With Recommendation Without Amendment",10,0,0,0,10
340680,102781,2011-10-06,House,"House Third Reading: Given Immediate Effect Roll Call # 397",81,27,0,0,108
340688,211929,2012-09-12,House,"Reported With Recommendation With Substitute H-1",17,0,0,0,17
341126,102845,2011-10-13,Senate,"Reported Favorably With Substitute S-1",3,0,0,0,3
341126,103053,2011-10-27,Senate,"Senate Third Reading: Passed Roll Call # 611",38,0,0,0,38
341126,213667,2012-11-08,House,"Reported With Recommendation With Substitute H-1",10,0,0,0,10
341126,214421,2012-11-29,House,"House Third Reading: Passed Roll Call # 636",105,3,0,0,108
341126,215067,2012-12-05,Senate,"Senate Third Reading: House Amendment(s) Concurred In Roll Call # 806",36,0,1,1,38
341126,215148,2012-12-05,Senate,"Senate Third Reading:  Roll Call # 806",36,0,1,1,38
341143,103799,2011-11-29,Senate,"Reported Favorably With Substitute S-1",6,0,0,0,6
341143,143763,2012-01-19,Senate,"Senate Third Reading: Passed Roll Call # 4",35,1,0,2,38
341143,147832,2012-01-31,House,"Reported With Recommendation For Referral To Committee On Agriculture",10,0,0,0,10
341143,169568,2012-03-08,House,"Reported With Recommendation With Substitute H-1",16,0,0,0,16
341143,173009,2012-03-15,House,"House Third Reading: Given Immediate Effect Roll Call # 122",107,0,0,0,107
341143,175920,2012-03-20,Senate,"Senate Third Reading:  Roll Call # 142",37,1,0,0,38
341173,153744,2012-02-09,Senate,"Reported Favorably With Substitute S-1",16,0,0,0,16
341173,158930,2012-02-21,Senate,"Senate Third Reading: Passed Roll Call # 89",36,0,0,2,38
341173,165810,2012-02-29,House,"Reported With Recommendation With Substitute H-2",25,0,0,0,25
341173,171686,2012-03-13,House,"House Third Reading: Given Immediate Effect Roll Call # 111",109,0,0,0,109
341173,172376,2012-03-14,Senate,"Senate Third Reading:  Roll Call # 133",38,0,0,0,38
341175,102825,2011-10-12,Senate,"Reported Favorably Without Amendment",3,0,0,0,3
341175,103036,2011-10-27,Senate,"Senate Third Reading: Passed Roll Call # 608",38,0,0,0,38
341175,213660,2012-11-08,House,"Reported With Recommendation With Amendment(s)",10,0,0,0,10
341175,214352,2012-11-29,House,"House Third Reading: Passed Roll Call # 635",105,3,0,0,108
341175,215129,2012-12-05,Senate,"Senate Third Reading:  Roll Call # 805",36,0,2,0,38
341199,102839,2011-10-11,House,"Reported With Recommendation Without Amendment",8,1,0,0,9
341199,102921,2011-10-20,House,"House Third Reading: Given Immediate Effect Roll Call # 423",70,37,0,0,107
341199,154477,2012-02-14,Senate,"Reported Favorably With Substitute S-1",5,1,0,0,6
341199,159806,2012-02-22,Senate,"Senate Third Reading: Given Immediate Effect Roll Call # 93",26,12,0,0,38
341199,164475,2012-02-28,House,"House Third Reading:  Roll Call # 74",64,41,0,0,105
341200,103632,2011-11-29,House,"Reported With Recommendation Without Amendment",5,2,0,0,7
341200,104978,2011-12-07,House,"House Third Reading: Given Immediate Effect Roll Call # 527",76,32,0,0,108
341200,194599,2012-05-08,Senate,"Reported Favorably With Substitute S-2",3,1,0,0,4
341200,194600,2012-05-08,Senate,"Senate Third Reading: Given Immediate Effect Roll Call # 310",26,11,0,1,38
341200,195396,2012-05-10,House,"House Third Reading:  Roll Call # 254",64,43,0,0,107
341206,102754,2011-10-05,House,"Reported With Recommendation With Substitute H-1",16,0,0,0,16
341206,102755,2011-10-06,House,"House Third Reading: Given Immediate Effect Roll Call # 390",108,0,0,0,108
341206,105255,2011-12-08,Senate,"Reported Favorably Without Amendment",7,1,0,0,8
341206,137301,2011-12-13,Senate,"Senate Third Reading: Given Immediate Effect Roll Call # 771",38,0,0,0,38
341207,201598,2012-06-07,House,"Reported With Recommendation With Substitute H-1",11,3,0,0,14
341210,102597,2011-09-28,House,"Reported With Recommendation Without Amendment",14,0,0,0,14
341210,102841,2011-10-12,House,"House Third Reading: Given Immediate Effect Roll Call # 411",109,0,0,0,109
341264,102842,2011-10-13,Senate,"Reported Favorably With Substitute S-1",11,1,0,0,12
341264,102924,2011-10-20,Senate,"Senate Third Reading: Passed Roll Call # 587",38,0,0,0,38
341264,105555,2011-12-07,House,"Reported With Recommendation With Substitute H-2",17,7,0,0,24
341264,105556,2011-12-13,House,"House Third Reading: Given Immediate Effect Roll Call # 576",63,45,0,0,108
341264,138696,2011-12-14,Senate,"Senate Third Reading:  Roll Call # 782",33,5,0,0,38
341289,197074,2012-05-16,House,"Reported With Recommendation Without Amendment",12,0,0,0,12
341302,212360,2012-09-27,House,"Reported With Recommendation Without Amendment",12,3,0,0,15
341302,213783,2012-11-28,House,"House Third Reading: Passed Roll Call # 619",76,32,0,0,108
341357,103043,2011-10-26,House,"Reported With Recommendation With Substitute H-2",11,7,0,0,18
341357,103175,2011-11-02,House,"House Third Reading: Given Immediate Effect Roll Call # 445",59,49,0,0,108
341357,105253,2011-12-07,Senate,"Reported Favorably With Substitute S-2",3,0,0,0,3
341357,105254,2011-12-07,Senate,"Senate Third Reading: Given Immediate Effect Roll Call # 760",26,10,0,2,38
341357,137040,2011-12-13,House,"House Third Reading:  Roll Call # 580",60,47,0,0,107
341358,103388,2011-11-10,Senate,"Reported Favorably With Substitute S-2",6,0,0,0,6
341358,103389,2011-11-10,Senate,"Senate Third Reading: Passed Roll Call # 663",25,12,0,1,38
341522,103502,2011-11-09,House,"Reported With Recommendation With Substitute H-2",11,3,0,0,14
341522,104746,2011-12-06,House,"House Third Reading: Given Immediate Effect Roll Call # 523",58,46,0,0,104
341522,202058,2012-06-13,Senate,"Reported Favorably With Substitute S-2",4,0,0,0,4
341522,202405,2012-06-14,Senate,"Senate Third Reading: Given Immediate Effect Roll Call # 540",36,2,0,0,38
341522,207212,2012-07-18,House,"House Third Reading:  Roll Call # 498",62,47,0,0,109
341522,207213,2012-07-18,House,"House Third Reading:  Roll Call # 499",62,48,0,0,110
341522,209837,2012-08-15,Senate,"Senate Third Reading:  Roll Call # 604",27,10,0,1,38
341532,137030,2011-12-13,Senate,"Reported Favorably Without Amendment",4,0,0,0,4
341532,148193,2012-01-31,Senate,"Senate Third Reading: Passed Roll Call # 31",38,0,0,0,38
341532,158048,2012-02-16,House,"Reported With Recommendation Without Amendment",17,0,0,0,17
341532,166650,2012-02-29,House,"House Third Reading: Given Immediate Effect Roll Call # 79",106,0,0,0,106
341535,103419,2011-11-09,Senate,"Reported Favorably With Substitute S-1",4,0,0,0,4
341535,146222,2012-01-26,Senate,"Senate Third Reading: Passed Roll Call # 20",38,0,0,0,38
341535,200553,2012-05-31,House,"Reported With Recommendation Without Amendment",13,0,0,0,13
341535,202365,2012-06-13,House,"House Third Reading: Given Immediate Effect Roll Call # 438",110,0,0,0,110
341537,103416,2011-11-09,Senate,"Reported Favorably With Substitute S-2",4,0,0,0,4
341537,146151,2012-01-26,Senate,"Senate Third Reading: Passed Roll Call # 21",38,0,0,0,38
341537,200403,2012-05-31,House,"Reported With Recommendation Without Amendment",13,0,0,0,13
341537,202320,2012-06-13,House,"House Third Reading: Given Immediate Effect Roll Call # 439",110,0,0,0,110
341540,102691,2011-10-04,Senate,"Reported Favorably With Substitute S-1",5,0,0,0,5
341540,102817,2011-10-11,Senate,"Senate Third Reading: Passed Roll Call # 566",38,0,0,0,38
341540,214238,2012-11-28,House,"Reported With Recommendation With Amendment(s)",13,5,0,0,18
341540,215549,2012-12-13,House,"House Third Reading: Given Immediate Effect Roll Call # 802",70,40,0,0,110
341540,215708,2012-12-13,Senate,"Senate Third Reading: House Amendment(s) Concurred In Roll Call # 1030",29,8,0,0,37
341546,212255,2012-09-27,Senate,"Reported Favorably With Substitute S-1",3,1,0,0,4
341546,213674,2012-11-08,Senate,"Senate Third Reading: Passed Roll Call # 730",34,3,0,1,38
341546,215500,2012-12-12,House,"Reported With Recommendation With Substitute H-1",9,3,0,0,12
341551,102751,2011-10-05,House,"Reported With Recommendation With Substitute H-1",24,0,0,0,24
341551,103773,2011-10-27,Senate,"Reported Favorably Without Amendment",16,0,0,0,16
341565,103438,2011-11-09,Senate,"Reported Favorably Without Amendment",4,0,0,0,4
341565,146387,2012-01-26,Senate,"Senate Third Reading: Passed Roll Call # 19",38,0,0,0,38
341565,200186,2012-05-31,House,"Reported With Recommendation Without Amendment",13,0,0,0,13
341565,202060,2012-06-13,House,"House Third Reading: Given Immediate Effect Roll Call # 437",110,0,0,0,110
341575,103491,2011-11-09,House,"Reported With Recommendation With Substitute H-2",14,0,0,0,14
341575,104959,2011-12-01,House,"House Third Reading: Given Immediate Effect Roll Call # 520",77,30,0,0,107
341575,148199,2012-01-31,Senate,"Reported Favorably Without Amendment",5,0,0,0,5
341575,159022,2012-02-21,Senate,"Senate Third Reading: Given Immediate Effect Roll Call # 86",27,9,0,2,38
341575,180770,2012-03-29,Senate,"Senate Third Reading: Passed Roll Call # 196",27,11,0,0,38
341575,180771,2012-03-29,House,"House Third Reading: Senate Amendment(s) Concurred In Roll Call # 170",78,31,0,0,109
341583,164807,2012-02-29,House,"Reported With Recommendation Without Amendment",13,0,0,0,13
341583,180417,2012-03-29,House,"House Third Reading: Passed Roll Call # 152",106,4,0,0,110
341583,197772,2012-05-22,Senate,"Reported Favorably Without Amendment",6,0,0,0,6
341583,201318,2012-06-06,Senate,"Senate Third Reading: Given Immediate Effect Roll Call # 443",38,0,0,0,38
341584,102847,2011-10-12,House,"Reported With Recommendation With Substitute H-1",25,0,0,0,25
341584,102909,2011-10-19,House,"House Third Reading: Given Immediate Effect Roll Call # 422",103,5,0,0,108
341584,103285,2011-11-08,Senate,"Reported Favorably With Substitute S-1",3,0,0,0,3
341584,103434,2011-11-10,Senate,"Senate Third Reading: Given Immediate Effect Roll Call # 675",28,8,0,2,38
341584,138643,2011-12-13,House,"House Third Reading:  Roll Call # 570",101,7,0,0,108
341584,138644,2011-12-14,Senate,"Senate Third Reading:  Roll Call # 801",20,17,0,1,38
341588,202105,2012-06-13,House,"Reported With Recommendation Without Amendment",17,0,0,0,17
341588,202444,2012-06-14,House,"House Third Reading: Given Immediate Effect Roll Call # 481",65,44,0,0,109
341588,207217,2012-07-18,Senate,"Senate Third Reading: Given Immediate Effect Roll Call # 586",31,6,0,1,38
341588,207218,2012-07-18,House,"House Third Reading:  Roll Call # 505",100,3,0,0,103
341627,105195,2011-12-07,House,"Reported With Recommendation Without Amendment",10,4,0,0,14
341627,105196,2011-12-08,House,"House Third Reading: Given Immediate Effect Roll Call # 535",62,46,0,0,108
341629,103127,2011-11-01,Senate,"Reported Favorably Without Amendment",4,0,0,0,4
341629,103197,2011-11-03,Senate,"Senate Third Reading: Passed Roll Call # 642",37,1,0,0,38
341633,149854,2012-01-31,House,"Reported With Recommendation With Substitute H-1",4,2,0,0,6
341634,149894,2012-01-31,House,"Reported With Recommendation Without Amendment",4,2,0,0,6
341639,102821,2011-10-11,House,"Reported With Recommendation Without Amendment",16,1,0,0,17
341641,144329,2012-01-19,House,"Reported With Recommendation With Substitute H-1",13,0,0,0,13
341642,149950,2012-01-31,House,"Reported With Recommendation With Substitute H-1",4,2,0,0,6
341646,144363,2012-01-19,House,"Reported With Recommendation With Substitute H-1",13,0,0,0,13
341647,102923,2011-10-20,Senate,"Reported Favorably With Substitute S-3",3,1,0,0,4
341647,103049,2011-10-27,Senate,"Senate Third Reading: Passed Roll Call # 598",26,12,0,0,38
341647,151511,2012-02-08,House,"Reported With Recommendation With Substitute H-2",15,1,0,0,16
341647,190343,2012-04-26,House,"House Third Reading: Given Immediate Effect Roll Call # 208",65,43,0,0,108
341647,192370,2012-05-02,Senate,"Senate Third Reading:  Roll Call # 277",26,11,0,1,38
341652,150692,2012-02-07,Senate,"Reported Favorably With Substitute S-4",3,0,0,0,3
341652,166510,2012-03-01,Senate,"Senate Third Reading: Passed Roll Call # 107",26,10,0,2,38
341652,179570,2012-03-27,House,"Reported With Recommendation With Substitute H-1",9,0,0,0,9
341652,180525,2012-03-29,House,"House Third Reading: Given Immediate Effect Roll Call # 163",109,1,0,0,110
341652,180526,2012-03-29,Senate,"Senate Third Reading:  Roll Call # 189",38,0,0,0,38
341654,150702,2012-02-07,Senate,"Reported Favorably With Substitute S-1",3,0,0,0,3
341654,166519,2012-03-01,Senate,"Senate Third Reading: Passed Roll Call # 106",34,0,1,3,38
341654,179610,2012-03-27,House,"Reported With Recommendation Without Amendment",9,0,0,0,9
341654,180541,2012-03-29,House,"House Third Reading: Given Immediate Effect Roll Call # 162",109,1,0,0,110
341655,102903,2011-10-19,House,"Reported With Recommendation For Referral To Committee On Government Operations",15,0,0,0,15
341662,102827,2011-10-12,Senate,"Reported Favorably Without Amendment",3,0,0,0,3
341662,103039,2011-10-27,Senate,"Senate Third Reading: Passed Roll Call # 609",38,0,0,0,38
341662,213663,2012-11-08,House,"Reported With Recommendation With Amendment(s)",10,0,0,0,10
341662,214362,2012-11-29,House,"House Third Reading: Passed Roll Call # 637",108,0,0,0,108
341662,215132,2012-12-05,Senate,"Senate Third Reading: House Amendment(s) Concurred In Roll Call # 807",38,0,0,0,38
341663,102925,2011-10-20,Senate,"Reported Favorably With Substitute S-3",3,1,0,0,4
341663,103052,2011-10-27,Senate,"Senate Third Reading: Passed Roll Call # 599",26,12,0,0,38
341663,151558,2012-02-08,House,"Reported With Recommendation With Substitute H-2",15,1,0,0,16
341663,190427,2012-04-26,House,"House Third Reading: Given Immediate Effect Roll Call # 209",65,44,0,0,109
341663,192490,2012-05-02,Senate,"Senate Third Reading:  Roll Call # 278",26,11,0,1,38
341674,103056,2011-10-27,Senate,"Reported Favorably With Recommendation For Referral To Committee On Banking And Financial Institutions",3,0,0,0,3
341678,149976,2012-01-31,House,"Reported With Recommendation Without Amendment",4,2,0,0,6
341713,103250,2011-11-03,Senate,"Reported Favorably Without Amendment",5,0,0,0,5
341713,103775,2011-11-30,House,"Reported With Recommendation Without Amendment",16,0,0,0,16
341848,138482,2011-12-13,Senate,"Reported Favorably Without Amendment",5,0,0,0,5
341848,147355,2012-01-26,Senate,"Senate Third Reading: Passed Roll Call # 22",38,0,0,0,38
341848,179073,2012-03-27,House,"Reported With Recommendation Without Amendment",17,0,0,0,17
341848,200631,2012-05-31,House,"House Third Reading: Given Immediate Effect Roll Call # 333",99,10,0,0,109
341852,103804,2011-11-29,Senate,"Reported Favorably With Substitute S-4",7,0,0,0,7
341852,143847,2012-01-19,Senate,"Senate Third Reading: Passed Roll Call # 5",36,0,0,2,38
341852,202342,2012-06-13,House,"Reported With Recommendation Without Amendment",10,0,0,0,10
341852,202599,2012-06-14,House,"House Third Reading: Given Immediate Effect Roll Call # 462",110,0,0,0,110
341853,158451,2012-02-21,Senate,"Reported Favorably Without Amendment",6,0,0,0,6
341853,180317,2012-03-28,Senate,"Senate Third Reading: Passed Roll Call # 173",38,0,0,0,38
341863,143399,2012-01-17,House,"Reported With Recommendation Without Amendment",8,0,0,0,8
341863,158342,2012-02-21,House,"House Third Reading: Given Immediate Effect Roll Call # 66",105,1,0,0,106
341863,177256,2012-03-22,Senate,"Reported Favorably Without Amendment",3,0,0,0,3
341865,103453,2011-11-10,Senate,"Reported Favorably Without Amendment",8,0,0,0,8
341865,105421,2011-12-08,Senate,"Senate Third Reading: Passed Roll Call # 762",35,0,0,3,38
341865,190353,2012-04-26,House,"Reported With Recommendation With Substitute H-2",15,0,0,0,15
341865,201212,2012-06-05,House,"House Third Reading: Given Immediate Effect Roll Call # 353",95,13,0,0,108
341865,201385,2012-06-06,Senate,"Senate Third Reading:  Roll Call # 453",38,0,0,0,38
341867,138523,2011-12-13,Senate,"Reported Favorably Without Amendment",5,0,0,0,5
341867,147486,2012-01-26,Senate,"Senate Third Reading: Passed Roll Call # 23",38,0,0,0,38
341867,179190,2012-03-27,House,"Reported With Recommendation Without Amendment",17,0,0,0,17
341867,200616,2012-05-31,House,"House Third Reading: Given Immediate Effect Roll Call # 334",99,10,0,0,109
341869,154441,2012-02-14,House,"Reported With Recommendation With Substitute H-4",7,0,0,0,7
341869,158721,2012-02-21,House,"House Third Reading: Given Immediate Effect Roll Call # 67",67,39,0,0,106
341869,177104,2012-03-22,Senate,"Reported Favorably With Substitute S-1",3,0,0,0,3
341869,180729,2012-03-29,Senate,"Senate Third Reading: Given Immediate Effect Roll Call # 176",26,12,0,0,38
341869,180730,2012-03-29,House,"House Third Reading:  Roll Call # 166",71,39,0,0,110
341902,102906,2011-10-19,Senate,"Reported Favorably Without Amendment",4,0,0,0,4
341902,103318,2011-11-09,Senate,"Senate Third Reading: Passed Roll Call # 657",37,0,0,1,38
341902,173531,2012-03-15,House,"Reported With Recommendation Without Amendment",14,0,0,0,14
341902,176239,2012-03-21,House,"House Third Reading: Given Immediate Effect Roll Call # 133",108,0,0,0,108
341919,103266,2011-11-08,Senate,"Reported Favorably Without Amendment",4,0,0,0,4
341919,104894,2011-12-01,Senate,"Senate Third Reading: Passed Roll Call # 726",36,0,1,1,38
341919,104895,2011-12-07,House,"Reported With Recommendation With Substitute H-1",18,0,0,0,18
341919,105714,2011-12-13,House,"House Third Reading: Given Immediate Effect Roll Call # 569",108,0,0,0,108
341919,105715,2011-12-14,Senate,"Senate Third Reading:  Roll Call # 783",38,0,0,0,38
341930,102908,2011-10-19,Senate,"Reported Favorably With Substitute S-1",4,0,0,0,4
341930,150952,2012-02-07,Senate,"Senate Third Reading: Passed Roll Call # 37",38,0,0,0,38
341930,213664,2012-11-08,House,"Reported With Recommendation With Substitute H-2",10,0,0,0,10
341930,214396,2012-11-29,House,"House Third Reading: Passed Roll Call # 638",108,0,0,0,108
341930,215141,2012-12-05,Senate,"Senate Third Reading:  Roll Call # 808",38,0,0,0,38
341931,102907,2011-10-19,Senate,"Reported Favorably Without Amendment",4,0,0,0,4
341931,103322,2011-11-09,Senate,"Senate Third Reading: Passed Roll Call # 656",36,0,0,2,38
341931,173563,2012-03-15,House,"Reported With Recommendation Without Amendment",14,0,0,0,14
341931,176264,2012-03-21,House,"House Third Reading: Given Immediate Effect Roll Call # 132",108,0,0,0,108
341936,173328,2012-03-15,House,"Reported With Recommendation With Substitute H-1",12,6,0,0,18
341936,201998,2012-06-12,House,"House Third Reading: Given Immediate Effect Roll Call # 425",59,50,0,0,109
341988,103790,2011-12-01,House,"Reported With Recommendation With Substitute H-1",13,0,0,0,13
341988,144412,2012-01-19,House,"House Third Reading: Given Immediate Effect Roll Call # 3",100,6,0,0,106
341993,102834,2011-10-12,House,"Reported With Recommendation Without Amendment",16,0,0,0,16
341993,102994,2011-10-25,House,"House Third Reading: Given Immediate Effect Roll Call # 425",107,0,0,0,107
341993,202339,2012-06-13,Senate,"Reported Favorably Without Amendment",4,0,0,0,4
341993,202596,2012-06-14,Senate,"Senate Third Reading: Given Immediate Effect Roll Call # 525",37,0,0,1,38
341994,102854,2011-10-13,House,"Reported With Recommendation With Amendment(s)",15,0,0,0,15
341994,105594,2011-12-13,House,"House Third Reading: Given Immediate Effect Roll Call # 571",108,0,0,0,108
341994,215331,2012-12-11,Senate,"Reported Favorably Without Amendment",3,0,0,0,3
341994,215686,2012-12-13,Senate,"Senate Third Reading: Given Immediate Effect Roll Call # 979",38,0,0,0,38
341999,102833,2011-10-12,House,"Reported With Recommendation Without Amendment",16,0,0,0,16
341999,102993,2011-10-25,House,"House Third Reading: Given Immediate Effect Roll Call # 426",107,0,0,0,107
341999,202313,2012-06-13,Senate,"Reported Favorably Without Amendment",4,0,0,0,4
341999,202590,2012-06-14,Senate,"Senate Third Reading: Given Immediate Effect Roll Call # 526",37,0,0,1,38
342007,103007,2011-10-25,Senate,"Reported Favorably Without Amendment",5,2,0,0,7
342007,105081,2011-12-06,House,"Reported With Recommendation Without Amendment",9,0,0,0,9
342025,159104,2012-02-21,Senate,"Reported Favorably Without Amendment",7,0,0,0,7
342038,103002,2011-10-25,Senate,"Reported Favorably Without Amendment",5,2,0,0,7
342038,105080,2011-12-06,House,"Reported With Recommendation Without Amendment",8,1,0,0,9
342113,148253,2012-01-31,House,"Reported With Recommendation With Substitute H-2",11,0,0,0,11
342113,149331,2012-02-02,House,"House Third Reading: Given Immediate Effect Roll Call # 26",105,0,0,0,105
342113,199465,2012-05-29,Senate,"Reported Favorably Without Amendment",6,0,0,0,6
342113,212235,2012-09-27,Senate,"Senate Third Reading: Given Immediate Effect Roll Call # 662",38,0,0,0,38
342117,105210,2011-12-07,House,"Reported With Recommendation Without Amendment",13,0,0,0,13
342117,105211,2011-12-08,House,"House Third Reading: Given Immediate Effect Roll Call # 540",96,12,0,0,108
342117,153357,2012-02-07,Senate,"Senate Third Reading: Given Immediate Effect Roll Call # 45",35,3,0,0,38
342158,105258,2011-12-07,House,"Reported With Recommendation Without Amendment",13,0,0,0,13
342158,105259,2011-12-08,House,"House Third Reading: Given Immediate Effect Roll Call # 539",96,12,0,0,108
342158,150656,2012-02-07,Senate,"Senate Third Reading: Given Immediate Effect Roll Call # 44",37,1,0,0,38
342166,103424,2011-11-10,Senate,"Reported Favorably With Substitute S-3",6,0,0,0,6
342166,103629,2011-11-29,Senate,"Senate Third Reading: Passed Roll Call # 703",36,2,0,0,38
342166,105742,2011-12-14,House,"House Third Reading: Given Immediate Effect Roll Call # 605",101,6,0,0,107
342166,138857,2011-12-15,Senate,"Senate Third Reading: House Amendment(s) Concurred In Roll Call # 820",36,2,0,0,38
342176,105260,2011-12-07,House,"Reported With Recommendation With Substitute H-5",3,1,0,0,4
342176,105261,2011-12-08,House,"House Third Reading: Given Immediate Effect Roll Call # 552",68,40,0,0,108
342176,137874,2011-12-14,Senate,"Reported Favorably With Substitute S-2",9,0,0,0,9
342176,137875,2011-12-14,Senate,"Senate Third Reading: Given Immediate Effect Roll Call # 789",33,4,0,1,38
342176,137876,2011-12-15,House,"House Third Reading:  Roll Call # 610",104,3,0,0,107
342178,105422,2011-12-06,Senate,"Reported Favorably Without Amendment",4,0,0,0,4
342178,154562,2012-02-14,Senate,"Senate Third Reading: Passed Roll Call # 74",38,0,0,0,38
342178,198329,2012-05-22,House,"Reported With Recommendation With Amendment(s)",7,2,0,0,9
342178,202259,2012-06-12,House,"House Third Reading: Given Immediate Effect Roll Call # 418",93,16,0,0,109
342178,202260,2012-06-13,Senate,"Senate Third Reading: House Amendment(s) Concurred In Roll Call # 511",37,0,0,1,38
342184,103330,2011-11-09,House,"Reported With Recommendation Without Amendment",27,0,0,0,27
342184,103669,2011-11-30,House,"House Third Reading:  Roll Call # 499",106,0,0,0,106
342184,138775,2011-12-15,Senate,"Reported Favorably Without Amendment",6,0,0,0,6
342184,138776,2011-12-15,Senate,"Senate Third Reading:  Roll Call # 831",38,0,0,0,38
342186,105426,2011-12-06,Senate,"Reported Favorably With Substitute S-1",4,0,0,0,4
342186,154578,2012-02-14,Senate,"Senate Third Reading: Passed Roll Call # 70",38,0,0,0,38
342196,143415,2012-01-17,House,"Reported With Recommendation Without Amendment",7,0,0,0,7
342196,147803,2012-01-31,House,"House Third Reading: Given Immediate Effect Roll Call # 19",104,1,0,0,105
342196,180696,2012-03-29,Senate,"Reported Favorably Without Amendment",3,0,0,0,3
342196,191579,2012-05-01,Senate,"Senate Third Reading: Given Immediate Effect Roll Call # 272",35,2,0,1,38
342213,172058,2012-03-13,House,"Reported With Recommendation With Substitute H-2",5,3,0,0,8
342213,180863,2012-03-29,House,"House Third Reading: Passed Roll Call # 153",65,45,0,0,110
342213,197828,2012-05-22,Senate,"Reported Favorably With Substitute S-1",3,1,0,0,4
342213,202040,2012-06-13,Senate,"Senate Third Reading: Given Immediate Effect Roll Call # 491",26,11,0,1,38
342213,202611,2012-06-14,House,"House Third Reading:  Roll Call # 471",65,45,0,0,110
342220,202174,2012-06-13,Senate,"Reported Favorably With Substitute S-2",4,0,0,0,4
342220,211870,2012-09-11,Senate,"Senate Third Reading: Passed Roll Call # 615",37,0,0,1,38
342225,212033,2012-09-13,House,"Reported With Recommendation Without Amendment",10,1,0,0,11
342225,214010,2012-11-28,House,"House Third Reading: Given Immediate Effect Roll Call # 609",63,46,0,0,109
342225,215253,2012-12-06,Senate,"Reported Favorably Without Amendment",3,1,0,0,4
342225,215655,2012-12-13,Senate,"Senate Third Reading: Given Immediate Effect Roll Call # 956",26,12,0,0,38
342229,103329,2011-11-09,House,"Reported With Recommendation Without Amendment",27,0,0,0,27
342229,103668,2011-11-30,House,"House Third Reading:  Roll Call # 498",106,0,0,0,106
342229,138770,2011-12-15,Senate,"Reported Favorably Without Amendment",6,0,0,0,6
342229,138771,2011-12-15,Senate,"Senate Third Reading:  Roll Call # 830",37,1,0,0,38
342235,150618,2012-02-02,House,"Reported With Recommendation With Substitute H-4",16,0,0,0,16
342235,151331,2012-02-08,House,"House Third Reading: Given Immediate Effect Roll Call # 39",100,3,0,0,103
342235,170121,2012-03-08,Senate,"Reported Favorably With Substitute S-1",4,0,0,0,4
342235,178745,2012-03-27,Senate,"Senate Third Reading: Given Immediate Effect Roll Call # 156",32,5,0,1,38
342235,180586,2012-03-29,House,"House Third Reading:  Roll Call # 149",105,4,0,0,109
342245,105265,2011-12-07,House,"Reported With Recommendation With Amendment(s)",12,0,0,0,12
342245,138111,2011-12-14,House,"House Third Reading: Given Immediate Effect Roll Call # 599",106,1,0,0,107
342245,152225,2012-02-07,Senate,"Senate Third Reading: Given Immediate Effect Roll Call # 43",37,1,0,0,38
342245,155666,2012-02-14,House,"House Third Reading: Senate Amendment(s) Concurred In Roll Call # 46",99,9,0,0,108
342257,145710,2012-01-25,Senate,"Reported Favorably With Recommendation For Referral To Committee On Energy And Technology",6,0,0,0,6
342257,165605,2012-02-29,Senate,"Reported Favorably With Substitute S-3",7,0,0,0,7
342257,172944,2012-03-15,Senate,"Senate Third Reading: Passed Roll Call # 140",28,10,0,0,38
342257,215826,2012-12-14,House,"House Third Reading: Passed Roll Call # 882",74,33,0,0,107
342260,212256,2012-09-27,House,"Reported With Recommendation With Substitute H-3",9,4,0,0,13
342260,214014,2012-11-28,House,"House Third Reading: Passed Roll Call # 618",65,44,0,0,109
342274,172738,2012-03-13,House,"Reported With Recommendation With Substitute H-2",8,0,0,0,8
342274,180868,2012-03-29,House,"House Third Reading: Passed Roll Call # 155",110,0,0,0,110
342274,197854,2012-05-22,Senate,"Reported Favorably With Amendment(s)",3,1,0,0,4
342274,202065,2012-06-13,Senate,"Senate Third Reading: Given Immediate Effect Roll Call # 492",36,1,0,1,38
342274,202413,2012-06-14,House,"House Third Reading: Senate Amendment(s) Concurred In Roll Call # 472",110,0,0,0,110
342293,105184,2011-12-07,House,"Reported With Recommendation With Amendment(s)",13,0,0,0,13
342293,105185,2011-12-08,House,"House Third Reading: Given Immediate Effect Roll Call # 538",79,29,0,0,108
342293,153122,2012-02-07,Senate,"Senate Third Reading: Given Immediate Effect Roll Call # 42",36,2,0,0,38
342293,155679,2012-02-14,House,"House Third Reading: Senate Amendment(s) Concurred In Roll Call # 45",85,23,0,0,108
342306,168499,2012-03-06,House,"Reported With Recommendation Without Amendment",8,0,0,0,8
342306,172740,2012-03-14,House,"House Third Reading: Passed Roll Call # 116",110,0,0,0,110
342306,200368,2012-05-31,Senate,"Reported Favorably With Substitute S-1",3,0,0,0,3
342306,202277,2012-06-13,Senate,"Senate Third Reading: Given Immediate Effect Roll Call # 489",37,0,0,1,38
342306,202578,2012-06-14,House,"House Third Reading:  Roll Call # 469",110,0,0,0,110
342315,105187,2011-12-07,House,"Reported With Recommendation With Amendment(s)",12,0,0,0,12
342315,105188,2011-12-08,House,"House Third Reading: Given Immediate Effect Roll Call # 541",97,11,0,0,108
342315,153143,2012-02-07,Senate,"Senate Third Reading: Given Immediate Effect Roll Call # 46",34,4,0,0,38
342344,103346,2011-11-09,House,"Reported With Recommendation Without Amendment",27,0,0,0,27
342344,103687,2011-11-30,House,"House Third Reading:  Roll Call # 497",106,0,0,0,106
342344,105744,2011-12-15,Senate,"Reported Favorably Without Amendment",6,0,0,0,6
342344,105745,2011-12-15,Senate,"Senate Third Reading:  Roll Call # 829",37,1,0,0,38
342367,105197,2011-12-07,House,"Reported With Recommendation With Substitute H-5",3,1,0,0,4
342367,105198,2011-12-08,House,"House Third Reading: Given Immediate Effect Roll Call # 551",68,40,0,0,108
342367,130360,2011-12-14,Senate,"Reported Favorably With Substitute S-3",9,0,0,0,9
342367,130361,2011-12-14,Senate,"Senate Third Reading: Given Immediate Effect Roll Call # 788",34,3,0,1,38
342367,130362,2011-12-15,House,"House Third Reading:  Roll Call # 609",104,3,0,0,107
342376,102905,2011-10-19,Senate,"Reported Favorably Without Amendment",4,0,0,0,4
342376,176201,2012-03-20,Senate,"Senate Third Reading: Passed Roll Call # 144",36,2,0,0,38
342376,215298,2012-12-06,House,"Reported With Recommendation With Amendment(s)",12,0,0,0,12
342378,105199,2011-12-07,House,"Reported With Recommendation With Substitute H-5",3,1,0,0,4
342378,105200,2011-12-08,House,"House Third Reading: Given Immediate Effect Roll Call # 553",68,40,0,0,108
342378,131220,2011-12-14,Senate,"Reported Favorably With Substitute S-2",9,0,0,0,9
342378,131221,2011-12-14,Senate,"Senate Third Reading: Given Immediate Effect Roll Call # 790",33,4,0,1,38
342378,131223,2011-12-15,House,"House Third Reading:  Roll Call # 611",104,3,0,0,107
342384,105487,2011-12-06,Senate,"Reported Favorably With Substitute S-2",3,1,0,0,4
342384,154831,2012-02-14,Senate,"Senate Third Reading: Passed Roll Call # 77",26,12,0,0,38
342384,197859,2012-05-22,House,"Reported With Recommendation With Amendment(s)",6,3,0,0,9
342384,202068,2012-06-12,House,"House Third Reading: Given Immediate Effect Roll Call # 419",66,43,0,0,109
342384,202069,2012-06-13,Senate,"Senate Third Reading: House Amendment(s) Concurred In Roll Call # 512",26,11,0,1,38
342402,105485,2011-12-06,Senate,"Reported Favorably With Substitute S-1",4,0,0,0,4
342402,154814,2012-02-14,Senate,"Senate Third Reading: Passed Roll Call # 65",38,0,0,0,38
342402,197834,2012-05-22,House,"Reported With Recommendation Without Amendment",9,0,0,0,9
342402,202044,2012-06-12,House,"House Third Reading: Given Immediate Effect Roll Call # 417",109,0,0,0,109
342402,202045,2012-06-13,Senate,"Senate Third Reading: House Amendment(s) Concurred In Roll Call # 510",37,0,0,1,38
342411,148108,2012-01-31,Senate,"Reported Favorably With Substitute S-1",6,0,0,0,6
342411,155498,2012-02-15,Senate,"Senate Third Reading: Passed Roll Call # 81",38,0,0,0,38
342411,190721,2012-04-25,House,"Reported With Recommendation Without Amendment",14,0,0,0,14
342411,200727,2012-05-31,House,"House Third Reading: Given Immediate Effect Roll Call # 341",109,0,0,0,109
342418,105201,2011-12-07,House,"Reported With Recommendation With Substitute H-5",3,1,0,0,4
342418,105202,2011-12-08,House,"House Third Reading: Given Immediate Effect Roll Call # 550",68,40,0,0,108
342418,132019,2011-12-14,Senate,"Reported Favorably With Substitute S-2",9,0,0,0,9
342418,132020,2011-12-14,Senate,"Senate Third Reading: Given Immediate Effect Roll Call # 787",34,3,0,1,38
342418,132021,2011-12-15,House,"House Third Reading:  Roll Call # 608",104,3,0,0,107
342424,168541,2012-03-06,House,"Reported With Recommendation With Substitute H-1",5,0,0,0,5
342424,172755,2012-03-14,House,"House Third Reading: Passed Roll Call # 115",110,0,0,0,110
342424,197965,2012-05-22,Senate,"Reported Favorably With Substitute S-1",3,0,0,0,3
342424,202196,2012-06-13,Senate,"Senate Third Reading: Given Immediate Effect Roll Call # 490",36,1,0,1,38
342424,202528,2012-06-14,House,"House Third Reading:  Roll Call # 470",84,26,0,0,110
342427,168542,2012-03-06,House,"Reported With Recommendation With Substitute H-3",5,3,0,0,8
342427,172766,2012-03-14,House,"House Third Reading: Passed Roll Call # 114",64,46,0,0,110
342444,105497,2011-12-06,Senate,"Reported Favorably With Substitute S-1",3,1,0,0,4
342444,154858,2012-02-14,Senate,"Senate Third Reading: Passed Roll Call # 64",27,11,0,0,38
342444,154859,2012-02-14,Senate,"Senate Third Reading: Passed Roll Call # 78",26,12,0,0,38
342444,197860,2012-05-22,House,"Reported With Recommendation With Amendment(s)",6,3,0,0,9
342444,202077,2012-06-12,House,"House Third Reading: Given Immediate Effect Roll Call # 416",65,44,0,0,109
342444,202078,2012-06-13,Senate,"Senate Third Reading: House Amendment(s) Concurred In Roll Call # 509",26,11,0,1,38
342448,150930,2012-02-02,House,"Reported With Recommendation With Substitute H-1",16,0,0,0,16
342448,151638,2012-02-08,House,"House Third Reading: Given Immediate Effect Roll Call # 40",100,3,0,0,103
342448,169896,2012-03-08,Senate,"Reported Favorably Without Amendment",4,0,0,0,4
342448,178613,2012-03-27,Senate,"Senate Third Reading: Given Immediate Effect Roll Call # 157",31,5,1,1,38
342448,180929,2012-03-29,House,"House Third Reading: Senate Amendment(s) Concurred In Roll Call # 150",101,8,0,0,109
342463,201905,2012-06-12,House,"Reported With Recommendation With Substitute H-3",14,0,0,0,14
342485,105452,2011-12-06,House,"Reported With Recommendation With Substitute H-1",6,2,0,0,8
342485,105453,2011-12-08,House,"House Third Reading: Given Immediate Effect Roll Call # 533",62,46,0,0,108
342485,150709,2012-02-07,Senate,"Reported Favorably With Amendment(s)",3,1,0,0,4
342485,154640,2012-02-14,Senate,"Senate Third Reading: Given Immediate Effect Roll Call # 73",26,12,0,0,38
342485,155547,2012-02-15,House,"House Third Reading: Senate Amendment(s) Concurred In Roll Call # 52",62,43,0,0,105
342486,105464,2011-12-07,House,"Reported With Recommendation Without Amendment",11,0,0,0,11
342486,105465,2011-12-08,House,"House Third Reading: Given Immediate Effect Roll Call # 542",63,45,0,0,108
342486,150711,2012-02-07,Senate,"Senate Third Reading: Given Immediate Effect Roll Call # 47",34,4,0,0,38
342492,138507,2011-12-14,House,"Reported With Recommendation With Substitute H-1",11,0,0,0,11
342492,145928,2012-01-25,House,"House Third Reading: Given Immediate Effect Roll Call # 10",107,0,0,0,107
342492,172186,2012-03-13,Senate,"Reported Favorably Without Amendment",6,0,0,0,6
342492,178666,2012-03-27,Senate,"Senate Third Reading: Given Immediate Effect Roll Call # 160",37,0,0,1,38
342500,165294,2012-02-29,House,"Reported With Recommendation With Substitute H-2",12,0,0,0,12
342500,172866,2012-03-15,House,"House Third Reading: Passed Roll Call # 118",101,5,0,0,106
342502,105323,2011-12-07,House,"Reported With Recommendation Without Amendment",12,0,0,0,12
342502,138552,2011-12-14,House,"House Third Reading: Given Immediate Effect Roll Call # 600",100,7,0,0,107
342502,152470,2012-02-07,Senate,"Senate Third Reading: Given Immediate Effect Roll Call # 49",37,1,0,0,38
342504,138544,2011-12-14,House,"Reported With Recommendation With Substitute H-1",11,0,0,0,11
342504,145965,2012-01-25,House,"House Third Reading: Given Immediate Effect Roll Call # 11",107,0,0,0,107
342504,172189,2012-03-13,Senate,"Reported Favorably Without Amendment",6,0,0,0,6
342504,178668,2012-03-27,Senate,"Senate Third Reading: Given Immediate Effect Roll Call # 161",37,0,0,1,38
342506,138538,2011-12-14,House,"Reported With Recommendation With Substitute H-1",11,0,0,0,11
342506,145954,2012-01-25,House,"House Third Reading: Given Immediate Effect Roll Call # 12",107,0,0,0,107
342506,172185,2012-03-13,Senate,"Reported Favorably With Substitute S-1",6,0,0,0,6
342506,178665,2012-03-27,Senate,"Senate Third Reading: Given Immediate Effect Roll Call # 162",37,0,0,1,38
342506,180514,2012-03-29,House,"House Third Reading:  Roll Call # 151",110,0,0,0,110
342508,105329,2011-12-07,House,"Reported With Recommendation With Amendment(s)",11,0,0,0,11
342508,105330,2011-12-08,House,"House Third Reading: Given Immediate Effect Roll Call # 543",95,13,0,0,108
342508,150466,2012-02-07,Senate,"Senate Third Reading: Given Immediate Effect Roll Call # 48",35,3,0,0,38
342509,201569,2012-06-06,House,"Reported With Recommendation With Substitute H-1",9,0,0,0,9
342509,215204,2012-12-06,House,"House Third Reading: Passed Roll Call # 703",63,46,0,0,109
342511,105348,2011-12-07,House,"Reported With Recommendation Without Amendment",15,0,0,0,15
342511,105349,2011-12-08,House,"House Third Reading: Given Immediate Effect Roll Call # 536",107,1,0,0,108
342511,138566,2011-12-15,Senate,"Reported Favorably Without Amendment",6,0,0,0,6
342511,138567,2011-12-15,Senate,"Senate Third Reading: Given Immediate Effect Roll Call # 835",37,1,0,0,38
342513,196915,2012-05-17,House,"Reported With Recommendation With Substitute H-1",16,0,0,0,16
342513,201460,2012-06-05,House,"House Third Reading: Passed Roll Call # 352",107,1,0,0,108
342513,212060,2012-09-19,Senate,"Reported Favorably Without Amendment",7,0,0,0,7
342513,215418,2012-12-12,Senate,"Senate Third Reading: Given Immediate Effect Roll Call # 883",38,0,0,0,38
342518,212137,2012-09-19,House,"Reported With Recommendation Without Amendment",6,0,0,0,6
342518,213734,2012-11-27,House,"House Third Reading: Given Immediate Effect Roll Call # 601",107,1,0,0,108
342518,215400,2012-12-12,Senate,"Senate Third Reading: Given Immediate Effect Roll Call # 924",37,0,0,1,38
342519,196912,2012-05-17,House,"Reported With Recommendation With Substitute H-2",16,0,0,0,16
342519,201449,2012-06-05,House,"House Third Reading: Passed Roll Call # 351",108,0,0,0,108
342519,212057,2012-09-19,Senate,"Reported Favorably Without Amendment",7,0,0,0,7
342519,215419,2012-12-12,Senate,"Senate Third Reading: Given Immediate Effect Roll Call # 882",38,0,0,0,38
342521,105372,2011-12-06,House,"Reported With Recommendation With Substitute H-2",6,2,0,0,8
342521,105373,2011-12-08,House,"House Third Reading: Given Immediate Effect Roll Call # 534",62,46,0,0,108
342521,150505,2012-02-07,Senate,"Reported Favorably With Amendment(s)",3,1,0,0,4
342521,154508,2012-02-14,Senate,"Senate Third Reading: Given Immediate Effect Roll Call # 72",26,12,0,0,38
342521,155412,2012-02-15,House,"House Third Reading: Senate Amendment(s) Concurred In Roll Call # 53",62,45,0,0,107
342523,212135,2012-09-19,House,"Reported With Recommendation With Substitute H-1",6,0,0,0,6
342523,213725,2012-11-27,House,"House Third Reading: Given Immediate Effect Roll Call # 602",107,1,0,0,108
342523,215392,2012-12-12,Senate,"Senate Third Reading: Given Immediate Effect Roll Call # 925",37,0,0,1,38
342525,200502,2012-05-31,Senate,"Reported Favorably Without Amendment",8,0,0,0,8
342525,201417,2012-06-06,Senate,"Senate Third Reading: Passed Roll Call # 451",38,0,0,0,38
342527,103214,2011-11-03,Senate,"Reported Favorably Without Amendment",4,0,0,0,4
342527,105676,2011-12-13,Senate,"Senate Third Reading: Passed Roll Call # 772",36,2,0,0,38
342527,196995,2012-05-17,House,"Reported With Recommendation Without Amendment",15,0,0,0,15
342527,200648,2012-05-31,House,"House Third Reading: Given Immediate Effect Roll Call # 336",109,0,0,0,109
342527,202222,2012-06-13,House,"House Third Reading: Passed Roll Call # 445",110,0,0,0,110
342527,202223,2012-06-13,Senate,"Senate Third Reading: House Amendment(s) Concurred In Roll Call # 522",34,2,0,2,38
342531,103194,2011-11-03,Senate,"Reported Favorably Without Amendment",4,0,0,0,4
342531,105702,2011-12-13,Senate,"Senate Third Reading: Passed Roll Call # 774",36,2,0,0,38
342531,196997,2012-05-17,House,"Reported With Recommendation Without Amendment",15,0,0,0,15
342531,200664,2012-05-31,House,"House Third Reading: Given Immediate Effect Roll Call # 338",109,0,0,0,109
342531,202506,2012-06-13,Senate,"Senate Third Reading: House Amendment(s) Concurred In Roll Call # 524",34,2,0,2,38
342537,103055,2011-10-27,Senate,"Reported Favorably Without Amendment",11,0,0,0,11
342537,103126,2011-11-01,Senate,"Senate Third Reading: Passed Roll Call # 614",26,12,0,0,38
342537,103374,2011-11-09,House,"Reported With Recommendation Without Amendment",21,2,0,0,23
342537,103402,2011-11-10,House,"House Third Reading: Given Immediate Effect Roll Call # 481",104,3,0,0,107
342550,103195,2011-11-03,Senate,"Reported Favorably Without Amendment",4,0,0,0,4
342550,105705,2011-12-13,Senate,"Senate Third Reading: Passed Roll Call # 773",36,2,0,0,38
342550,197574,2012-05-17,House,"Reported With Recommendation Without Amendment",15,0,0,0,15
342550,200671,2012-05-31,House,"House Third Reading: Given Immediate Effect Roll Call # 337",109,0,0,0,109
342550,202264,2012-06-13,House,"House Third Reading: Passed Roll Call # 446",110,0,0,0,110
342550,202265,2012-06-13,Senate,"Senate Third Reading: House Amendment(s) Concurred In Roll Call # 523",34,2,0,2,38
342558,105614,2011-12-07,House,"Reported With Recommendation With Substitute H-2",11,2,0,0,13
342558,105615,2011-12-08,House,"House Third Reading: Given Immediate Effect Roll Call # 549",70,37,0,0,107
342558,138737,2011-12-15,Senate,"Senate Third Reading: Given Immediate Effect Roll Call # 838",33,5,0,0,38
342558,138738,2011-12-15,House,"House Third Reading: Senate Amendment(s) Concurred In Roll Call # 619",101,4,0,0,105
342561,103149,2011-11-01,House,"Reported With Recommendation With Substitute H-1",7,2,0,0,9
342561,103803,2011-11-29,House,"House Third Reading: Given Immediate Effect Roll Call # 496",98,7,0,0,105
342561,154683,2012-02-14,Senate,"Reported Favorably Without Amendment",5,0,0,0,5
342561,165752,2012-02-29,Senate,"Senate Third Reading: Given Immediate Effect Roll Call # 105",37,0,0,1,38
342561,168137,2012-03-06,House,"House Third Reading: Senate Amendment(s) Concurred In Roll Call # 92",101,8,0,0,109
342564,105613,2011-12-07,House,"Reported With Recommendation Without Amendment",11,0,0,0,11
342564,138735,2011-12-14,House,"House Third Reading: Given Immediate Effect Roll Call # 601",100,7,0,0,107
342564,151185,2012-02-07,Senate,"Senate Third Reading: Given Immediate Effect Roll Call # 53",37,1,0,0,38
342571,105534,2011-12-07,House,"Reported With Recommendation With Substitute H-7",11,2,0,0,13
342571,105535,2011-12-08,House,"House Third Reading: Given Immediate Effect Roll Call # 546",87,21,0,0,108
342571,151694,2012-02-08,Senate,"Senate Third Reading: Passed Roll Call # 55",32,5,1,0,38
342571,151695,2012-02-08,Senate,"Senate Third Reading: Given Immediate Effect Roll Call # 56",32,6,0,0,38
342571,154969,2012-02-14,House,"House Third Reading:  Roll Call # 50",86,22,0,0,108
342573,105539,2011-12-07,House,"Reported With Recommendation With Substitute H-1",11,0,0,0,11
342573,105540,2011-12-08,House,"House Third Reading: Given Immediate Effect Roll Call # 548",95,13,0,0,108
342573,151055,2012-02-07,Senate,"Senate Third Reading: Given Immediate Effect Roll Call # 54",37,1,0,0,38
342578,105541,2011-12-07,House,"Reported With Recommendation With Substitute H-1",11,0,0,0,11
342578,138682,2011-12-14,House,"House Third Reading: Given Immediate Effect Roll Call # 602",100,7,0,0,107
342579,105543,2011-12-07,House,"Reported With Recommendation With Substitute H-2",15,0,0,0,15
342579,105544,2011-12-08,House,"House Third Reading: Given Immediate Effect Roll Call # 545",97,11,0,0,108
342579,151112,2012-02-07,Senate,"Senate Third Reading: Given Immediate Effect Roll Call # 51",36,2,0,0,38
342579,155921,2012-02-14,House,"House Third Reading:  Roll Call # 48",87,21,0,0,108
342583,103124,2011-11-01,House,"Reported With Recommendation Without Amendment",8,0,0,0,8
342583,103617,2011-11-29,House,"House Third Reading: Given Immediate Effect Roll Call # 495",78,27,0,0,105
342583,154710,2012-02-14,Senate,"Reported Favorably Without Amendment",5,0,0,0,5
342583,165772,2012-02-29,Senate,"Senate Third Reading: Given Immediate Effect Roll Call # 104",28,9,0,1,38
342583,168165,2012-03-06,House,"House Third Reading: Senate Amendment(s) Concurred In Roll Call # 91",78,31,0,0,109
342584,105550,2011-12-07,House,"Reported With Recommendation With Substitute H-1",11,0,0,0,11
342584,105551,2011-12-08,House,"House Third Reading: Given Immediate Effect Roll Call # 544",98,10,0,0,108
342584,151171,2012-02-07,Senate,"Senate Third Reading: Given Immediate Effect Roll Call # 50",37,1,0,0,38
342584,155988,2012-02-14,House,"House Third Reading: Senate Amendment(s) Concurred In Roll Call # 47",96,12,0,0,108
342585,105548,2011-12-07,House,"Reported With Recommendation Without Amendment",10,0,0,0,10
342585,105549,2011-12-08,House,"House Third Reading: Given Immediate Effect Roll Call # 547",88,20,0,0,108
342585,151147,2012-02-07,Senate,"Senate Third Reading: Given Immediate Effect Roll Call # 52",37,1,0,0,38
342585,155981,2012-02-14,House,"House Third Reading: Senate Amendment(s) Concurred In Roll Call # 49",90,18,0,0,108
342604,197066,2012-05-17,Senate,"Reported Favorably With Substitute S-1",10,5,0,0,15
342604,201612,2012-06-07,Senate,"Senate Third Reading: Passed Roll Call # 463",25,12,0,1,38
342604,215262,2012-12-05,House,"Reported With Recommendation Without Amendment",16,10,0,0,26
342604,215519,2012-12-13,House,"House Third Reading: Passed Roll Call # 824",68,41,0,0,109
342605,103356,2011-11-09,Senate,"Reported Favorably Without Amendment",4,0,0,0,4
342605,104711,2011-12-01,Senate,"Senate Third Reading: Passed Roll Call # 720",37,0,0,1,38
342605,186939,2012-04-17,House,"Reported With Recommendation With Substitute H-1",18,0,0,0,18
342605,195362,2012-05-10,House,"House Third Reading: Given Immediate Effect Roll Call # 255",107,0,0,0,107
342605,196136,2012-05-15,Senate,"Senate Third Reading:  Roll Call # 331",37,0,0,1,38
342606,103042,2011-10-27,Senate,"Reported Favorably Without Amendment",4,0,0,0,4
342607,104640,2011-11-30,House,"Reported With Recommendation Without Amendment",15,3,0,0,18
342608,103311,2011-11-09,Senate,"Reported Favorably Without Amendment",4,0,0,0,4
342608,104739,2011-12-01,Senate,"Senate Third Reading: Passed Roll Call # 721",37,0,0,1,38
342608,186975,2012-04-17,House,"Reported With Recommendation Without Amendment",18,0,0,0,18
342608,195503,2012-05-10,House,"House Third Reading: Given Immediate Effect Roll Call # 256",107,0,0,0,107
342610,196999,2012-05-17,Senate,"Reported Favorably With Substitute S-3",9,5,0,0,14
342610,201577,2012-06-07,Senate,"Senate Third Reading: Passed Roll Call # 462",25,12,0,1,38
342610,215214,2012-12-05,House,"Reported With Recommendation With Substitute H-1",15,11,0,0,26
342610,215573,2012-12-13,House,"House Third Reading: Passed Roll Call # 823",68,41,0,0,109
342610,215740,2012-12-14,Senate,"Senate Third Reading:  Roll Call # 1066",26,12,0,0,38
342614,196996,2012-05-17,Senate,"Reported Favorably With Substitute S-1",10,5,0,0,15
342614,201576,2012-06-07,Senate,"Senate Third Reading: Passed Roll Call # 464",25,12,0,1,38
342614,215213,2012-12-05,House,"Reported With Recommendation With Substitute H-1",16,10,0,0,26
342614,215574,2012-12-13,House,"House Third Reading: Passed Roll Call # 825",68,41,0,0,109
342614,215743,2012-12-14,Senate,"Senate Third Reading:  Roll Call # 1078",20,18,0,0,38
342614,215818,2012-12-14,Senate,"Senate Third Reading:  Roll Call # 1067",26,12,0,0,38
342632,103004,2011-10-25,House,"Reported With Recommendation Without Amendment",8,0,0,0,8
342632,103054,2011-10-27,House,"House Third Reading: Given Immediate Effect Roll Call # 436",108,0,0,0,108
342632,103403,2011-11-10,Senate,"Reported Favorably Without Amendment",6,0,0,0,6
342632,103404,2011-11-10,Senate,"Senate Third Reading: Given Immediate Effect Roll Call # 681",35,1,0,2,38
342738,103117,2011-11-01,Senate,"Reported Favorably Without Amendment",4,0,0,0,4
342738,103212,2011-11-03,Senate,"Senate Third Reading: Passed Roll Call # 643",38,0,0,0,38
342749,145566,2012-01-24,House,"Reported With Recommendation Without Amendment",8,1,0,0,9
342749,148875,2012-02-01,House,"House Third Reading: Given Immediate Effect Roll Call # 22",90,16,0,0,106
342749,197972,2012-05-22,Senate,"Reported Favorably Without Amendment",3,1,0,0,4
342749,197973,2012-05-23,Senate,"Senate Third Reading: Passed Roll Call # 381",24,13,0,1,38
342756,104365,2011-12-01,House,"Reported With Recommendation With Substitute H-1",17,0,0,0,17
342756,105517,2011-12-08,House,"House Third Reading: Given Immediate Effect Roll Call # 562",105,3,0,0,108
342782,103201,2011-11-03,Senate,"Reported Favorably With Substitute S-1",3,0,0,0,3
342782,144039,2012-01-19,Senate,"Senate Third Reading: Passed Roll Call # 2",30,6,0,2,38
342782,155204,2012-02-15,House,"Reported With Recommendation With Substitute H-1",3,0,0,0,3
342782,166300,2012-03-01,House,"House Third Reading: Given Immediate Effect Roll Call # 85",96,11,0,0,107
342782,169174,2012-03-07,Senate,"Senate Third Reading:  Roll Call # 111",31,7,0,0,38
342783,105407,2011-12-07,Senate,"Reported Favorably With Substitute S-3",3,0,0,0,3
342784,103312,2011-11-09,House,"Reported With Recommendation Without Amendment",9,7,0,0,16
342784,103672,2011-11-30,House,"House Third Reading: Given Immediate Effect Roll Call # 508",66,40,0,0,106
342784,105708,2011-12-14,Senate,"Reported Favorably With Substitute S-2",9,0,0,0,9
342784,138781,2011-12-15,Senate,"Senate Third Reading: Given Immediate Effect Roll Call # 836",20,18,0,0,38
342784,150554,2012-02-07,House,"House Third Reading:  Roll Call # 28",63,41,0,0,104
342785,105424,2011-12-07,Senate,"Reported Favorably With Substitute S-3",3,0,0,0,3
342793,195266,2012-05-09,House,"Reported With Recommendation Without Amendment",14,0,0,0,14
342794,103316,2011-11-09,House,"Reported With Recommendation Without Amendment",9,7,0,0,16
342794,103646,2011-11-30,House,"House Third Reading: Given Immediate Effect Roll Call # 509",64,42,0,0,106
342794,105710,2011-12-14,Senate,"Reported Favorably With Substitute S-4",9,0,0,0,9
342794,138783,2011-12-15,Senate,"Senate Third Reading: Given Immediate Effect Roll Call # 837",20,18,0,0,38
342794,150561,2012-02-07,House,"House Third Reading:  Roll Call # 29",63,41,0,0,104
342795,200673,2012-05-31,House,"Reported With Recommendation With Substitute H-3",15,0,0,0,15
342795,202598,2012-06-14,House,"House Third Reading: Given Immediate Effect Roll Call # 465",103,7,0,0,110
342795,211904,2012-09-12,Senate,"Reported Favorably Without Amendment",4,0,0,0,4
342795,212126,2012-09-20,Senate,"Senate Third Reading: Given Immediate Effect Roll Call # 648",38,0,0,0,38
342795,212262,2012-09-27,House,"House Third Reading:  Roll Call # 552",101,7,0,0,108
342798,145966,2012-01-24,House,"Reported With Recommendation Without Amendment",9,0,0,0,9
342798,148796,2012-02-01,House,"House Third Reading: Given Immediate Effect Roll Call # 23",104,2,0,0,106
342799,198619,2012-05-24,House,"Reported With Recommendation With Substitute H-4",9,0,0,0,9
342799,200506,2012-05-31,House,"House Third Reading: Given Immediate Effect Roll Call # 344",67,43,0,0,110
342799,209751,2012-08-15,Senate,"Reported Favorably With Amendment(s)",3,0,0,0,3
342799,211910,2012-09-12,Senate,"Senate Third Reading: Given Immediate Effect Roll Call # 621",38,0,0,0,38
342799,212241,2012-09-27,House,"House Third Reading: Senate Amendment(s) Concurred In Roll Call # 549",78,30,0,0,108
342808,105508,2011-12-07,Senate,"Reported Favorably With Substitute S-2",3,0,0,0,3
342848,160218,2012-02-22,Senate,"Reported Favorably Without Amendment",3,0,0,0,3
342848,172543,2012-03-14,Senate,"Senate Third Reading: Passed Roll Call # 135",31,7,0,0,38
342848,201515,2012-06-06,House,"Reported With Recommendation With Substitute H-1",7,1,0,0,8
342848,202445,2012-06-14,House,"House Third Reading: Given Immediate Effect Roll Call # 458",86,24,0,0,110
342848,202446,2012-06-14,Senate,"Senate Third Reading:  Roll Call # 555",31,7,0,0,38
342855,154552,2012-02-14,House,"Reported With Recommendation With Substitute H-1",7,2,0,0,9
342855,172226,2012-03-13,House,"House Third Reading: Passed Roll Call # 105",71,38,0,0,109
342855,192661,2012-05-02,Senate,"Reported Favorably Without Amendment",3,0,0,0,3
342855,204097,2012-03-13,House,"House Third Reading:  Roll Call # 106",69,40,0,0,109
342857,103203,2011-11-03,House,"Reported With Recommendation With Substitute H-1",15,0,0,0,15
342857,144049,2012-01-19,House,"House Third Reading: Given Immediate Effect Roll Call # 1",106,0,0,0,106
342857,178653,2012-03-27,Senate,"Reported Favorably Without Amendment",8,0,0,0,8
342857,201860,2012-06-12,Senate,"Senate Third Reading: Given Immediate Effect Roll Call # 479",38,0,0,0,38
342875,151610,2012-02-08,House,"Reported With Recommendation With Substitute H-1",16,0,0,0,16
342875,155764,2012-02-15,House,"House Third Reading: Given Immediate Effect Roll Call # 55",106,1,0,0,107
342875,176054,2012-03-20,Senate,"Reported Favorably With Amendment(s)",5,0,0,0,5
342875,197981,2012-05-23,Senate,"Senate Third Reading: Given Immediate Effect Roll Call # 385",28,7,2,1,38
342875,199998,2012-05-30,House,"House Third Reading: Senate Amendment(s) Concurred In As Amended Roll Call # 315",107,2,0,0,109
342875,200529,2012-05-31,Senate,"Senate Third Reading: House Amendment(s) To Senate Amendment(s) Concurred In Roll Call # 411",34,2,0,2,38
342885,201607,2012-06-07,House,"Reported With Recommendation With Substitute H-1",16,0,0,0,16
342885,212361,2012-09-27,House,"House Third Reading: Given Immediate Effect Roll Call # 574",97,10,0,0,107
342885,215291,2012-12-06,Senate,"Reported Favorably With Recommendation For Referral To Committee On Economic Development",3,0,0,0,3
342987,105313,2011-12-08,Senate,"Reported Favorably Without Amendment",8,0,0,0,8
342987,148645,2012-02-01,Senate,"Senate Third Reading: Passed Roll Call # 35",37,0,0,1,38
342987,157659,2012-02-16,House,"Reported With Recommendation Without Amendment",16,0,0,0,16
342987,165092,2012-02-29,House,"House Third Reading: Given Immediate Effect Roll Call # 81",106,0,0,0,106
342997,103394,2011-11-10,Senate,"Reported Favorably Without Amendment",6,0,0,0,6
342997,103630,2011-11-29,Senate,"Senate Third Reading: Passed Roll Call # 704",36,2,0,0,38
342999,103215,2011-11-03,Senate,"Reported Favorably Without Amendment",5,0,0,0,5
343001,105336,2011-12-08,Senate,"Reported Favorably Without Amendment",8,0,0,0,8
343001,148743,2012-02-01,Senate,"Senate Third Reading: Passed Roll Call # 34",37,0,0,1,38
343001,157780,2012-02-16,House,"Reported With Recommendation Without Amendment",17,0,0,0,17
343001,166554,2012-02-29,House,"House Third Reading: Given Immediate Effect Roll Call # 80",106,0,0,0,106
343002,103373,2011-11-09,Senate,"Reported Favorably Without Amendment",3,0,0,0,3
343002,104930,2011-12-01,Senate,"Senate Third Reading: Passed Roll Call # 727",36,0,1,1,38
343002,173699,2012-03-15,House,"Reported With Recommendation Without Amendment",13,0,0,0,13
343002,201603,2012-06-07,House,"House Third Reading: Given Immediate Effect Roll Call # 385",107,0,0,0,107
343002,201996,2012-06-12,Senate,"Senate Third Reading:  Roll Call # 476",37,0,0,1,38
343027,104527,2011-12-01,House,"Reported With Recommendation With Substitute H-1",12,0,0,0,12
343027,148571,2012-02-01,House,"House Third Reading: Given Immediate Effect Roll Call # 21",100,6,0,0,106
343027,200282,2012-05-31,Senate,"Reported Favorably With Substitute S-1",3,0,0,0,3
343027,202128,2012-06-13,Senate,"Senate Third Reading: Given Immediate Effect Roll Call # 493",25,12,0,1,38
343027,202452,2012-06-14,House,"House Third Reading:  Roll Call # 473",101,9,0,0,110
343035,103421,2011-11-10,House,"Reported With Recommendation Without Amendment",9,0,0,0,9
343035,105471,2011-12-06,House,"House Third Reading: Given Immediate Effect Roll Call # 524",104,0,0,0,104
343035,145031,2012-01-24,Senate,"Reported Favorably Without Amendment",6,0,0,0,6
343035,152087,2012-02-09,Senate,"Senate Third Reading: Given Immediate Effect Roll Call # 57",36,0,0,2,38
343068,103265,2011-11-08,Senate,"Reported Favorably Without Amendment",3,0,0,0,3
343114,103326,2011-11-09,Senate,"Reported Favorably Without Amendment",3,0,0,0,3
343114,103426,2011-11-10,Senate,"Senate Third Reading: Passed Roll Call # 679",36,0,0,2,38
343114,105475,2011-12-07,House,"Reported With Recommendation With Substitute H-1",5,0,0,0,5
343114,105476,2011-12-08,House,"House Third Reading: Given Immediate Effect Roll Call # 555",108,0,0,0,108
343114,138632,2011-12-13,Senate,"Senate Third Reading:  Roll Call # 768",38,0,0,0,38
343117,103325,2011-11-09,Senate,"Reported Favorably Without Amendment",3,0,0,0,3
343117,103428,2011-11-10,Senate,"Senate Third Reading: Passed Roll Call # 678",36,0,0,2,38
343117,105480,2011-12-07,House,"Reported With Recommendation Without Amendment",5,0,0,0,5
343117,105481,2011-12-08,House,"House Third Reading: Given Immediate Effect Roll Call # 554",108,0,0,0,108
343118,104450,2011-12-01,House,"Reported With Recommendation Without Amendment",16,0,0,0,16
343118,202283,2012-06-12,House,"House Third Reading: Given Immediate Effect Roll Call # 414",110,0,0,0,110
343118,209844,2012-08-15,Senate,"Senate Third Reading: Given Immediate Effect Roll Call # 613",25,12,0,1,38
343122,196052,2012-05-15,Senate,"Reported Favorably With Substitute S-3",12,1,0,0,13
343122,199872,2012-05-29,Senate,"Senate Third Reading: Passed Roll Call # 389",30,5,0,3,38
343122,210024,2012-08-15,House,"Reported With Recommendation Without Amendment",23,1,0,0,24
343122,212091,2012-09-19,House,"House Third Reading: Passed Roll Call # 528",104,1,0,0,105
343125,190561,2012-04-26,House,"Reported With Recommendation Without Amendment",16,0,0,0,16
343127,103653,2011-11-30,House,"House Third Reading: Adverse Roll Call",7,0,0,0,7
343127,104815,2011-12-07,House,"Reported With Recommendation With Substitute H-1",14,1,0,0,15
343127,105670,2011-12-08,House,"House Third Reading: Given Immediate Effect Roll Call # 537",107,1,0,0,108
343127,105671,2011-12-14,Senate,"Reported Favorably Without Amendment",9,0,0,0,9
343127,105672,2011-12-14,Senate,"Senate Third Reading: Given Immediate Effect Roll Call # 791",34,3,0,1,38
343129,103439,2011-11-10,Senate,"Reported Favorably With Substitute S-1",6,0,0,0,6
343129,103440,2011-11-10,Senate,"Senate Third Reading:  Roll Call # 664",13,24,0,1,38
343129,103441,2011-11-10,Senate,"Senate Third Reading:  Roll Call # 665",19,17,1,1,38
343129,103442,2011-11-10,Senate,"Senate Third Reading:  Roll Call # 666",12,25,0,1,38
343129,103443,2011-11-10,Senate,"Senate Third Reading:  Roll Call # 667",20,17,0,1,38
343213,104786,2011-12-01,House,"Reported With Recommendation Without Amendment",17,0,0,0,17
343213,105659,2011-12-08,House,"House Third Reading: Given Immediate Effect Roll Call # 563",104,4,0,0,108
343213,138750,2011-12-15,Senate,"Senate Third Reading: Given Immediate Effect Roll Call # 825",32,6,0,0,38
343214,192304,2012-05-02,House,"Reported With Recommendation Without Amendment",16,0,0,0,16
343214,196314,2012-05-15,House,"House Third Reading: Passed Roll Call # 266",109,0,0,0,109
343214,201555,2012-06-07,Senate,"Reported Favorably Without Amendment",7,0,0,0,7
343214,211923,2012-09-12,Senate,"Senate Third Reading: Given Immediate Effect Roll Call # 619",38,0,0,0,38
343215,156049,2012-02-14,House,"Reported With Recommendation With Substitute H-1",6,0,0,0,6
343215,172803,2012-03-14,House,"House Third Reading: Passed Roll Call # 117",110,0,0,0,110
343215,195225,2012-05-10,Senate,"Reported Favorably With Substitute S-2",6,0,0,0,6
343215,202533,2012-06-14,Senate,"Senate Third Reading: Given Immediate Effect Roll Call # 528",37,0,1,0,38
343215,202534,2012-06-14,House,"House Third Reading:  Roll Call # 483",109,0,0,0,109
343216,212145,2012-09-20,House,"Reported With Recommendation With Substitute H-1",14,0,0,0,14
343216,212276,2012-09-27,House,"House Third Reading: Given Immediate Effect Roll Call # 589",107,0,0,0,107
343216,215288,2012-12-06,Senate,"Reported Favorably Without Amendment",5,0,0,0,5
343216,215670,2012-12-13,Senate,"Senate Third Reading: Given Immediate Effect Roll Call # 978",36,0,2,0,38
343218,195413,2012-05-09,House,"Reported With Recommendation Without Amendment",14,0,0,0,14
343219,103776,2011-11-10,House,"Reported With Recommendation With Amendment(s)",15,0,0,0,15
343225,165265,2012-02-29,House,"Reported With Recommendation With Substitute H-1",17,0,0,0,17
343225,172228,2012-03-13,House,"House Third Reading: Given Immediate Effect Roll Call # 112",109,0,0,0,109
343225,202493,2012-06-13,Senate,"Reported Favorably Without Amendment",7,0,0,0,7
343228,104389,2011-12-06,Senate,"Reported Favorably With Substitute S-1",4,0,0,0,4
343228,154255,2012-02-14,Senate,"Senate Third Reading: Passed Roll Call # 66",30,8,0,0,38
343228,197885,2012-05-22,House,"Reported With Recommendation With Amendment(s)",6,3,0,0,9
343228,202106,2012-06-12,House,"House Third Reading: Given Immediate Effect Roll Call # 421",67,43,0,0,110
343228,202107,2012-06-13,Senate,"Senate Third Reading: House Amendment(s) Concurred In Roll Call # 513",26,11,0,1,38
343229,154926,2012-02-14,Senate,"Reported Favorably With Recommendation For Referral To Committee On Reforms, Restructuring And Reinventing",11,2,0,0,13
343229,190517,2012-04-26,Senate,"Reported Favorably With Substitute S-1",5,2,0,0,7
343229,193401,2012-05-03,Senate,"Senate Third Reading: Passed Roll Call # 305",27,11,0,0,38
343229,215094,2012-12-04,House,"Reported With Recommendation With Substitute H-4",4,0,0,0,4
343229,215557,2012-12-12,House,"House Third Reading: Given Immediate Effect Roll Call # 759",102,7,0,0,109
343229,215721,2012-12-13,Senate,"Senate Third Reading:  Roll Call # 1031",28,10,0,0,38
343236,104973,2011-12-01,Senate,"Reported Favorably With Substitute S-1",5,2,0,0,7
343236,104974,2011-12-01,Senate,"Senate Third Reading: Passed Roll Call # 733",23,11,1,3,38
343236,105746,2011-12-13,House,"Reported With Recommendation With Substitute H-1",12,7,0,0,19
343236,105747,2011-12-14,House,"House Third Reading: Given Immediate Effect Roll Call # 591",61,47,0,0,108
343236,105748,2011-12-14,Senate,"Senate Third Reading:  Roll Call # 809",26,12,0,0,38
343238,149238,2012-02-01,House,"Reported With Recommendation Without Amendment",13,1,0,0,14
343239,202036,2012-06-12,Senate,"Reported Favorably With Substitute S-1",4,1,0,0,5
343240,198475,2012-05-24,Senate,"Reported Favorably With Substitute S-3",4,0,0,0,4
343240,201395,2012-06-06,Senate,"Senate Third Reading: Passed Roll Call # 446",38,0,0,0,38
343240,212144,2012-09-20,House,"Reported With Recommendation With Substitute H-1",17,0,0,0,17
343240,212265,2012-09-27,House,"House Third Reading: Given Immediate Effect Roll Call # 554",108,0,0,0,108
343240,212266,2012-09-27,Senate,"Senate Third Reading:  Roll Call # 689",35,0,0,3,38
343242,211938,2012-09-13,Senate,"Reported Favorably Without Amendment",7,0,0,0,7
343242,214618,2012-11-29,Senate,"Senate Third Reading: Passed Roll Call # 780",38,0,0,0,38
343246,103628,2011-11-29,Senate,"Reported Favorably Without Amendment",7,0,0,0,7
343246,103682,2011-11-30,Senate,"Senate Third Reading: Passed Roll Call # 718",38,0,0,0,38
343246,104961,2011-12-07,House,"Reported With Recommendation Without Amendment",10,0,0,0,10
343246,105741,2011-12-14,House,"House Third Reading: Given Immediate Effect Roll Call # 589",66,41,0,0,107
343681,191969,2012-05-01,House,"Reported With Recommendation With Substitute H-2",10,0,0,0,10
343681,195550,2012-05-10,House,"House Third Reading: Given Immediate Effect Roll Call # 263",106,0,0,0,106
343681,199371,2012-05-29,Senate,"Reported Favorably Without Amendment",5,1,0,0,6
343681,202267,2012-06-13,Senate,"Senate Third Reading: Given Immediate Effect Roll Call # 488",31,6,0,1,38
343710,213751,2012-11-27,Senate,"Reported Favorably With Substitute S-2",3,1,0,0,4
343710,214358,2012-11-29,Senate,"Senate Third Reading: Passed Roll Call # 795",36,1,0,1,38
343710,215043,2012-12-04,House,"Reported With Recommendation Without Amendment",8,0,0,0,8
343710,215907,2012-12-14,House,"House Third Reading: Passed Roll Call # 884",71,36,0,0,107
343710,215908,2012-12-14,Senate,"Senate Third Reading:  Roll Call # 1087",26,12,0,0,38
343712,103631,2011-11-29,House,"Reported With Recommendation Without Amendment",5,0,0,0,5
343712,104967,2011-12-01,House,"House Third Reading: Passed Roll Call # 522",62,45,0,0,107
343718,144687,2012-01-18,Senate,"Reported Favorably With Substitute S-2",4,0,0,0,4
343718,150986,2012-02-07,Senate,"Senate Third Reading: Passed Roll Call # 41",38,0,0,0,38
343718,213665,2012-11-08,House,"Reported With Recommendation With Amendment(s)",10,0,0,0,10
343718,214404,2012-11-29,House,"House Third Reading: Passed Roll Call # 642",108,0,0,0,108
343718,215144,2012-12-05,Senate,"Senate Third Reading: House Amendment(s) Concurred In Roll Call # 812",38,0,0,0,38
343719,154821,2012-02-14,Senate,"Reported Favorably With Substitute S-1",6,0,0,0,6
343735,213752,2012-11-27,Senate,"Reported Favorably Without Amendment",4,0,0,0,4
343735,214360,2012-11-29,Senate,"Senate Third Reading: Passed Roll Call # 796",37,0,0,1,38
343735,215049,2012-12-04,House,"Reported With Recommendation Without Amendment",8,0,0,0,8
343735,215910,2012-12-14,House,"House Third Reading: Passed Roll Call # 885",99,8,0,0,107
343742,164716,2012-02-29,House,"Reported With Recommendation For Referral To Committee On Natural Resources, Tourism, And Outdoor Recreation",14,0,0,0,14
343760,150534,2012-02-07,Senate,"Reported Favorably With Substitute S-2",3,1,0,0,4
343760,154289,2012-02-14,Senate,"Senate Third Reading: Passed Roll Call # 68",26,12,0,0,38
343760,197816,2012-05-22,House,"Reported With Recommendation With Amendment(s)",6,3,0,0,9
343760,201833,2012-06-12,House,"House Third Reading: Given Immediate Effect Roll Call # 422",68,42,0,0,110
343760,202145,2012-06-13,Senate,"Senate Third Reading: House Amendment(s) Concurred In Roll Call # 514",26,11,0,1,38
343772,195468,2012-05-10,House,"Reported With Recommendation With Amendment(s)",11,0,0,0,11
343772,198392,2012-05-24,House,"House Third Reading: Given Immediate Effect Roll Call # 293",108,0,0,0,108
343772,209771,2012-08-15,Senate,"Reported Favorably Without Amendment",3,0,0,0,3
343772,211864,2012-09-11,Senate,"Senate Third Reading: Given Immediate Effect Roll Call # 616",37,0,0,1,38
343774,207221,2012-07-18,House,"Reported With Recommendation For Referral To Committee On Military And Veterans Affairs And Homeland Security",13,0,0,0,13
343779,150446,2012-02-07,Senate,"Reported Favorably With Substitute S-2",3,1,0,0,4
343779,154269,2012-02-14,Senate,"Senate Third Reading: Passed Roll Call # 71",26,12,0,0,38
343779,197895,2012-05-22,House,"Reported With Recommendation With Substitute H-2",6,3,0,0,9
343779,202135,2012-06-12,House,"House Third Reading: Given Immediate Effect Roll Call # 423",65,45,0,0,110
343779,202136,2012-06-13,Senate,"Senate Third Reading:  Roll Call # 515",26,11,0,1,38
343790,104829,2011-12-01,House,"Reported With Recommendation With Substitute H-1",7,2,0,0,9
343791,144788,2012-01-18,Senate,"Reported Favorably With Substitute S-2",4,0,0,0,4
343791,150545,2012-02-07,Senate,"Senate Third Reading: Passed Roll Call # 40",38,0,0,0,38
343791,213668,2012-11-08,House,"Reported With Recommendation With Amendment(s)",10,0,0,0,10
343791,214426,2012-11-29,House,"House Third Reading: Passed Roll Call # 641",108,0,0,0,108
343791,215068,2012-12-05,Senate,"Senate Third Reading: House Amendment(s) Concurred In Roll Call # 811",38,0,0,0,38
343795,144841,2012-01-18,Senate,"Reported Favorably With Substitute S-2",4,0,0,0,4
343795,150592,2012-02-07,Senate,"Senate Third Reading: Passed Roll Call # 39",38,0,0,0,38
343795,213671,2012-11-08,House,"Reported With Recommendation With Amendment(s)",10,0,0,0,10
343795,214471,2012-11-29,House,"House Third Reading: Passed Roll Call # 640",108,0,0,0,108
343795,215074,2012-12-05,Senate,"Senate Third Reading: House Amendment(s) Concurred In Roll Call # 810",38,0,0,0,38
343797,150468,2012-02-07,Senate,"Reported Favorably Without Amendment",3,1,0,0,4
343797,154328,2012-02-14,Senate,"Senate Third Reading: Passed Roll Call # 69",26,12,0,0,38
343797,197907,2012-05-22,House,"Reported With Recommendation Without Amendment",6,3,0,0,9
343797,202163,2012-06-12,House,"House Third Reading: Given Immediate Effect Roll Call # 424",68,42,0,0,110
343797,202164,2012-06-13,Senate,"Senate Third Reading: House Amendment(s) Concurred In Roll Call # 516",26,11,0,1,38
343809,105333,2011-12-08,Senate,"Senate Third Reading: Passed Roll Call # 767",26,9,0,3,38
343809,159670,2012-02-21,House,"House Third Reading: Given Immediate Effect Roll Call # 62",106,0,0,0,106
343809,159671,2012-02-22,Senate,"Senate Third Reading:  Roll Call # 91",37,1,0,0,38
343811,105695,2011-12-14,House,"Reported With Recommendation With Substitute H-2",17,7,0,0,24
343835,144867,2012-01-18,Senate,"Reported Favorably With Substitute S-2",4,0,0,0,4
343835,150660,2012-02-07,Senate,"Senate Third Reading: Passed Roll Call # 38",38,0,0,0,38
343835,213670,2012-11-08,House,"Reported With Recommendation With Amendment(s)",10,0,0,0,10
343835,214459,2012-11-29,House,"House Third Reading: Passed Roll Call # 639",108,0,0,0,108
343835,215073,2012-12-05,Senate,"Senate Third Reading: House Amendment(s) Concurred In Roll Call # 809",38,0,0,0,38
343848,168125,2012-03-06,Senate,"Reported Favorably With Substitute S-3",5,0,0,0,5
343848,176994,2012-03-22,Senate,"Senate Third Reading: Passed Roll Call # 152",33,5,0,0,38
343848,207222,2012-07-18,House,"Reported With Recommendation With Substitute H-3",9,0,0,0,9
343848,207223,2012-07-18,House,"House Third Reading: Given Immediate Effect Roll Call # 503",63,46,0,0,109
343848,207224,2012-07-18,Senate,"Senate Third Reading:  Roll Call # 594",28,9,0,1,38
343849,195496,2012-05-10,House,"Reported With Recommendation With Substitute H-1",12,0,0,0,12
343849,198500,2012-05-24,House,"House Third Reading: Given Immediate Effect Roll Call # 294",108,0,0,0,108
343849,209752,2012-08-15,Senate,"Reported Favorably Without Amendment",3,0,0,0,3
343849,211862,2012-09-11,Senate,"Senate Third Reading: Given Immediate Effect Roll Call # 617",37,0,0,1,38
343849,212369,2012-09-27,House,"House Third Reading: Senate Amendment(s) Concurred In Roll Call # 547",108,0,0,0,108
344185,194940,2012-05-09,House,"Reported With Recommendation Without Amendment",15,0,0,0,15
344227,155951,2012-02-14,House,"Reported With Recommendation With Substitute H-1",7,2,0,0,9
344227,172150,2012-03-13,House,"House Third Reading: Passed Roll Call # 109",72,37,0,0,109
344227,192510,2012-05-02,Senate,"Reported Favorably Without Amendment",3,0,0,0,3
344227,203305,2012-03-13,House,"House Third Reading:  Roll Call # 110",69,40,0,0,109
344233,105650,2011-12-14,Senate,"Reported Favorably Without Amendment",6,0,0,0,6
344233,143741,2012-01-19,Senate,"Senate Third Reading: Passed Roll Call # 6",36,0,0,2,38
344233,200627,2012-05-30,House,"Reported With Recommendation Without Amendment",17,0,0,0,17
344233,202559,2012-06-14,House,"House Third Reading: Given Immediate Effect Roll Call # 453",110,0,0,0,110
344236,105649,2011-12-14,House,"Reported With Recommendation Without Amendment",19,1,0,0,20
344252,104792,2011-12-07,House,"Reported With Recommendation With Substitute H-1",25,0,0,0,25
344252,105665,2011-12-14,House,"House Third Reading: Given Immediate Effect Roll Call # 594",108,0,0,0,108
344252,173244,2012-03-15,Senate,"Reported Favorably Without Amendment",15,0,0,0,15
344252,192960,2012-05-03,Senate,"Senate Third Reading: Given Immediate Effect Roll Call # 303",38,0,0,0,38
344257,105662,2011-12-01,Senate,"Reported Favorably Without Amendment",5,0,0,0,5
344257,105663,2011-12-08,Senate,"Senate Third Reading: Passed Roll Call # 763",30,5,0,3,38
344257,105664,2011-12-13,House,"Reported With Recommendation With Substitute H-1",12,7,0,0,19
344257,138755,2011-12-15,House,"House Third Reading: Given Immediate Effect Roll Call # 613",82,24,0,0,106
344257,138756,2011-12-15,Senate,"Senate Third Reading:  Roll Call # 842",35,3,0,0,38
344259,215222,2012-12-06,House,"Reported With Recommendation With Substitute H-2",10,0,0,0,10
344262,156070,2012-02-14,House,"Reported With Recommendation With Substitute H-1",6,2,0,0,8
344262,168571,2012-02-14,House,"Reported With Recommendation Without Amendment",6,2,0,0,8
344262,172207,2012-03-13,House,"House Third Reading: Passed Roll Call # 107",72,37,0,0,109
344262,192650,2012-05-02,Senate,"Reported Favorably Without Amendment",3,0,0,0,3
344262,204085,2012-03-13,House,"House Third Reading:  Roll Call # 108",70,39,0,0,109
344262,215459,2012-12-12,Senate,"Senate Third Reading: Passed Roll Call # 880",29,9,0,0,38
344266,104803,2011-12-07,House,"Reported With Recommendation With Substitute H-3",3,2,0,0,5
344266,105667,2011-12-08,House,"House Third Reading: Passed Roll Call # 564",58,50,0,0,108
344266,105668,2011-12-14,Senate,"Senate Third Reading: Given Immediate Effect Roll Call # 803",20,17,0,1,38
344267,198695,2012-05-24,House,"Reported With Recommendation For Referral To Committee On Oversight, Reform, And Ethics",13,0,0,0,13
344268,146269,2012-01-25,House,"Reported With Recommendation Without Amendment",17,0,0,0,17
344268,152222,2012-02-09,House,"House Third Reading: Given Immediate Effect Roll Call # 44",94,11,0,0,105
344268,166207,2012-03-01,Senate,"Reported Favorably Without Amendment",6,0,0,0,6
344268,191715,2012-05-01,Senate,"Senate Third Reading: Given Immediate Effect Roll Call # 271",36,1,0,1,38
344294,104754,2011-12-07,House,"Reported With Recommendation With Substitute H-1",17,2,0,0,19
344294,104755,2011-12-07,House,"House Third Reading: Given Immediate Effect Roll Call # 530",68,40,0,0,108
344294,190054,2012-04-26,Senate,"Senate Third Reading: Given Immediate Effect Roll Call # 268",38,0,0,0,38
344294,190055,2012-04-26,House,"House Third Reading:  Roll Call # 210",96,9,0,0,105
344295,104763,2011-12-06,House,"Reported With Recommendation With Substitute H-1",13,3,0,0,16
344295,104764,2011-12-07,House,"House Third Reading: Given Immediate Effect Roll Call # 529",62,46,0,0,108
344295,138746,2011-12-15,Senate,"Senate Third Reading: Given Immediate Effect Roll Call # 840",36,1,1,0,38
344295,138747,2011-12-15,House,"House Third Reading:  Roll Call # 618",100,6,0,0,106
344314,198088,2012-05-23,Senate,"Reported Favorably With Substitute S-1",6,0,0,0,6
344314,201466,2012-06-06,Senate,"Senate Third Reading: Passed Roll Call # 445",38,0,0,0,38
344314,215821,2012-12-14,House,"House Third Reading: Given Immediate Effect Roll Call # 869",107,0,0,0,107
344314,215822,2012-12-14,Senate,"Senate Third Reading:  Roll Call # 1079",38,0,0,0,38
344314,217275,2012-12-13,House,"Reported With Recommendation With Substitute H-1",12,0,0,0,12
344317,104937,2011-12-07,Senate,"Reported Favorably With Substitute S-2",3,0,0,0,3
344317,104938,2011-12-07,Senate,"Senate Third Reading: Passed Roll Call # 742",34,2,0,2,38
344317,138838,2011-12-15,House,"House Third Reading: Given Immediate Effect Roll Call # 616",106,1,0,0,107
344317,138839,2011-12-15,Senate,"Senate Third Reading:  Roll Call # 844",37,1,0,0,38
344318,105729,2011-12-14,Senate,"Reported Favorably With Substitute S-1",9,0,0,0,9
344318,138840,2011-12-15,Senate,"Senate Third Reading: Passed Roll Call # 832",26,12,0,0,38
344318,215176,2012-12-06,House,"Reported With Recommendation With Substitute H-5",9,5,0,0,14
344318,215526,2012-12-12,House,"House Third Reading: Passed Roll Call # 782",63,46,0,0,109
344318,215527,2012-12-12,House,"House Third Reading:  Roll Call # 783",64,45,0,0,109
344318,215690,2012-12-13,Senate,"Senate Third Reading:  Roll Call # 1007",23,15,0,0,38
344322,177070,2012-03-22,Senate,"Reported Favorably Without Amendment",3,0,0,0,3
344322,197996,2012-05-23,Senate,"Senate Third Reading: Passed Roll Call # 369",36,0,0,2,38
344322,200323,2012-05-31,House,"Reported With Recommendation Without Amendment",16,0,0,0,16
344322,202148,2012-06-13,House,"House Third Reading: Given Immediate Effect Roll Call # 440",110,0,0,0,110
344323,104940,2011-12-06,House,"Reported With Recommendation Without Amendment",5,0,0,0,5
344323,104941,2011-12-07,House,"House Third Reading: Given Immediate Effect Roll Call # 528",88,20,0,0,108
344323,138841,2011-12-15,Senate,"Reported Favorably Without Amendment",6,0,0,0,6
344323,145632,2012-01-25,Senate,"Senate Third Reading: Given Immediate Effect Roll Call # 18",35,2,1,0,38
344323,146200,2012-01-26,House,"House Third Reading:  Roll Call # 13",84,22,0,0,106
344324,104943,2011-12-07,House,"Reported With Recommendation Without Amendment",26,0,0,0,26
344324,105731,2011-12-08,House,"House Third Reading: Passed Roll Call # 566",105,1,0,0,106
344324,138842,2011-12-15,Senate,"Reported Favorably With Substitute S-1",6,0,0,0,6
344324,138843,2011-12-15,Senate,"Senate Third Reading: Given Immediate Effect Roll Call # 833",38,0,0,0,38
344324,145645,2012-01-19,House,"House Third Reading:  Roll Call # 4",103,3,0,0,106
344326,169723,2012-03-08,House,"Reported With Recommendation With Substitute H-1",5,0,0,0,5
344326,200682,2012-05-30,House,"House Third Reading: Given Immediate Effect Roll Call # 320",110,0,0,0,110
344326,215221,2012-12-06,Senate,"Reported Favorably With Substitute S-2",6,0,0,0,6
344326,215755,2012-12-13,Senate,"Senate Third Reading: Given Immediate Effect Roll Call # 951",38,0,0,0,38
344326,215756,2012-12-13,House,"House Third Reading:  Roll Call # 849",109,0,0,0,109
344327,196901,2012-05-17,Senate,"Reported Favorably Without Amendment",7,0,0,0,7
344327,198059,2012-05-23,Senate,"Senate Third Reading: Passed Roll Call # 378",37,0,0,1,38
344327,211903,2012-09-12,House,"Reported With Recommendation With Substitute H-1",13,2,0,0,15
344327,214524,2012-11-29,House,"House Third Reading: Given Immediate Effect Roll Call # 629",64,43,0,0,107
344327,215086,2012-12-05,Senate,"Senate Third Reading:  Roll Call # 813",38,0,0,0,38
344328,104944,2011-12-07,House,"Reported With Recommendation Without Amendment",26,0,0,0,26
344328,105730,2011-12-08,House,"House Third Reading: Passed Roll Call # 567",105,2,0,0,107
344328,138845,2011-12-15,Senate,"Reported Favorably With Substitute S-1",6,0,0,0,6
344328,138846,2011-12-15,Senate,"Senate Third Reading: Given Immediate Effect Roll Call # 834",38,0,0,0,38
344328,145657,2012-01-19,House,"House Third Reading:  Roll Call # 5",103,3,0,0,106
356225,145052,2012-01-24,House,"Reported With Recommendation Without Amendment",10,0,0,0,10
356244,158986,2012-02-21,Senate,"Reported Favorably Without Amendment",7,0,0,0,7
356294,159930,2012-02-22,Senate,"Reported Favorably Without Amendment",4,0,0,0,4
356294,175919,2012-03-20,Senate,"Senate Third Reading: Passed Roll Call # 145",38,0,0,0,38
356308,164561,2012-02-28,Senate,"Reported Favorably With Substitute S-1",11,0,0,0,11
356308,172998,2012-03-15,Senate,"Senate Third Reading: Passed Roll Call # 139",24,14,0,0,38
356308,193127,2012-05-02,House,"Reported With Recommendation Without Amendment",20,3,0,0,23
356308,195330,2012-05-10,House,"House Third Reading: Given Immediate Effect Roll Call # 261",71,35,0,0,106
356315,164571,2012-02-28,Senate,"Reported Favorably Without Amendment",11,0,0,0,11
356315,173021,2012-03-15,Senate,"Senate Third Reading: Passed Roll Call # 138",24,14,0,0,38
356315,193129,2012-05-02,House,"Reported With Recommendation Without Amendment",20,3,0,0,23
356315,195332,2012-05-10,House,"House Third Reading: Given Immediate Effect Roll Call # 260",70,37,0,0,107
356337,187704,2012-04-19,Senate,"Reported Favorably With Substitute S-4",3,0,0,0,3
356337,195355,2012-05-10,Senate,"Senate Third Reading: Passed Roll Call # 328",37,0,0,1,38
356337,202451,2012-06-12,House,"Reported With Recommendation With Substitute H-3",7,0,0,0,7
356337,212288,2012-09-27,House,"House Third Reading: Given Immediate Effect Roll Call # 560",108,0,0,0,108
356337,212289,2012-09-27,Senate,"Senate Third Reading:  Roll Call # 690",35,0,0,3,38
356379,164604,2012-02-28,Senate,"Reported Favorably With Substitute S-1",10,4,0,0,14
356379,168835,2012-03-07,Senate,"Senate Third Reading: Passed Roll Call # 116",21,17,0,0,38
356379,215502,2012-12-12,House,"Reported With Recommendation With Substitute H-3",16,9,0,0,25
356379,215829,2012-12-14,House,"House Third Reading: Passed Roll Call # 896",56,50,0,0,106
356379,215830,2012-12-14,Senate,"Senate Third Reading:  Roll Call # 1092",21,17,0,0,38
356386,164610,2012-02-28,Senate,"Reported Favorably Without Amendment",10,5,0,0,15
356386,168838,2012-03-07,Senate,"Senate Third Reading: Passed Roll Call # 115",20,18,0,0,38
356408,148091,2012-01-31,Senate,"Reported Favorably With Substitute S-1",7,0,0,0,7
356408,156209,2012-02-16,Senate,"Senate Third Reading: Passed Roll Call # 85",38,0,0,0,38
356408,172890,2012-03-15,House,"Reported With Recommendation Without Amendment",14,0,0,0,14
356408,178800,2012-03-27,House,"House Third Reading: Given Immediate Effect Roll Call # 142",109,0,0,0,109
356408,180625,2012-03-29,House,"House Third Reading:  Roll Call # 146",108,0,0,0,108
356415,195078,2012-05-09,Senate,"Reported Favorably Without Amendment",7,0,0,0,7
356415,199916,2012-05-30,Senate,"Senate Third Reading: Passed Roll Call # 400",36,0,0,2,38
356415,212079,2012-09-19,House,"Reported With Recommendation Without Amendment",15,0,0,0,15
356415,215153,2012-12-06,House,"House Third Reading: Passed Roll Call # 707",57,52,0,0,109
356430,201621,2012-06-07,Senate,"Reported Favorably With Substitute S-1",8,0,0,0,8
356430,201622,2012-06-07,Senate,"Senate Third Reading: Passed Roll Call # 474",31,6,0,1,38
356430,202374,2012-06-13,House,"Reported With Recommendation With Substitute H-2",22,0,0,0,22
356430,202617,2012-06-14,House,"House Third Reading: Given Immediate Effect Roll Call # 450",79,31,0,0,110
356430,202618,2012-06-14,Senate,"Senate Third Reading:  Roll Call # 567",26,11,1,0,38
356436,196979,2012-05-17,Senate,"Reported Favorably With Substitute S-1",10,5,0,0,15
356436,201531,2012-06-07,Senate,"Senate Third Reading: Passed Roll Call # 465",24,13,0,1,38
356444,145973,2012-01-25,Senate,"Reported Favorably With Substitute S-1",7,0,0,0,7
356479,145433,2012-01-24,House,"Reported With Recommendation With Substitute H-1",10,0,0,0,10
356528,145438,2012-01-24,House,"Reported With Recommendation With Substitute H-1",10,0,0,0,10
356601,193260,2012-05-02,House,"Reported With Recommendation Without Amendment",16,0,0,0,16
356601,196246,2012-05-15,House,"House Third Reading: Given Immediate Effect Roll Call # 267",108,0,0,0,108
356601,201543,2012-06-07,Senate,"Reported Favorably Without Amendment",7,0,0,0,7
356601,211920,2012-09-12,Senate,"Senate Third Reading: Given Immediate Effect Roll Call # 620",38,0,0,0,38
356607,149047,2012-02-02,House,"Reported With Recommendation For Referral To Committee On Health Policy",16,0,0,0,16
356615,149046,2012-02-02,House,"Reported With Recommendation For Referral To Committee On Health Policy",16,0,0,0,16
356622,149057,2012-02-02,House,"Reported With Recommendation For Referral To Committee On Health Policy",16,0,0,0,16
356629,149064,2012-02-02,House,"Reported With Recommendation For Referral To Committee On Health Policy",16,0,0,0,16
356636,169822,2012-03-08,House,"Reported With Recommendation With Substitute H-1",16,0,0,0,16
356636,176123,2012-03-20,House,"House Third Reading: Given Immediate Effect Roll Call # 123",109,0,0,0,109
356636,195181,2012-05-10,Senate,"Reported Favorably Without Amendment",6,1,0,0,7
356636,196767,2012-05-17,Senate,"Senate Third Reading: Given Immediate Effect Roll Call # 361",36,2,0,0,38
356664,176588,2012-03-21,House,"Reported With Recommendation With Substitute H-2",16,0,0,0,16
356664,180913,2012-03-29,House,"House Third Reading: Passed Roll Call # 158",110,0,0,0,110
356664,198185,2012-05-23,Senate,"Reported Favorably With Substitute S-2",7,0,0,0,7
356664,201376,2012-06-06,Senate,"Senate Third Reading: Given Immediate Effect Roll Call # 444",38,0,0,0,38
356664,201956,2012-06-12,House,"House Third Reading:  Roll Call # 412",110,0,0,0,110
356679,143388,2012-01-17,House,"Reported With Recommendation For Referral To Committee On Natural Resources, Tourism, And Outdoor Recreation",7,0,0,0,7
356679,148187,2012-01-31,House,"Reported With Recommendation Without Amendment",10,0,0,0,10
356679,149286,2012-02-02,House,"House Third Reading: Given Immediate Effect Roll Call # 27",104,2,0,0,106
356679,189061,2012-04-24,Senate,"Reported Favorably Without Amendment",6,0,0,0,6
356679,201890,2012-06-12,Senate,"Senate Third Reading: Given Immediate Effect Roll Call # 480",33,4,1,0,38
356685,198476,2012-05-24,House,"Reported With Recommendation With Substitute H-3",9,2,0,0,11
356685,202341,2012-06-13,House,"House Third Reading: Given Immediate Effect Roll Call # 433",74,36,0,0,110
356685,211854,2012-09-11,Senate,"Reported Favorably Without Amendment",3,1,0,0,4
356685,215361,2012-12-12,Senate,"Senate Third Reading: Given Immediate Effect Roll Call # 877",27,11,0,0,38
356685,215535,2012-12-13,House,"House Third Reading:  Roll Call # 822",73,36,0,0,109
356685,215680,2012-12-14,Senate,"Senate Third Reading:  Roll Call # 1068",27,11,0,0,38
356700,196206,2012-05-15,House,"Reported With Recommendation With Substitute H-1",6,2,0,0,8
356700,201491,2012-06-07,House,"House Third Reading: Given Immediate Effect Roll Call # 383",71,37,0,0,108
356700,209827,2012-08-15,Senate,"Reported Favorably With Substitute S-3",3,1,0,0,4
356721,201627,2012-06-06,House,"Reported With Recommendation With Substitute H-1",15,0,0,0,15
356721,212058,2012-09-19,House,"House Third Reading: Given Immediate Effect Roll Call # 529",105,0,0,0,105
356721,214373,2012-11-29,Senate,"Reported Favorably Without Amendment",6,0,0,0,6
356721,215638,2012-12-13,Senate,"Senate Third Reading: Given Immediate Effect Roll Call # 996",37,1,0,0,38
356721,215828,2012-12-14,House,"House Third Reading: Senate Amendment(s) Concurred In Roll Call # 897",105,0,0,0,105
356774,148765,2012-02-01,House,"Reported With Recommendation Without Amendment",15,0,0,0,15
356774,150597,2012-02-07,House,"House Third Reading: Given Immediate Effect Roll Call # 38",104,0,0,0,104
356774,178985,2012-03-27,Senate,"Reported Favorably Without Amendment",5,0,0,0,5
356774,180741,2012-03-29,Senate,"Senate Third Reading: Given Immediate Effect Roll Call # 193",38,0,0,0,38
356782,148777,2012-02-01,House,"Reported With Recommendation Without Amendment",15,0,0,0,15
356782,150604,2012-02-07,House,"House Third Reading: Given Immediate Effect Roll Call # 37",104,0,0,0,104
356782,179011,2012-03-27,Senate,"Reported Favorably Without Amendment",5,0,0,0,5
356782,180751,2012-03-29,Senate,"Senate Third Reading: Given Immediate Effect Roll Call # 192",38,0,0,0,38
356789,148789,2012-02-01,House,"Reported With Recommendation Without Amendment",15,0,0,0,15
356789,150620,2012-02-07,House,"House Third Reading: Given Immediate Effect Roll Call # 36",104,0,0,0,104
356789,179054,2012-03-27,Senate,"Reported Favorably Without Amendment",5,0,0,0,5
356789,180764,2012-03-29,Senate,"Senate Third Reading: Given Immediate Effect Roll Call # 191",38,0,0,0,38
356794,148791,2012-02-01,House,"Reported With Recommendation Without Amendment",15,0,0,0,15
356794,150623,2012-02-07,House,"House Third Reading: Given Immediate Effect Roll Call # 35",104,0,0,0,104
356794,179058,2012-03-27,Senate,"Reported Favorably Without Amendment",5,0,0,0,5
356794,180768,2012-03-29,Senate,"Senate Third Reading: Given Immediate Effect Roll Call # 186",38,0,0,0,38
356803,148805,2012-02-01,House,"Reported With Recommendation Without Amendment",15,0,0,0,15
356803,150646,2012-02-07,House,"House Third Reading: Given Immediate Effect Roll Call # 34",104,0,0,0,104
356803,179077,2012-03-27,Senate,"Reported Favorably Without Amendment",5,0,0,0,5
356803,180772,2012-03-29,Senate,"Senate Third Reading: Given Immediate Effect Roll Call # 185",38,0,0,0,38
356811,148804,2012-02-01,House,"Reported With Recommendation Without Amendment",15,0,0,0,15
356811,150635,2012-02-07,House,"House Third Reading: Given Immediate Effect Roll Call # 33",104,0,0,0,104
356811,179082,2012-03-27,Senate,"Reported Favorably Without Amendment",5,0,0,0,5
356811,180786,2012-03-29,Senate,"Senate Third Reading: Given Immediate Effect Roll Call # 184",38,0,0,0,38
356816,148794,2012-02-01,House,"Reported With Recommendation Without Amendment",15,0,0,0,15
356816,150630,2012-02-07,House,"House Third Reading: Given Immediate Effect Roll Call # 32",104,0,0,0,104
356816,179055,2012-03-27,Senate,"Reported Favorably Without Amendment",5,0,0,0,5
356816,180763,2012-03-29,Senate,"Senate Third Reading: Given Immediate Effect Roll Call # 183",38,0,0,0,38
356830,170277,2012-03-08,House,"Reported With Recommendation With Amendment(s)",13,0,0,0,13
368303,198347,2012-05-22,House,"Reported With Recommendation With Substitute H-1",7,0,0,0,7
368303,212306,2012-09-27,House,"House Third Reading: Given Immediate Effect Roll Call # 562",106,2,0,0,108
368624,198346,2012-05-24,House,"Reported With Recommendation With Substitute H-2",13,3,0,0,16
368624,201636,2012-06-07,House,"House Third Reading: Given Immediate Effect Roll Call # 390",87,20,0,0,107
368624,202428,2012-06-14,Senate,"Reported Favorably With Substitute S-1",6,0,0,0,6
368624,202429,2012-06-14,Senate,"Senate Third Reading: Given Immediate Effect Roll Call # 547",28,8,2,0,38
368624,207215,2012-07-18,Senate,"Senate Third Reading:  Roll Call # 599",26,10,1,1,38
368624,207216,2012-07-18,House,"House Third Reading:  Roll Call # 504",86,23,0,0,109
368732,168758,2012-03-06,House,"Reported With Recommendation With Substitute H-2",18,0,0,0,18
368732,187593,2012-04-19,House,"House Third Reading: Passed Roll Call # 180",83,26,0,0,109
368732,215179,2012-12-06,Senate,"Reported Favorably With Substitute S-2",5,0,0,0,5
369904,198368,2012-05-24,Senate,"Reported Favorably Without Amendment",4,0,0,0,4
369904,201288,2012-06-06,Senate,"Senate Third Reading: Passed Roll Call # 447",38,0,0,0,38
369904,213657,2012-11-08,House,"Reported With Recommendation Without Amendment",10,0,0,0,10
369904,215631,2012-12-13,House,"House Third Reading: Given Immediate Effect Roll Call # 793",110,0,0,0,110
369904,215632,2012-12-13,Senate,"Senate Third Reading:  Roll Call # 1032",38,0,0,0,38
371341,168438,2012-03-06,Senate,"Reported Favorably Without Amendment",5,1,0,0,6
371341,176703,2012-03-21,Senate,"Senate Third Reading: Passed Roll Call # 147",34,4,0,0,38
371341,201532,2012-06-05,House,"Reported With Recommendation Without Amendment",11,0,0,0,11
371341,201894,2012-06-12,House,"House Third Reading: Given Immediate Effect Roll Call # 415",105,5,0,0,110
372060,212066,2012-09-19,House,"Reported With Recommendation With Substitute H-2",15,1,0,0,16
372060,214625,2012-11-29,House,"House Third Reading: Given Immediate Effect Roll Call # 659",105,1,0,0,106
372060,215610,2012-12-13,Senate,"Reported Favorably With Substitute S-3",7,0,0,0,7
372060,215611,2012-12-13,Senate,"Senate Third Reading: Given Immediate Effect Roll Call # 980",38,0,0,0,38
372060,215824,2012-12-14,House,"House Third Reading:  Roll Call # 877",107,0,0,0,107
372144,197041,2012-05-17,House,"Reported With Recommendation With Substitute H-1",16,0,0,0,16
372144,199921,2012-05-30,House,"House Third Reading: Passed Roll Call # 329",108,1,0,0,109
372144,199922,2012-05-30,House,"House Third Reading:  Roll Call # 330",102,8,0,0,110
372144,215241,2012-12-06,Senate,"Reported Favorably Without Amendment",4,0,0,0,4
372144,215636,2012-12-13,Senate,"Senate Third Reading: Given Immediate Effect Roll Call # 1009",37,0,1,0,38
376802,146227,2012-01-26,Senate,"Reported Favorably With Substitute S-1",6,1,0,0,7
376802,196577,2012-05-16,Senate,"Senate Third Reading: Passed Roll Call # 343",37,1,0,0,38
376908,209746,2012-08-15,Senate,"Reported Favorably With Substitute S-1",3,1,0,0,4
376966,209776,2012-08-15,Senate,"Reported Favorably With Substitute S-5",3,1,0,0,4
377022,189695,2012-04-25,Senate,"Reported Favorably Without Amendment",4,0,0,0,4
377022,196876,2012-05-17,Senate,"Senate Third Reading: Passed Roll Call # 352",37,1,0,0,38
377022,213643,2012-11-08,House,"Reported With Recommendation With Substitute H-1",11,0,0,0,11
377022,214149,2012-11-29,House,"House Third Reading: Passed Roll Call # 645",108,0,0,0,108
377022,215080,2012-12-05,Senate,"Senate Third Reading:  Roll Call # 816",37,1,0,0,38
377077,189734,2012-04-25,Senate,"Reported Favorably With Substitute S-1",4,0,0,0,4
377077,196913,2012-05-17,Senate,"Senate Third Reading: Passed Roll Call # 351",36,1,1,0,38
377077,213651,2012-11-08,House,"Reported With Recommendation With Substitute H-1",11,0,0,0,11
377077,214294,2012-11-29,House,"House Third Reading: Passed Roll Call # 644",108,0,0,0,108
377077,215118,2012-12-05,Senate,"Senate Third Reading:  Roll Call # 815",37,1,0,0,38
377137,189697,2012-04-25,Senate,"Reported Favorably Without Amendment",4,0,0,0,4
377137,196884,2012-05-17,Senate,"Senate Third Reading: Passed Roll Call # 350",37,1,0,0,38
377137,213642,2012-11-08,House,"Reported With Recommendation With Substitute H-1",11,0,0,0,11
377137,214115,2012-11-29,House,"House Third Reading: Passed Roll Call # 643",108,0,0,0,108
377137,215075,2012-12-05,Senate,"Senate Third Reading:  Roll Call # 814",37,1,0,0,38
377248,215353,2012-12-11,Senate,"Reported Favorably Without Amendment",3,0,0,0,3
377306,202140,2012-06-13,Senate,"Reported Favorably Without Amendment",7,0,0,0,7
377361,168832,2012-03-06,House,"Reported With Recommendation Without Amendment",8,1,0,0,9
377433,197119,2012-05-17,House,"Reported With Recommendation Without Amendment",10,1,0,0,11
377433,200454,2012-05-31,House,"House Third Reading: Given Immediate Effect Roll Call # 335",95,14,0,0,109
377433,215257,2012-12-06,Senate,"Reported Favorably Without Amendment",4,0,0,0,4
377433,215658,2012-12-13,Senate,"Senate Third Reading: Given Immediate Effect Roll Call # 946",36,2,0,0,38
377793,169839,2012-03-08,House,"Reported With Recommendation With Substitute H-3",6,0,0,0,6
377793,199900,2012-05-30,House,"House Third Reading: Given Immediate Effect Roll Call # 321",110,0,0,0,110
377936,177182,2012-03-21,House,"Reported With Recommendation With Substitute H-2",9,0,0,0,9
377936,180928,2012-03-29,House,"House Third Reading: Passed Roll Call # 157",103,7,0,0,110
377936,201848,2012-06-12,Senate,"Reported Favorably Without Amendment",5,0,0,0,5
377936,215757,2012-12-13,Senate,"Senate Third Reading: Given Immediate Effect Roll Call # 940",38,0,0,0,38
377936,215758,2012-12-13,Senate,"Senate Third Reading: Passed Roll Call # 987",33,5,0,0,38
377936,215903,2012-12-14,House,"House Third Reading:  Roll Call # 890",96,10,0,0,106
378029,165908,2012-03-01,House,"Reported With Recommendation Without Amendment",12,0,0,0,12
378029,172660,2012-03-13,House,"House Third Reading: Given Immediate Effect Roll Call # 113",109,0,0,0,109
378029,215327,2012-12-11,Senate,"Reported Favorably Without Amendment",3,0,0,0,3
378029,215664,2012-12-13,Senate,"Senate Third Reading: Given Immediate Effect Roll Call # 970",38,0,0,0,38
378125,155075,2012-02-15,House,"Reported With Recommendation For Referral To Committee On Education",26,0,0,0,26
378125,198849,2012-05-23,House,"Reported With Recommendation With Substitute H-2",17,0,0,0,17
378125,201570,2012-06-07,House,"House Third Reading: Given Immediate Effect Roll Call # 378",108,0,0,0,108
378125,212008,2012-09-13,Senate,"Reported Favorably With Recommendation For Referral To Committee On Education",15,0,0,0,15
378125,212304,2012-09-27,Senate,"Reported Favorably With Substitute S-2",5,0,0,0,5
378125,215369,2012-12-12,Senate,"Senate Third Reading: Given Immediate Effect Roll Call # 917",11,26,0,1,38
378125,215513,2012-12-13,House,"House Third Reading:  Roll Call # 832",109,0,0,0,109
378553,158785,2012-02-21,Senate,"Reported Favorably With Substitute S-1",7,0,0,0,7
378553,166528,2012-03-01,Senate,"Senate Third Reading: Passed Roll Call # 108",36,0,0,2,38
378553,187026,2012-04-18,House,"Reported With Recommendation With Substitute H-1",10,0,0,0,10
378553,195417,2012-05-10,House,"House Third Reading: Given Immediate Effect Roll Call # 257",107,0,0,0,107
378553,196662,2012-05-17,Senate,"Senate Third Reading:  Roll Call # 362",38,0,0,0,38
379781,187848,2012-04-19,House,"Reported With Recommendation Without Amendment",16,0,0,0,16
379781,195409,2012-05-10,House,"House Third Reading: Given Immediate Effect Roll Call # 258",106,0,0,0,106
379781,212328,2012-09-27,Senate,"Senate Third Reading: Given Immediate Effect Roll Call # 663",38,0,0,0,38
379781,212437,2012-06-06,Senate,"Reported Favorably With Amendment(s)",4,0,0,0,4
379781,214453,2012-11-29,Senate,"Senate Third Reading: Passed Roll Call # 779",38,0,0,0,38
379781,214973,2012-12-04,House,"House Third Reading:  Roll Call # 664",105,0,0,0,105
380739,186645,2012-04-17,Senate,"Reported Favorably Without Amendment",4,2,0,0,6
380739,213711,2012-11-27,Senate,"Senate Third Reading: Passed Roll Call # 748",23,15,0,0,38
380739,215194,2012-12-05,House,"Reported With Recommendation Without Amendment",10,0,0,0,10
380739,215883,2012-12-14,House,"House Third Reading: Passed Roll Call # 892",57,48,0,0,105
380789,186649,2012-04-17,Senate,"Reported Favorably With Substitute S-2",4,2,0,0,6
380789,213713,2012-11-27,Senate,"Senate Third Reading: Passed Roll Call # 747",22,15,1,0,38
380789,215201,2012-12-05,House,"Reported With Recommendation Without Amendment",10,0,0,0,10
380789,215202,2012-12-06,House,"House Third Reading: Passed Roll Call # 702",57,50,0,0,107
380886,173179,2012-03-15,Senate,"Reported Favorably With Substitute S-3",4,0,0,0,4
380886,213732,2012-11-27,Senate,"Senate Third Reading: Passed Roll Call # 753",22,16,0,0,38
380886,213733,2012-11-27,Senate,"Senate Third Reading: Passed Roll Call # 756",24,14,0,0,38
380886,215250,2012-12-05,House,"Reported With Recommendation Without Amendment",10,0,0,0,10
380886,215251,2012-12-06,House,"House Third Reading: Given Immediate Effect Roll Call # 691",57,50,0,0,107
380975,160317,2012-02-22,Senate,"Reported Favorably Without Amendment",9,0,0,0,9
381130,196702,2012-05-17,House,"Reported With Recommendation With Substitute H-1",17,0,0,0,17
381130,200696,2012-05-31,House,"House Third Reading: Passed Roll Call # 332",109,0,0,0,109
381130,214980,2012-12-04,Senate,"Reported Favorably Without Amendment",7,0,0,0,7
381130,215390,2012-12-12,Senate,"Senate Third Reading: Given Immediate Effect Roll Call # 899",38,0,0,0,38
381187,199978,2012-05-30,House,"Reported With Recommendation With Substitute H-4",9,6,0,0,15
381187,201610,2012-06-07,House,"House Third Reading: Given Immediate Effect Roll Call # 381",64,44,0,0,108
381187,214248,2012-11-29,Senate,"Reported Favorably With Substitute S-1",5,0,0,0,5
381187,215408,2012-12-12,Senate,"Senate Third Reading: Given Immediate Effect Roll Call # 892",26,12,0,0,38
381187,215558,2012-12-13,House,"House Third Reading:  Roll Call # 835",65,44,0,0,109
381493,200082,2012-05-30,House,"Reported With Recommendation With Substitute H-4",9,6,0,0,15
381493,201631,2012-06-07,House,"House Third Reading: Given Immediate Effect Roll Call # 380",63,45,0,0,108
381493,214291,2012-11-29,Senate,"Reported Favorably With Substitute S-2",5,0,0,0,5
381493,215465,2012-12-12,Senate,"Senate Third Reading: Given Immediate Effect Roll Call # 891",26,11,1,0,38
381493,215591,2012-12-13,House,"House Third Reading:  Roll Call # 834",65,43,0,0,108
381521,200105,2012-05-30,House,"Reported With Recommendation With Substitute H-4",9,6,0,0,15
381521,201633,2012-06-07,House,"House Third Reading: Given Immediate Effect Roll Call # 379",64,44,0,0,108
381521,214321,2012-11-29,Senate,"Reported Favorably With Substitute S-1",5,0,0,0,5
381521,215470,2012-12-12,Senate,"Senate Third Reading: Given Immediate Effect Roll Call # 890",26,12,0,0,38
381521,215602,2012-12-13,House,"House Third Reading:  Roll Call # 833",65,44,0,0,109
381637,169320,2012-03-06,House,"Reported With Recommendation With Substitute H-1",8,0,0,0,8
381637,173429,2012-03-15,House,"House Third Reading: Passed Roll Call # 119",107,0,0,0,107
381637,202468,2012-06-13,Senate,"Senate Third Reading: Given Immediate Effect Roll Call # 508",37,0,0,1,38
381637,202469,2012-06-14,House,"House Third Reading: Senate Amendment(s) Concurred In Roll Call # 474",110,0,0,0,110
381663,161360,2012-02-23,House,"Reported With Recommendation Without Amendment",14,0,0,0,14
381663,193247,2012-05-03,House,"House Third Reading: Given Immediate Effect Roll Call # 239",90,19,0,0,109
381775,180517,2012-03-27,House,"Reported With Recommendation Without Amendment",10,0,0,0,10
381775,202595,2012-06-14,House,"House Third Reading: Given Immediate Effect Roll Call # 478",110,0,0,0,110
381775,211873,2012-09-11,Senate,"Reported Favorably With Substitute S-1",7,0,0,0,7
381775,211993,2012-09-13,Senate,"Senate Third Reading: Given Immediate Effect Roll Call # 630",38,0,0,0,38
381775,212353,2012-09-27,House,"House Third Reading:  Roll Call # 550",108,0,0,0,108
381801,192398,2012-05-02,House,"Reported With Recommendation With Substitute H-1",16,0,0,0,16
381801,196936,2012-05-17,House,"House Third Reading: Given Immediate Effect Roll Call # 269",106,0,0,0,106
381830,211983,2012-09-12,House,"Reported With Recommendation For Referral To Committee On Appropriations",16,0,0,0,16
381859,159698,2012-02-22,House,"Reported With Recommendation Without Amendment",9,0,0,0,9
381859,176310,2012-03-21,House,"House Third Reading: Given Immediate Effect Roll Call # 131",108,0,0,0,108
381859,194406,2012-05-08,Senate,"Reported Favorably Without Amendment",5,0,0,0,5
381859,196732,2012-05-16,Senate,"Senate Third Reading: Given Immediate Effect Roll Call # 342",37,1,0,0,38
381885,159726,2012-02-22,House,"Reported With Recommendation Without Amendment",9,0,0,0,9
381885,176340,2012-03-21,House,"House Third Reading: Given Immediate Effect Roll Call # 130",108,0,0,0,108
381885,194420,2012-05-08,Senate,"Reported Favorably Without Amendment",5,0,0,0,5
381885,196765,2012-05-16,Senate,"Senate Third Reading: Given Immediate Effect Roll Call # 341",37,1,0,0,38
381911,159767,2012-02-22,House,"Reported With Recommendation Without Amendment",9,0,0,0,9
381911,177088,2012-03-21,House,"House Third Reading: Given Immediate Effect Roll Call # 129",108,0,0,0,108
381911,194502,2012-05-08,Senate,"Reported Favorably Without Amendment",5,0,0,0,5
381911,196537,2012-05-16,Senate,"Senate Third Reading: Given Immediate Effect Roll Call # 340",26,12,0,0,38
381911,202210,2012-06-13,House,"House Third Reading:  Roll Call # 435",58,52,0,0,110
384276,151420,2012-02-08,Senate,"Reported Favorably With Substitute S-1",4,0,0,0,4
384764,150982,2012-02-07,House,"Reported With Recommendation Without Amendment",12,4,0,0,16
384764,155872,2012-02-15,House,"House Third Reading: Given Immediate Effect Roll Call # 54",88,19,0,0,107
384764,166733,2012-03-01,Senate,"Reported Favorably Without Amendment",6,0,0,0,6
384764,177323,2012-03-22,Senate,"Senate Third Reading: Given Immediate Effect Roll Call # 151",30,8,0,0,38
384812,201464,2012-06-07,House,"Reported With Recommendation Without Amendment",16,0,0,0,16
384812,212291,2012-09-27,House,"House Third Reading: Given Immediate Effect Roll Call # 575",96,11,0,0,107
384812,215283,2012-12-06,Senate,"Reported Favorably With Recommendation For Referral To Committee On Economic Development",4,0,0,0,4
384842,177520,2012-03-22,House,"Reported With Recommendation Without Amendment",13,0,0,0,13
384842,193270,2012-05-03,House,"House Third Reading: Given Immediate Effect Roll Call # 241",105,4,0,0,109
384842,196228,2012-05-15,Senate,"Reported Favorably Without Amendment",4,0,0,0,4
384842,198163,2012-05-23,Senate,"Senate Third Reading: Given Immediate Effect Roll Call # 376",37,0,0,1,38
384869,177538,2012-03-22,House,"Reported With Recommendation Without Amendment",13,0,0,0,13
384869,193277,2012-05-03,House,"House Third Reading: Given Immediate Effect Roll Call # 240",104,5,0,0,109
384869,196232,2012-05-15,Senate,"Reported Favorably Without Amendment",4,0,0,0,4
384869,198171,2012-05-23,Senate,"Senate Third Reading: Given Immediate Effect Roll Call # 375",36,0,0,2,38
384981,196776,2012-05-16,House,"Reported With Recommendation Without Amendment",12,0,0,0,12
384981,198598,2012-05-24,House,"House Third Reading: Passed Roll Call # 301",106,2,0,0,108
384981,198599,2012-05-24,House,"House Third Reading:  Roll Call # 302",108,0,0,0,108
385009,196809,2012-05-16,House,"Reported With Recommendation Without Amendment",12,0,0,0,12
385009,198665,2012-05-24,House,"House Third Reading: Given Immediate Effect Roll Call # 300",106,2,0,0,108
385038,193269,2012-05-03,House,"Reported With Recommendation With Amendment(s)",16,0,0,0,16
385038,196205,2012-05-15,House,"House Third Reading: Given Immediate Effect Roll Call # 268",108,0,0,0,108
385038,211876,2012-09-11,Senate,"Reported Favorably With Substitute S-1",6,1,0,0,7
385038,211877,2012-09-11,Senate,"Reported Favorably With Substitute S-1",6,1,0,0,7
385038,211995,2012-09-13,Senate,"Senate Third Reading: Given Immediate Effect Roll Call # 624",35,2,0,1,38
385038,212356,2012-09-27,House,"House Third Reading:  Roll Call # 551",108,0,0,0,108
385177,212118,2012-09-19,House,"Reported With Recommendation With Substitute H-1",17,0,0,0,17
385410,172898,2012-03-15,House,"Reported With Recommendation Without Amendment",15,0,0,0,15
385862,180321,2012-03-28,House,"House Third Reading: Adverse Roll Call",7,0,0,0,7
385862,186883,2012-04-18,House,"Reported With Recommendation Without Amendment",14,1,0,0,15
385862,201354,2012-06-06,House,"House Third Reading: Given Immediate Effect Roll Call # 362",99,10,0,0,109
386178,154897,2012-02-14,House,"Reported With Recommendation With Substitute H-1",5,0,0,0,5
386178,163866,2012-02-28,House,"House Third Reading: Given Immediate Effect Roll Call # 75",94,11,0,0,105
386645,173515,2012-03-15,House,"Reported With Recommendation With Substitute H-1",13,0,0,0,13
386645,200385,2012-05-31,House,"House Third Reading: Passed Roll Call # 347",110,0,0,0,110
386645,200386,2012-05-31,House,"House Third Reading:  Roll Call # 348",109,0,0,0,109
386645,201943,2012-06-12,Senate,"Senate Third Reading: Given Immediate Effect Roll Call # 483",38,0,0,0,38
387292,187047,2012-04-18,House,"Reported With Recommendation Without Amendment",12,2,0,0,14
387292,192821,2012-05-02,House,"House Third Reading: Given Immediate Effect Roll Call # 219",88,22,0,0,110
387292,201564,2012-06-07,Senate,"Reported Favorably With Substitute S-1",7,0,0,0,7
387292,202544,2012-06-14,Senate,"Senate Third Reading: Given Immediate Effect Roll Call # 533",38,0,0,0,38
387292,202545,2012-06-14,House,"House Third Reading:  Roll Call # 484",109,0,0,0,109
390121,151923,2012-02-09,Senate,"Reported Favorably Without Amendment",7,0,0,0,7
390121,159656,2012-02-22,Senate,"Senate Third Reading: Passed Roll Call # 94",36,2,0,0,38
390121,180940,2012-03-28,House,"Reported With Recommendation Without Amendment",12,4,0,0,16
390121,201112,2012-06-05,House,"House Third Reading: Given Immediate Effect Roll Call # 350",59,48,0,0,107
390306,151938,2012-02-09,Senate,"Reported Favorably With Substitute S-1",6,0,0,0,6
390306,160746,2012-02-23,Senate,"Senate Third Reading: Passed Roll Call # 98",35,2,0,1,38
390306,186492,2012-04-17,House,"Reported With Recommendation Without Amendment",17,0,0,0,17
390306,196308,2012-05-15,House,"House Third Reading: Given Immediate Effect Roll Call # 264",97,11,0,0,108
391233,214467,2012-11-29,House,"House Third Reading: Given Immediate Effect Roll Call # 663",61,45,0,0,106
391233,215676,2012-12-13,Senate,"Reported Favorably With Substitute S-2",7,0,0,0,7
391233,215677,2012-12-13,Senate,"Senate Third Reading: Given Immediate Effect Roll Call # 1004",34,3,1,0,38
391233,215852,2012-12-14,House,"House Third Reading:  Roll Call # 889",106,0,0,0,106
391409,188938,2012-04-24,House,"Reported With Recommendation With Substitute H-2",17,9,0,0,26
391409,189380,2012-04-25,House,"House Third Reading: Given Immediate Effect Roll Call # 198",58,52,0,0,110
391409,192517,2012-05-02,Senate,"Senate Third Reading: Passed Roll Call # 284",26,11,0,1,38
391409,193089,2012-05-03,House,"House Third Reading:  Roll Call # 237",0,109,0,0,109
391409,200492,2012-05-31,House,"House Third Reading: Conference Report Adopted Roll Call # 345",61,49,0,0,110
391409,200493,2012-05-31,Senate,"Senate Third Reading: Senate Adopted Conference Report With Immediate Effect Roll Call # 430",20,16,0,2,38
391499,164818,2012-02-29,House,"Reported With Recommendation With Substitute H-1",25,1,0,0,26
391499,176100,2012-03-20,House,"House Third Reading: Given Immediate Effect Roll Call # 124",98,11,0,0,109
391499,178591,2012-03-27,Senate,"Reported Favorably Without Amendment",15,0,0,0,15
391499,189985,2012-04-26,Senate,"Senate Third Reading: Given Immediate Effect Roll Call # 269",38,0,0,0,38
391499,201606,2012-06-07,House,"House Third Reading:  Roll Call # 386",30,77,0,0,107
391499,202587,2012-06-14,House,"House Third Reading: Conference Report Adopted Roll Call # 496",95,14,0,0,109
391499,202588,2012-06-14,House,"House Third Reading: Conference Report Adopted Roll Call # 497",95,14,0,0,109
391499,207188,2012-07-18,Senate,"Senate Third Reading: Senate Adopted Conference Report Roll Call # 568",30,7,0,1,38
391586,200617,2012-05-30,House,"Reported With Recommendation With Substitute H-1",18,0,0,0,18
391586,201639,2012-06-07,House,"House Third Reading: Given Immediate Effect Roll Call # 387",107,0,0,0,107
391586,215355,2012-12-11,Senate,"Reported Favorably Without Amendment",4,0,0,0,4
391675,170290,2012-03-08,House,"Reported With Recommendation With Substitute H-1",17,0,0,0,17
391675,187266,2012-04-19,House,"House Third Reading: Passed Roll Call # 181",109,0,0,0,109
391675,192457,2012-05-02,Senate,"Reported Favorably Without Amendment",7,0,0,0,7
391675,196951,2012-05-17,Senate,"Senate Third Reading: Given Immediate Effect Roll Call # 358",38,0,0,0,38
391675,197787,2012-05-22,House,"House Third Reading: Senate Amendment(s) Concurred In Roll Call # 279",106,0,0,0,106
391832,165385,2012-02-29,House,"Reported With Recommendation Without Amendment",25,0,0,0,25
391832,194478,2012-05-08,House,"House Third Reading:  Roll Call # 250",107,1,0,0,108
391832,197042,2012-05-17,Senate,"Reported Favorably Without Amendment",13,0,0,0,13
391832,209769,2012-08-15,Senate,"Senate Third Reading:  Roll Call # 601",37,0,0,1,38
391871,207220,2012-07-18,Senate,"Senate Third Reading: Passed Roll Call # 588",35,2,0,1,38
391871,213994,2012-11-28,House,"Reported With Recommendation With Substitute H-1",16,4,0,0,20
391871,214374,2012-11-29,House,"House Third Reading: Given Immediate Effect Roll Call # 660",62,45,0,0,107
391871,214375,2012-11-29,Senate,"Senate Third Reading:  Roll Call # 797",0,37,0,1,38
391871,215445,2012-12-12,Senate,"Senate Third Reading:  Roll Call # 931",26,11,0,1,38
391947,170057,2012-03-08,Senate,"Reported Favorably Without Amendment",4,0,0,0,4
391947,194983,2012-05-08,Senate,"Senate Third Reading: Passed Roll Call # 312",35,2,0,1,38
391947,214174,2012-11-29,House,"Reported With Recommendation Without Amendment",9,2,0,0,11
391947,215386,2012-12-12,House,"House Third Reading: Given Immediate Effect Roll Call # 745",77,31,0,0,108
391985,159649,2012-02-22,Senate,"Reported Favorably With Substitute S-1",4,0,0,0,4
391985,176191,2012-03-20,Senate,"Senate Third Reading: Passed Roll Call # 146",38,0,0,0,38
391985,213673,2012-11-08,House,"Reported With Recommendation With Amendment(s)",10,0,0,0,10
391985,214363,2012-11-29,House,"House Third Reading: Passed Roll Call # 646",108,0,0,0,108
391985,215131,2012-12-05,Senate,"Senate Third Reading: House Amendment(s) Concurred In Roll Call # 817",38,0,0,0,38
392100,169502,2012-03-08,Senate,"Reported Favorably With Substitute S-1",6,0,0,0,6
392100,176275,2012-03-21,Senate,"Senate Third Reading: Passed Roll Call # 148",38,0,0,0,38
392100,198321,2012-05-23,House,"Reported With Recommendation With Substitute H-1",11,0,0,0,11
392100,200329,2012-05-30,House,"House Third Reading: Given Immediate Effect Roll Call # 328",109,0,0,0,109
392100,201171,2012-06-05,Senate,"Senate Third Reading:  Roll Call # 435",38,0,0,0,38
392135,159782,2012-02-22,Senate,"Reported Favorably Without Amendment",3,0,0,0,3
392205,159808,2012-02-22,Senate,"Reported Favorably Without Amendment",3,0,0,0,3
392889,189324,2012-04-24,House,"Reported With Recommendation With Substitute H-1",16,10,0,0,26
392889,190370,2012-04-26,House,"House Third Reading: Passed Roll Call # 204",56,54,0,0,110
392889,190371,2012-04-26,House,"House Third Reading:  Roll Call # 205",100,10,0,0,110
392889,192445,2012-05-02,Senate,"Senate Third Reading: Passed Roll Call # 285",25,12,0,1,38
392889,193036,2012-05-03,House,"House Third Reading:  Roll Call # 238",0,109,0,0,109
392889,200975,2012-06-01,House,"House Third Reading: Conference Report Adopted Roll Call # 349",58,51,0,0,109
392889,201181,2012-06-05,Senate,"Senate Third Reading: Senate Adopted Conference Report With Immediate Effect Roll Call # 433",21,17,0,0,38
393815,155370,2012-02-15,House,"Reported With Recommendation With Substitute H-2",3,2,0,0,5
393815,155371,2012-02-15,House,"House Third Reading:  Roll Call # 56",67,39,0,0,106
394041,177089,2012-03-21,House,"Reported With Recommendation With Substitute H-1",17,1,0,0,18
394041,190357,2012-04-26,House,"House Third Reading: Passed Roll Call # 202",63,47,0,0,110
394119,201361,2012-06-06,House,"Reported With Recommendation With Substitute H-3",16,0,0,0,16
394119,211892,2012-09-12,House,"House Third Reading: Passed Roll Call # 521",108,0,0,0,108
394119,212283,2012-09-27,Senate,"Reported Favorably With Substitute S-1",4,1,0,0,5
394119,212284,2012-09-27,Senate,"Senate Third Reading: Given Immediate Effect Roll Call # 695",35,0,0,3,38
394119,212285,2012-09-27,House,"House Third Reading:  Roll Call # 591",107,0,0,0,107
397212,176147,2012-03-20,Senate,"Reported Favorably With Substitute S-1",4,1,0,0,5
397212,196322,2012-05-15,Senate,"Senate Third Reading: Passed Roll Call # 332",26,12,0,0,38
397212,213756,2012-11-27,House,"Reported With Recommendation Without Amendment",6,3,0,0,9
397212,215267,2012-12-06,House,"House Third Reading: Given Immediate Effect Roll Call # 711",65,43,0,0,108
397212,215325,2012-12-11,Senate,"Senate Third Reading: House Amendment(s) Concurred In Roll Call # 868",26,12,0,0,38
397227,176190,2012-03-20,Senate,"Reported Favorably Without Amendment",4,1,0,0,5
397227,196071,2012-05-15,Senate,"Senate Third Reading: Passed Roll Call # 333",26,12,0,0,38
397227,213793,2012-11-27,House,"Reported With Recommendation Without Amendment",7,3,0,0,10
397227,215228,2012-12-06,House,"House Third Reading: Given Immediate Effect Roll Call # 712",65,43,0,0,108
397242,176169,2012-03-20,Senate,"Reported Favorably Without Amendment",4,1,0,0,5
397242,196323,2012-05-15,Senate,"Senate Third Reading: Passed Roll Call # 334",26,12,0,0,38
397242,213758,2012-11-27,House,"Reported With Recommendation Without Amendment",7,3,0,0,10
397242,215269,2012-12-06,House,"House Third Reading: Given Immediate Effect Roll Call # 713",65,43,0,0,108
397258,176200,2012-03-20,Senate,"Reported Favorably Without Amendment",4,1,0,0,5
397258,196081,2012-05-15,Senate,"Senate Third Reading: Passed Roll Call # 335",26,12,0,0,38
397258,213801,2012-11-27,House,"Reported With Recommendation Without Amendment",7,3,0,0,10
397258,215233,2012-12-06,House,"House Third Reading: Given Immediate Effect Roll Call # 714",64,44,0,0,108
397320,164062,2012-02-28,Senate,"Reported Favorably With Substitute S-1",12,0,0,0,12
397320,170004,2012-03-08,Senate,"Senate Third Reading: Passed Roll Call # 127",37,1,0,0,38
397320,173536,2012-03-15,House,"Reported With Recommendation Without Amendment",16,0,0,0,16
397320,176910,2012-03-22,House,"House Third Reading: Given Immediate Effect Roll Call # 136",106,2,0,0,108
397335,189055,2012-04-24,Senate,"Reported Favorably With Substitute S-1",5,0,0,0,5
397335,189056,2012-04-24,Senate,"Senate Third Reading: Passed Roll Call # 217",28,10,0,0,38
397335,192677,2012-05-02,House,"House Third Reading: Passed Roll Call # 221",63,47,0,0,110
397335,193167,2012-05-03,Senate,"Senate Third Reading:  Roll Call # 286",0,38,0,0,38
397335,199904,2012-05-30,Senate,"Senate Third Reading: Senate Adopted Conference Report Roll Call # 390",29,7,0,2,38
397368,189197,2012-04-24,Senate,"Reported Favorably With Substitute S-1",9,7,0,0,16
397368,189653,2012-04-25,Senate,"Senate Third Reading: Passed Roll Call # 247",20,18,0,0,38
397368,192182,2012-05-02,House,"House Third Reading: Passed Roll Call # 222",63,47,0,0,110
397368,192902,2012-05-03,Senate,"Senate Third Reading:  Roll Call # 287",0,38,0,0,38
397368,200065,2012-05-30,Senate,"Senate Third Reading: Senate Adopted Conference Report Roll Call # 391",21,15,0,2,38
397383,189182,2012-04-24,Senate,"Reported Favorably With Substitute S-1",5,0,0,0,5
397383,189183,2012-04-24,Senate,"Senate Third Reading: Passed Roll Call # 226",24,14,0,0,38
397383,192844,2012-05-02,House,"House Third Reading: Passed Roll Call # 223",63,47,0,0,110
397383,193257,2012-05-03,Senate,"Senate Third Reading:  Roll Call # 288",0,38,0,0,38
397383,199933,2012-05-30,Senate,"Senate Third Reading: Senate Adopted Conference Report Roll Call # 392",22,14,0,2,38
397397,186346,2012-04-17,Senate,"Reported Favorably With Substitute S-1",9,5,0,0,14
397397,188913,2012-04-24,Senate,"Senate Third Reading: Passed Roll Call # 230",20,18,0,0,38
397397,192352,2012-05-02,House,"House Third Reading: Passed Roll Call # 224",63,47,0,0,110
397397,192957,2012-05-03,Senate,"Senate Third Reading:  Roll Call # 289",0,38,0,0,38
397397,199931,2012-05-30,Senate,"Senate Third Reading: Senate Adopted Conference Report Roll Call # 393",20,16,0,2,38
397412,189186,2012-04-24,Senate,"Reported Favorably With Substitute S-1",10,2,0,0,12
397412,189634,2012-04-25,Senate,"Senate Third Reading: Passed Roll Call # 238",24,14,0,0,38
397412,192873,2012-05-02,House,"House Third Reading: Passed Roll Call # 225",63,47,0,0,110
397412,192874,2012-05-03,Senate,"Senate Third Reading:  Roll Call # 290",1,37,0,0,38
397412,200057,2012-05-30,Senate,"Senate Third Reading: Senate Rejected Conference Report Roll Call # 405",0,35,1,2,38
397412,200058,2012-05-30,Senate,"Senate Third Reading: Senate Adopted Conference Report Roll Call # 407",31,5,0,2,38
397432,189184,2012-04-24,Senate,"Reported Favorably With Substitute S-1",5,0,0,0,5
397432,189185,2012-04-24,Senate,"Senate Third Reading: Passed Roll Call # 218",26,12,0,0,38
397432,192850,2012-05-02,House,"House Third Reading: Passed Roll Call # 226",63,47,0,0,110
397432,193264,2012-05-03,Senate,"Senate Third Reading:  Roll Call # 291",1,36,1,0,38
397432,199511,2012-05-29,Senate,"Senate Third Reading: Senate Adopted Conference Report Roll Call # 387",25,10,0,3,38
397447,189201,2012-04-24,Senate,"Reported Favorably With Substitute S-1",9,7,0,0,16
397447,190279,2012-04-26,Senate,"Senate Third Reading: Passed Roll Call # 258",19,19,0,0,38
397447,192198,2012-05-02,House,"House Third Reading: Passed Roll Call # 227",63,47,0,0,110
397447,192904,2012-05-03,Senate,"Senate Third Reading:  Roll Call # 292",0,38,0,0,38
397447,200075,2012-05-30,Senate,"Senate Third Reading: Senate Rejected Conference Report Roll Call # 394",18,18,0,2,38
397447,200076,2012-05-30,Senate,"Senate Third Reading: Senate Adopted Conference Report Roll Call # 402",21,15,0,2,38
397461,189210,2012-04-24,Senate,"Reported Favorably With Substitute S-1",11,5,0,0,16
397461,190281,2012-04-26,Senate,"Senate Third Reading: Passed Roll Call # 267",22,16,0,0,38
397461,192197,2012-05-02,House,"House Third Reading: Passed Roll Call # 228",63,47,0,0,110
397461,192903,2012-05-03,Senate,"Senate Third Reading:  Roll Call # 293",0,38,0,0,38
397461,201147,2012-06-05,Senate,"Senate Third Reading: Senate Adopted Conference Report Roll Call # 432",22,16,0,0,38
397476,189214,2012-04-24,Senate,"Reported Favorably With Substitute S-1",5,0,0,0,5
397476,189215,2012-04-24,Senate,"Senate Third Reading: Passed Roll Call # 223",25,13,0,0,38
397476,192905,2012-05-02,House,"House Third Reading: Passed Roll Call # 229",63,47,0,0,110
397476,192906,2012-05-03,Senate,"Senate Third Reading:  Roll Call # 294",0,38,0,0,38
397476,200180,2012-05-30,Senate,"Senate Third Reading: Senate Adopted Conference Report Roll Call # 395",24,12,0,2,38
397493,189211,2012-04-24,Senate,"Reported Favorably With Substitute S-1",5,0,0,0,5
397493,189212,2012-04-24,Senate,"Senate Third Reading: Passed Roll Call # 227",23,15,0,0,38
397493,192200,2012-05-02,House,"House Third Reading: Passed Roll Call # 230",63,47,0,0,110
397493,192918,2012-05-03,Senate,"Senate Third Reading:  Roll Call # 295",0,38,0,0,38
397493,200124,2012-05-30,Senate,"Senate Third Reading: Senate Adopted Conference Report Roll Call # 396",23,13,0,2,38
397509,189228,2012-04-24,Senate,"Reported Favorably With Substitute S-1",12,1,0,0,13
397509,189678,2012-04-25,Senate,"Senate Third Reading: Passed Roll Call # 235",25,13,0,0,38
397509,192218,2012-05-02,House,"House Third Reading: Passed Roll Call # 231",63,47,0,0,110
397509,192925,2012-05-03,Senate,"Senate Third Reading:  Roll Call # 296",0,38,0,0,38
397509,200189,2012-05-30,Senate,"Senate Third Reading: Senate Adopted Conference Report Roll Call # 397",23,13,0,2,38
397524,189231,2012-04-24,Senate,"Reported Favorably With Substitute S-1",11,0,0,0,11
397524,189693,2012-04-25,Senate,"Senate Third Reading: Passed Roll Call # 232",26,12,0,0,38
397524,192236,2012-05-02,House,"House Third Reading: Passed Roll Call # 232",63,47,0,0,110
397524,192938,2012-05-03,Senate,"Senate Third Reading:  Roll Call # 297",0,38,0,0,38
397524,200166,2012-05-30,Senate,"Senate Third Reading: Senate Adopted Conference Report Roll Call # 398",25,11,0,2,38
397539,189233,2012-04-24,Senate,"Reported Favorably With Substitute S-1",5,0,0,0,5
397539,189234,2012-04-24,Senate,"Senate Third Reading: Passed Roll Call # 220",25,13,0,0,38
397539,192936,2012-05-02,House,"House Third Reading: Passed Roll Call # 233",63,47,0,0,110
397539,192937,2012-05-03,Senate,"Senate Third Reading:  Roll Call # 298",0,38,0,0,38
397539,199588,2012-05-29,Senate,"Senate Third Reading: Senate Adopted Conference Report Roll Call # 388",25,10,0,3,38
397558,189241,2012-04-24,Senate,"Reported Favorably With Substitute S-1",11,5,0,0,16
397558,189701,2012-04-25,Senate,"Senate Third Reading: Passed Roll Call # 244",25,13,0,0,38
397558,192310,2012-05-02,House,"House Third Reading: Passed Roll Call # 234",63,47,0,0,110
397558,192978,2012-05-03,Senate,"Senate Third Reading:  Roll Call # 299",0,38,0,0,38
397558,200541,2012-05-31,Senate,"Senate Third Reading: Senate Adopted Conference Report Roll Call # 419",20,16,0,2,38
397571,189240,2012-04-24,Senate,"Reported Favorably With Substitute S-1",16,0,0,0,16
397571,189698,2012-04-25,Senate,"Senate Third Reading: Passed Roll Call # 233",38,0,0,0,38
397571,192291,2012-05-02,House,"House Third Reading: Passed Roll Call # 235",63,47,0,0,110
397571,192972,2012-05-03,Senate,"Senate Third Reading:  Roll Call # 300",0,38,0,0,38
397571,199656,2012-05-30,Senate,"Senate Third Reading: Senate Adopted Conference Report Roll Call # 399",34,2,0,2,38
397586,189242,2012-04-24,Senate,"Reported Favorably With Substitute S-1",5,0,0,0,5
397586,189243,2012-04-24,Senate,"Senate Third Reading: Passed Roll Call # 231",36,2,0,0,38
397586,192312,2012-05-02,House,"House Third Reading: Passed Roll Call # 236",63,47,0,0,110
397586,192987,2012-05-03,Senate,"Senate Third Reading:  Roll Call # 301",0,38,0,0,38
397586,199667,2012-05-30,Senate,"Senate Third Reading: Senate Adopted Conference Report Roll Call # 408",31,5,0,2,38
397647,186589,2012-04-17,Senate,"Reported Favorably With Substitute S-1",4,2,0,0,6
397647,213710,2012-11-27,Senate,"Senate Third Reading: Passed Roll Call # 749",23,15,0,0,38
397647,215193,2012-12-05,House,"Reported With Recommendation Without Amendment",10,0,0,0,10
397647,215881,2012-12-14,House,"House Third Reading: Passed Roll Call # 893",56,49,0,0,105
398135,212055,2012-09-19,House,"Reported With Recommendation With Substitute H-1",25,0,0,0,25
398135,212056,2012-09-19,House,"House Third Reading: Given Immediate Effect Roll Call # 544",103,2,0,0,105
398135,212237,2012-09-27,Senate,"Reported Favorably With Substitute S-1",4,1,0,0,5
398135,212238,2012-09-27,Senate,"Senate Third Reading: Given Immediate Effect Roll Call # 686",38,0,0,0,38
398135,212339,2012-09-27,House,"House Third Reading:  Roll Call # 577",106,1,0,0,107
398431,199559,2012-05-29,Senate,"Reported Favorably Without Amendment",3,0,0,0,3
398456,159416,2012-02-22,Senate,"Reported Favorably With Amendment(s)",4,0,0,0,4
398456,159417,2012-02-22,Senate,"Senate Third Reading: Given Immediate Effect Roll Call # 95",26,12,0,0,38
398456,164972,2012-02-29,House,"Reported With Recommendation Without Amendment",3,2,0,0,5
398456,166404,2012-03-01,House,"House Third Reading: Passed Roll Call # 86",62,45,0,0,107
398478,202344,2012-06-13,Senate,"Reported Favorably With Substitute S-1",4,0,0,0,4
398478,214974,2012-12-04,Senate,"Senate Third Reading: Passed Roll Call # 799",20,18,0,0,38
398478,215511,2012-12-13,House,"Reported With Recommendation Without Amendment",10,0,0,0,10
398478,215512,2012-12-13,House,"House Third Reading: Given Immediate Effect Roll Call # 820",59,50,0,0,109
398504,212236,2012-09-27,Senate,"Reported Favorably With Substitute S-3",5,0,0,0,5
398504,213011,2012-10-17,Senate,"Senate Third Reading: Passed Roll Call # 715",37,0,0,1,38
398504,214241,2012-11-29,House,"Reported With Recommendation Without Amendment",13,0,0,0,13
398504,215555,2012-12-13,House,"House Third Reading: Given Immediate Effect Roll Call # 784",105,0,0,0,105
398504,215714,2012-12-13,Senate,"Senate Third Reading:  Roll Call # 1033",38,0,0,0,38
398524,214230,2012-11-29,Senate,"Reported Favorably With Substitute S-2",4,0,0,0,4
398524,214999,2012-12-04,Senate,"Senate Third Reading: Passed Roll Call # 803",38,0,0,0,38
398574,177555,2012-03-22,House,"Reported With Recommendation Without Amendment",11,0,0,0,11
398574,197918,2012-05-22,House,"House Third Reading: Given Immediate Effect Roll Call # 282",107,0,0,0,107
398574,215346,2012-12-11,Senate,"Reported Favorably Without Amendment",9,0,0,0,9
398574,215736,2012-12-13,Senate,"Senate Third Reading: Given Immediate Effect Roll Call # 960",38,0,0,0,38
399279,172633,2012-03-14,Senate,"Reported Favorably Without Amendment",3,0,0,0,3
399395,176098,2012-03-20,Senate,"Reported Favorably Without Amendment",6,1,0,0,7
399514,195141,2012-05-10,Senate,"Reported Favorably With Substitute S-1",7,0,0,0,7
399514,201418,2012-06-05,Senate,"Senate Third Reading: Passed Roll Call # 436",38,0,0,0,38
399514,213755,2012-11-27,House,"Reported With Recommendation Without Amendment",14,0,0,0,14
399514,215263,2012-12-06,House,"House Third Reading: Given Immediate Effect Roll Call # 709",67,42,0,0,109
399514,215360,2012-12-12,Senate,"Senate Third Reading: House Amendment(s) Concurred In Roll Call # 872",36,0,0,2,38
399631,215007,2012-12-04,Senate,"Reported Favorably With Substitute S-2",6,1,0,0,7
399631,215186,2012-12-06,Senate,"Senate Third Reading: Passed Roll Call # 833",26,12,0,0,38
399631,215368,2012-12-12,House,"Reported With Recommendation With Substitute H-1",11,5,0,0,16
399978,170486,2012-03-08,House,"Reported With Recommendation With Substitute H-1",18,0,0,0,18
399978,179044,2012-03-27,House,"House Third Reading: Given Immediate Effect Roll Call # 140",109,0,0,0,109
399978,189366,2012-04-25,Senate,"Reported Favorably Without Amendment",6,0,0,0,6
399978,201114,2012-06-05,Senate,"Senate Third Reading: Given Immediate Effect Roll Call # 437",38,0,0,0,38
400307,177081,2012-03-21,House,"Reported With Recommendation For Referral To Committee On Oversight, Reform, And Ethics",4,0,0,0,4
402278,176105,2012-03-20,Senate,"Reported Favorably Without Amendment",5,2,0,0,7
402468,177242,2012-03-21,House,"Reported With Recommendation With Substitute H-1",15,0,0,0,15
402576,180468,2012-03-27,House,"Reported With Recommendation With Substitute H-1",9,1,0,0,10
402576,189501,2012-04-24,House,"House Third Reading: Passed Roll Call # 188",80,28,0,0,108
402576,201889,2012-06-12,Senate,"Reported Favorably With Substitute S-1",15,0,0,0,15
402576,202461,2012-06-14,Senate,"Senate Third Reading: Given Immediate Effect Roll Call # 527",26,10,1,1,38
402576,202462,2012-06-14,House,"House Third Reading:  Roll Call # 485",81,28,0,0,109
402609,180542,2012-03-27,House,"Reported With Recommendation With Substitute H-1",10,0,0,0,10
402609,198292,2012-05-23,House,"House Third Reading: Given Immediate Effect Roll Call # 286",98,9,0,0,107
402609,215225,2012-12-06,Senate,"Reported Favorably Without Amendment",5,0,0,0,5
402609,215762,2012-12-13,Senate,"Senate Third Reading: Given Immediate Effect Roll Call # 954",38,0,0,0,38
402814,170115,2012-03-08,House,"Reported With Recommendation With Substitute H-1",18,0,0,0,18
402814,178726,2012-03-27,House,"House Third Reading: Given Immediate Effect Roll Call # 141",109,0,0,0,109
402814,189627,2012-04-25,Senate,"Reported Favorably Without Amendment",6,0,0,0,6
402814,201156,2012-06-05,Senate,"Senate Third Reading: Given Immediate Effect Roll Call # 438",38,0,0,0,38
402849,199924,2012-05-30,House,"Reported With Recommendation Without Amendment",18,0,0,0,18
402849,201424,2012-06-06,House,"House Third Reading: Given Immediate Effect Roll Call # 363",109,0,0,0,109
402849,215352,2012-12-11,Senate,"Reported Favorably With Substitute S-1",3,0,0,0,3
402849,215770,2012-12-13,Senate,"Senate Third Reading: Given Immediate Effect Roll Call # 967",38,0,0,0,38
402849,215909,2012-12-14,House,"House Third Reading:  Roll Call # 875",107,0,0,0,107
402880,177466,2012-03-22,House,"Reported With Recommendation Without Amendment",12,0,0,0,12
402915,201389,2012-06-06,House,"Reported With Recommendation With Substitute H-1",14,2,0,0,16
402915,201586,2012-06-07,House,"House Third Reading: Given Immediate Effect Roll Call # 391",97,10,0,0,107
402915,202569,2012-06-14,Senate,"Senate Third Reading: Given Immediate Effect Roll Call # 551",36,2,0,0,38
402915,202570,2012-06-14,House,"House Third Reading:  Roll Call # 490",99,10,0,0,109
404249,173909,2012-03-14,Senate,"Reported Favorably With Substitute S-1",9,0,0,0,9
404249,177325,2012-03-21,Senate,"Senate Third Reading:  Roll Call # 149",38,0,0,0,38
404249,177326,2012-03-21,Senate,"Senate Third Reading:  Roll Call # 150",38,0,0,0,38
404249,186922,2012-04-17,House,"Reported With Recommendation Without Amendment",21,0,0,0,21
404893,190348,2012-04-26,House,"Reported With Recommendation With Amendment(s)",11,0,0,0,11
404893,197716,2012-05-22,House,"House Third Reading: Given Immediate Effect Roll Call # 283",102,5,0,0,107
404893,202213,2012-06-13,Senate,"Reported Favorably With Substitute S-2",4,0,0,0,4
404893,212131,2012-09-20,Senate,"Senate Third Reading: Given Immediate Effect Roll Call # 645",38,0,0,0,38
404893,212378,2012-09-27,House,"House Third Reading:  Roll Call # 565",106,2,0,0,108
404926,190349,2012-04-26,House,"Reported With Recommendation Without Amendment",10,0,0,0,10
404926,197991,2012-05-22,House,"House Third Reading: Given Immediate Effect Roll Call # 284",105,2,0,0,107
404926,202249,2012-06-13,Senate,"Reported Favorably With Substitute S-1",4,0,0,0,4
404926,212136,2012-09-20,Senate,"Senate Third Reading: Given Immediate Effect Roll Call # 646",38,0,0,0,38
404926,212290,2012-09-27,House,"House Third Reading:  Roll Call # 568",105,2,0,0,107
404962,190366,2012-04-26,House,"Reported With Recommendation Without Amendment",11,0,0,0,11
404962,197773,2012-05-22,House,"House Third Reading: Given Immediate Effect Roll Call # 285",101,7,0,0,108
404962,202276,2012-06-13,Senate,"Reported Favorably With Substitute S-2",4,0,0,0,4
404962,212138,2012-09-20,Senate,"Senate Third Reading: Given Immediate Effect Roll Call # 647",38,0,0,0,38
404962,212292,2012-09-27,House,"House Third Reading:  Roll Call # 569",101,6,0,0,107
405106,201396,2012-06-05,House,"Reported With Recommendation With Substitute H-1",17,0,0,0,17
405106,202412,2012-06-14,House,"House Third Reading: Given Immediate Effect Roll Call # 464",110,0,0,0,110
405106,214180,2012-11-29,Senate,"Reported Favorably Without Amendment",6,0,0,0,6
405106,215727,2012-12-13,Senate,"Senate Third Reading: Given Immediate Effect Roll Call # 998",38,0,0,0,38
405175,177321,2012-03-22,Senate,"Reported Favorably With Substitute S-1",3,0,0,0,3
405214,194781,2012-05-09,Senate,"Reported Favorably Without Amendment",4,0,0,0,4
405214,198076,2012-05-23,Senate,"Senate Third Reading: Passed Roll Call # 371",36,0,0,2,38
405214,212010,2012-09-13,House,"Reported With Recommendation For Referral To Committee On Banking And Financial Services",13,0,0,0,13
405214,215184,2012-12-05,House,"Reported With Recommendation Without Amendment",6,0,0,0,6
405214,215537,2012-12-12,House,"House Third Reading: Given Immediate Effect Roll Call # 767",109,0,0,0,109
405249,195209,2012-05-09,Senate,"Reported Favorably Without Amendment",4,0,0,0,4
405249,198102,2012-05-23,Senate,"Senate Third Reading: Passed Roll Call # 372",36,0,0,2,38
405249,212011,2012-09-13,House,"Reported With Recommendation For Referral To Committee On Banking And Financial Services",13,0,0,0,13
405249,215188,2012-12-05,House,"Reported With Recommendation Without Amendment",6,0,0,0,6
405249,215538,2012-12-12,House,"House Third Reading: Given Immediate Effect Roll Call # 768",109,0,0,0,109
405283,195218,2012-05-09,Senate,"Reported Favorably Without Amendment",4,0,0,0,4
405283,198134,2012-05-23,Senate,"Senate Third Reading: Passed Roll Call # 373",36,0,0,2,38
405283,212012,2012-09-13,House,"Reported With Recommendation For Referral To Committee On Banking And Financial Services",13,0,0,0,13
405283,215190,2012-12-05,House,"Reported With Recommendation Without Amendment",7,0,0,0,7
405283,215543,2012-12-12,House,"House Third Reading: Given Immediate Effect Roll Call # 769",109,0,0,0,109
405312,172204,2012-03-13,Senate,"Reported Favorably With Substitute S-1",5,0,0,0,5
405312,172205,2012-03-13,Senate,"Senate Third Reading: Passed Roll Call # 132",28,10,0,0,38
405312,179502,2012-03-27,House,"Reported With Recommendation With Substitute H-2",7,0,0,0,7
405312,180440,2012-03-29,House,"House Third Reading: Given Immediate Effect Roll Call # 161",84,26,0,0,110
405312,180441,2012-03-29,Senate,"Senate Third Reading:  Roll Call # 190",28,10,0,0,38
407723,199391,2012-05-29,Senate,"Reported Favorably Without Amendment",5,0,0,0,5
407723,201392,2012-06-06,Senate,"Senate Third Reading: Passed Roll Call # 448",36,2,0,0,38
407723,215579,2012-12-12,House,"Reported With Recommendation With Amendment(s)",13,0,0,0,13
407723,215580,2012-12-13,House,"House Third Reading: Given Immediate Effect Roll Call # 805",109,1,0,0,110
407763,195412,2012-05-09,House,"Reported With Recommendation With Substitute H-1",15,0,0,0,15
407763,196968,2012-05-17,House,"House Third Reading: Given Immediate Effect Roll Call # 278",107,0,0,0,107
407763,212099,2012-09-20,Senate,"Reported Favorably Without Amendment",5,0,0,0,5
407763,215697,2012-12-13,Senate,"Senate Third Reading: Given Immediate Effect Roll Call # 942",37,0,0,1,38
407776,195407,2012-05-09,House,"Reported With Recommendation With Substitute H-1",15,0,0,0,15
407776,196962,2012-05-17,House,"House Third Reading: Given Immediate Effect Roll Call # 275",107,0,0,0,107
407776,212098,2012-09-20,Senate,"Reported Favorably Without Amendment",5,0,0,0,5
407776,215698,2012-12-13,Senate,"Senate Third Reading: Given Immediate Effect Roll Call # 941",37,0,1,0,38
407820,189002,2012-04-24,House,"Reported With Recommendation Without Amendment",7,0,0,0,7
407820,195278,2012-05-10,House,"House Third Reading: Given Immediate Effect Roll Call # 259",107,0,0,0,107
407820,201602,2012-06-07,Senate,"Reported Favorably Without Amendment",3,0,0,0,3
407820,202308,2012-06-13,Senate,"Senate Third Reading: Given Immediate Effect Roll Call # 499",37,0,0,1,38
408439,168333,2012-03-06,House,"Reported With Recommendation Without Amendment",11,0,0,0,11
408525,198176,2012-05-23,Senate,"Reported Favorably With Substitute S-1",5,0,0,0,5
408525,200669,2012-05-31,Senate,"Senate Third Reading: Passed Roll Call # 425",36,0,0,2,38
408525,202002,2012-06-12,House,"Reported With Recommendation Without Amendment",15,0,0,0,15
408525,215394,2012-12-12,House,"House Third Reading: Passed Roll Call # 735",109,0,0,0,109
408561,196983,2012-05-17,Senate,"Reported Favorably With Substitute S-2",7,0,0,0,7
408561,200630,2012-05-31,Senate,"Senate Third Reading: Passed Roll Call # 421",36,0,0,2,38
408561,211893,2012-09-12,House,"Reported With Recommendation Without Amendment",17,0,0,0,17
408561,212293,2012-09-27,House,"House Third Reading: Given Immediate Effect Roll Call # 567",107,0,0,0,107
408596,166192,2012-03-01,Senate,"Reported Favorably Without Amendment",6,0,0,0,6
408596,169084,2012-03-07,Senate,"Senate Third Reading: Passed Roll Call # 117",33,5,0,0,38
408596,172074,2012-03-13,House,"Reported With Recommendation Without Amendment",12,0,0,0,12
408596,176158,2012-03-20,House,"House Third Reading: Given Immediate Effect Roll Call # 125",97,12,0,0,109
408848,176912,2012-03-20,House,"Reported With Recommendation Without Amendment",16,0,0,0,16
409200,197761,2012-05-22,House,"Reported With Recommendation Without Amendment",13,0,0,0,13
409289,201349,2012-06-06,Senate,"Reported Favorably With Substitute S-1",7,0,0,0,7
409289,201571,2012-06-07,Senate,"Senate Third Reading: Passed Roll Call # 468",37,0,0,1,38
409289,201939,2012-06-12,House,"Reported With Recommendation Without Amendment",13,0,0,0,13
409289,202557,2012-06-14,House,"House Third Reading: Given Immediate Effect Roll Call # 459",109,1,0,0,110
409304,199406,2012-05-29,Senate,"Reported Favorably With Substitute S-2",3,0,0,0,3
409304,214239,2012-11-29,Senate,"Senate Third Reading: Passed Roll Call # 767",35,3,0,0,38
409304,215087,2012-12-05,House,"Reported With Recommendation Without Amendment",16,0,0,0,16
409304,215524,2012-12-13,House,"House Third Reading: Given Immediate Effect Roll Call # 786",85,22,0,0,107
409361,212311,2012-09-27,Senate,"Reported Favorably With Substitute S-1",4,0,0,0,4
409361,212992,2012-10-17,Senate,"Senate Third Reading: Passed Roll Call # 709",37,0,0,1,38
409361,215634,2012-12-12,House,"Reported With Recommendation Without Amendment",9,2,0,0,11
409361,215635,2012-12-13,House,"House Third Reading: Given Immediate Effect Roll Call # 806",90,20,0,0,110
409374,192691,2012-05-02,Senate,"Reported Favorably With Substitute S-1",4,0,0,0,4
409374,196676,2012-05-17,Senate,"Senate Third Reading: Passed Roll Call # 359",35,3,0,0,38
409374,212133,2012-09-19,House,"Reported With Recommendation Without Amendment",5,0,0,0,5
409374,214450,2012-11-29,House,"House Third Reading: Passed Roll Call # 631",62,46,0,0,108
411398,201597,2012-06-07,Senate,"Reported Favorably Without Amendment",6,1,0,0,7
411398,202583,2012-06-14,Senate,"Senate Third Reading: Passed Roll Call # 532",35,1,2,0,38
411398,207209,2012-07-18,House,"Reported With Recommendation With Substitute H-1",12,2,0,0,14
411398,212314,2012-09-27,House,"House Third Reading: Given Immediate Effect Roll Call # 566",86,22,0,0,108
411398,212315,2012-09-27,Senate,"Senate Third Reading:  Roll Call # 691",34,1,0,3,38
411525,169776,2012-03-08,Senate,"Reported Favorably Without Amendment",4,0,0,0,4
411525,173229,2012-03-15,Senate,"Senate Third Reading: Passed Roll Call # 141",38,0,0,0,38
411525,186380,2012-04-17,House,"Reported With Recommendation With Substitute H-1",8,0,0,0,8
411525,189640,2012-04-25,House,"House Third Reading: Given Immediate Effect Roll Call # 196",110,0,0,0,110
411525,190269,2012-04-26,Senate,"Senate Third Reading:  Roll Call # 262",38,0,0,0,38
411543,212094,2012-09-20,Senate,"Reported Favorably Without Amendment",5,1,0,0,6
411543,212312,2012-09-27,Senate,"Senate Third Reading: Passed Roll Call # 678",32,6,0,0,38
411543,213718,2012-11-27,House,"Reported With Recommendation With Substitute H-1",14,0,0,0,14
411543,215424,2012-12-12,House,"House Third Reading: Given Immediate Effect Roll Call # 737",108,0,0,0,108
411543,215745,2012-12-13,Senate,"Senate Third Reading:  Roll Call # 1039",32,6,0,0,38
411581,212909,2012-10-17,Senate,"Reported Favorably With Substitute S-5",5,0,0,0,5
411581,213661,2012-11-08,Senate,"Senate Third Reading: Passed Roll Call # 732",37,0,0,1,38
411581,215140,2012-12-05,House,"Reported With Recommendation With Substitute H-4",7,3,0,0,10
411581,215501,2012-12-13,House,"House Third Reading: Given Immediate Effect Roll Call # 787",106,1,0,0,107
411581,215644,2012-12-13,Senate,"Senate Third Reading:  Roll Call # 1040",38,0,0,0,38
411628,196393,2012-05-15,House,"Reported With Recommendation Without Amendment",10,0,0,0,10
411628,199932,2012-05-30,House,"House Third Reading: Given Immediate Effect Roll Call # 324",110,0,0,0,110
411628,211875,2012-09-11,Senate,"Reported Favorably Without Amendment",7,0,0,0,7
411628,211997,2012-09-13,Senate,"Senate Third Reading: Given Immediate Effect Roll Call # 625",38,0,0,0,38
411842,192330,2012-05-02,House,"Reported With Recommendation With Substitute H-1",12,0,0,0,12
412351,187145,2012-04-17,House,"Reported With Recommendation With Substitute H-1",6,0,0,0,6
412351,192868,2012-05-02,House,"House Third Reading: Given Immediate Effect Roll Call # 218",109,0,0,0,109
412351,197971,2012-05-23,Senate,"Reported Favorably Without Amendment",5,0,0,0,5
412351,215729,2012-12-13,Senate,"Senate Third Reading: Given Immediate Effect Roll Call # 1035",36,0,2,0,38
412369,201191,2012-06-05,House,"Reported With Recommendation With Substitute H-1",17,0,0,0,17
412369,202503,2012-06-14,House,"House Third Reading: Given Immediate Effect Roll Call # 466",109,1,0,0,110
412369,214243,2012-11-29,Senate,"Reported Favorably Without Amendment",5,2,0,0,7
412369,215409,2012-12-12,Senate,"Senate Third Reading: Given Immediate Effect Roll Call # 914",27,10,0,1,38
412386,196558,2012-05-16,House,"Reported With Recommendation With Substitute H-1",15,0,0,0,15
412386,198409,2012-05-24,House,"House Third Reading: Given Immediate Effect Roll Call # 305",106,2,0,0,108
412386,202580,2012-06-14,Senate,"Reported Favorably Without Amendment",4,0,0,0,4
412386,215133,2012-12-05,Senate,"Reported Favorably With Substitute S-2",7,0,0,0,7
412386,215134,2012-12-05,Senate,"Senate Third Reading: Given Immediate Effect Roll Call # 822",27,11,0,0,38
412386,215637,2012-12-13,House,"House Third Reading:  Roll Call # 807",58,49,0,0,107
413661,186525,2012-04-17,Senate,"Reported Favorably With Recommendation For Referral To Committee On Finance",15,0,0,0,15
413687,186536,2012-04-17,Senate,"Reported Favorably With Recommendation For Referral To Committee On Finance",15,0,0,0,15
413714,186555,2012-04-17,Senate,"Reported Favorably With Recommendation For Referral To Committee On Finance",15,0,0,0,15
413759,189312,2012-04-24,Senate,"Reported Favorably Without Amendment",5,0,0,0,5
413786,195143,2012-05-10,House,"Reported With Recommendation With Substitute H-1",13,0,0,0,13
413786,201599,2012-06-07,House,"House Third Reading: Given Immediate Effect Roll Call # 377",87,21,0,0,108
413786,214227,2012-11-29,Senate,"Reported Favorably With Substitute S-4",4,0,0,0,4
413786,215458,2012-12-12,Senate,"Senate Third Reading: Given Immediate Effect Roll Call # 889",28,8,2,0,38
413786,215546,2012-12-13,House,"House Third Reading:  Roll Call # 836",86,23,0,0,109
413831,192913,2012-05-01,House,"Reported With Recommendation With Substitute H-2",21,0,0,0,21
413831,192914,2012-05-03,House,"House Third Reading: Given Immediate Effect Roll Call # 248",106,3,0,0,109
413831,201519,2012-06-07,Senate,"Reported Favorably With Substitute S-1",8,0,0,0,8
413831,202125,2012-06-13,Senate,"Senate Third Reading: Given Immediate Effect Roll Call # 496",29,7,1,1,38
413831,202126,2012-06-13,House,"House Third Reading:  Roll Call # 447",106,4,0,0,110
414062,178799,2012-03-27,House,"Reported With Recommendation With Substitute H-1",11,0,0,0,11
414074,177459,2012-03-22,Senate,"Reported Favorably With Substitute S-1",3,0,0,0,3
414074,177460,2012-03-22,Senate,"Senate Third Reading: Given Immediate Effect Roll Call # 155",25,13,0,0,38
414074,178818,2012-03-27,House,"Reported With Recommendation Without Amendment",3,2,0,0,5
414074,179777,2012-03-28,House,"House Third Reading: Given Immediate Effect Roll Call # 144",63,46,0,0,109
414074,180628,2012-03-29,House,"House Third Reading:  Roll Call # 147",45,63,0,0,108
414641,201224,2012-06-05,Senate,"Reported Favorably With Substitute S-1",5,0,0,0,5
414641,213721,2012-11-27,Senate,"Senate Third Reading: Passed Roll Call # 755",25,13,0,0,38
414641,214986,2012-12-04,House,"Reported With Recommendation With Substitute H-1",7,0,0,0,7
414641,215532,2012-12-13,House,"House Third Reading: Given Immediate Effect Roll Call # 795",95,15,0,0,110
414641,215696,2012-12-13,Senate,"Senate Third Reading:  Roll Call # 1054",23,15,0,0,38
414653,201234,2012-06-05,Senate,"Reported Favorably With Substitute S-1",4,1,0,0,5
414653,213731,2012-11-27,Senate,"Senate Third Reading: Passed Roll Call # 754",25,13,0,0,38
414653,215000,2012-12-04,House,"Reported With Recommendation With Substitute H-2",7,2,0,0,9
414653,215556,2012-12-13,House,"House Third Reading: Given Immediate Effect Roll Call # 794",92,18,0,0,110
414653,215715,2012-12-13,Senate,"Senate Third Reading:  Roll Call # 1053",25,13,0,0,38
414663,214444,2012-11-29,Senate,"Reported Favorably With Substitute S-1",4,0,0,0,4
414663,214970,2012-12-04,Senate,"Senate Third Reading: Passed Roll Call # 804",38,0,0,0,38
414676,178820,2012-03-27,House,"Reported With Recommendation With Substitute H-1",12,0,0,0,12
414754,213787,2012-11-28,House,"Reported With Recommendation With Substitute H-1",10,6,0,0,16
414774,192147,2012-05-01,House,"Reported With Recommendation With Substitute H-1",17,1,0,0,18
414774,196331,2012-05-15,House,"House Third Reading: Given Immediate Effect Roll Call # 265",97,12,0,0,109
414774,200302,2012-05-31,Senate,"Reported Favorably With Substitute S-1",5,1,0,0,6
414774,201549,2012-06-07,Senate,"Senate Third Reading: Passed Roll Call # 466",29,7,1,1,38
414774,201550,2012-06-07,Senate,"Senate Third Reading: Passed Roll Call # 467",29,8,0,1,38
414774,201910,2012-06-12,House,"House Third Reading:  Roll Call # 413",98,12,0,0,110
414774,229894,2012-06-07,Senate,"Senate Third Reading: Given Immediate Effect Roll Call # 467",29,8,0,1,38
414793,180282,2012-03-28,House,"Reported With Recommendation With Substitute H-2",10,0,0,0,10
414793,189451,2012-04-25,House,"House Third Reading: Passed Roll Call # 190",108,2,0,0,110
414802,180320,2012-03-28,House,"Reported With Recommendation With Substitute H-1",10,0,0,0,10
414802,189476,2012-04-25,House,"House Third Reading: Passed Roll Call # 191",108,2,0,0,110
414802,196267,2012-05-15,Senate,"Reported Favorably With Substitute S-1",6,0,0,0,6
414816,180300,2012-03-28,House,"Reported With Recommendation With Substitute H-1",10,0,0,0,10
414816,189452,2012-04-25,House,"House Third Reading: Passed Roll Call # 192",107,3,0,0,110
414816,196248,2012-05-15,Senate,"Reported Favorably With Substitute S-1",6,0,0,0,6
414826,180352,2012-03-28,House,"Reported With Recommendation With Substitute H-1",10,0,0,0,10
414826,189532,2012-04-25,House,"House Third Reading: Passed Roll Call # 193",108,2,0,0,110
414834,180385,2012-03-28,House,"Reported With Recommendation With Substitute H-1",10,0,0,0,10
414834,189552,2012-04-25,House,"House Third Reading: Passed Roll Call # 194",108,2,0,0,110
414834,196286,2012-05-15,Senate,"Reported Favorably With Substitute S-2",6,0,0,0,6
414846,180338,2012-03-28,House,"Reported With Recommendation With Substitute H-1",10,0,0,0,10
414846,189533,2012-04-25,House,"House Third Reading: Passed Roll Call # 195",108,2,0,0,110
414846,196268,2012-05-15,Senate,"Reported Favorably With Substitute S-2",6,0,0,0,6
414871,194847,2012-05-09,House,"Reported With Recommendation With Substitute H-2",16,0,0,0,16
414871,213802,2012-11-28,House,"House Third Reading: Passed Roll Call # 607",108,1,0,0,109
414871,215088,2012-12-05,Senate,"Reported Favorably Without Amendment",7,0,0,0,7
414871,215395,2012-12-12,Senate,"Senate Third Reading: Given Immediate Effect Roll Call # 901",38,0,0,0,38
414882,201290,2012-06-06,House,"Reported With Recommendation With Substitute H-1",15,0,0,0,15
414882,212336,2012-09-27,House,"House Third Reading: Given Immediate Effect Roll Call # 587",105,2,0,0,107
416350,196178,2012-05-15,Senate,"Reported Favorably With Substitute S-3",6,0,0,0,6
416350,201829,2012-06-12,Senate,"Senate Third Reading: Passed Roll Call # 484",38,0,0,0,38
416350,212077,2012-09-19,House,"Reported With Recommendation Without Amendment",6,0,0,0,6
416350,215505,2012-12-13,House,"House Third Reading: Given Immediate Effect Roll Call # 816",107,2,0,0,109
416350,215653,2012-12-14,Senate,"Senate Third Reading:  Roll Call # 1055",37,0,0,1,38
416370,196181,2012-05-15,Senate,"Reported Favorably With Substitute S-2",6,0,0,0,6
416370,201838,2012-06-12,Senate,"Senate Third Reading: Passed Roll Call # 485",38,0,0,0,38
416384,192710,2012-05-02,Senate,"Reported Favorably Without Amendment",6,0,0,0,6
416384,196722,2012-05-17,Senate,"Senate Third Reading: Passed Roll Call # 356",37,0,1,0,38
416384,200707,2012-05-30,House,"Reported With Recommendation Without Amendment",16,0,0,0,16
416384,202620,2012-06-14,House,"House Third Reading: Given Immediate Effect Roll Call # 454",110,0,0,0,110
416389,201124,2012-06-05,Senate,"Reported Favorably Without Amendment",5,1,0,0,6
416389,201271,2012-06-06,Senate,"Senate Third Reading: Passed Roll Call # 458",35,3,0,0,38
416389,214097,2012-11-27,House,"Reported With Recommendation With Substitute H-1",11,0,0,0,11
416389,215200,2012-12-06,House,"House Third Reading: Given Immediate Effect Roll Call # 715",66,42,0,0,108
416389,215401,2012-12-12,Senate,"Senate Third Reading:  Roll Call # 873",32,5,0,1,38
416434,198541,2012-05-24,House,"Reported With Recommendation Without Amendment",9,2,0,0,11
416434,202354,2012-06-13,House,"House Third Reading: Given Immediate Effect Roll Call # 436",75,35,0,0,110
416434,211857,2012-09-11,Senate,"Reported Favorably With Substitute S-1",4,0,0,0,4
416451,198529,2012-05-24,House,"Reported With Recommendation With Substitute H-1",9,2,0,0,11
416451,202350,2012-06-13,House,"House Third Reading: Given Immediate Effect Roll Call # 434",75,35,0,0,110
416451,211856,2012-09-11,Senate,"Reported Favorably Without Amendment",4,0,0,0,4
416468,201482,2012-06-05,House,"Reported With Recommendation For Referral To Committee On Insurance",14,0,0,0,14
416487,192825,2012-05-02,House,"Reported With Recommendation Without Amendment",16,0,0,0,16
416487,196769,2012-05-17,House,"House Third Reading: Passed Roll Call # 270",107,0,0,0,107
416487,196770,2012-05-17,House,"House Third Reading:  Roll Call # 271",107,0,0,0,107
416821,192428,2012-05-02,Senate,"Reported Favorably Without Amendment",6,0,0,0,6
416821,196942,2012-05-17,Senate,"Senate Third Reading: Passed Roll Call # 357",38,0,0,0,38
416821,199648,2012-05-30,House,"Reported With Recommendation Without Amendment",17,0,0,0,17
416821,202573,2012-06-14,House,"House Third Reading: Given Immediate Effect Roll Call # 455",110,0,0,0,110
416821,202574,2012-06-14,Senate,"Senate Third Reading: House Amendment(s) Concurred In Roll Call # 556",38,0,0,0,38
416945,201635,2012-06-06,House,"Reported With Recommendation With Substitute H-1",11,0,0,0,11
416989,193235,2012-05-02,House,"Reported With Recommendation Without Amendment",16,0,0,0,16
416989,196757,2012-05-17,House,"House Third Reading: Given Immediate Effect Roll Call # 272",107,0,0,0,107
417060,193258,2012-05-02,House,"Reported With Recommendation With Substitute H-1",15,1,0,0,16
417268,186953,2012-04-17,House,"Reported With Recommendation Without Amendment",21,0,0,0,21
417432,186961,2012-04-17,House,"Reported With Recommendation Without Amendment",21,0,0,0,21
417458,196435,2012-05-16,Senate,"Reported Favorably With Substitute S-2",3,0,0,0,3
417458,196626,2012-05-17,Senate,"Senate Third Reading: Passed Roll Call # 349",20,18,0,0,38
417458,198290,2012-05-24,House,"Reported With Recommendation With Substitute H-2",17,10,0,0,27
417458,202472,2012-06-14,House,"House Third Reading: Given Immediate Effect Roll Call # 449",57,47,0,0,104
417458,207196,2012-07-18,Senate,"Senate Third Reading:  Roll Call # 600",16,22,0,0,38
417458,209760,2012-08-15,Senate,"Senate Third Reading:  Roll Call # 605",21,16,0,1,38
417458,209761,2012-08-15,House,"House Third Reading:  Roll Call # 511",57,48,0,0,105
417480,201615,2012-06-07,Senate,"Reported Favorably Without Amendment",8,0,0,0,8
417480,201616,2012-06-07,Senate,"Senate Third Reading: Passed Roll Call # 469",37,0,0,1,38
417480,212052,2012-09-19,House,"Reported With Recommendation Without Amendment",25,0,0,0,25
417480,214985,2012-12-04,House,"House Third Reading: Given Immediate Effect Roll Call # 665",105,0,0,0,105
417525,199796,2012-05-29,Senate,"Reported Favorably With Substitute S-1",6,1,0,0,7
417525,207195,2012-07-18,Senate,"Senate Third Reading: Passed Roll Call # 571",36,1,0,1,38
417525,212110,2012-09-19,House,"Reported With Recommendation With Substitute H-2",16,0,0,0,16
417525,215375,2012-12-12,House,"House Third Reading: Given Immediate Effect Roll Call # 736",109,0,0,0,109
417525,215671,2012-12-13,Senate,"Senate Third Reading:  Roll Call # 1041",26,12,0,0,38
418077,199413,2012-05-29,Senate,"Reported Favorably With Substitute S-1",7,0,0,0,7
418077,200513,2012-05-31,Senate,"Senate Third Reading: Passed Roll Call # 427",36,0,0,2,38
418087,199416,2012-05-29,Senate,"Reported Favorably Without Amendment",7,0,0,0,7
418087,200518,2012-05-31,Senate,"Senate Third Reading: Passed Roll Call # 426",36,0,0,2,38
418096,199429,2012-05-29,Senate,"Reported Favorably With Substitute S-2",5,0,0,0,5
418096,199945,2012-05-30,Senate,"Senate Third Reading: Passed Roll Call # 401",34,2,0,2,38
418096,201235,2012-06-05,House,"Reported With Recommendation Without Amendment",11,0,0,0,11
418096,201427,2012-06-06,House,"House Third Reading: Given Immediate Effect Roll Call # 367",109,0,0,0,109
418111,196886,2012-05-17,Senate,"Reported Favorably Without Amendment",10,0,0,0,10
418111,200551,2012-05-31,Senate,"Senate Third Reading: Passed Roll Call # 422",25,11,0,2,38
418111,201249,2012-06-06,House,"Reported With Recommendation Without Amendment",17,5,0,0,22
418111,202379,2012-06-13,House,"House Third Reading: Given Immediate Effect Roll Call # 442",66,44,0,0,110
418120,212081,2012-09-20,Senate,"Reported Favorably With Substitute S-2",3,0,0,0,3
418120,213799,2012-11-28,Senate,"Senate Third Reading: Passed Roll Call # 758",29,9,0,0,38
418120,213800,2012-11-28,Senate,"Senate Third Reading: Passed Roll Call # 766",28,10,0,0,38
418120,215168,2012-12-06,House,"Reported With Recommendation Without Amendment",11,1,0,0,12
418120,215528,2012-12-13,House,"House Third Reading: Passed Roll Call # 791",73,34,0,0,107
418322,215154,2012-12-05,House,"Reported With Recommendation With Substitute H-2",9,0,0,0,9
418342,215152,2012-12-05,House,"Reported With Recommendation With Amendment(s)",9,0,0,0,9
418669,212141,2012-09-20,Senate,"Reported Favorably With Substitute S-1",4,0,0,0,4
418669,213672,2012-11-08,Senate,"Senate Third Reading: Passed Roll Call # 745",31,6,0,1,38
418669,215569,2012-12-12,House,"Reported With Recommendation With Substitute H-1",11,0,0,0,11
418669,215570,2012-12-13,House,"House Third Reading: Given Immediate Effect Roll Call # 814",108,1,0,0,109
418669,215735,2012-12-14,Senate,"Senate Third Reading:  Roll Call # 1056",33,4,0,1,38
418681,194586,2012-05-08,Senate,"Reported Favorably Without Amendment",5,2,0,0,7
418681,198362,2012-05-23,Senate,"Senate Third Reading: Passed Roll Call # 379",26,11,0,1,38
418681,202489,2012-06-13,House,"Reported With Recommendation With Substitute H-1",9,0,0,0,9
418681,202490,2012-06-14,House,"House Third Reading: Given Immediate Effect Roll Call # 463",82,28,0,0,110
418681,202491,2012-06-14,Senate,"Senate Third Reading:  Roll Call # 557",27,11,0,0,38
418759,201565,2012-06-05,House,"Reported With Recommendation With Substitute H-3",19,0,0,0,19
418759,211926,2012-09-12,House,"House Third Reading: Passed Roll Call # 519",108,0,0,0,108
418759,213775,2012-11-28,Senate,"Reported Favorably With Substitute S-1",6,0,0,0,6
418759,215452,2012-12-12,Senate,"Senate Third Reading: Given Immediate Effect Roll Call # 888",38,0,0,0,38
418759,215504,2012-12-13,House,"House Third Reading:  Roll Call # 837",109,0,0,0,109
418827,186400,2012-04-17,House,"Reported With Recommendation Without Amendment",12,0,0,0,12
418879,196404,2012-05-16,Senate,"Reported Favorably Without Amendment",3,0,0,0,3
418879,201374,2012-06-06,Senate,"Senate Third Reading: Passed Roll Call # 442",38,0,0,0,38
418879,213669,2012-11-08,House,"Reported With Recommendation Without Amendment",10,0,0,0,10
418879,214456,2012-11-29,House,"House Third Reading: Given Immediate Effect Roll Call # 647",108,0,0,0,108
418879,215072,2012-12-05,Senate,"Senate Third Reading: House Amendment(s) Concurred In Roll Call # 818",38,0,0,0,38
418891,201962,2012-06-12,Senate,"Reported Favorably With Substitute S-1",5,0,0,0,5
418891,212097,2012-09-20,Senate,"Senate Third Reading: Passed Roll Call # 639",38,0,0,0,38
418891,214996,2012-12-04,House,"Reported With Recommendation Without Amendment",9,0,0,0,9
418900,201993,2012-06-12,Senate,"Reported Favorably With Substitute S-1",5,0,0,0,5
418900,212125,2012-09-20,Senate,"Senate Third Reading: Passed Roll Call # 640",38,0,0,0,38
418900,214975,2012-12-04,House,"Reported With Recommendation Without Amendment",9,0,0,0,9
418914,201995,2012-06-12,Senate,"Reported Favorably With Substitute S-1",5,0,0,0,5
418914,212128,2012-09-20,Senate,"Senate Third Reading: Passed Roll Call # 641",38,0,0,0,38
418914,214452,2012-11-29,Senate,"Senate Third Reading: Passed Roll Call # 778",38,0,0,0,38
418914,214972,2012-12-04,House,"Reported With Recommendation With Substitute H-1",9,0,0,0,9
418923,201982,2012-06-12,Senate,"Reported Favorably Without Amendment",5,0,0,0,5
418923,212119,2012-09-20,Senate,"Senate Third Reading: Passed Roll Call # 642",38,0,0,0,38
418936,201994,2012-06-12,Senate,"Reported Favorably With Substitute S-1",5,0,0,0,5
418936,212127,2012-09-20,Senate,"Senate Third Reading: Passed Roll Call # 643",38,0,0,0,38
418936,215058,2012-12-04,House,"Reported With Recommendation Without Amendment",9,0,0,0,9
418947,201983,2012-06-12,Senate,"Reported Favorably With Substitute S-1",5,0,0,0,5
418947,212123,2012-09-20,Senate,"Senate Third Reading: Passed Roll Call # 644",38,0,0,0,38
418947,215041,2012-12-04,House,"Reported With Recommendation With Substitute H-1",9,0,0,0,9
418967,212046,2012-09-19,Senate,"Reported Favorably Without Amendment",7,0,0,0,7
420987,192402,2012-05-02,Senate,"Reported Favorably Without Amendment",5,2,0,0,7
420987,195238,2012-05-10,Senate,"Senate Third Reading: Passed Roll Call # 316",22,15,0,1,38
420987,215192,2012-12-05,House,"Reported With Recommendation With Substitute H-1",10,7,0,0,17
420989,192432,2012-05-02,Senate,"Reported Favorably Without Amendment",5,2,0,0,7
420989,195271,2012-05-10,Senate,"Senate Third Reading: Passed Roll Call # 327",24,13,0,1,38
420989,215107,2012-12-05,House,"Reported With Recommendation With Substitute H-1",10,7,0,0,17
420989,215585,2012-12-13,House,"House Third Reading: Passed Roll Call # 866",57,51,0,0,108
420989,215747,2012-12-14,Senate,"Senate Third Reading:  Roll Call # 1075",25,13,0,0,38
420995,192420,2012-05-02,Senate,"Reported Favorably Without Amendment",5,2,0,0,7
420995,195249,2012-05-10,Senate,"Senate Third Reading: Passed Roll Call # 326",23,14,0,1,38
420995,215092,2012-12-05,House,"Reported With Recommendation With Substitute H-1",10,7,0,0,17
420995,215568,2012-12-13,House,"House Third Reading: Passed Roll Call # 865",58,50,0,0,108
420995,215734,2012-12-14,Senate,"Senate Third Reading:  Roll Call # 1074",26,12,0,0,38
420997,192447,2012-05-02,Senate,"Reported Favorably Without Amendment",5,2,0,0,7
420997,195336,2012-05-10,Senate,"Senate Third Reading: Passed Roll Call # 323",23,14,0,1,38
420997,215109,2012-12-05,House,"Reported With Recommendation With Substitute H-1",10,7,0,0,17
420997,215586,2012-12-13,House,"House Third Reading: Passed Roll Call # 864",57,51,0,0,108
420997,215752,2012-12-14,Senate,"Senate Third Reading:  Roll Call # 1073",25,13,0,0,38
421001,192469,2012-05-02,Senate,"Reported Favorably Without Amendment",5,2,0,0,7
421001,195360,2012-05-10,Senate,"Senate Third Reading: Passed Roll Call # 320",23,14,0,1,38
421001,215120,2012-12-05,House,"Reported With Recommendation With Substitute H-1",10,7,0,0,17
421001,215596,2012-12-13,House,"House Third Reading: Passed Roll Call # 862",57,52,0,0,109
421001,215768,2012-12-14,Senate,"Senate Third Reading:  Roll Call # 1072",25,13,0,0,38
421005,192459,2012-05-02,Senate,"Reported Favorably Without Amendment",5,2,0,0,7
421005,195335,2012-05-10,Senate,"Senate Third Reading: Passed Roll Call # 319",23,14,0,1,38
421005,215117,2012-12-05,House,"Reported With Recommendation With Substitute H-2",10,7,0,0,17
421005,215590,2012-12-13,House,"House Third Reading: Passed Roll Call # 861",57,52,0,0,109
421005,215763,2012-12-14,Senate,"Senate Third Reading: House Amendment(s) Concurred In Roll Call # 1071",25,13,0,0,38
421010,192484,2012-05-02,Senate,"Reported Favorably Without Amendment",5,2,0,0,7
421010,195356,2012-05-10,Senate,"Senate Third Reading: Passed Roll Call # 318",23,14,0,1,38
421010,215119,2012-12-05,House,"Reported With Recommendation With Substitute H-1",10,7,0,0,17
421010,215595,2012-12-13,House,"House Third Reading: Passed Roll Call # 860",57,52,0,0,109
421010,215767,2012-12-14,Senate,"Senate Third Reading:  Roll Call # 1070",25,13,0,0,38
421014,192489,2012-05-02,Senate,"Reported Favorably Without Amendment",5,2,0,0,7
421014,195359,2012-05-10,Senate,"Senate Third Reading: Passed Roll Call # 317",23,14,0,1,38
421014,215123,2012-12-05,House,"Reported With Recommendation With Substitute H-2",10,7,0,0,17
421014,215612,2012-12-13,House,"House Third Reading: Passed Roll Call # 859",57,52,0,0,109
421014,215786,2012-12-14,Senate,"Senate Third Reading:  Roll Call # 1069",25,13,0,0,38
421020,187466,2012-04-19,Senate,"Reported Favorably With Substitute S-1",3,0,0,0,3
421020,189060,2012-04-24,Senate,"Senate Third Reading: Passed Roll Call # 216",38,0,0,0,38
421020,191972,2012-05-01,House,"Reported With Recommendation Without Amendment",21,0,0,0,21
421020,193161,2012-05-03,House,"House Third Reading: Given Immediate Effect Roll Call # 249",104,5,0,0,109
421199,191883,2012-05-01,Senate,"Reported Favorably With Substitute S-1",4,0,0,0,4
421237,192442,2012-05-02,Senate,"Reported Favorably With Recommendation For Referral To Committee On Local Government And Elections",4,0,0,0,4
421237,201562,2012-06-07,Senate,"Reported Favorably Without Amendment",8,0,0,0,8
421237,201563,2012-06-07,Senate,"Senate Third Reading: Passed Roll Call # 472",26,11,0,1,38
421294,201425,2012-06-06,House,"Reported With Recommendation Without Amendment",17,0,0,0,17
421294,214470,2012-11-29,House,"House Third Reading: Passed Roll Call # 628",106,1,0,0,107
421325,201238,2012-06-06,House,"Reported With Recommendation With Substitute H-1",19,5,0,0,24
421325,201433,2012-06-07,House,"House Third Reading: Given Immediate Effect Roll Call # 382",85,23,0,0,108
421325,202322,2012-06-13,Senate,"Senate Third Reading: Given Immediate Effect Roll Call # 507",36,1,0,1,38
421355,189255,2012-04-24,House,"Reported With Recommendation Without Amendment",6,1,0,0,7
421438,192347,2012-05-02,House,"Reported With Recommendation Without Amendment",26,0,0,0,26
421438,194429,2012-05-08,House,"House Third Reading:  Roll Call # 251",107,1,0,0,108
421438,197024,2012-05-17,Senate,"Reported Favorably Without Amendment",14,0,0,0,14
421438,209759,2012-08-15,Senate,"Senate Third Reading:  Roll Call # 602",37,0,0,1,38
421441,192384,2012-05-02,House,"Reported With Recommendation Without Amendment",26,0,0,0,26
421441,194448,2012-05-08,House,"House Third Reading:  Roll Call # 252",107,1,0,0,108
421441,197032,2012-05-17,Senate,"Reported Favorably Without Amendment",14,0,0,0,14
421441,209768,2012-08-15,Senate,"Senate Third Reading:  Roll Call # 603",37,0,0,1,38
421471,194364,2012-05-08,Senate,"Reported Favorably Without Amendment",6,0,0,0,6
421471,196657,2012-05-17,Senate,"Senate Third Reading: Passed Roll Call # 360",38,0,0,0,38
421471,198164,2012-05-23,House,"Reported With Recommendation Without Amendment",5,0,0,0,5
421471,200652,2012-05-30,House,"House Third Reading: Given Immediate Effect Roll Call # 331",109,1,0,0,110
421475,195068,2012-05-09,Senate,"Reported Favorably With Substitute S-1",7,0,0,0,7
421498,209747,2012-08-15,Senate,"Reported Favorably With Substitute S-2",6,1,0,0,7
421498,214099,2012-11-29,Senate,"Senate Third Reading: Passed Roll Call # 768",26,12,0,0,38
421502,209750,2012-08-15,Senate,"Reported Favorably With Substitute S-1",6,1,0,0,7
421502,214170,2012-11-29,Senate,"Senate Third Reading: Passed Roll Call # 769",26,12,0,0,38
421509,189990,2012-04-26,Senate,"Reported Favorably With Substitute S-1",4,2,0,0,6
421509,196972,2012-05-17,Senate,"Senate Third Reading: Passed Roll Call # 353",26,12,0,0,38
421509,198816,2012-05-24,House,"Reported With Recommendation Without Amendment",10,4,0,0,14
421509,200455,2012-05-31,House,"House Third Reading: Given Immediate Effect Roll Call # 343",63,47,0,0,110
421509,201589,2012-06-07,House,"House Third Reading: Passed Roll Call # 370",63,44,0,0,107
421509,201984,2012-06-12,Senate,"Senate Third Reading: House Amendment(s) Concurred In Roll Call # 478",26,11,0,1,38
421526,196408,2012-05-16,Senate,"Reported Favorably With Substitute S-2",3,0,0,0,3
421526,200333,2012-05-31,Senate,"Senate Third Reading: Passed Roll Call # 420",36,0,0,2,38
421526,201174,2012-06-05,House,"Reported With Recommendation With Substitute H-2",15,0,0,0,15
421526,201558,2012-06-07,House,"House Third Reading: Given Immediate Effect Roll Call # 384",107,0,0,0,107
421526,201928,2012-06-12,Senate,"Senate Third Reading:  Roll Call # 477",37,0,0,1,38
421584,198501,2012-05-23,House,"Reported With Recommendation With Substitute H-1",3,0,0,0,3
421584,201582,2012-06-07,House,"House Third Reading: Given Immediate Effect Roll Call # 373",100,8,0,0,108
421625,189665,2012-04-25,House,"Reported With Recommendation With Substitute H-1",12,0,0,0,12
421625,213656,2012-11-08,House,"House Third Reading: Given Immediate Effect Roll Call # 592",91,16,0,0,107
421625,214978,2012-12-04,Senate,"Reported Favorably Without Amendment",3,0,0,0,3
421625,215652,2012-12-14,Senate,"Senate Third Reading: Given Immediate Effect Roll Call # 1090",24,11,3,0,38
421669,214987,2012-12-04,House,"Reported With Recommendation With Substitute H-2",9,0,0,0,9
421669,215181,2012-12-06,House,"House Third Reading: Passed Roll Call # 700",66,43,0,0,109
421690,196447,2012-05-16,House,"Reported With Recommendation With Substitute H-2",17,0,0,0,17
421690,200346,2012-05-31,House,"House Third Reading: Given Immediate Effect Roll Call # 339",109,0,0,0,109
421690,201561,2012-06-07,Senate,"Reported Favorably Without Amendment",7,0,0,0,7
421690,202538,2012-06-14,Senate,"Senate Third Reading: Given Immediate Effect Roll Call # 534",38,0,0,0,38
422135,200524,2012-05-29,Senate,"Reported Favorably With Substitute S-1",3,0,0,0,3
422141,194619,2012-05-08,Senate,"Reported Favorably Without Amendment",5,2,0,0,7
422141,196212,2012-05-16,Senate,"Senate Third Reading: Passed Roll Call # 338",26,12,0,0,38
422141,200601,2012-05-30,House,"Reported With Recommendation With Substitute H-1",7,2,0,0,9
422141,201151,2012-06-05,House,"House Third Reading: Given Immediate Effect Roll Call # 355",67,40,0,0,107
422141,201309,2012-06-06,Senate,"Senate Third Reading:  Roll Call # 454",28,10,0,0,38
422148,202143,2012-06-13,Senate,"Reported Favorably Without Amendment",7,0,0,0,7
422154,194481,2012-05-08,Senate,"Reported Favorably Without Amendment",7,0,0,0,7
422154,197945,2012-05-22,Senate,"Senate Third Reading: Passed Roll Call # 365",36,0,0,2,38
422161,194469,2012-05-08,Senate,"Reported Favorably Without Amendment",7,0,0,0,7
422161,197909,2012-05-22,Senate,"Senate Third Reading: Passed Roll Call # 364",36,0,0,2,38
422169,194501,2012-05-08,Senate,"Reported Favorably Without Amendment",7,0,0,0,7
422169,197983,2012-05-22,Senate,"Senate Third Reading: Passed Roll Call # 363",36,0,0,2,38
422181,200730,2012-05-30,House,"Reported With Recommendation Without Amendment",9,0,0,0,9
422181,201613,2012-06-07,House,"House Third Reading: Given Immediate Effect Roll Call # 396",76,31,0,0,107
422181,207206,2012-07-18,Senate,"Reported Favorably Without Amendment",6,0,0,0,6
422181,207207,2012-07-18,Senate,"Senate Third Reading: Given Immediate Effect Roll Call # 584",29,8,0,1,38
422188,200741,2012-05-30,House,"Reported With Recommendation Without Amendment",9,0,0,0,9
422188,201617,2012-06-07,House,"House Third Reading: Given Immediate Effect Roll Call # 395",76,31,0,0,107
422188,207179,2012-07-18,Senate,"Reported Favorably With Substitute S-4",6,0,0,0,6
422188,207180,2012-07-18,Senate,"Senate Third Reading: Given Immediate Effect Roll Call # 582",28,9,0,1,38
422188,207208,2012-07-18,House,"House Third Reading:  Roll Call # 510",79,24,0,0,103
422194,200753,2012-05-30,House,"Reported With Recommendation Without Amendment",9,0,0,0,9
422194,201630,2012-06-07,House,"House Third Reading: Given Immediate Effect Roll Call # 394",72,34,0,0,106
422194,207181,2012-07-18,Senate,"Reported Favorably With Substitute S-1",6,0,0,0,6
422194,207182,2012-07-18,Senate,"Senate Third Reading: Given Immediate Effect Roll Call # 580",28,9,0,1,38
422194,207183,2012-07-18,House,"House Third Reading:  Roll Call # 508",77,26,0,0,103
422201,200765,2012-05-30,House,"Reported With Recommendation Without Amendment",9,0,0,0,9
422201,201634,2012-06-07,House,"House Third Reading: Given Immediate Effect Roll Call # 393",77,30,0,0,107
422201,207192,2012-07-18,Senate,"Reported Favorably With Substitute S-2",6,0,0,0,6
422201,207193,2012-07-18,Senate,"Senate Third Reading: Given Immediate Effect Roll Call # 578",28,9,0,1,38
422201,207194,2012-07-18,House,"House Third Reading:  Roll Call # 507",78,25,0,0,103
422208,200747,2012-05-30,House,"Reported With Recommendation With Substitute H-2",9,0,0,0,9
422208,201629,2012-06-07,House,"House Third Reading: Given Immediate Effect Roll Call # 392",73,34,0,0,107
422208,207184,2012-07-18,Senate,"Reported Favorably With Substitute S-5",6,0,0,0,6
422208,207185,2012-07-18,Senate,"Senate Third Reading: Given Immediate Effect Roll Call # 576",27,10,0,1,38
422208,207186,2012-07-18,House,"House Third Reading:  Roll Call # 506",81,22,0,0,103
422230,193241,2012-05-03,House,"Reported With Recommendation Without Amendment",16,0,0,0,16
422230,196991,2012-05-17,House,"House Third Reading: Given Immediate Effect Roll Call # 277",107,0,0,0,107
422230,201308,2012-06-06,Senate,"Reported Favorably Without Amendment",4,0,0,0,4
422230,202639,2012-06-14,Senate,"Senate Third Reading: Given Immediate Effect Roll Call # 544",38,0,0,0,38
422230,202640,2012-06-14,House,"House Third Reading: Senate Amendment(s) Concurred In Roll Call # 488",109,0,0,0,109
422237,193230,2012-05-03,House,"Reported With Recommendation Without Amendment",16,0,0,0,16
422237,196989,2012-05-17,House,"House Third Reading: Given Immediate Effect Roll Call # 276",107,0,0,0,107
422237,202647,2012-06-14,Senate,"Senate Third Reading: Given Immediate Effect Roll Call # 543",38,0,0,0,38
422237,202648,2012-06-14,House,"House Third Reading: Senate Amendment(s) Concurred In Roll Call # 487",109,0,0,0,109
422237,212701,2012-06-06,Senate,"Reported Favorably With Amendment(s)",4,0,0,0,4
422250,201644,2012-06-07,House,"House Third Reading: Given Immediate Effect Roll Call # 389",97,10,0,0,107
422250,202361,2012-06-13,Senate,"Reported Favorably Without Amendment",4,0,0,0,4
422250,202605,2012-06-14,Senate,"Senate Third Reading: Given Immediate Effect Roll Call # 537",36,2,0,0,38
422270,201366,2012-06-06,House,"Reported With Recommendation Without Amendment",15,0,0,0,15
422270,212326,2012-09-27,House,"House Third Reading: Given Immediate Effect Roll Call # 590",93,14,0,0,107
422270,215203,2012-12-06,Senate,"Reported Favorably Without Amendment",5,0,0,0,5
422270,215718,2012-12-13,Senate,"Senate Third Reading: Given Immediate Effect Roll Call # 958",38,0,0,0,38
422299,195233,2012-05-08,House,"Reported With Recommendation Without Amendment",6,0,0,0,6
422299,196793,2012-05-17,House,"House Third Reading: Given Immediate Effect Roll Call # 274",107,0,0,0,107
422299,201926,2012-06-12,Senate,"Reported Favorably Without Amendment",15,0,0,0,15
422299,202200,2012-06-13,Senate,"Senate Third Reading: Given Immediate Effect Roll Call # 503",37,0,0,1,38
422358,196797,2012-05-17,Senate,"Reported Favorably With Substitute S-1",5,0,0,0,5
422358,198230,2012-05-23,Senate,"Senate Third Reading: Passed Roll Call # 384",37,0,0,1,38
422358,202035,2012-06-12,House,"Reported With Recommendation With Substitute H-1",16,1,0,0,17
422358,202607,2012-06-14,House,"House Third Reading: Given Immediate Effect Roll Call # 461",105,5,0,0,110
422358,202608,2012-06-14,Senate,"Senate Third Reading:  Roll Call # 558",38,0,0,0,38
422395,195088,2012-05-09,Senate,"Reported Favorably Without Amendment",4,0,0,0,4
422395,201245,2012-06-06,Senate,"Senate Third Reading: Passed Roll Call # 441",38,0,0,0,38
422395,215589,2012-12-12,House,"Reported With Recommendation With Amendment(s)",14,2,0,0,16
422414,212323,2012-09-27,Senate,"Reported Favorably Without Amendment",6,0,0,0,6
422414,213000,2012-10-17,Senate,"Senate Third Reading: Passed Roll Call # 717",37,0,0,1,38
422414,215189,2012-12-05,House,"Reported With Recommendation Without Amendment",12,0,0,0,12
422414,215541,2012-12-12,House,"House Third Reading: Given Immediate Effect Roll Call # 772",109,0,0,0,109
422637,212108,2012-09-20,House,"Reported With Recommendation For Referral To Committee On Local, Intergovernmental, And Regional Affairs",17,0,0,0,17
422647,197875,2012-05-22,House,"Reported With Recommendation With Substitute H-1",15,0,0,0,15
422647,200208,2012-05-31,House,"House Third Reading: Given Immediate Effect Roll Call # 342",109,0,0,0,109
422647,202417,2012-06-14,Senate,"Reported Favorably Without Amendment",6,0,0,0,6
422647,207214,2012-07-18,Senate,"Senate Third Reading: Given Immediate Effect Roll Call # 574",30,7,0,1,38
422691,193096,2012-05-03,House,"Reported With Recommendation Without Amendment",15,0,0,0,15
422691,195383,2012-05-10,House,"House Third Reading: Given Immediate Effect Roll Call # 262",107,0,0,0,107
422691,201496,2012-06-07,Senate,"Reported Favorably Without Amendment",4,0,0,0,4
422691,202087,2012-06-13,Senate,"Senate Third Reading: Given Immediate Effect Roll Call # 502",37,0,0,1,38
422701,199454,2012-05-29,House,"Reported With Recommendation With Substitute H-1",8,0,0,0,8
422701,201115,2012-06-05,House,"House Third Reading: Passed Roll Call # 354",74,34,0,0,108
422701,201609,2012-06-07,Senate,"Reported Favorably Without Amendment",3,0,0,0,3
422701,202317,2012-06-13,Senate,"Senate Third Reading: Given Immediate Effect Roll Call # 506",37,0,0,1,38
422701,202591,2012-06-14,House,"House Third Reading:  Roll Call # 495",75,34,0,0,109
422701,207210,2012-07-18,Senate,"Senate Third Reading:  Roll Call # 598",37,0,0,1,38
422716,193175,2012-05-03,Senate,"Reported Favorably Without Amendment",6,0,0,0,6
422725,193173,2012-05-03,Senate,"Reported Favorably Without Amendment",6,0,0,0,6
422725,198013,2012-05-22,Senate,"Senate Third Reading: Passed Roll Call # 368",37,0,0,1,38
422725,200339,2012-05-30,House,"Reported With Recommendation Without Amendment",17,0,0,0,17
422725,202571,2012-06-14,House,"House Third Reading: Given Immediate Effect Roll Call # 452",110,0,0,0,110
422725,202572,2012-06-14,Senate,"Senate Third Reading:  Roll Call # 559",38,0,0,0,38
422739,211915,2012-09-12,Senate,"Reported Favorably Without Amendment",4,0,0,0,4
422739,212067,2012-09-19,Senate,"Senate Third Reading: Passed Roll Call # 637",38,0,0,0,38
422753,211913,2012-09-12,Senate,"Reported Favorably Without Amendment",4,0,0,0,4
422753,212068,2012-09-19,Senate,"Senate Third Reading: Passed Roll Call # 636",38,0,0,0,38
422779,200257,2012-05-30,Senate,"Reported Favorably With Substitute S-1",4,0,0,0,4
422779,209782,2012-08-15,Senate,"Senate Third Reading: Passed Roll Call # 610",35,2,0,1,38
422795,200303,2012-05-30,Senate,"Reported Favorably Without Amendment",4,0,0,0,4
422795,209821,2012-08-15,Senate,"Senate Third Reading: Passed Roll Call # 608",36,1,0,1,38
422808,200275,2012-05-30,Senate,"Reported Favorably With Substitute S-1",4,0,0,0,4
422808,209785,2012-08-15,Senate,"Senate Third Reading: Passed Roll Call # 609",36,1,0,1,38
422823,200309,2012-05-30,Senate,"Reported Favorably Without Amendment",4,0,0,0,4
422823,209822,2012-08-15,Senate,"Senate Third Reading: Passed Roll Call # 607",36,1,0,1,38
422835,200312,2012-05-30,Senate,"Reported Favorably Without Amendment",4,0,0,0,4
422835,209787,2012-08-15,Senate,"Senate Third Reading: Passed Roll Call # 606",36,1,0,1,38
423235,197846,2012-05-22,Senate,"Reported Favorably Without Amendment",5,0,0,0,5
423235,200142,2012-05-31,Senate,"Senate Third Reading: Passed Roll Call # 423",33,3,0,2,38
423235,212139,2012-09-19,House,"Reported With Recommendation Without Amendment",8,0,0,0,8
423235,214114,2012-11-29,House,"House Third Reading: Given Immediate Effect Roll Call # 630",105,3,0,0,108
423255,195471,2012-05-10,Senate,"Reported Favorably Without Amendment",7,0,0,0,7
423255,198083,2012-05-23,Senate,"Senate Third Reading: Passed Roll Call # 374",36,0,0,2,38
423255,201459,2012-06-05,House,"Reported With Recommendation Without Amendment",17,0,0,0,17
423255,202537,2012-06-14,House,"House Third Reading: Given Immediate Effect Roll Call # 457",109,0,0,0,109
423273,196766,2012-05-17,Senate,"Reported Favorably Without Amendment",5,0,0,0,5
423273,198208,2012-05-23,Senate,"Senate Third Reading: Passed Roll Call # 377",36,0,1,1,38
423273,201221,2012-06-05,House,"Reported With Recommendation Without Amendment",16,1,0,0,17
423273,202411,2012-06-14,House,"House Third Reading: Given Immediate Effect Roll Call # 456",100,10,0,0,110
423417,207205,2012-07-18,House,"Reported With Recommendation Without Amendment",14,1,0,0,15
423417,212080,2012-09-19,House,"House Third Reading: Given Immediate Effect Roll Call # 542",86,19,0,0,105
423417,212209,2012-09-25,Senate,"Reported Favorably With Substitute S-1",16,0,0,0,16
423417,212286,2012-09-27,Senate,"Senate Third Reading: Given Immediate Effect Roll Call # 664",33,5,0,0,38
423417,212287,2012-09-27,House,"House Third Reading:  Roll Call # 572",93,14,0,0,107
423433,201239,2012-06-05,House,"Reported With Recommendation With Substitute H-1",13,0,0,0,13
423433,211919,2012-09-12,House,"House Third Reading: Given Immediate Effect Roll Call # 513",108,0,0,0,108
423433,212243,2012-09-27,Senate,"Reported Favorably Without Amendment",4,0,0,0,4
423433,215430,2012-12-12,Senate,"Senate Third Reading: Given Immediate Effect Roll Call # 884",38,0,0,0,38
423446,201236,2012-06-05,House,"Reported With Recommendation With Substitute H-1",13,0,0,0,13
423446,211916,2012-09-12,House,"House Third Reading: Given Immediate Effect Roll Call # 514",108,0,0,0,108
423446,212245,2012-09-27,Senate,"Reported Favorably Without Amendment",5,0,0,0,5
423446,215431,2012-12-12,Senate,"Senate Third Reading: Given Immediate Effect Roll Call # 885",38,0,0,0,38
423511,201657,2012-06-07,House,"Reported With Recommendation With Substitute H-1",11,2,0,0,13
423526,201500,2012-06-07,House,"Reported With Recommendation With Substitute H-2",10,5,0,0,15
423542,201486,2012-06-07,House,"Reported With Recommendation With Substitute H-2",11,4,0,0,15
423556,201297,2012-06-05,House,"Reported With Recommendation With Substitute H-2",13,0,0,0,13
423556,211908,2012-09-12,House,"House Third Reading: Given Immediate Effect Roll Call # 515",108,0,0,0,108
423556,212240,2012-09-27,Senate,"Reported Favorably Without Amendment",5,0,0,0,5
423556,215428,2012-12-12,Senate,"Senate Third Reading: Given Immediate Effect Roll Call # 886",38,0,0,0,38
423556,215582,2012-12-13,House,"House Third Reading: Senate Amendment(s) Concurred In Roll Call # 838",108,0,0,0,108
423670,195047,2012-05-09,Senate,"Reported Favorably With Substitute S-1",4,0,0,0,4
423670,201654,2012-06-07,Senate,"Senate Third Reading: Passed Roll Call # 473",32,5,0,1,38
423670,209834,2012-08-15,House,"Reported With Recommendation With Substitute H-2",11,1,0,0,12
423670,212004,2012-09-12,House,"House Third Reading: Given Immediate Effect Roll Call # 516",98,10,0,0,108
423670,212048,2012-09-19,Senate,"Senate Third Reading:  Roll Call # 635",32,6,0,0,38
423980,214128,2012-11-29,Senate,"Reported Favorably Without Amendment",4,0,0,0,4
423980,214129,2012-11-29,Senate,"Senate Third Reading: Passed Roll Call # 794",27,11,0,0,38
423980,215550,2012-12-12,House,"Reported With Recommendation Without Amendment",14,2,0,0,16
423980,215551,2012-12-13,House,"House Third Reading: Passed Roll Call # 809",107,3,0,0,110
423996,214154,2012-11-29,Senate,"Reported Favorably Without Amendment",4,0,0,0,4
423996,214155,2012-11-29,Senate,"Senate Third Reading: Passed Roll Call # 793",26,12,0,0,38
424032,214235,2012-11-29,Senate,"Reported Favorably Without Amendment",4,0,0,0,4
424032,214236,2012-11-29,Senate,"Senate Third Reading: Passed Roll Call # 792",36,2,0,0,38
424032,215521,2012-12-12,House,"Reported With Recommendation Without Amendment",16,1,0,0,17
424032,215522,2012-12-13,House,"House Third Reading: Passed Roll Call # 808",108,2,0,0,110
424053,207197,2012-07-18,Senate,"Reported Favorably Without Amendment",6,0,0,0,6
424053,207198,2012-07-18,Senate,"Senate Third Reading: Passed Roll Call # 591",37,0,0,1,38
424053,215280,2012-12-06,House,"Reported With Recommendation Without Amendment",16,0,0,0,16
424053,215856,2012-12-14,House,"House Third Reading: Given Immediate Effect Roll Call # 872",107,0,0,0,107
424069,207199,2012-07-18,Senate,"Reported Favorably Without Amendment",6,0,0,0,6
424069,207200,2012-07-18,Senate,"Senate Third Reading: Passed Roll Call # 590",37,0,0,1,38
424069,215285,2012-12-06,House,"Reported With Recommendation With Substitute H-1",16,0,0,0,16
424069,215859,2012-12-14,House,"House Third Reading: Given Immediate Effect Roll Call # 871",107,0,0,0,107
424069,215860,2012-12-14,Senate,"Senate Third Reading:  Roll Call # 1082",38,0,0,0,38
424089,207201,2012-07-18,Senate,"Reported Favorably Without Amendment",6,0,0,0,6
424089,207202,2012-07-18,Senate,"Senate Third Reading: Passed Roll Call # 589",37,0,0,1,38
424089,215297,2012-12-06,House,"Reported With Recommendation With Substitute H-2",17,0,0,0,17
424089,215876,2012-12-14,House,"House Third Reading: Given Immediate Effect Roll Call # 870",106,1,0,0,107
424089,215877,2012-12-14,Senate,"Senate Third Reading:  Roll Call # 1081",38,0,0,0,38
424212,214250,2012-11-29,House,"Reported With Recommendation Without Amendment",9,0,0,0,9
424223,196904,2012-05-16,House,"Reported With Recommendation With Substitute H-2",17,0,0,0,17
424223,198063,2012-05-23,House,"House Third Reading: Given Immediate Effect Roll Call # 290",107,1,0,0,108
424223,201876,2012-06-12,Senate,"Reported Favorably Without Amendment",15,0,0,0,15
424223,202120,2012-06-13,Senate,"Senate Third Reading: Given Immediate Effect Roll Call # 505",37,0,0,1,38
424223,202447,2012-06-14,House,"House Third Reading: Senate Amendment(s) Concurred In Roll Call # 475",110,0,0,0,110
424237,196907,2012-05-16,House,"Reported With Recommendation With Substitute H-1",17,0,0,0,17
424237,198065,2012-05-23,House,"House Third Reading: Given Immediate Effect Roll Call # 289",108,0,0,0,108
424237,201882,2012-06-12,Senate,"Reported Favorably Without Amendment",15,0,0,0,15
424237,202133,2012-06-13,Senate,"Senate Third Reading: Given Immediate Effect Roll Call # 504",37,0,0,1,38
424275,198343,2012-05-24,House,"Reported With Recommendation For Referral To Committee On Local, Intergovernmental, And Regional Affairs",13,0,0,0,13
424275,200779,2012-05-31,House,"Reported With Recommendation With Substitute H-1",15,0,0,0,15
424275,201509,2012-06-07,House,"House Third Reading: Given Immediate Effect Roll Call # 388",107,0,0,0,107
424275,209826,2012-08-15,Senate,"Reported Favorably Without Amendment",3,0,0,0,3
424275,211899,2012-09-12,Senate,"Senate Third Reading: Given Immediate Effect Roll Call # 622",38,0,0,0,38
424786,196703,2012-05-16,House,"Reported With Recommendation Without Amendment",17,0,0,0,17
424836,196300,2012-05-15,Senate,"Reported Favorably With Substitute S-2",5,0,0,0,5
424836,196768,2012-05-17,Senate,"Senate Third Reading: Passed Roll Call # 354",38,0,0,0,38
424836,198858,2012-05-24,House,"Reported With Recommendation Without Amendment",12,1,0,0,13
424883,212363,2012-09-27,House,"Reported With Recommendation With Substitute H-3",16,0,0,0,16
424883,214148,2012-11-28,House,"House Third Reading: Given Immediate Effect Roll Call # 620",109,0,0,0,109
424883,215178,2012-12-06,Senate,"Reported Favorably With Substitute S-1",4,0,0,0,4
424883,215694,2012-12-13,Senate,"Senate Third Reading: Given Immediate Effect Roll Call # 983",38,0,0,0,38
424883,215863,2012-12-14,House,"House Third Reading: Senate Amendment(s) Concurred In Roll Call # 898",105,0,0,0,105
425044,202355,2012-06-13,Senate,"Reported Favorably With Substitute S-1",7,0,0,0,7
425044,202604,2012-06-14,Senate,"Senate Third Reading: Passed Roll Call # 552",38,0,0,0,38
425044,212307,2012-09-27,House,"Reported With Recommendation With Substitute H-1",17,0,0,0,17
425044,215370,2012-12-12,House,"House Third Reading: Passed Roll Call # 738",107,1,0,0,108
425044,215663,2012-12-13,Senate,"Senate Third Reading:  Roll Call # 1042",38,0,0,0,38
425075,197853,2012-05-22,Senate,"Reported Favorably With Substitute S-1",6,0,0,0,6
425075,200116,2012-05-31,Senate,"Senate Third Reading: Passed Roll Call # 424",36,0,0,2,38
425075,212029,2012-09-13,House,"Reported With Recommendation With Substitute H-1",17,0,0,0,17
425075,212044,2012-09-19,House,"House Third Reading: Passed Roll Call # 546",104,1,0,0,105
425075,212308,2012-09-27,Senate,"Senate Third Reading:  Roll Call # 661",36,0,1,1,38
425104,200015,2012-05-29,Senate,"Reported Favorably Without Amendment",3,0,0,0,3
425125,200670,2012-05-30,House,"Reported With Recommendation Without Amendment",15,0,0,0,15
425125,201369,2012-06-06,House,"House Third Reading: Given Immediate Effect Roll Call # 364",109,0,0,0,109
425139,200697,2012-05-30,House,"Reported With Recommendation Without Amendment",15,0,0,0,15
425139,201406,2012-06-06,House,"House Third Reading: Given Immediate Effect Roll Call # 365",79,30,0,0,109
425157,199871,2012-05-30,House,"Reported With Recommendation Without Amendment",14,0,0,0,14
425157,200491,2012-05-31,House,"House Third Reading: Given Immediate Effect Roll Call # 346",110,0,0,0,110
425157,201596,2012-06-07,Senate,"Reported Favorably With Substitute S-1",7,0,0,0,7
425157,202291,2012-06-13,Senate,"Senate Third Reading: Given Immediate Effect Roll Call # 500",37,0,0,1,38
425157,202582,2012-06-14,House,"House Third Reading:  Roll Call # 476",110,0,0,0,110
425172,198218,2012-05-23,House,"Reported With Recommendation Without Amendment",13,0,0,0,13
425172,198583,2012-05-24,House,"House Third Reading: Given Immediate Effect Roll Call # 306",105,3,0,0,108
425172,201227,2012-06-05,Senate,"Reported Favorably With Substitute S-1",7,0,0,0,7
425172,202100,2012-06-13,Senate,"Senate Third Reading: Given Immediate Effect Roll Call # 495",37,0,0,1,38
425172,202432,2012-06-14,House,"House Third Reading:  Roll Call # 477",106,4,0,0,110
425329,196369,2012-05-16,House,"Reported With Recommendation Without Amendment",15,0,0,0,15
425340,199841,2012-05-29,House,"Reported With Recommendation Without Amendment",17,1,0,0,18
425340,212053,2012-09-19,House,"House Third Reading: Given Immediate Effect Roll Call # 524",90,15,0,0,105
425340,212973,2012-10-17,Senate,"Reported Favorably Without Amendment",5,0,0,0,5
425340,212974,2012-10-17,Senate,"Senate Third Reading: Given Immediate Effect Roll Call # 722",32,5,0,1,38
425360,199835,2012-05-29,House,"Reported With Recommendation Without Amendment",17,0,0,0,17
425360,212050,2012-09-19,House,"House Third Reading: Given Immediate Effect Roll Call # 523",92,13,0,0,105
425360,212935,2012-10-17,Senate,"Reported Favorably Without Amendment",5,0,0,0,5
425360,212936,2012-10-17,Senate,"Senate Third Reading: Given Immediate Effect Roll Call # 721",30,6,1,1,38
425370,199861,2012-05-29,House,"Reported With Recommendation Without Amendment",14,3,0,0,17
425370,212054,2012-09-19,House,"House Third Reading: Given Immediate Effect Roll Call # 522",82,22,0,0,104
425370,212978,2012-10-17,Senate,"Reported Favorably Without Amendment",5,0,0,0,5
425370,212979,2012-10-17,Senate,"Senate Third Reading: Given Immediate Effect Roll Call # 720",32,5,0,1,38
426320,201214,2012-06-05,Senate,"Reported Favorably With Substitute S-1",5,1,0,0,6
426320,201386,2012-06-06,Senate,"Senate Third Reading: Passed Roll Call # 459",26,12,0,0,38
426320,202269,2012-06-13,House,"Reported With Recommendation With Substitute H-1",6,0,0,0,6
426320,207225,2012-07-18,Senate,"Senate Third Reading: Passed Roll Call # 570",24,13,0,1,38
426320,207226,2012-07-18,House,"House Third Reading: Given Immediate Effect Roll Call # 509",63,40,0,0,103
426333,202466,2012-06-14,Senate,"Reported Favorably With Substitute S-2",6,0,0,0,6
426333,202467,2012-06-14,Senate,"Senate Third Reading: Passed Roll Call # 546",25,11,2,0,38
426333,212329,2012-09-27,House,"Reported With Recommendation With Substitute H-1",16,8,0,0,24
426333,212330,2012-09-27,House,"House Third Reading: Passed Roll Call # 557",77,30,0,0,107
426333,212331,2012-09-27,House,"House Third Reading: Given Immediate Effect Roll Call # 558",80,28,0,0,108
426333,212332,2012-09-27,Senate,"Senate Third Reading:  Roll Call # 692",26,9,0,3,38
426359,202199,2012-06-13,Senate,"Reported Favorably With Substitute S-1",4,0,0,0,4
426359,212271,2012-09-27,Senate,"Senate Third Reading: Passed Roll Call # 676",38,0,0,0,38
426359,215268,2012-12-06,House,"Reported With Recommendation With Substitute H-2",12,0,0,0,12
426359,215639,2012-12-13,House,"House Third Reading: Given Immediate Effect Roll Call # 796",87,23,0,0,110
426359,215640,2012-12-14,Senate,"Senate Third Reading:  Roll Call # 1057",38,0,0,0,38
426372,202216,2012-06-13,Senate,"Reported Favorably With Substitute S-1",4,0,0,0,4
426372,212275,2012-09-27,Senate,"Senate Third Reading: Passed Roll Call # 675",38,0,0,0,38
426372,215156,2012-12-06,House,"Reported With Recommendation Without Amendment",10,1,0,0,11
426372,215518,2012-12-13,House,"House Third Reading: Passed Roll Call # 792",101,6,0,0,107
426384,200442,2012-05-31,Senate,"Reported Favorably Without Amendment",5,0,0,0,5
426384,201391,2012-06-06,Senate,"Senate Third Reading: Passed Roll Call # 457",33,5,0,0,38
426384,212069,2012-09-19,House,"Reported With Recommendation With Substitute H-1",16,2,0,0,18
426384,212070,2012-09-19,House,"House Third Reading: Given Immediate Effect Roll Call # 527",85,20,0,0,105
426384,212205,2012-09-25,Senate,"Senate Third Reading:  Roll Call # 658",33,5,0,0,38
426397,200441,2012-05-31,Senate,"Reported Favorably Without Amendment",5,0,0,0,5
426397,201390,2012-06-06,Senate,"Senate Third Reading: Passed Roll Call # 456",34,4,0,0,38
426397,212072,2012-09-19,House,"Reported With Recommendation With Substitute H-1",14,1,0,0,15
426397,212073,2012-09-19,House,"House Third Reading: Given Immediate Effect Roll Call # 526",88,17,0,0,105
426397,212206,2012-09-25,Senate,"Senate Third Reading:  Roll Call # 657",33,5,0,0,38
426410,200686,2012-05-31,Senate,"Reported Favorably Without Amendment",4,0,0,0,4
426410,201397,2012-06-06,Senate,"Senate Third Reading: Passed Roll Call # 455",34,4,0,0,38
426410,211932,2012-09-12,House,"Reported With Recommendation With Substitute H-1",15,2,0,0,17
426410,212142,2012-09-19,House,"House Third Reading: Given Immediate Effect Roll Call # 525",86,19,0,0,105
426410,212216,2012-09-25,Senate,"Senate Third Reading:  Roll Call # 656",32,6,0,0,38
426436,201400,2012-06-06,House,"Reported With Recommendation Without Amendment",18,0,0,0,18
426449,197276,2012-05-16,House,"Reported With Recommendation With Substitute H-1",17,0,0,0,17
426518,201444,2012-06-07,House,"Reported With Recommendation Without Amendment",17,0,0,0,17
426527,201475,2012-06-07,House,"Reported With Recommendation Without Amendment",16,0,0,0,16
426527,201476,2012-06-07,House,"House Third Reading: Given Immediate Effect Roll Call # 398",107,0,0,0,107
426533,201471,2012-06-07,House,"Reported With Recommendation Without Amendment",14,0,0,0,14
426533,201472,2012-06-07,House,"House Third Reading: Given Immediate Effect Roll Call # 399",107,0,0,0,107
426542,201478,2012-06-07,House,"Reported With Recommendation Without Amendment",17,0,0,0,17
426542,201479,2012-06-07,House,"House Third Reading: Given Immediate Effect Roll Call # 400",107,0,0,0,107
426551,201480,2012-06-07,House,"Reported With Recommendation Without Amendment",17,0,0,0,17
426551,201481,2012-06-07,House,"House Third Reading: Given Immediate Effect Roll Call # 401",107,0,0,0,107
426559,201489,2012-06-07,House,"Reported With Recommendation Without Amendment",17,0,0,0,17
426559,201490,2012-06-07,House,"House Third Reading: Given Immediate Effect Roll Call # 402",107,0,0,0,107
426566,201484,2012-06-07,House,"Reported With Recommendation Without Amendment",17,0,0,0,17
426566,201485,2012-06-07,House,"House Third Reading: Given Immediate Effect Roll Call # 403",107,0,0,0,107
426575,201498,2012-06-07,House,"Reported With Recommendation Without Amendment",17,0,0,0,17
426575,201499,2012-06-07,House,"House Third Reading: Given Immediate Effect Roll Call # 404",107,0,0,0,107
426583,201492,2012-06-07,House,"Reported With Recommendation Without Amendment",17,0,0,0,17
426583,201493,2012-06-07,House,"House Third Reading: Passed Roll Call # 405",106,0,0,0,106
426583,201494,2012-06-07,House,"House Third Reading:  Roll Call # 406",105,1,0,0,106
426827,199525,2012-05-29,House,"Reported With Recommendation Without Amendment",15,2,0,0,17
426827,201119,2012-06-05,House,"House Third Reading: Given Immediate Effect Roll Call # 356",96,11,0,0,107
426827,202042,2012-06-12,Senate,"Reported Favorably Without Amendment",7,0,0,0,7
426827,202371,2012-06-14,Senate,"Senate Third Reading: Given Immediate Effect Roll Call # 536",36,2,0,0,38
426933,215163,2012-12-04,House,"Reported With Recommendation Without Amendment",8,0,0,0,8
426933,215164,2012-12-06,House,"House Third Reading: Passed Roll Call # 699",68,40,0,0,108
427095,211880,2012-09-11,Senate,"Reported Favorably With Substitute S-1",16,0,0,0,16
427095,211998,2012-09-13,Senate,"Senate Third Reading: Passed Roll Call # 626",38,0,0,0,38
427095,213653,2012-11-08,House,"Reported With Recommendation Without Amendment",24,0,0,0,24
427095,215054,2012-12-04,House,"House Third Reading: Given Immediate Effect Roll Call # 666",105,0,0,0,105
427107,212987,2012-10-17,Senate,"Reported Favorably With Substitute S-1",5,0,0,0,5
427107,213686,2012-11-08,Senate,"Senate Third Reading: Passed Roll Call # 743",37,0,0,1,38
427107,215097,2012-12-04,House,"Reported With Recommendation Without Amendment",8,0,0,0,8
427107,215559,2012-12-12,House,"House Third Reading: Given Immediate Effect Roll Call # 755",109,0,0,0,109
427122,201823,2012-06-12,Senate,"Reported Favorably Without Amendment",7,0,0,0,7
427895,200398,2012-05-31,Senate,"Reported Favorably With Substitute S-1",8,0,0,0,8
427895,200399,2012-05-31,Senate,"Senate Third Reading: Passed Roll Call # 428",33,3,0,2,38
427943,200419,2012-05-31,Senate,"Reported Favorably With Substitute S-2",8,0,0,0,8
427943,200420,2012-05-31,Senate,"Senate Third Reading: Passed Roll Call # 429",33,3,0,2,38
427943,215391,2012-12-12,House,"Reported With Recommendation With Substitute H-3",16,0,0,0,16
427943,215867,2012-12-14,House,"House Third Reading: Passed Roll Call # 888",105,1,0,0,106
427943,215868,2012-12-14,Senate,"Senate Third Reading:  Roll Call # 1093",34,3,1,0,38
427958,198147,2012-05-23,House,"Reported With Recommendation Without Amendment",11,0,0,0,11
427958,199811,2012-05-29,House,"House Third Reading: Given Immediate Effect Roll Call # 307",91,19,0,0,110
427958,201587,2012-06-07,Senate,"Reported Favorably Without Amendment",5,1,0,0,6
427958,201965,2012-06-12,Senate,"Senate Third Reading: Given Immediate Effect Roll Call # 487",36,2,0,0,38
427958,201966,2012-06-12,House,"House Third Reading: Senate Amendment(s) Concurred In By 3/4 Vote Roll Call # 426",100,8,0,0,108
427958,201967,2012-06-12,House,"House Third Reading: Senate Amendment(s) Concurred In By 3/4 Vote Roll Call # 427",98,11,0,0,109
427966,201513,2012-06-06,House,"Reported With Recommendation With Substitute H-1",17,0,0,0,17
427966,202637,2012-06-14,House,"House Third Reading: Given Immediate Effect Roll Call # 493",109,0,0,0,109
427966,215328,2012-12-11,Senate,"Reported Favorably Without Amendment",3,0,0,0,3
427979,200581,2012-05-31,House,"Reported With Recommendation With Substitute H-2",10,6,0,0,16
427979,201505,2012-06-07,House,"House Third Reading: Given Immediate Effect Roll Call # 397",63,44,0,0,107
427979,202101,2012-06-13,Senate,"Reported Favorably Without Amendment",4,0,0,0,4
427979,202435,2012-06-14,Senate,"Senate Third Reading: Given Immediate Effect Roll Call # 538",20,18,0,0,38
427993,200588,2012-05-30,House,"Reported With Recommendation Without Amendment",12,1,0,0,13
428195,212298,2012-09-27,Senate,"Reported Favorably With Substitute S-2",10,0,0,0,10
428195,212986,2012-10-17,Senate,"Senate Third Reading: Passed Roll Call # 707",37,0,0,1,38
428195,215249,2012-12-06,House,"Reported With Recommendation With Substitute H-1",14,0,0,0,14
428195,215604,2012-12-13,House,"House Third Reading: Given Immediate Effect Roll Call # 797",110,0,0,0,110
428195,215775,2012-12-13,Senate,"Senate Third Reading:  Roll Call # 1043",38,0,0,0,38
428247,201187,2012-06-05,House,"Reported With Recommendation With Substitute H-3",17,0,0,0,17
428247,207219,2012-07-18,House,"House Third Reading: Passed Roll Call # 500",110,0,0,0,110
428247,212327,2012-09-27,Senate,"Reported Favorably With Substitute S-2",6,0,0,0,6
428247,215713,2012-12-13,Senate,"Senate Third Reading: Given Immediate Effect Roll Call # 994",21,17,0,0,38
428247,215879,2012-12-14,House,"House Third Reading:  Roll Call # 899",59,45,0,0,104
428277,212349,2012-09-27,House,"Reported With Recommendation Without Amendment",15,0,0,0,15
428287,212351,2012-09-27,House,"Reported With Recommendation With Amendment(s)",15,0,0,0,15
428436,201632,2012-06-07,Senate,"Reported Favorably With Substitute S-1",7,0,0,0,7
428436,214061,2012-11-28,Senate,"Senate Third Reading: Passed Roll Call # 757",38,0,0,0,38
428436,215843,2012-12-14,House,"House Third Reading: Given Immediate Effect Roll Call # 881",107,0,0,0,107
428436,215844,2012-12-14,Senate,"Senate Third Reading:  Roll Call # 1083",38,0,0,0,38
428464,212074,2012-09-19,House,"Reported With Recommendation With Substitute H-1",9,0,0,0,9
428464,214140,2012-11-27,House,"House Third Reading: Given Immediate Effect Roll Call # 597",108,0,0,0,108
428464,215329,2012-12-11,Senate,"Reported Favorably With Substitute S-2",9,0,0,0,9
428464,215378,2012-12-12,Senate,"Senate Third Reading: Given Immediate Effect Roll Call # 926",37,0,0,1,38
428464,215523,2012-12-13,House,"House Third Reading:  Roll Call # 839",108,0,0,0,108
428485,212075,2012-09-19,House,"Reported With Recommendation With Substitute H-1",9,0,0,0,9
428485,214160,2012-11-27,House,"House Third Reading: Given Immediate Effect Roll Call # 598",108,0,0,0,108
428508,212078,2012-09-19,House,"Reported With Recommendation With Substitute H-1",9,0,0,0,9
428508,213728,2012-11-27,House,"House Third Reading: Given Immediate Effect Roll Call # 599",108,0,0,0,108
428530,212076,2012-09-19,House,"Reported With Recommendation Without Amendment",9,0,0,0,9
428530,214153,2012-11-27,House,"House Third Reading: Given Immediate Effect Roll Call # 600",105,3,0,0,108
428575,201544,2012-06-06,House,"Reported With Recommendation Without Amendment",16,0,0,0,16
428575,212343,2012-09-27,House,"House Third Reading: Given Immediate Effect Roll Call # 579",107,0,0,0,107
428575,213770,2012-11-27,Senate,"Reported Favorably Without Amendment",6,0,0,0,6
428850,211962,2012-09-13,Senate,"Reported Favorably Without Amendment",7,0,0,0,7
428850,212129,2012-09-20,Senate,"Senate Third Reading: Passed Roll Call # 649",38,0,0,0,38
428850,213768,2012-11-27,House,"Reported With Recommendation With Substitute H-1",15,0,0,0,15
428850,215171,2012-12-06,House,"House Third Reading: Given Immediate Effect Roll Call # 710",58,51,0,0,109
428850,215377,2012-12-12,Senate,"Senate Third Reading:  Roll Call # 874",38,0,0,0,38
428861,201428,2012-06-06,Senate,"Reported Favorably Without Amendment",5,0,0,0,5
428861,201429,2012-06-06,Senate,"Senate Third Reading: Passed Roll Call # 460",38,0,0,0,38
428861,202004,2012-06-12,House,"Reported With Recommendation Without Amendment",14,0,0,0,14
428861,202593,2012-06-14,House,"House Third Reading: Given Immediate Effect Roll Call # 460",109,1,0,0,110
428880,200562,2012-05-31,House,"Reported With Recommendation With Substitute H-1",17,0,0,0,17
428880,201274,2012-06-06,House,"House Third Reading: Given Immediate Effect Roll Call # 368",96,12,0,0,108
428891,200083,2012-05-30,House,"Reported With Recommendation Without Amendment",15,0,0,0,15
428891,201272,2012-06-06,House,"House Third Reading: Passed Roll Call # 359",107,2,0,0,109
428891,201273,2012-06-06,House,"House Third Reading:  Roll Call # 360",106,3,0,0,109
428891,202424,2012-06-14,Senate,"Reported Favorably Without Amendment",6,0,0,0,6
428891,202425,2012-06-14,Senate,"Senate Third Reading: Given Immediate Effect Roll Call # 566",32,6,0,0,38
428891,202426,2012-06-14,House,"House Third Reading: Senate Amendment(s) Concurred In Roll Call # 492",106,3,0,0,109
428903,200114,2012-05-30,House,"Reported With Recommendation Without Amendment",16,0,0,0,16
428903,201281,2012-06-06,House,"House Third Reading: Passed Roll Call # 357",103,5,0,0,108
428903,201282,2012-06-06,House,"House Third Reading:  Roll Call # 358",99,9,0,0,108
428903,202430,2012-06-14,Senate,"Reported Favorably Without Amendment",6,0,0,0,6
428903,202431,2012-06-14,Senate,"Senate Third Reading: Given Immediate Effect Roll Call # 563",31,7,0,0,38
428926,211990,2012-09-13,House,"Reported With Recommendation With Substitute H-2",17,0,0,0,17
428926,212086,2012-09-19,House,"House Third Reading: Passed Roll Call # 545",104,1,0,0,105
428926,212211,2012-09-25,Senate,"Senate Third Reading: Given Immediate Effect Roll Call # 660",38,0,0,0,38
428926,212294,2012-09-27,House,"House Third Reading:  Roll Call # 570",106,1,0,0,107
428938,201283,2012-06-06,House,"Reported With Recommendation Without Amendment",15,0,0,0,15
428938,212340,2012-09-27,House,"House Third Reading: Given Immediate Effect Roll Call # 561",106,2,0,0,108
428938,214298,2012-11-29,Senate,"Reported Favorably With Substitute S-2",6,0,0,0,6
428938,215463,2012-12-12,Senate,"Senate Third Reading: Given Immediate Effect Roll Call # 881",37,1,0,0,38
428950,212373,2012-09-27,House,"Reported With Recommendation Without Amendment",15,0,0,0,15
428950,214062,2012-11-28,House,"House Third Reading: Passed Roll Call # 624",108,0,0,0,108
428950,215270,2012-12-06,Senate,"Reported Favorably Without Amendment",4,0,0,0,4
428950,215645,2012-12-13,Senate,"Senate Third Reading: Passed Roll Call # 950",38,0,0,0,38
428950,215646,2012-12-13,House,"House Third Reading: Senate Amendment(s) Concurred In Roll Call # 852",109,0,0,0,109
428964,212375,2012-09-27,House,"Reported With Recommendation Without Amendment",15,0,0,0,15
428964,214092,2012-11-28,House,"House Third Reading: Passed Roll Call # 623",108,0,0,0,108
428964,215287,2012-12-06,Senate,"Reported Favorably Without Amendment",4,0,0,0,4
428964,215668,2012-12-13,Senate,"Senate Third Reading: Passed Roll Call # 949",38,0,0,0,38
428964,215669,2012-12-13,House,"House Third Reading: Senate Amendment(s) Concurred In Roll Call # 851",109,0,0,0,109
428974,212374,2012-09-27,House,"Reported With Recommendation Without Amendment",15,0,0,0,15
428974,214067,2012-11-28,House,"House Third Reading: Passed Roll Call # 622",109,0,0,0,109
428974,215274,2012-12-06,Senate,"Reported Favorably Without Amendment",4,0,0,0,4
428974,215660,2012-12-13,Senate,"Senate Third Reading: Passed Roll Call # 948",38,0,0,0,38
428986,212376,2012-09-27,House,"Reported With Recommendation Without Amendment",15,0,0,0,15
428986,213785,2012-11-28,House,"House Third Reading: Passed Roll Call # 621",109,0,0,0,109
428986,215294,2012-12-06,Senate,"Reported Favorably Without Amendment",4,0,0,0,4
428986,215683,2012-12-13,Senate,"Senate Third Reading: Given Immediate Effect Roll Call # 947",38,0,0,0,38
428986,215684,2012-12-13,House,"House Third Reading: Senate Amendment(s) Concurred In Roll Call # 850",109,0,0,0,109
429034,200199,2012-05-31,House,"Reported With Recommendation With Substitute H-1",11,0,0,0,11
429034,201516,2012-06-07,House,"House Third Reading: Passed Roll Call # 407",79,27,0,0,106
429034,201517,2012-06-07,House,"House Third Reading:  Roll Call # 408",77,29,0,0,106
429034,202127,2012-06-13,Senate,"Reported Favorably Without Amendment",4,0,0,0,4
429034,214989,2012-12-04,Senate,"Senate Third Reading: Given Immediate Effect Roll Call # 800",25,13,0,0,38
429034,215533,2012-12-13,House,"House Third Reading:  Roll Call # 818",60,49,0,0,109
429105,212006,2012-09-13,House,"Reported With Recommendation Without Amendment",12,0,0,0,12
429105,213786,2012-11-28,House,"House Third Reading: Given Immediate Effect Roll Call # 610",109,0,0,0,109
429105,215292,2012-12-06,Senate,"Reported Favorably Without Amendment",3,0,0,0,3
429330,200511,2012-05-31,House,"Reported With Recommendation With Substitute H-2",12,0,0,0,12
429330,201655,2012-06-07,House,"House Third Reading: Given Immediate Effect Roll Call # 409",92,14,0,0,106
429330,202146,2012-06-13,Senate,"Reported Favorably Without Amendment",4,0,0,0,4
429330,214991,2012-12-04,Senate,"Senate Third Reading: Given Immediate Effect Roll Call # 801",23,15,0,0,38
429330,215536,2012-12-13,House,"House Third Reading: Senate Amendment(s) Concurred In Roll Call # 819",61,48,0,0,109
429363,201643,2012-06-07,Senate,"Senate Third Reading: Passed Roll Call # 471",29,8,0,1,38
429363,207189,2012-07-18,House,"Reported With Recommendation With Substitute H-2",24,0,0,0,24
429363,207190,2012-07-18,House,"House Third Reading: Given Immediate Effect Roll Call # 502",109,0,0,0,109
429363,207191,2012-07-18,Senate,"Senate Third Reading:  Roll Call # 596",36,1,0,1,38
429377,212934,2012-10-17,Senate,"Reported Favorably Without Amendment",5,0,0,0,5
429377,213675,2012-11-08,Senate,"Senate Third Reading: Passed Roll Call # 737",37,0,0,1,38
429377,214098,2012-11-27,House,"Reported With Recommendation With Substitute H-1",11,0,0,0,11
429377,215205,2012-12-06,House,"House Third Reading: Given Immediate Effect Roll Call # 719",68,40,0,0,108
429377,215719,2012-12-13,Senate,"Senate Third Reading:  Roll Call # 938",38,0,0,0,38
429381,212942,2012-10-17,Senate,"Reported Favorably With Substitute S-1",5,0,0,0,5
429381,213676,2012-11-08,Senate,"Senate Third Reading: Passed Roll Call # 735",36,0,1,1,38
429381,213677,2012-11-08,Senate,"Senate Third Reading: Passed Roll Call # 736",37,0,0,1,38
429381,214102,2012-11-27,House,"Reported With Recommendation With Substitute H-1",11,0,0,0,11
429381,215212,2012-12-06,House,"House Third Reading: Given Immediate Effect Roll Call # 718",68,40,0,0,108
429381,215733,2012-12-13,Senate,"Senate Third Reading:  Roll Call # 937",37,0,0,1,38
429390,212944,2012-10-17,Senate,"Reported Favorably With Substitute S-1",5,0,0,0,5
429390,213678,2012-11-08,Senate,"Senate Third Reading: Passed Roll Call # 734",37,0,0,1,38
429390,214130,2012-11-27,House,"Reported With Recommendation With Substitute H-1",11,0,0,0,11
429390,215223,2012-12-06,House,"House Third Reading: Given Immediate Effect Roll Call # 717",67,41,0,0,108
429390,215741,2012-12-13,Senate,"Senate Third Reading:  Roll Call # 936",37,0,0,1,38
429395,212960,2012-10-17,Senate,"Reported Favorably With Substitute S-1",5,0,0,0,5
429395,213679,2012-11-08,Senate,"Senate Third Reading: Passed Roll Call # 733",37,0,0,1,38
429395,213724,2012-11-27,House,"Reported With Recommendation With Substitute H-1",11,0,0,0,11
429395,215236,2012-12-06,House,"House Third Reading: Given Immediate Effect Roll Call # 716",67,41,0,0,108
429395,215432,2012-12-12,Senate,"Senate Third Reading:  Roll Call # 875",38,0,0,0,38
429416,201197,2012-06-05,House,"Reported With Recommendation Without Amendment",11,0,0,0,11
429434,201200,2012-06-05,House,"Reported With Recommendation Without Amendment",11,0,0,0,11
429438,201363,2012-06-06,House,"Reported With Recommendation With Substitute H-2",18,0,0,0,18
429438,201364,2012-06-06,House,"House Third Reading: Given Immediate Effect Roll Call # 369",104,5,0,0,109
429438,202674,2012-06-14,Senate,"Reported Favorably With Substitute S-2",6,0,0,0,6
429438,202675,2012-06-14,Senate,"Senate Third Reading: Given Immediate Effect Roll Call # 548",38,0,0,0,38
429438,202676,2012-06-14,House,"House Third Reading:  Roll Call # 491",103,6,0,0,109
429459,201203,2012-06-05,House,"Reported With Recommendation Without Amendment",15,0,0,0,15
429459,201375,2012-06-06,House,"House Third Reading: Given Immediate Effect Roll Call # 366",109,0,0,0,109
429459,201957,2012-06-12,Senate,"Senate Third Reading: Given Immediate Effect Roll Call # 482",38,0,0,0,38
429464,201443,2012-06-07,House,"Reported With Recommendation Without Amendment",13,5,0,0,18
429470,201581,2012-06-07,House,"Reported With Recommendation Without Amendment",13,4,0,0,17
429478,201579,2012-06-07,House,"Reported With Recommendation With Amendment(s)",13,5,0,0,18
429478,202062,2012-06-13,House,"House Third Reading: Passed Roll Call # 448",70,39,0,0,109
429478,209772,2012-08-15,Senate,"Reported Favorably Without Amendment",3,1,0,0,4
429478,215371,2012-12-12,Senate,"Senate Third Reading: Given Immediate Effect Roll Call # 912",27,10,1,0,38
429478,215847,2012-12-14,House,"House Third Reading:  Roll Call # 880",72,35,0,0,107
429478,215848,2012-12-14,Senate,"Senate Third Reading:  Roll Call # 1086",27,10,1,0,38
429595,215199,2012-12-06,House,"Reported With Recommendation Without Amendment",10,1,0,0,11
429601,215210,2012-12-06,House,"House Third Reading: Adverse Roll Call",2,4,0,0,6
429761,201628,2012-06-07,Senate,"Reported Favorably Without Amendment",3,0,0,0,3
429761,202399,2012-06-14,Senate,"Senate Third Reading: Passed Roll Call # 535",37,1,0,0,38
429776,201839,2012-06-12,Senate,"Reported Favorably With Recommendation For Referral To Committee On Transportation",15,0,0,0,15
429822,212242,2012-09-27,House,"Reported With Recommendation With Substitute H-2",16,8,0,0,24
429941,212333,2012-09-27,Senate,"Reported Favorably With Substitute S-1",4,1,0,0,5
429941,212334,2012-09-27,Senate,"Senate Third Reading: Passed Roll Call # 685",37,1,0,0,38
429941,215101,2012-12-05,House,"Reported With Recommendation Without Amendment",6,0,0,0,6
429941,215562,2012-12-12,House,"House Third Reading: Given Immediate Effect Roll Call # 770",109,0,0,0,109
429997,211865,2012-09-11,House,"Reported With Recommendation With Substitute H-2",17,0,0,0,17
429997,212370,2012-09-27,House,"House Third Reading: Passed Roll Call # 588",107,0,0,0,107
429997,215138,2012-12-05,Senate,"Reported Favorably With Substitute S-1",7,0,0,0,7
429997,215474,2012-12-12,Senate,"Senate Third Reading: Given Immediate Effect Roll Call # 900",38,0,0,0,38
429997,215641,2012-12-13,House,"House Third Reading:  Roll Call # 840",107,0,0,0,107
430032,203471,2012-06-14,Senate,"Reported Favorably Without Amendment",6,0,0,0,6
430041,202602,2012-06-14,Senate,"Reported Favorably Without Amendment",11,0,0,0,11
430057,201885,2012-06-12,House,"Reported With Recommendation With Substitute H-1",10,0,0,0,10
430057,202454,2012-06-14,House,"House Third Reading: Given Immediate Effect Roll Call # 467",97,13,0,0,110
430320,211872,2012-09-11,Senate,"Reported Favorably With Recommendation For Referral To Committee On Appropriations",4,0,0,0,4
430320,212263,2012-09-27,Senate,"Reported Favorably With Substitute S-1",10,0,0,0,10
430320,213028,2012-10-17,Senate,"Senate Third Reading: Passed Roll Call # 708",37,0,0,1,38
430320,215224,2012-12-06,House,"Reported With Recommendation With Substitute -1",14,0,0,0,14
430320,215308,2012-12-06,House,"Reported With Recommendation With Substitute H-1",14,0,0,0,14
430320,215577,2012-12-13,House,"House Third Reading: Given Immediate Effect Roll Call # 798",106,4,0,0,110
430320,215744,2012-12-13,Senate,"Senate Third Reading:  Roll Call # 1044",38,0,0,0,38
430393,212130,2012-09-19,House,"Reported With Recommendation Without Amendment",11,4,0,0,15
430410,211934,2012-09-12,House,"Reported With Recommendation Without Amendment",17,0,0,0,17
430410,215149,2012-12-05,House,"House Third Reading: Given Immediate Effect Roll Call # 680",88,19,0,0,107
430410,215678,2012-12-13,Senate,"Reported Favorably Without Amendment",7,0,0,0,7
430410,215679,2012-12-13,Senate,"Senate Third Reading: Given Immediate Effect Roll Call # 1003",37,0,1,0,38
430487,211909,2012-09-12,Senate,"Reported Favorably Without Amendment",7,0,0,0,7
430487,212355,2012-09-27,Senate,"Senate Third Reading: Passed Roll Call # 674",38,0,0,0,38
430487,214425,2012-11-28,House,"Reported With Recommendation Without Amendment",16,0,0,0,16
430487,215453,2012-12-12,House,"House Third Reading: Given Immediate Effect Roll Call # 741",108,0,0,0,108
430583,209803,2012-08-15,Senate,"Reported Favorably With Substitute S-3",3,0,0,0,3
430583,209804,2012-08-15,Senate,"Senate Third Reading: Passed Roll Call # 612",24,13,0,1,38
430583,213645,2012-11-08,House,"Reported With Recommendation With Substitute H-1",17,0,0,0,17
430583,214259,2012-11-29,House,"House Third Reading: Passed Roll Call # 657",88,18,0,0,106
430583,215104,2012-12-05,Senate,"Senate Third Reading:  Roll Call # 820",26,12,0,0,38
430584,209805,2012-08-15,Senate,"Reported Favorably Without Amendment",3,0,0,0,3
430584,209806,2012-08-15,Senate,"Senate Third Reading: Passed Roll Call # 611",24,12,1,1,38
430584,213646,2012-11-08,House,"Reported With Recommendation With Substitute H-1",17,0,0,0,17
430584,214268,2012-11-29,House,"House Third Reading: Passed Roll Call # 656",88,18,0,0,106
430584,215106,2012-12-05,Senate,"Senate Third Reading:  Roll Call # 819",26,12,0,0,38
430591,212181,2012-09-25,Senate,"Reported Favorably Without Amendment",16,0,0,0,16
430591,212239,2012-09-27,Senate,"Senate Third Reading: Passed Roll Call # 681",38,0,0,0,38
430591,213750,2012-11-27,House,"Reported With Recommendation Without Amendment",6,0,0,0,6
430591,215447,2012-12-12,House,"House Third Reading: Given Immediate Effect Roll Call # 740",108,0,0,0,108
430592,212335,2012-09-27,Senate,"Reported Favorably Without Amendment",6,0,0,0,6
430592,213008,2012-10-17,Senate,"Senate Third Reading: Passed Roll Call # 718",35,2,0,1,38
430606,211980,2012-09-12,House,"Reported With Recommendation For Referral To Committee On Oversight, Reform, And Ethics",5,0,0,0,5
430606,213763,2012-11-27,House,"Reported With Recommendation With Substitute H-1",5,0,0,0,5
430606,215167,2012-12-05,House,"House Third Reading: Passed Roll Call # 681",107,0,0,0,107
430606,215376,2012-12-12,Senate,"Reported Favorably Without Amendment",3,0,0,0,3
430611,215016,2012-12-04,House,"Reported With Recommendation With Substitute H-1",6,2,0,0,8
430613,215013,2012-12-04,House,"Reported With Recommendation With Substitute H-1",6,2,0,0,8
431991,214414,2012-11-29,House,"Reported With Recommendation With Substitute H-1",11,0,0,0,11
431991,215265,2012-12-06,House,"House Third Reading: Passed Roll Call # 705",60,49,0,0,109
431995,214428,2012-11-29,House,"Reported With Recommendation Without Amendment",8,3,0,0,11
431999,212101,2012-09-19,House,"Reported With Recommendation With Substitute H-2",16,0,0,0,16
431999,212102,2012-09-19,House,"House Third Reading: Given Immediate Effect Roll Call # 543",88,17,0,0,105
431999,212317,2012-09-27,Senate,"Reported Favorably With Substitute S-1",4,1,0,0,5
431999,212318,2012-09-27,Senate,"Senate Third Reading: Given Immediate Effect Roll Call # 673",32,5,1,0,38
431999,212319,2012-09-27,House,"House Third Reading:  Roll Call # 573",95,12,0,0,107
432004,212379,2012-09-27,House,"Reported With Recommendation Without Amendment",13,1,0,0,14
432004,213754,2012-11-27,House,"House Third Reading: Given Immediate Effect Roll Call # 595",104,4,0,0,108
432004,215053,2012-12-04,Senate,"Senate Third Reading: Given Immediate Effect Roll Call # 802",38,0,0,0,38
432011,211950,2012-09-12,House,"House Third Reading: Adverse Roll Call",2,1,0,0,3
432012,211948,2012-09-13,House,"Reported With Recommendation With Substitute H-1",12,0,0,0,12
432021,212188,2012-09-25,Senate,"Reported Favorably Without Amendment",16,0,0,0,16
432021,212252,2012-09-27,Senate,"Senate Third Reading: Given Immediate Effect Roll Call # 682",27,11,0,0,38
432021,215130,2012-12-04,House,"Reported With Recommendation Without Amendment",7,0,0,0,7
432021,215594,2012-12-12,House,"House Third Reading: Given Immediate Effect Roll Call # 760",69,40,0,0,109
432024,212234,2012-09-27,Senate,"Reported Favorably Without Amendment",3,0,0,0,3
432024,213007,2012-10-17,Senate,"Senate Third Reading: Passed Roll Call # 710",37,0,0,1,38
432025,211874,2012-09-11,Senate,"Reported Favorably With Substitute S-1",6,0,0,0,6
432025,212264,2012-09-27,Senate,"Senate Third Reading: Passed Roll Call # 683",31,7,0,0,38
432025,215139,2012-12-04,House,"Reported With Recommendation With Substitute H-1",17,0,0,0,17
432025,215613,2012-12-12,House,"House Third Reading: Given Immediate Effect Roll Call # 775",99,10,0,0,109
432025,215785,2012-12-13,Senate,"Senate Third Reading:  Roll Call # 1045",32,6,0,0,38
432026,211925,2012-09-12,Senate,"Reported Favorably With Substitute S-1",7,0,0,0,7
432026,211984,2012-09-13,Senate,"Senate Third Reading: Passed Roll Call # 628",38,0,0,0,38
432026,215195,2012-12-06,House,"Reported With Recommendation Without Amendment",13,0,0,0,13
432026,215552,2012-12-13,House,"House Third Reading: Passed Roll Call # 799",110,0,0,0,110
432026,215709,2012-12-13,Senate,"Senate Third Reading:  Roll Call # 1046",38,0,0,0,38
432028,211927,2012-09-12,Senate,"Reported Favorably Without Amendment",7,0,0,0,7
432028,211985,2012-09-13,Senate,"Senate Third Reading: Passed Roll Call # 632",38,0,0,0,38
432029,211928,2012-09-12,Senate,"Reported Favorably With Substitute S-1",7,0,0,0,7
432029,211986,2012-09-13,Senate,"Senate Third Reading: Passed Roll Call # 629",26,12,0,0,38
432029,215211,2012-12-06,House,"Reported With Recommendation With Amendment(s)",12,0,0,0,12
432036,211930,2012-09-12,Senate,"Reported Favorably Without Amendment",7,0,0,0,7
432036,211994,2012-09-13,Senate,"Senate Third Reading: Passed Roll Call # 633",38,0,0,0,38
432787,211996,2012-09-13,House,"Reported With Recommendation With Substitute H-1",19,2,0,0,21
432787,212089,2012-09-19,House,"House Third Reading: Given Immediate Effect Roll Call # 533",88,17,0,0,105
432787,212213,2012-09-25,Senate,"Reported Favorably Without Amendment",16,0,0,0,16
432787,212305,2012-09-27,Senate,"Senate Third Reading: Given Immediate Effect Roll Call # 667",32,6,0,0,38
432796,211863,2012-09-11,House,"Reported With Recommendation With Substitute H-1",13,0,0,0,13
432802,211922,2012-09-12,Senate,"Reported Favorably Without Amendment",4,0,0,0,4
432803,212975,2012-10-17,Senate,"Reported Favorably With Substitute S-1",5,0,0,0,5
432803,213684,2012-11-08,Senate,"Senate Third Reading: Passed Roll Call # 738",26,11,0,1,38
432803,215090,2012-12-05,House,"Reported With Recommendation With Substitute H-1",7,3,0,0,10
432803,215565,2012-12-13,House,"House Third Reading: Given Immediate Effect Roll Call # 826",65,44,0,0,109
432803,215566,2012-12-13,House,"House Third Reading: Passed Roll Call # 868",65,41,0,0,106
432803,215730,2012-12-14,Senate,"Senate Third Reading:  Roll Call # 1084",26,12,0,0,38
432805,213003,2012-10-17,Senate,"Senate Third Reading: Passed Roll Call # 724",26,11,0,1,38
432805,214100,2012-11-28,House,"Reported With Recommendation With Substitute H-2",13,5,0,0,18
432805,215520,2012-12-13,House,"House Third Reading: Given Immediate Effect Roll Call # 803",69,41,0,0,110
432805,215667,2012-12-13,Senate,"Senate Third Reading:  Roll Call # 1047",27,11,0,0,38
432807,212117,2012-09-20,Senate,"Reported Favorably Without Amendment",4,0,0,0,4
432807,212253,2012-09-27,Senate,"Senate Third Reading: Passed Roll Call # 679",37,1,0,0,38
432807,214365,2012-11-29,House,"Reported With Recommendation Without Amendment",13,0,0,0,13
432809,212121,2012-09-20,Senate,"Reported Favorably With Substitute S-1",3,0,0,0,3
432809,212258,2012-09-27,Senate,"Senate Third Reading: Passed Roll Call # 680",36,2,0,0,38
432809,215137,2012-12-04,House,"Reported With Recommendation Without Amendment",9,0,0,0,9
432809,215605,2012-12-12,House,"House Third Reading: Given Immediate Effect Roll Call # 756",109,0,0,0,109
432812,212198,2012-09-25,Senate,"Reported Favorably Without Amendment",5,0,0,0,5
432812,212966,2012-10-17,Senate,"Senate Third Reading: Passed Roll Call # 706",37,0,0,1,38
432820,212045,2012-09-19,Senate,"Reported Favorably Without Amendment",6,0,0,0,6
432820,212214,2012-09-25,Senate,"Senate Third Reading: Passed Roll Call # 659",35,2,1,0,38
432825,212322,2012-09-27,House,"Reported With Recommendation Without Amendment",8,0,0,0,8
432825,214172,2012-11-28,House,"House Third Reading: Given Immediate Effect Roll Call # 613",109,0,0,0,109
432825,215335,2012-12-11,Senate,"Reported Favorably Without Amendment",9,0,0,0,9
432825,215700,2012-12-13,Senate,"Senate Third Reading: Given Immediate Effect Roll Call # 962",38,0,0,0,38
432825,215866,2012-12-14,House,"House Third Reading: Senate Amendment(s) Concurred In Roll Call # 874",107,0,0,0,107
432826,212112,2012-09-19,House,"Reported With Recommendation Without Amendment",8,0,0,0,8
432826,212337,2012-09-27,House,"House Third Reading: Given Immediate Effect Roll Call # 583",107,0,0,0,107
432826,215034,2012-12-04,Senate,"Reported Favorably With Substitute S-1",5,0,0,0,5
432826,215467,2012-12-12,Senate,"Senate Third Reading: Given Immediate Effect Roll Call # 913",38,0,0,0,38
432826,215599,2012-12-13,House,"House Third Reading:  Roll Call # 843",108,0,0,0,108
432826,215771,2012-12-14,Senate,"Senate Third Reading:  Roll Call # 1085",38,0,0,0,38
432827,212113,2012-09-19,House,"Reported With Recommendation Without Amendment",8,0,0,0,8
432827,212338,2012-09-27,House,"House Third Reading: Given Immediate Effect Roll Call # 582",107,0,0,0,107
432827,215036,2012-12-04,Senate,"Reported Favorably Without Amendment",5,0,0,0,5
432827,215472,2012-12-12,Senate,"Senate Third Reading: Given Immediate Effect Roll Call # 897",38,0,0,0,38
432828,212114,2012-09-19,House,"Reported With Recommendation Without Amendment",8,0,0,0,8
432828,212342,2012-09-27,House,"House Third Reading: Given Immediate Effect Roll Call # 581",107,0,0,0,107
432828,215052,2012-12-04,Senate,"Reported Favorably With Substitute S-1",5,0,0,0,5
432828,215473,2012-12-12,Senate,"Senate Third Reading: Given Immediate Effect Roll Call # 896",38,0,0,0,38
432828,215623,2012-12-13,House,"House Third Reading:  Roll Call # 842",108,0,0,0,108
432829,212115,2012-09-19,House,"Reported With Recommendation Without Amendment",8,0,0,0,8
432829,212344,2012-09-27,House,"House Third Reading: Given Immediate Effect Roll Call # 580",107,0,0,0,107
432829,215055,2012-12-04,Senate,"Reported Favorably With Substitute S-1",5,0,0,0,5
432829,215475,2012-12-12,Senate,"Senate Third Reading: Given Immediate Effect Roll Call # 895",38,0,0,0,38
432829,215642,2012-12-13,House,"House Third Reading:  Roll Call # 841",108,0,0,0,108
432833,214256,2012-11-28,House,"Reported With Recommendation With Substitute H-1",15,9,0,0,24
432833,215011,2012-12-04,House,"House Third Reading: Given Immediate Effect Roll Call # 672",65,40,0,0,105
432833,215342,2012-12-11,Senate,"Reported Favorably With Substitute S-1",9,0,0,0,9
432833,215731,2012-12-13,Senate,"Senate Third Reading: Given Immediate Effect Roll Call # 964",38,0,0,0,38
432833,215732,2012-12-13,House,"House Third Reading:  Roll Call # 854",67,42,0,0,109
432834,214249,2012-11-28,House,"Reported With Recommendation With Substitute H-1",17,1,0,0,18
432834,215006,2012-12-04,House,"House Third Reading: Given Immediate Effect Roll Call # 671",65,40,0,0,105
432834,215341,2012-12-11,Senate,"Reported Favorably Without Amendment",10,0,0,0,10
432834,215726,2012-12-13,Senate,"Senate Third Reading: Given Immediate Effect Roll Call # 963",38,0,0,0,38
432839,211952,2012-09-13,House,"Reported With Recommendation Without Amendment",24,0,0,0,24
432839,212061,2012-09-19,House,"House Third Reading: Given Immediate Effect Roll Call # 539",105,0,0,0,105
432839,212191,2012-09-25,Senate,"Reported Favorably Without Amendment",16,0,0,0,16
432840,211953,2012-09-13,House,"Reported With Recommendation With Substitute H-2",19,1,0,0,20
432840,212059,2012-09-19,House,"House Third Reading: Given Immediate Effect Roll Call # 538",85,20,0,0,105
432841,211954,2012-09-13,House,"Reported With Recommendation With Substitute H-2",19,1,0,0,20
432841,212063,2012-09-19,House,"House Third Reading: Given Immediate Effect Roll Call # 537",85,20,0,0,105
432841,212195,2012-09-25,Senate,"Reported Favorably Without Amendment",16,0,0,0,16
432841,212257,2012-09-27,Senate,"Senate Third Reading: Given Immediate Effect Roll Call # 671",31,7,0,0,38
432842,211956,2012-09-13,House,"Reported With Recommendation With Substitute H-1",19,1,0,0,20
432842,212122,2012-09-19,House,"House Third Reading: Given Immediate Effect Roll Call # 536",81,24,0,0,105
432842,212197,2012-09-25,Senate,"Reported Favorably Without Amendment",16,0,0,0,16
432842,212259,2012-09-27,Senate,"Senate Third Reading: Given Immediate Effect Roll Call # 670",32,6,0,0,38
432843,211955,2012-09-13,House,"Reported With Recommendation With Substitute H-1",19,1,0,0,20
432843,212062,2012-09-19,House,"House Third Reading: Given Immediate Effect Roll Call # 535",84,21,0,0,105
432843,212194,2012-09-25,Senate,"Reported Favorably Without Amendment",16,0,0,0,16
432843,212254,2012-09-27,Senate,"Senate Third Reading: Given Immediate Effect Roll Call # 669",32,6,0,0,38
432844,211957,2012-09-13,House,"Reported With Recommendation With Substitute H-1",18,1,0,0,19
432844,212064,2012-09-19,House,"House Third Reading: Given Immediate Effect Roll Call # 534",83,22,0,0,105
432844,212200,2012-09-25,Senate,"Reported Favorably Without Amendment",16,0,0,0,16
432844,212261,2012-09-27,Senate,"Senate Third Reading: Given Immediate Effect Roll Call # 668",32,6,0,0,38
432845,211959,2012-09-13,House,"Reported With Recommendation With Substitute H-1",19,2,0,0,21
432845,212124,2012-09-19,House,"House Third Reading: Given Immediate Effect Roll Call # 532",87,18,0,0,105
432845,212199,2012-09-25,Senate,"Reported Favorably Without Amendment",16,0,0,0,16
432845,212260,2012-09-27,Senate,"Senate Third Reading: Given Immediate Effect Roll Call # 666",33,5,0,0,38
432846,211960,2012-09-13,House,"Reported With Recommendation With Substitute H-1",19,2,0,0,21
432846,212065,2012-09-19,House,"House Third Reading: Given Immediate Effect Roll Call # 531",88,16,0,0,104
432847,212120,2012-09-19,House,"Reported With Recommendation With Substitute H-2",13,0,0,0,13
432847,214302,2012-11-29,House,"House Third Reading: Passed Roll Call # 632",107,0,0,0,107
432847,215759,2012-12-13,Senate,"Reported Favorably With Substitute S-1",7,0,0,0,7
432847,215760,2012-12-13,Senate,"Senate Third Reading: Given Immediate Effect Roll Call # 976",38,0,0,0,38
432847,215905,2012-12-14,House,"House Third Reading:  Roll Call # 878",107,0,0,0,107
432859,211924,2012-09-12,House,"Reported With Recommendation With Substitute H-1",17,0,0,0,17
432860,212082,2012-09-20,House,"Reported With Recommendation Without Amendment",13,1,0,0,14
432860,213760,2012-11-27,House,"House Third Reading: Given Immediate Effect Roll Call # 603",77,30,0,0,107
432860,215284,2012-12-06,Senate,"Reported Favorably Without Amendment",5,0,0,0,5
432860,215665,2012-12-13,Senate,"Senate Third Reading: Given Immediate Effect Roll Call # 945",36,2,0,0,38
432861,212083,2012-09-20,House,"Reported With Recommendation With Substitute H-2",14,1,0,0,15
432861,213662,2012-11-08,House,"House Third Reading: Passed Roll Call # 593",71,36,0,0,107
432864,212377,2012-09-27,House,"Reported With Recommendation Without Amendment",10,0,0,0,10
432864,214261,2012-11-28,House,"House Third Reading: Given Immediate Effect Roll Call # 605",109,0,0,0,109
432864,215350,2012-12-11,Senate,"Reported Favorably Without Amendment",9,0,0,0,9
432864,215739,2012-12-13,Senate,"Senate Third Reading: Given Immediate Effect Roll Call # 961",38,0,0,0,38
432867,212087,2012-09-19,House,"Reported With Recommendation With Amendment(s)",14,0,0,0,14
432867,213788,2012-11-28,House,"House Third Reading: Given Immediate Effect Roll Call # 611",109,0,0,0,109
432871,211871,2012-09-11,House,"Reported With Recommendation Without Amendment",5,3,0,0,8
432872,211991,2012-09-13,House,"Reported With Recommendation With Substitute H-1",21,0,0,0,21
432872,212088,2012-09-19,House,"House Third Reading: Given Immediate Effect Roll Call # 530",91,14,0,0,105
432872,212212,2012-09-25,Senate,"Reported Favorably Without Amendment",16,0,0,0,16
432872,212300,2012-09-27,Senate,"Senate Third Reading: Given Immediate Effect Roll Call # 665",36,2,0,0,38
432872,212301,2012-09-27,House,"House Third Reading: Senate Amendment(s) Concurred In Roll Call # 571",90,17,0,0,107
433162,211944,2012-09-13,Senate,"Reported Favorably Without Amendment",7,0,0,0,7
433162,211945,2012-09-13,Senate,"Senate Third Reading:  Roll Call # 634",38,0,0,0,38
433162,212296,2012-09-27,House,"Reported With Recommendation Without Amendment",24,0,0,0,24
433162,212297,2012-09-27,House,"House Third Reading:  Roll Call # 553",108,0,0,0,108
433165,212103,2012-09-20,Senate,"Reported Favorably With Substitute S-1",3,0,0,0,3
433165,212104,2012-09-20,Senate,"Senate Third Reading: Passed Roll Call # 655",33,5,0,0,38
433165,212320,2012-09-27,House,"Reported With Recommendation Without Amendment",17,4,0,0,21
433165,212321,2012-09-27,House,"House Third Reading: Given Immediate Effect Roll Call # 556",82,26,0,0,108
433166,212105,2012-09-20,Senate,"Reported Favorably With Substitute S-1",3,0,0,0,3
433166,212106,2012-09-20,Senate,"Senate Third Reading: Passed Roll Call # 654",36,2,0,0,38
433166,212324,2012-09-27,House,"Reported With Recommendation Without Amendment",18,5,0,0,23
433166,212325,2012-09-27,House,"House Third Reading: Given Immediate Effect Roll Call # 555",86,21,0,0,107
433186,215334,2012-12-11,Senate,"Reported Favorably With Substitute S-1",3,0,0,0,3
433188,214192,2012-11-29,Senate,"Reported Favorably Without Amendment",4,0,0,0,4
433188,214193,2012-11-29,Senate,"Senate Third Reading: Passed Roll Call # 787",38,0,0,0,38
433188,215091,2012-12-05,House,"Reported With Recommendation Without Amendment",17,1,0,0,18
433188,215545,2012-12-13,House,"House Third Reading: Given Immediate Effect Roll Call # 785",70,36,0,0,106
433191,212971,2012-10-17,Senate,"Reported Favorably Without Amendment",4,0,0,0,4
433191,213960,2012-11-28,Senate,"Senate Third Reading: Passed Roll Call # 760",38,0,0,0,38
433191,215050,2012-12-04,House,"Reported With Recommendation Without Amendment",8,0,0,0,8
433192,212310,2012-09-27,Senate,"Reported Favorably Without Amendment",6,0,0,0,6
433192,212990,2012-10-17,Senate,"Senate Third Reading: Passed Roll Call # 719",37,0,0,1,38
433193,212968,2012-10-17,Senate,"Reported Favorably Without Amendment",3,1,0,0,4
433193,213961,2012-11-28,Senate,"Senate Third Reading: Passed Roll Call # 759",25,13,0,0,38
433193,215051,2012-12-04,House,"Reported With Recommendation With Substitute H-1",6,3,0,0,9
433193,215601,2012-12-12,House,"House Third Reading: Given Immediate Effect Roll Call # 757",63,46,0,0,109
433193,215772,2012-12-13,Senate,"Senate Third Reading:  Roll Call # 1048",20,17,1,0,38
433195,212313,2012-09-27,Senate,"Reported Favorably With Substitute S-1",4,0,0,0,4
433195,212993,2012-10-17,Senate,"Senate Third Reading: Passed Roll Call # 716",35,2,0,1,38
433195,215151,2012-12-05,House,"Reported With Recommendation Without Amendment",17,0,0,0,17
433195,215506,2012-12-12,House,"House Third Reading: Passed Roll Call # 774",106,3,0,0,109
433206,214299,2012-11-29,House,"Reported With Recommendation With Substitute H-3",14,12,0,0,26
433206,214300,2012-11-29,House,"House Third Reading: Given Immediate Effect Roll Call # 658",58,48,0,0,106
433206,215351,2012-12-11,Senate,"Reported Favorably Without Amendment",10,0,0,0,10
433206,215751,2012-12-13,Senate,"Senate Third Reading: Given Immediate Effect Roll Call # 965",24,14,0,0,38
433211,212132,2012-09-19,House,"Reported With Recommendation With Amendment(s)",14,0,0,0,14
433211,212362,2012-09-27,House,"House Third Reading: Given Immediate Effect Roll Call # 576",106,1,0,0,107
433216,211972,2012-09-13,House,"Reported With Recommendation Without Amendment",19,0,0,0,19
433216,212071,2012-09-19,House,"House Third Reading: Given Immediate Effect Roll Call # 540",104,0,0,0,104
433216,214457,2012-11-29,Senate,"Reported Favorably Without Amendment",13,0,0,0,13
433216,215699,2012-12-13,Senate,"Senate Third Reading: Given Immediate Effect Roll Call # 997",38,0,0,0,38
433229,212140,2012-09-19,House,"Reported With Recommendation Without Amendment",8,0,0,0,8
433229,212365,2012-09-27,House,"House Third Reading: Given Immediate Effect Roll Call # 584",107,0,0,0,107
433229,214998,2012-12-04,Senate,"Reported Favorably With Substitute S-1",5,0,0,0,5
433229,215398,2012-12-12,Senate,"Senate Third Reading: Given Immediate Effect Roll Call # 898",38,0,0,0,38
433229,215547,2012-12-13,House,"House Third Reading:  Roll Call # 844",109,0,0,0,109
433242,214392,2012-11-28,House,"Reported With Recommendation With Substitute H-1",18,0,0,0,18
433242,215142,2012-12-05,House,"House Third Reading: Passed Roll Call # 678",106,0,0,0,106
433242,215322,2012-12-11,Senate,"Reported Favorably Without Amendment",4,0,0,0,4
433242,215616,2012-12-13,Senate,"Senate Third Reading: Given Immediate Effect Roll Call # 971",38,0,0,0,38
433244,214403,2012-11-28,House,"Reported With Recommendation With Substitute H-2",15,0,0,0,15
433245,214413,2012-11-28,House,"Reported With Recommendation With Substitute H-3",15,0,0,0,15
433246,214427,2012-11-28,House,"Reported With Recommendation Without Amendment",14,0,0,0,14
433252,212269,2012-09-27,House,"Reported With Recommendation With Substitute H-1",17,0,0,0,17
433252,214066,2012-11-28,House,"House Third Reading: Given Immediate Effect Roll Call # 614",107,2,0,0,109
433252,215271,2012-12-06,Senate,"Reported Favorably With Amendment(s)",4,0,0,0,4
433252,215649,2012-12-13,Senate,"Senate Third Reading: Passed Roll Call # 985",38,0,0,0,38
433252,215831,2012-12-14,House,"House Third Reading: Senate Amendment(s) Concurred In Roll Call # 900",102,3,0,0,105
433260,212277,2012-09-27,Senate,"Reported Favorably With Substitute S-1",4,1,0,0,5
433264,212095,2012-09-20,Senate,"Reported Favorably Without Amendment",3,0,0,0,3
433264,212096,2012-09-20,Senate,"Senate Third Reading: Passed Roll Call # 652",38,0,0,0,38
433264,215111,2012-12-04,House,"Reported With Recommendation Without Amendment",14,1,0,0,15
433264,215578,2012-12-12,House,"House Third Reading: Given Immediate Effect Roll Call # 776",97,12,0,0,109
433268,212281,2012-09-27,Senate,"Reported Favorably Without Amendment",4,1,0,0,5
433268,212981,2012-10-17,Senate,"Senate Third Reading: Passed Roll Call # 705",36,1,0,1,38
433268,215114,2012-12-04,House,"Reported With Recommendation Without Amendment",11,0,0,0,11
433268,215581,2012-12-12,House,"House Third Reading: Given Immediate Effect Roll Call # 765",109,0,0,0,109
433270,212278,2012-09-27,Senate,"Reported Favorably With Substitute S-1",4,1,0,0,5
433270,213044,2012-10-17,Senate,"Senate Third Reading: Passed Roll Call # 704",36,1,0,1,38
433270,215146,2012-12-04,House,"Reported With Recommendation Without Amendment",11,0,0,0,11
433270,215627,2012-12-12,House,"House Third Reading: Given Immediate Effect Roll Call # 764",109,0,0,0,109
433271,212280,2012-09-27,Senate,"Reported Favorably With Substitute S-1",4,1,0,0,5
433271,212980,2012-10-17,Senate,"Senate Third Reading: Passed Roll Call # 703",36,1,0,1,38
433271,215105,2012-12-04,House,"Reported With Recommendation Without Amendment",11,0,0,0,11
433271,215571,2012-12-12,House,"House Third Reading: Given Immediate Effect Roll Call # 763",109,0,0,0,109
433272,212282,2012-09-27,Senate,"Reported Favorably With Substitute S-1",4,1,0,0,5
433272,212983,2012-10-17,Senate,"Senate Third Reading: Passed Roll Call # 702",36,1,0,1,38
433272,215124,2012-12-04,House,"Reported With Recommendation Without Amendment",11,0,0,0,11
433272,215592,2012-12-12,House,"House Third Reading: Given Immediate Effect Roll Call # 762",109,0,0,0,109
433276,212279,2012-09-27,Senate,"Reported Favorably With Substitute S-1",4,1,0,0,5
433276,212977,2012-10-17,Senate,"Senate Third Reading: Passed Roll Call # 701",36,1,0,1,38
433276,215100,2012-12-04,House,"Reported With Recommendation Without Amendment",11,0,0,0,11
433276,215563,2012-12-12,House,"House Third Reading: Given Immediate Effect Roll Call # 761",109,0,0,0,109
433276,215728,2012-12-14,Senate,"Senate Third Reading: House Amendment(s) Concurred In Roll Call # 1058",36,1,1,0,38
433280,214468,2012-11-28,House,"Reported With Recommendation Without Amendment",13,0,0,0,13
433287,214065,2012-11-28,House,"Reported With Recommendation With Substitute H-1",15,0,0,0,15
433292,211894,2012-09-12,House,"Reported With Recommendation With Substitute H-1",16,0,0,0,16
433292,212049,2012-09-19,House,"House Third Reading: Given Immediate Effect Roll Call # 541",86,19,0,0,105
433292,212215,2012-09-25,Senate,"Reported Favorably Without Amendment",16,0,0,0,16
433292,212316,2012-09-27,Senate,"Senate Third Reading: Given Immediate Effect Roll Call # 672",32,6,0,0,38
433293,212364,2012-09-27,House,"Reported With Recommendation Without Amendment",13,0,0,0,13
433293,214152,2012-11-28,House,"House Third Reading: Given Immediate Effect Roll Call # 616",106,3,0,0,109
433293,215685,2012-12-13,Senate,"Senate Third Reading: Passed Roll Call # 986",38,0,0,0,38
433294,212107,2012-09-20,House,"Reported With Recommendation With Substitute H-2",10,0,0,0,10
433294,212368,2012-09-27,House,"House Third Reading: Given Immediate Effect Roll Call # 586",64,43,0,0,107
433294,214272,2012-11-29,Senate,"Reported Favorably With Substitute S-1",4,2,0,0,6
433294,215753,2012-12-13,Senate,"Senate Third Reading: Given Immediate Effect Roll Call # 944",25,12,0,1,38
433294,215754,2012-12-13,House,"House Third Reading:  Roll Call # 853",66,43,0,0,109
433295,212100,2012-09-20,House,"Reported With Recommendation Without Amendment",14,0,0,0,14
433295,212367,2012-09-27,House,"House Third Reading: Given Immediate Effect Roll Call # 585",106,0,0,0,106
433295,214267,2012-11-29,Senate,"Reported Favorably Without Amendment",6,0,0,0,6
433295,215749,2012-12-13,Senate,"Senate Third Reading: Given Immediate Effect Roll Call # 943",36,1,0,1,38
433300,215078,2012-12-05,House,"Reported With Recommendation With Amendment(s)",12,0,0,0,12
433300,215172,2012-12-06,House,"House Third Reading: Passed Roll Call # 701",66,43,0,0,109
433305,213791,2012-11-27,House,"Reported With Recommendation Without Amendment",10,0,0,0,10
433305,215079,2012-12-05,House,"House Third Reading: Given Immediate Effect Roll Call # 677",106,0,0,0,106
433305,215380,2012-12-12,Senate,"Reported Favorably Without Amendment",4,0,0,0,4
433305,215687,2012-12-13,Senate,"Senate Third Reading: Given Immediate Effect Roll Call # 975",38,0,0,0,38
433331,212092,2012-09-20,Senate,"Reported Favorably Without Amendment",3,0,0,0,3
433331,212093,2012-09-20,Senate,"Senate Third Reading: Passed Roll Call # 653",38,0,0,0,38
433331,215115,2012-12-04,House,"Reported With Recommendation Without Amendment",15,0,0,0,15
433331,215583,2012-12-12,House,"House Third Reading: Given Immediate Effect Roll Call # 753",109,0,0,0,109
433352,212984,2012-10-17,Senate,"Reported Favorably With Substitute S-1",5,0,0,0,5
433352,213685,2012-11-08,Senate,"Senate Third Reading: Passed Roll Call # 739",26,11,0,1,38
433356,212354,2012-09-27,House,"Reported With Recommendation Without Amendment",17,0,0,0,17
433356,214412,2012-11-28,House,"House Third Reading: Given Immediate Effect Roll Call # 615",105,4,0,0,109
433356,215260,2012-12-06,Senate,"Reported Favorably Without Amendment",4,0,0,0,4
433356,215659,2012-12-13,Senate,"Senate Third Reading: Passed Roll Call # 984",38,0,0,0,38
433356,215835,2012-12-14,House,"House Third Reading: Senate Amendment(s) Concurred In Roll Call # 901",103,2,0,0,105
433486,213805,2012-11-27,House,"Reported With Recommendation Without Amendment",6,0,0,0,6
433487,213836,2012-11-28,House,"Reported With Recommendation With Amendment(s)",9,4,0,0,13
433487,215031,2012-12-04,House,"House Third Reading: Given Immediate Effect Roll Call # 669",64,41,0,0,105
433487,215226,2012-12-06,Senate,"Reported Favorably Without Amendment",5,2,0,0,7
433487,215765,2012-12-13,Senate,"Senate Third Reading: Given Immediate Effect Roll Call # 952",26,12,0,0,38
433493,213859,2012-11-28,House,"Reported With Recommendation With Amendment(s)",9,4,0,0,13
433493,215032,2012-12-04,House,"House Third Reading: Given Immediate Effect Roll Call # 670",64,41,0,0,105
433493,215232,2012-12-06,Senate,"Reported Favorably Without Amendment",5,2,0,0,7
433493,215773,2012-12-13,Senate,"Senate Third Reading: Given Immediate Effect Roll Call # 953",26,12,0,0,38
433498,213929,2012-11-27,House,"Reported With Recommendation With Substitute H-2",17,1,0,0,18
433498,214329,2012-11-29,House,"House Third Reading: Given Immediate Effect Roll Call # 661",95,10,0,0,105
433498,215240,2012-12-06,Senate,"Reported Favorably Without Amendment",5,0,0,0,5
433498,215437,2012-12-12,Senate,"Senate Third Reading: Given Immediate Effect Roll Call # 922",37,0,0,1,38
433505,212937,2012-10-17,Senate,"Reported Favorably With Substitute S-1",5,0,0,0,5
433505,212938,2012-10-17,Senate,"Senate Third Reading: Passed Roll Call # 723",25,12,0,1,38
433506,212963,2012-10-17,Senate,"Reported Favorably With Substitute S-1",5,0,0,0,5
433506,213680,2012-11-08,Senate,"Senate Third Reading: Passed Roll Call # 740",26,10,1,1,38
433506,213681,2012-11-08,Senate,"Senate Third Reading: Passed Roll Call # 746",26,11,0,1,38
433506,215084,2012-12-04,House,"Reported With Recommendation Without Amendment",6,4,0,0,10
433506,215529,2012-12-13,House,"House Third Reading: Given Immediate Effect Roll Call # 817",67,42,0,0,109
433506,215695,2012-12-14,Senate,"Senate Third Reading:  Roll Call # 1059",27,11,0,0,38
433507,212345,2012-09-27,Senate,"Reported Favorably Without Amendment",4,1,0,0,5
433507,213015,2012-10-17,Senate,"Senate Third Reading: Passed Roll Call # 697",36,0,0,2,38
433507,215096,2012-12-05,House,"Reported With Recommendation With Substitute H-1",7,0,0,0,7
433507,215410,2012-12-12,House,"House Third Reading: Given Immediate Effect Roll Call # 729",105,3,0,0,108
433507,215720,2012-12-13,Senate,"Senate Third Reading:  Roll Call # 1049",38,0,0,0,38
433510,212348,2012-09-27,Senate,"Reported Favorably Without Amendment",4,1,0,0,5
433510,213021,2012-10-17,Senate,"Senate Third Reading: Passed Roll Call # 698",36,0,0,2,38
433510,215098,2012-12-05,House,"Reported With Recommendation Without Amendment",7,0,0,0,7
433510,215417,2012-12-12,House,"House Third Reading: Given Immediate Effect Roll Call # 730",108,0,0,0,108
433511,212347,2012-09-27,Senate,"Reported Favorably Without Amendment",4,1,0,0,5
433511,213019,2012-10-17,Senate,"Senate Third Reading: Passed Roll Call # 699",37,0,0,1,38
433511,215093,2012-12-05,House,"Reported With Recommendation Without Amendment",7,0,0,0,7
433511,215406,2012-12-12,House,"House Third Reading: Given Immediate Effect Roll Call # 731",108,0,0,0,108
433512,212346,2012-09-27,Senate,"Reported Favorably Without Amendment",4,1,0,0,5
433512,213022,2012-10-17,Senate,"Senate Third Reading: Passed Roll Call # 700",37,0,0,1,38
433512,215095,2012-12-05,House,"Reported With Recommendation Without Amendment",7,0,0,0,7
433512,215407,2012-12-12,House,"House Third Reading: Given Immediate Effect Roll Call # 732",108,0,0,0,108
433514,212972,2012-10-17,Senate,"Reported Favorably Without Amendment",5,0,0,0,5
433514,213682,2012-11-08,Senate,"Senate Third Reading: Passed Roll Call # 741",36,0,1,1,38
433514,213683,2012-11-08,Senate,"Senate Third Reading: Passed Roll Call # 742",37,0,0,1,38
433514,215089,2012-12-04,House,"Reported With Recommendation Without Amendment",9,0,0,0,9
433520,212185,2012-09-25,Senate,"Reported Favorably Without Amendment",5,0,0,0,5
433520,212246,2012-09-27,Senate,"Senate Third Reading: Passed Roll Call # 693",34,1,0,3,38
433520,215127,2012-12-04,House,"Reported With Recommendation With Substitute H-4",19,0,0,0,19
433520,215128,2012-12-05,House,"House Third Reading: Given Immediate Effect Roll Call # 682",104,3,0,0,107
433520,215436,2012-12-12,Senate,"Senate Third Reading:  Roll Call # 869",33,2,0,3,38
433521,212186,2012-09-25,Senate,"Reported Favorably Without Amendment",5,0,0,0,5
433521,212247,2012-09-27,Senate,"Senate Third Reading: Passed Roll Call # 694",34,1,0,3,38
433521,215125,2012-12-04,House,"Reported With Recommendation With Substitute H-2",19,0,0,0,19
433521,215126,2012-12-05,House,"House Third Reading: Given Immediate Effect Roll Call # 683",102,5,0,0,107
433521,215442,2012-12-12,Senate,"Senate Third Reading:  Roll Call # 870",34,2,0,2,38
433523,213048,2012-10-17,Senate,"Reported Favorably With Substitute S-2",5,0,0,0,5
433523,213049,2012-10-17,Senate,"Senate Third Reading: Passed Roll Call # 725",33,4,0,1,38
433523,215173,2012-12-05,House,"Reported With Recommendation With Substitute H-3",10,1,0,0,11
433523,215174,2012-12-06,House,"House Third Reading: Given Immediate Effect Roll Call # 689",61,49,0,0,110
433523,215175,2012-12-06,Senate,"Senate Third Reading:  Roll Call # 837",28,10,0,0,38
433524,212956,2012-10-17,Senate,"Reported Favorably With Substitute S-2",5,0,0,0,5
433524,212957,2012-10-17,Senate,"Senate Third Reading: Passed Roll Call # 727",33,4,0,1,38
433524,215196,2012-12-05,House,"Reported With Recommendation With Substitute H-3",10,1,0,0,11
433524,215197,2012-12-06,House,"House Third Reading: Given Immediate Effect Roll Call # 690",61,49,0,0,110
433524,215198,2012-12-06,Senate,"Senate Third Reading:  Roll Call # 838",28,10,0,0,38
433532,214182,2012-11-29,Senate,"Reported Favorably With Substitute S-1",4,0,0,0,4
433532,214183,2012-11-29,Senate,"Senate Third Reading: Passed Roll Call # 781",36,2,0,0,38
433532,215191,2012-12-06,House,"Reported With Recommendation Without Amendment",10,2,0,0,12
433532,215393,2012-12-12,House,"House Third Reading: Given Immediate Effect Roll Call # 733",64,44,0,0,108
433536,212299,2012-09-27,Senate,"Reported Favorably With Substitute S-1",4,0,0,0,4
433536,213655,2012-11-08,Senate,"Senate Third Reading: Passed Roll Call # 731",34,3,0,1,38
433536,215564,2012-12-12,House,"Reported With Recommendation Without Amendment",9,3,0,0,12
433541,213745,2012-11-27,Senate,"Reported Favorably Without Amendment",3,0,0,0,3
433543,213742,2012-11-27,Senate,"Reported Favorably With Substitute S-1",3,0,0,0,3
433545,213747,2012-11-27,Senate,"Reported Favorably Without Amendment",5,0,0,0,5
433545,214353,2012-11-29,Senate,"Senate Third Reading: Passed Roll Call # 772",38,0,0,0,38
433545,215603,2012-12-13,House,"Reported With Recommendation Without Amendment",9,0,0,0,9
433549,212303,2012-09-27,Senate,"Reported Favorably Without Amendment",4,0,0,0,4
433549,212989,2012-10-17,Senate,"Senate Third Reading: Passed Roll Call # 712",37,0,0,1,38
433549,215628,2012-12-12,House,"Reported With Recommendation With Substitute H-2",11,0,0,0,11
433549,215629,2012-12-13,House,"House Third Reading: Given Immediate Effect Roll Call # 810",99,11,0,0,110
433549,215630,2012-12-13,Senate,"Senate Third Reading:  Roll Call # 1051",38,0,0,0,38
433549,215788,2012-12-13,Senate,"Senate Third Reading:  Roll Call # 1050",38,0,0,0,38
433550,212302,2012-09-27,Senate,"Reported Favorably Without Amendment",4,0,0,0,4
433550,212988,2012-10-17,Senate,"Senate Third Reading: Passed Roll Call # 711",37,0,0,1,38
433556,213652,2012-11-08,House,"Reported With Recommendation Without Amendment",24,0,0,0,24
433556,214005,2012-11-28,House,"House Third Reading: Given Immediate Effect Roll Call # 627",108,0,0,0,108
433556,215321,2012-12-11,Senate,"Reported Favorably Without Amendment",9,0,0,0,9
433556,215615,2012-12-13,Senate,"Senate Third Reading: Given Immediate Effect Roll Call # 966",38,0,0,0,38
433569,213726,2012-11-27,House,"Reported With Recommendation With Substitute H-1",13,0,0,0,13
433569,215245,2012-12-06,House,"House Third Reading: Passed Roll Call # 704",73,35,0,0,108
433569,215774,2012-12-13,Senate,"Senate Third Reading: Given Immediate Effect Roll Call # 974",38,0,0,0,38
433573,213729,2012-11-27,House,"Reported With Recommendation Without Amendment",15,0,0,0,15
433573,214228,2012-11-29,House,"House Third Reading: Given Immediate Effect Roll Call # 649",108,0,0,0,108
433573,215707,2012-12-13,Senate,"Senate Third Reading: Given Immediate Effect Roll Call # 959",33,5,0,0,38
433748,212267,2012-09-27,House,"Reported With Recommendation With Substitute H-1",11,0,0,0,11
433749,212268,2012-09-27,House,"Reported With Recommendation With Substitute H-1",11,0,0,0,11
433753,212270,2012-09-27,Senate,"Reported Favorably Without Amendment",4,1,0,0,5
433753,213036,2012-10-17,Senate,"Senate Third Reading: Passed Roll Call # 696",36,0,1,1,38
433753,215231,2012-12-06,House,"Reported With Recommendation With Substitute H-2",12,0,0,0,12
433753,215587,2012-12-13,House,"House Third Reading: Given Immediate Effect Roll Call # 800",96,14,0,0,110
433753,215750,2012-12-14,Senate,"Senate Third Reading:  Roll Call # 1061",38,0,0,0,38
433753,215819,2012-12-14,Senate,"Senate Third Reading:  Roll Call # 1060",38,0,0,0,38
433756,214330,2012-11-29,Senate,"Reported Favorably Without Amendment",4,0,0,0,4
433756,214331,2012-11-29,Senate,"Senate Third Reading: Passed Roll Call # 782",29,9,0,0,38
433756,215299,2012-12-06,House,"Reported With Recommendation Without Amendment",10,2,0,0,12
433756,215433,2012-12-12,House,"House Third Reading: Given Immediate Effect Roll Call # 734",66,43,0,0,109
433769,212273,2012-09-27,Senate,"Reported Favorably With Substitute S-1",4,0,0,0,4
433769,213039,2012-10-17,Senate,"Senate Third Reading: Passed Roll Call # 713",37,0,0,1,38
433769,215237,2012-12-06,House,"Reported With Recommendation With Substitute H-2",14,0,0,0,14
433769,215593,2012-12-13,House,"House Third Reading: Given Immediate Effect Roll Call # 801",110,0,0,0,110
433769,215766,2012-12-14,Senate,"Senate Third Reading:  Roll Call # 1061",38,0,0,0,38
433771,212274,2012-09-27,Senate,"Reported Favorably Without Amendment",4,0,0,0,4
433771,213040,2012-10-17,Senate,"Senate Third Reading: Passed Roll Call # 714",37,0,0,1,38
433774,213765,2012-11-27,Senate,"Reported Favorably Without Amendment",3,0,0,0,3
433774,214405,2012-11-29,Senate,"Senate Third Reading: Passed Roll Call # 770",28,10,0,0,38
433774,215624,2012-12-12,House,"Reported With Recommendation With Amendment(s)",11,3,0,0,14
433774,215625,2012-12-13,House,"House Third Reading: Given Immediate Effect Roll Call # 811",80,30,0,0,110
433774,215787,2012-12-14,Senate,"Senate Third Reading: House Amendment(s) Concurred In Roll Call # 1062",29,9,0,0,38
433776,213648,2012-11-08,Senate,"Reported Favorably Without Amendment",3,0,0,0,3
433776,213940,2012-11-28,Senate,"Senate Third Reading: Passed Roll Call # 761",38,0,0,0,38
433776,215275,2012-12-06,House,"Reported With Recommendation With Substitute H-1",10,0,0,0,10
433776,215510,2012-12-12,House,"House Third Reading: Given Immediate Effect Roll Call # 777",109,0,0,0,109
433780,213647,2012-11-08,Senate,"Reported Favorably Without Amendment",3,0,0,0,3
433780,213930,2012-11-28,Senate,"Senate Third Reading: Passed Roll Call # 762",38,0,0,0,38
433780,215272,2012-12-06,House,"Reported With Recommendation Without Amendment",10,0,0,0,10
433780,215507,2012-12-12,House,"House Third Reading: Given Immediate Effect Roll Call # 778",109,0,0,0,109
433783,213649,2012-11-08,Senate,"Reported Favorably Without Amendment",3,0,0,0,3
433783,213954,2012-11-28,Senate,"Senate Third Reading: Passed Roll Call # 763",38,0,0,0,38
433783,215282,2012-12-06,House,"Reported With Recommendation Without Amendment",10,0,0,0,10
433783,215514,2012-12-12,House,"House Third Reading: Given Immediate Effect Roll Call # 779",109,0,0,0,109
433785,213650,2012-11-08,Senate,"Reported Favorably Without Amendment",3,0,0,0,3
433785,213941,2012-11-28,Senate,"Senate Third Reading: Passed Roll Call # 764",38,0,0,0,38
433785,215309,2012-12-06,House,"Reported With Recommendation Without Amendment",10,0,0,0,10
433785,215503,2012-12-12,House,"House Third Reading: Given Immediate Effect Roll Call # 780",109,0,0,0,109
433788,213637,2012-11-08,Senate,"Reported Favorably Without Amendment",3,0,0,0,3
433788,213955,2012-11-28,Senate,"Senate Third Reading: Passed Roll Call # 765",38,0,0,0,38
433788,215279,2012-12-06,House,"Reported With Recommendation With Substitute H-1",10,0,0,0,10
433788,215515,2012-12-12,House,"House Third Reading: Given Immediate Effect Roll Call # 781",109,0,0,0,109
433788,215662,2012-12-13,Senate,"Senate Third Reading:  Roll Call # 1051",38,0,0,0,38
433789,213714,2012-11-27,Senate,"Reported Favorably With Substitute S-1",3,0,0,0,3
433789,214101,2012-11-29,Senate,"Senate Third Reading: Passed Roll Call # 771",38,0,0,0,38
433789,215539,2012-12-12,House,"Reported With Recommendation Without Amendment",15,0,0,0,15
433789,215540,2012-12-13,House,"House Third Reading: Passed Roll Call # 812",107,3,0,0,110
433792,214397,2012-11-29,Senate,"Reported Favorably Without Amendment",4,0,0,0,4
433792,214398,2012-11-29,Senate,"Senate Third Reading: Passed Roll Call # 783",37,1,0,0,38
433792,215303,2012-12-06,House,"Reported With Recommendation Without Amendment",10,0,0,0,10
433792,215619,2012-12-13,House,"House Third Reading: Given Immediate Effect Roll Call # 788",107,0,0,0,107
433795,214390,2012-11-29,Senate,"Reported Favorably Without Amendment",4,0,0,0,4
433795,214391,2012-11-29,Senate,"Senate Third Reading: Passed Roll Call # 784",37,1,0,0,38
433795,215302,2012-12-06,House,"Reported With Recommendation Without Amendment",10,0,0,0,10
433795,215620,2012-12-13,House,"House Third Reading: Given Immediate Effect Roll Call # 789",107,0,0,0,107
433798,214409,2012-11-29,Senate,"Reported Favorably Without Amendment",4,0,0,0,4
433798,214410,2012-11-29,Senate,"Senate Third Reading: Passed Roll Call # 785",37,1,0,0,38
433798,215304,2012-12-06,House,"Reported With Recommendation Without Amendment",10,0,0,0,10
433798,215633,2012-12-13,House,"House Third Reading: Given Immediate Effect Roll Call # 790",107,0,0,0,107
433808,214643,2012-11-29,Senate,"Reported Favorably With Substitute S-1",4,0,0,0,4
433808,214644,2012-11-29,Senate,"Senate Third Reading: Passed Roll Call # 788",25,12,1,0,38
433808,215143,2012-12-05,House,"Reported With Recommendation Without Amendment",7,3,0,0,10
433808,215626,2012-12-12,House,"House Third Reading: Given Immediate Effect Roll Call # 773",68,41,0,0,109
433808,215789,2012-12-14,Senate,"Senate Third Reading:  Roll Call # 1063",26,12,0,0,38
433910,212248,2012-09-27,House,"House Third Reading:  Roll Call # 563",108,0,0,0,108
433910,212249,2012-09-27,Senate,"Senate Third Reading:  Roll Call # 687",36,0,0,2,38
433912,212250,2012-09-27,House,"House Third Reading:  Roll Call # 564",108,0,0,0,108
433912,212251,2012-09-27,Senate,"Senate Third Reading:  Roll Call # 688",36,0,0,2,38
433918,213654,2012-11-08,House,"Reported With Recommendation Without Amendment",17,0,0,0,17
433918,214113,2012-11-28,House,"House Third Reading: Given Immediate Effect Roll Call # 626",108,0,0,0,108
433918,215703,2012-12-13,Senate,"Reported Favorably Without Amendment",7,0,0,0,7
433918,215704,2012-12-13,Senate,"Senate Third Reading: Given Immediate Effect Roll Call # 977",38,0,0,0,38
433937,214666,2012-11-29,Senate,"Reported Favorably Without Amendment",4,0,0,0,4
433938,213638,2012-11-08,Senate,"Reported Favorably With Substitute S-1",3,0,0,0,3
433938,213658,2012-11-08,Senate,"Senate Third Reading: Passed Roll Call # 728",25,12,0,1,38
433938,214301,2012-11-28,House,"Reported With Recommendation Without Amendment",9,4,0,0,13
433938,215448,2012-12-12,House,"House Third Reading: Given Immediate Effect Roll Call # 727",64,45,0,0,109
433939,213639,2012-11-08,Senate,"Reported Favorably Without Amendment",3,0,0,0,3
433939,213659,2012-11-08,Senate,"Senate Third Reading: Passed Roll Call # 729",25,12,0,1,38
433939,214319,2012-11-28,House,"Reported With Recommendation Without Amendment",9,4,0,0,13
433939,215449,2012-12-12,House,"House Third Reading: Given Immediate Effect Roll Call # 728",64,45,0,0,109
433940,213730,2012-11-27,Senate,"Reported Favorably With Substitute S-2",6,0,0,0,6
433940,214229,2012-11-29,Senate,"Senate Third Reading: Passed Roll Call # 773",38,0,0,0,38
433940,215567,2012-12-13,House,"Reported With Recommendation Without Amendment",10,0,0,0,10
433940,215892,2012-12-14,House,"House Third Reading: Passed Roll Call # 873",107,0,0,0,107
434589,215170,2012-12-05,House,"Reported With Recommendation With Substitute H-2",8,0,0,0,8
434590,215177,2012-12-05,House,"Reported With Recommendation With Substitute H-2",9,0,0,0,9
434633,214378,2012-11-29,Senate,"Senate Third Reading: Passed Roll Call # 789",38,0,0,0,38
434633,215301,2012-12-06,House,"Reported With Recommendation Without Amendment",9,0,0,0,9
434633,215606,2012-12-13,House,"House Third Reading: Given Immediate Effect Roll Call # 815",109,0,0,0,109
434633,215776,2012-12-14,Senate,"Senate Third Reading:  Roll Call # 1065",38,0,0,0,38
434634,213772,2012-11-27,Senate,"Reported Favorably Without Amendment",5,2,0,0,7
434634,214447,2012-11-29,Senate,"Senate Third Reading: Passed Roll Call # 790",23,15,0,0,38
434634,215070,2012-12-04,House,"Reported With Recommendation With Substitute H-1",6,2,0,0,8
434634,215499,2012-12-12,House,"House Third Reading: Given Immediate Effect Roll Call # 766",66,43,0,0,109
434634,215643,2012-12-14,Senate,"Senate Third Reading:  Roll Call # 1064",27,11,0,0,38
434638,213712,2012-11-27,Senate,"Reported Favorably Without Amendment",5,0,0,0,5
434638,214093,2012-11-29,Senate,"Senate Third Reading: Passed Roll Call # 776",38,0,0,0,38
434646,213720,2012-11-27,Senate,"Reported Favorably Without Amendment",6,0,0,0,6
434646,214157,2012-11-29,Senate,"Senate Third Reading: Passed Roll Call # 775",38,0,0,0,38
434647,213723,2012-11-27,Senate,"Reported Favorably Without Amendment",6,0,0,0,6
434647,214169,2012-11-29,Senate,"Senate Third Reading: Passed Roll Call # 774",38,0,0,0,38
435676,214138,2012-11-29,Senate,"Reported Favorably Without Amendment",4,0,0,0,4
435676,214139,2012-11-29,Senate,"Senate Third Reading: Passed Roll Call # 786",26,12,0,0,38
435676,215076,2012-12-05,House,"Reported With Recommendation Without Amendment",17,9,0,0,26
435676,215077,2012-12-05,House,"House Third Reading: Given Immediate Effect Roll Call # 673",64,43,0,0,107
435679,215219,2012-12-05,Senate,"Reported Favorably With Substitute S-1",7,0,0,0,7
435679,215220,2012-12-06,Senate,"Senate Third Reading: Passed Roll Call # 834",38,0,0,0,38
435679,215575,2012-12-12,House,"Reported With Recommendation Without Amendment",10,5,0,0,15
435679,215576,2012-12-13,House,"House Third Reading: Given Immediate Effect Roll Call # 813",85,24,0,0,109
435688,214006,2012-11-28,House,"Reported With Recommendation Without Amendment",25,0,0,0,25
435688,214385,2012-11-28,House,"Reported With Recommendation With Substitute H-2",25,0,0,0,25
435688,215059,2012-12-04,House,"House Third Reading: Given Immediate Effect Roll Call # 668",105,0,0,0,105
435688,215781,2012-12-13,Senate,"Reported Favorably Without Amendment",7,0,0,0,7
435688,215782,2012-12-13,Senate,"Senate Third Reading: Given Immediate Effect Roll Call # 982",38,0,0,0,38
435689,214011,2012-11-28,House,"Reported With Recommendation Without Amendment",25,0,0,0,25
435689,215060,2012-12-04,House,"House Third Reading: Given Immediate Effect Roll Call # 667",66,39,0,0,105
435689,215783,2012-12-13,Senate,"Reported Favorably Without Amendment",7,0,0,0,7
435689,215784,2012-12-13,Senate,"Senate Third Reading: Given Immediate Effect Roll Call # 981",27,11,0,0,38
435689,215825,2012-12-14,House,"House Third Reading:  Roll Call # 879",64,43,0,0,107
435692,215157,2012-12-05,House,"Reported With Recommendation With Substitute H-1",10,7,0,0,17
435692,215158,2012-12-06,House,"House Third Reading: Passed Roll Call # 698",57,52,0,0,109
435692,215373,2012-12-12,Senate,"Reported Favorably With Substitute S-1",4,0,0,0,4
435692,215374,2012-12-12,Senate,"Senate Third Reading: Passed Roll Call # 935",23,14,0,1,38
435692,215508,2012-12-13,House,"House Third Reading:  Roll Call # 858",56,53,0,0,109
435693,215161,2012-12-05,House,"Reported With Recommendation With Substitute H-2",10,7,0,0,17
435693,215162,2012-12-06,House,"House Third Reading: Passed Roll Call # 697",57,52,0,0,109
435693,215362,2012-12-12,Senate,"Reported Favorably With Substitute S-1",4,0,0,0,4
435693,215363,2012-12-12,Senate,"Senate Third Reading: Passed Roll Call # 934",21,16,0,1,38
435693,215534,2012-12-13,House,"House Third Reading:  Roll Call # 857",56,53,0,0,109
435693,215681,2012-12-14,Senate,"Senate Third Reading:  Roll Call # 1078",20,18,0,0,38
435694,215165,2012-12-05,House,"Reported With Recommendation With Substitute H-2",10,7,0,0,17
435694,215166,2012-12-06,House,"House Third Reading: Passed Roll Call # 696",57,52,0,0,109
435694,215366,2012-12-12,Senate,"Reported Favorably With Substitute S-1",4,0,0,0,4
435694,215367,2012-12-12,Senate,"Senate Third Reading: Passed Roll Call # 933",23,14,0,1,38
435694,215542,2012-12-13,House,"House Third Reading:  Roll Call # 855",57,52,0,0,109
435694,215692,2012-12-14,Senate,"Senate Third Reading:  Roll Call # 1077",24,14,0,0,38
435696,213766,2012-11-27,House,"Reported With Recommendation Without Amendment",13,0,0,0,13
435696,213767,2012-11-27,House,"House Third Reading: Given Immediate Effect Roll Call # 604",85,22,0,0,107
435696,215372,2012-12-12,Senate,"Senate Third Reading: Given Immediate Effect Roll Call # 923",22,15,0,1,38
435697,215159,2012-12-05,House,"Reported With Recommendation Without Amendment",10,7,0,0,17
435697,215160,2012-12-06,House,"House Third Reading: Passed Roll Call # 695",57,52,0,0,109
435697,215358,2012-12-12,Senate,"Reported Favorably With Substitute S-1",4,0,0,0,4
435697,215359,2012-12-12,Senate,"Senate Third Reading: Passed Roll Call # 932",24,13,0,1,38
435697,215531,2012-12-13,House,"House Third Reading:  Roll Call # 856",57,52,0,0,109
435697,215674,2012-12-14,Senate,"Senate Third Reading:  Roll Call # 1076",24,14,0,0,38
435708,213776,2012-11-27,House,"Reported With Recommendation With Substitute H01",9,1,0,0,10
435708,214449,2012-11-29,House,"House Third Reading: Given Immediate Effect Roll Call # 655",64,42,0,0,106
435708,215277,2012-12-06,Senate,"Reported Favorably Without Amendment",5,0,0,0,5
435708,215673,2012-12-13,Senate,"Senate Third Reading: Given Immediate Effect Roll Call # 993",26,12,0,0,38
435708,215850,2012-12-14,House,"House Third Reading:  Roll Call # 907",69,36,0,0,105
435709,213784,2012-11-27,House,"Reported With Recommendation With Substitute H-1",9,0,0,0,9
435709,214461,2012-11-29,House,"House Third Reading: Given Immediate Effect Roll Call # 654",62,44,0,0,106
435709,215289,2012-12-06,Senate,"Reported Favorably Without Amendment",5,0,0,0,5
435709,215693,2012-12-13,Senate,"Senate Third Reading: Given Immediate Effect Roll Call # 992",26,12,0,0,38
435709,215861,2012-12-14,House,"House Third Reading:  Roll Call # 906",68,37,0,0,105
435711,213777,2012-11-27,House,"Reported With Recommendation With Substitute H-1",9,1,0,0,10
435711,214454,2012-11-29,House,"House Third Reading: Given Immediate Effect Roll Call # 653",62,44,0,0,106
435711,215278,2012-12-06,Senate,"Reported Favorably Without Amendment",5,0,0,0,5
435711,215672,2012-12-13,Senate,"Senate Third Reading: Given Immediate Effect Roll Call # 991",26,12,0,0,38
435711,215849,2012-12-14,House,"House Third Reading:  Roll Call # 905",68,37,0,0,105
435712,213782,2012-11-27,House,"Reported With Recommendation With Substitute H-1",9,2,0,0,11
435712,214460,2012-11-29,House,"House Third Reading: Given Immediate Effect Roll Call # 650",61,47,0,0,108
435712,215286,2012-12-06,Senate,"Reported Favorably Without Amendment",5,0,0,0,5
435712,215688,2012-12-13,Senate,"Senate Third Reading: Given Immediate Effect Roll Call # 990",26,12,0,0,38
435712,215857,2012-12-14,House,"House Third Reading: Senate Amendment(s) Concurred In Roll Call # 904",65,40,0,0,105
435713,213715,2012-11-27,House,"Reported With Recommendation With Substitute H-1",9,1,0,0,10
435713,214104,2012-11-29,House,"House Third Reading: Given Immediate Effect Roll Call # 651",62,45,0,0,107
435713,215293,2012-12-06,Senate,"Reported Favorably Without Amendment",5,0,0,0,5
435713,215675,2012-12-13,Senate,"Senate Third Reading: Given Immediate Effect Roll Call # 989",26,12,0,0,38
435713,215851,2012-12-14,House,"House Third Reading:  Roll Call # 903",67,38,0,0,105
435714,213716,2012-11-27,House,"Reported With Recommendation With Substitute H-1",9,0,0,0,9
435714,214103,2012-11-29,House,"House Third Reading: Given Immediate Effect Roll Call # 652",63,43,0,0,106
435714,215295,2012-12-06,Senate,"Reported Favorably Without Amendment",5,0,0,0,5
435714,215682,2012-12-13,Senate,"Senate Third Reading: Given Immediate Effect Roll Call # 988",26,12,0,0,38
435714,215853,2012-12-14,House,"House Third Reading: Senate Amendment(s) Concurred In Roll Call # 902",67,38,0,0,105
435714,215981,2012-12-14,House,"House Third Reading:  Roll Call # 902",67,38,0,0,105
436442,213789,2012-11-28,House,"Reported With Recommendation Without Amendment",24,0,0,0,24
436442,214121,2012-11-29,House,"House Third Reading:  Roll Call # 662",106,0,0,0,106
436442,215496,2012-12-11,Senate,"Reported Favorably Without Amendment",9,0,0,0,9
436442,215497,2012-12-11,Senate,"Senate Third Reading:  Roll Call # 867",38,0,0,0,38
436463,215255,2012-12-05,House,"Reported With Recommendation Without Amendment",11,0,0,0,11
436480,215116,2012-12-05,Senate,"Reported Favorably With Substitute S-1",7,0,0,0,7
436480,215229,2012-12-06,Senate,"Senate Third Reading: Passed Roll Call # 835",37,1,0,0,38
436598,215023,2012-12-04,House,"Reported With Recommendation With Substitute H-1",7,0,0,0,7
436598,215108,2012-12-05,House,"House Third Reading: Given Immediate Effect Roll Call # 684",65,43,0,0,108
436601,215024,2012-12-04,House,"Reported With Recommendation Without Amendment",6,0,0,0,6
436603,215025,2012-12-04,House,"Reported With Recommendation Without Amendment",7,0,0,0,7
436603,215110,2012-12-05,House,"House Third Reading: Given Immediate Effect Roll Call # 685",65,43,0,0,108
436603,215761,2012-12-13,Senate,"Senate Third Reading: Given Immediate Effect Roll Call # 1015",22,16,0,0,38
436603,215976,2012-12-14,House,"House Third Reading:  Roll Call # 886",65,40,0,0,105
436604,215026,2012-12-04,House,"Reported With Recommendation Without Amendment",7,0,0,0,7
436604,215112,2012-12-05,House,"House Third Reading: Given Immediate Effect Roll Call # 686",63,45,0,0,108
436608,215029,2012-12-04,House,"Reported With Recommendation With Substitute H-1",7,0,0,0,7
436608,215113,2012-12-05,House,"House Third Reading: Given Immediate Effect Roll Call # 687",65,43,0,0,108
436608,215764,2012-12-13,Senate,"Senate Third Reading: Given Immediate Effect Roll Call # 1017",22,16,0,0,38
436608,215906,2012-12-14,House,"House Third Reading:  Roll Call # 887",65,40,0,0,105
436611,215030,2012-12-04,House,"Reported With Recommendation Without Amendment",18,0,0,0,18
436633,215102,2012-12-05,Senate,"Reported Favorably With Substitute S-2",7,0,0,0,7
436633,215103,2012-12-05,Senate,"Senate Third Reading: Given Immediate Effect Roll Call # 823",26,12,0,0,38
436633,215560,2012-12-12,House,"Reported With Recommendation Without Amendment",17,8,0,0,25
436633,215561,2012-12-13,House,"House Third Reading: Given Immediate Effect Roll Call # 867",64,43,0,0,107
436633,215725,2012-12-14,Senate,"Senate Third Reading: House Amendment(s) Concurred In Roll Call # 1081",38,0,0,0,38
436633,215817,2012-12-14,Senate,"Senate Third Reading: House Amendment(s) Concurred In Roll Call # 1080",26,12,0,0,38
