bill_id,roll_call_id,date,chamber,description,yea,nay,nv,absent,total
1652423,1233245,2023-01-11,House,"House Third Reading: Roll Call # 2",100,9,0,0,109
1652552,1233246,2023-01-11,House,"House Third Reading: Roll Call # 3",105,4,0,0,109
1656317,1271721,2023-03-08,House,"Reported With Recommendation Without Amendment",7,3,0,0,10
1656317,1271722,2023-03-08,House,"House Third Reading: Given Immediate Effect Roll Call # 22",56,53,0,0,109
1656317,1278050,2023-03-15,Senate,"Reported Favorably Without Amendment",3,1,0,0,4
1656317,1280706,2023-03-21,Senate,"Senate Third Reading: Passed Roll Call # 99",20,16,0,2,38
1656317,1345081,2023-03-21,House,"House Third Reading: Roll Call # 37",56,52,0,0,108
1656337,1449437,2024-05-23,House,"Reported With Recommendation With Substitute H-4",9,1,0,0,10
1656358,1276370,2023-03-14,Senate,"Reported Favorably Without Amendment",5,2,0,0,7
1656358,1276371,2023-03-14,Senate,"Senate Third Reading: Passed Roll Call # 74",20,17,0,1,38
1656358,1280991,2023-03-21,House,"House Third Reading: Given Immediate Effect Roll Call # 33",56,52,0,0,108
1656385,1236709,2023-01-26,Senate,"Senate Third Reading: Passed Roll Call # 14",23,15,0,0,38
1656385,1236710,2023-01-26,Senate,"Reported Favorably Without Amendment",6,0,0,0,6
1656430,1348072,2023-06-13,House,"Reported With Recommendation Without Amendment",10,1,0,0,11
1656430,1356097,2023-10-12,House,"House Third Reading: Given Immediate Effect Roll Call # 355",100,10,0,0,110
1656430,1395792,2024-02-21,Senate,"Reported Favorably Without Amendment",10,0,0,0,10
1656430,1411769,2024-03-19,Senate,"Senate Third Reading: Given Immediate Effect Roll Call # 60",37,0,0,1,38
1656476,1238457,2023-01-26,Senate,"Senate Third Reading: Passed Roll Call # 9",20,18,0,0,38
1656476,1239441,2023-01-31,House,"House Third Reading: Given Immediate Effect Roll Call # 10",56,53,0,0,109
1656567,1242366,2023-02-01,Senate,"Reported Favorably Without Amendment",5,1,0,0,6
1656567,1245995,2023-02-08,Senate,"Senate Third Reading: Passed Roll Call # 20",22,16,0,0,38
1656567,1264838,2023-02-28,House,"Reported With Recommendation Without Amendment",9,5,0,0,14
1656567,1270741,2023-03-07,House,"House Third Reading: Given Immediate Effect Roll Call # 17",57,51,0,0,108
1656587,1237318,2023-01-26,Senate,"Senate Third Reading: Passed Roll Call # 8",27,11,0,0,38
1656587,1237469,2023-01-24,Senate,"Reported Favorably With Substitute S-5",9,2,0,0,11
1656609,1271710,2023-03-08,House,"Reported With Recommendation Without Amendment",7,1,0,0,8
1656609,1271711,2023-03-08,House,"House Third Reading: Given Immediate Effect Roll Call # 21",56,53,0,0,109
1656638,1401300,2024-02-29,House,"House Third Reading: Given Immediate Effect Roll Call # 18",93,13,0,0,106
1656684,1236982,2023-01-26,House,"House Third Reading: Given Immediate Effect Roll Call # 6",100,8,0,0,108
1656706,1237059,2023-01-26,House,"House Third Reading: Given Immediate Effect Roll Call # 5",67,41,0,0,108
1656706,1239792,2023-02-01,Senate,"Senate Third Reading: Passed Roll Call # 16",20,18,0,0,38
1656706,1252835,2023-02-09,House,"House Third Reading: Conference Report Adopted Roll Call # 13",56,53,0,0,109
1656706,1255491,2023-02-01,House,"House Third Reading: Roll Call # 12",53,56,0,0,109
1656706,1256529,2023-02-16,Senate,"Senate Third Reading: Senate Adopted Conference Report Roll Call # 22",20,17,0,1,38
1656732,1266491,2023-03-01,House,"Reported With Recommendation With Substitute H-1",8,5,0,0,13
1656732,1269663,2023-03-02,House,"House Third Reading: Given Immediate Effect Roll Call # 15",58,50,0,0,108
1656732,1271545,2023-03-08,Senate,"Senate Third Reading: Passed Roll Call # 47",20,18,0,0,38
1656753,1271770,2023-03-08,House,"Reported With Recommendation Without Amendment",8,3,0,0,11
1656753,1271771,2023-03-08,House,"House Third Reading: Given Immediate Effect Roll Call # 19",64,45,0,0,109
1656778,1271743,2023-03-08,House,"Reported With Recommendation Without Amendment",7,2,0,0,9
1656778,1271744,2023-03-08,House,"House Third Reading: Given Immediate Effect Roll Call # 20",56,53,0,0,109
1656778,1276099,2023-03-14,Senate,"Reported Favorably Without Amendment",5,2,0,0,7
1656778,1276100,2023-03-14,Senate,"Senate Third Reading: Passed Roll Call # 69",20,17,0,1,38
1656778,1280547,2023-03-21,Senate,"Senate Third Reading: Passed Roll Call # 101",20,16,0,2,38
1656778,1280971,2023-03-21,House,"House Third Reading: Senate Amendment(s) Concurred In Roll Call # 38",56,52,0,0,108
1656800,1241086,2023-02-01,House,"House Third Reading: Given Immediate Effect Roll Call # 11",56,53,0,0,109
1656800,1264819,2023-02-28,Senate,"Reported Favorably With Substitute S-1",14,5,0,0,19
1656800,1264820,2023-02-28,Senate,"Senate Third Reading: Given Immediate Effect Roll Call # 28",22,16,0,0,38
1656800,1308147,2023-03-01,House,"House Third Reading: Roll Call # 14",59,49,0,0,108
1656822,1270760,2023-03-02,Senate,"Reported Favorably Without Amendment",6,4,0,0,10
1656822,1271349,2023-03-08,Senate,"Senate Third Reading: Passed Roll Call # 41",20,18,0,0,38
1656822,1281515,2023-03-15,House,"Reported With Recommendation Without Amendment",8,5,0,0,13
1656822,1282361,2023-03-22,House,"House Third Reading: Given Immediate Effect Roll Call # 40",56,52,0,0,108
1656845,1235361,2023-01-24,House,"House Third Reading: Passed Roll Call # 4",56,52,0,0,108
1656845,1236184,2023-01-25,Senate,"Senate Third Reading: Roll Call: Roll Call # 7",0,38,0,0,38
1656845,1241051,2023-01-18,Senate,"Senate Third Reading: Passed Roll Call # 5",20,17,0,1,38
1656845,1245500,2023-01-26,Senate,"Senate Third Reading: Senate Adopted Conference Report With Immediate Effect Roll Call # 15",24,14,0,0,38
1656845,1278579,2023-01-26,House,"House Third Reading: Conference Report Adopted With Immediate Effect Roll Call # 8",60,48,0,0,108
1656894,1233661,2023-01-18,Senate,"Senate Third Reading: Passed Roll Call # 6",20,17,0,1,38
1656894,1236889,2023-01-26,House,"House Third Reading: Given Immediate Effect Roll Call # 7",74,34,0,0,108
1656935,1251424,2023-02-14,Senate,"Reported Favorably Without Amendment",5,1,0,0,6
1656935,1270753,2023-03-01,Senate,"Senate Third Reading: Passed Roll Call # 32",23,15,0,0,38
1656935,1271756,2023-03-08,House,"Reported With Recommendation Without Amendment",8,3,0,0,11
1656935,1271757,2023-03-08,House,"House Third Reading: Given Immediate Effect Roll Call # 18",64,45,0,0,109
1660613,1334017,2023-05-25,Senate,"Reported Favorably Without Amendment",10,0,0,0,10
1660613,1340661,2023-06-07,Senate,"Senate Third Reading: Passed Roll Call # 324",34,4,0,0,38
1660613,1356365,2023-10-03,House,"Reported With Recommendation Without Amendment",13,0,0,0,13
1660613,1357248,2023-11-08,House,"House Third Reading: Given Immediate Effect Roll Call # 518",91,18,0,0,109
1660788,1312983,2023-04-25,Senate,"Reported Favorably Without Amendment",3,1,0,0,4
1660788,1331689,2023-05-17,Senate,"Senate Third Reading: Passed Roll Call # 295",20,18,0,0,38
1660788,1347781,2023-06-22,House,"Reported With Recommendation Without Amendment",5,3,0,0,8
1660788,1348812,2023-06-28,House,"House Third Reading: Given Immediate Effect Roll Call # 260",56,52,0,0,108
1661328,1272379,2023-03-07,Senate,"Reported Favorably Without Amendment",6,0,0,0,6
1661328,1272779,2023-03-09,Senate,"Senate Third Reading: Passed Roll Call # 49",38,0,0,0,38
1661328,1306580,2023-04-19,House,"Reported With Recommendation With Substitute H-1",13,0,0,0,13
1661328,1316595,2023-04-27,House,"House Third Reading: Given Immediate Effect Roll Call # 71",104,3,0,0,107
1661328,1317744,2023-05-02,Senate,"Senate Third Reading: Roll Call: Roll Call # 142",37,0,0,1,38
1662046,1312197,2023-03-22,House,"Reported With Recommendation Without Amendment",5,0,0,0,5
1664890,1356081,2023-10-12,Senate,"Reported Favorably With Substitute S-3",9,1,0,0,10
1664890,1356205,2023-10-18,Senate,"Senate Third Reading: Passed Roll Call # 544",35,3,0,0,38
1664890,1434643,2024-04-25,House,"Reported With Recommendation Without Amendment",12,0,0,0,12
1664890,1437405,2024-05-01,House,"House Third Reading: Given Immediate Effect Roll Call # 49",93,12,0,0,105
1665057,1331805,2023-05-23,Senate,"Reported Favorably With Substitute S-3",3,1,0,0,4
1665057,1346637,2023-06-14,Senate,"Senate Third Reading: Passed Roll Call # 344",20,18,0,0,38
1665057,1363266,2023-09-28,House,"Reported With Recommendation With Substitute H-1",6,3,0,0,9
1665352,1356533,2023-10-19,Senate,"Reported Favorably With Substitute S-1",18,1,0,0,19
1665429,1363256,2023-10-10,House,"Reported With Recommendation With Substitute H-2",13,0,0,0,13
1665429,1383036,2024-02-07,House,"House Third Reading: Given Immediate Effect Roll Call # 6",106,0,0,0,106
1665623,1266488,2023-03-01,House,"Reported With Recommendation Without Amendment",8,5,0,0,13
1665623,1269644,2023-03-02,House,"House Third Reading: Given Immediate Effect Roll Call # 16",58,50,0,0,108
1665623,1271521,2023-03-08,Senate,"Senate Third Reading: Passed Roll Call # 48",20,18,0,0,38
1665725,1264854,2023-02-28,House,"Reported With Recommendation For Referral To Committee On Health Policy",9,0,0,0,9
1665874,1312193,2023-03-01,House,"Reported With Recommendation Without Amendment",8,5,0,0,13
1665924,1469570,2024-11-12,House,"Reported With Recommendation With Substitute H-2",13,0,0,0,13
1665924,1469592,2024-12-03,House,"House Third Reading: Given Immediate Effect Roll Call # 366",100,5,0,0,105
1666123,1312290,2023-03-22,House,"Reported With Recommendation Without Amendment",12,0,0,0,12
1666123,1355862,2023-09-26,House,"House Third Reading: Given Immediate Effect Roll Call # 309",95,14,0,0,109
1666123,1356615,2023-10-24,Senate,"Reported Favorably Without Amendment",7,0,0,0,7
1666123,1356777,2023-10-31,Senate,"Senate Third Reading: Passed Roll Call # 630",27,10,0,1,38
1668133,1343284,2023-06-08,Senate,"Reported Favorably With Substitute S-2",9,0,0,0,9
1668133,1346789,2023-06-14,Senate,"Senate Third Reading: Passed Roll Call # 346",27,11,0,0,38
1668133,1348133,2023-06-27,House,"Reported With Recommendation With Substitute H-1",16,0,0,0,16
1668133,1353710,2023-09-12,House,"House Third Reading: Given Immediate Effect Roll Call # 277",67,42,0,0,109
1668133,1354996,2023-09-19,Senate,"Senate Third Reading: Roll Call: Roll Call # 453",27,10,0,1,38
1668229,1275889,2023-03-14,Senate,"Reported Favorably With Substitute S-1",5,2,0,0,7
1668229,1275890,2023-03-14,Senate,"Senate Third Reading: Passed Roll Call # 60",20,17,0,1,38
1668229,1281018,2023-03-21,House,"House Third Reading: Given Immediate Effect Roll Call # 34",56,52,0,0,108
1668229,1292183,2023-03-21,Senate,"Senate Third Reading: House Amendment(s) Concurred In Roll Call # 100",20,16,0,2,38
1668430,1469272,2024-11-13,Senate,"Reported Favorably Without Amendment",9,0,0,0,9
1668430,1469699,2024-12-04,Senate,"Senate Third Reading: Passed Roll Call # 435",36,0,0,2,38
1668530,1267982,2023-03-01,Senate,"Reported Favorably Without Amendment",10,0,0,0,10
1668530,1275920,2023-03-09,Senate,"Senate Third Reading: Passed Roll Call # 51",25,13,0,0,38
1668530,1331756,2023-05-16,House,"Reported With Recommendation Without Amendment",8,0,0,0,8
1668530,1345553,2023-06-20,House,"House Third Reading: Given Immediate Effect Roll Call # 172",56,53,0,0,109
1668726,1270756,2023-03-07,Senate,"Reported Favorably With Substitute S-2",5,0,0,0,5
1668726,1272498,2023-03-09,Senate,"Senate Third Reading: Passed Roll Call # 52",38,0,0,0,38
1668726,1327465,2023-05-10,House,"Reported With Recommendation With Substitute H-1",13,0,0,0,13
1668726,1331800,2023-05-18,House,"House Third Reading: Given Immediate Effect Roll Call # 118",103,4,0,0,107
1668726,1342280,2023-06-06,Senate,"Senate Third Reading: Roll Call: Roll Call # 322",38,0,0,0,38
1669095,1312186,2023-03-07,House,"Reported With Recommendation With Substitute H-1",8,0,0,0,8
1669095,1330352,2023-05-11,House,"House Third Reading: Given Immediate Effect Roll Call # 98",94,13,0,0,107
1677271,1270744,2023-03-02,Senate,"Reported Favorably Without Amendment",6,4,0,0,10
1677271,1271527,2023-03-08,Senate,"Senate Third Reading: Passed Roll Call # 40",20,18,0,0,38
1677337,1469811,2024-12-05,Senate,"Reported Favorably With Substitute S-3",10,0,0,0,10
1677337,1469963,2024-12-10,House,"House Third Reading: Given Immediate Effect Roll Call # 379",58,51,0,0,109
1677408,1291175,2023-03-02,Senate,"Reported Favorably Without Amendment",6,4,0,0,10
1677482,1330760,2023-01-25,House,"Reported With Recommendation Without Amendment",22,0,0,0,22
1677551,1269141,2023-03-02,Senate,"Reported Favorably Without Amendment",6,4,0,0,10
1677551,1271513,2023-03-08,Senate,"Senate Third Reading: Passed Roll Call # 39",20,18,0,0,38
1678020,1277155,2023-03-15,House,"Reported With Recommendation With Substitute H-1",8,3,0,0,11
1678020,1277156,2023-03-16,House,"House Third Reading: Given Immediate Effect Roll Call # 26",85,19,0,0,104
1678020,1281014,2023-03-21,Senate,"Senate Third Reading: Given Immediate Effect Roll Call # 102",35,1,0,2,38
1682472,1277043,2023-03-15,House,"Reported With Recommendation With Substitute H-1",11,0,0,0,11
1682472,1277044,2023-03-16,House,"House Third Reading: Given Immediate Effect Roll Call # 31",96,7,0,0,103
1682472,1306379,2023-04-19,Senate,"Senate Third Reading: Given Immediate Effect Roll Call # 119",36,2,0,0,38
1682706,1300851,2023-04-11,House,"Reported With Recommendation For Referral To Committee On Judiciary",13,0,0,0,13
1682944,1312324,2023-03-16,House,"Reported With Recommendation Without Amendment",7,2,0,0,9
1682944,1345766,2023-06-20,House,"House Third Reading: Given Immediate Effect Roll Call # 181",56,53,0,0,109
1682944,1348630,2023-06-28,Senate,"Reported Favorably Without Amendment",9,0,0,0,9
1682944,1348631,2023-06-28,Senate,"Senate Third Reading: Passed Roll Call # 437",20,17,0,1,38
1683198,1357201,2023-11-07,Senate,"Reported Favorably Without Amendment",10,0,0,0,10
1683198,1397077,2023-11-08,Senate,"Senate Third Reading: Passed Roll Call # 703",35,0,0,3,38
1683384,1357206,2023-11-07,Senate,"Reported Favorably With Substitute S-2",10,0,0,0,10
1683384,1403832,2023-11-08,Senate,"Senate Third Reading: Passed Roll Call # 702",35,0,0,3,38
1683574,1283642,2023-03-23,Senate,"Senate Third Reading: Passed Roll Call # 108",28,10,0,0,38
1683574,1295940,2023-03-22,Senate,"Reported Favorably With Substitute S-1",12,0,0,0,12
1683574,1345757,2023-06-20,House,"Reported With Recommendation Without Amendment",13,0,0,0,13
1683574,1355531,2023-09-27,House,"House Third Reading: Given Immediate Effect Roll Call # 318",75,35,0,0,110
1688718,1356869,2023-10-10,House,"Reported With Recommendation Without Amendment",15,0,0,0,15
1688718,1357039,2023-11-02,House,"House Third Reading: Given Immediate Effect Roll Call # 476",106,3,0,0,109
1689184,1306525,2023-03-22,House,"Reported With Recommendation Without Amendment",5,0,0,0,5
1689184,1309335,2023-04-20,House,"House Third Reading: Given Immediate Effect Roll Call # 61",106,0,0,0,106
1689671,1315808,2023-04-27,Senate,"Reported Favorably With Substitute S-1",8,0,0,0,8
1689671,1331664,2023-05-17,Senate,"Senate Third Reading: Passed Roll Call # 305",37,1,0,0,38
1689671,1344666,2023-06-14,House,"House Third Reading: Given Immediate Effect Roll Call # 147",105,4,0,0,109
1689928,1443435,2024-05-15,House,"Reported With Recommendation With Substitute H-3",7,5,0,0,12
1689928,1463234,2024-06-27,House,"House Third Reading: Given Immediate Effect Roll Call # 262",57,53,0,0,110
1689928,1463235,2024-06-27,House,"House Third Reading: Given Immediate Effect Roll Call # 272",56,54,0,0,110
1689928,1468541,2024-10-09,Senate,"Reported Favorably Without Amendment",8,3,0,0,11
1689928,1470981,2024-12-11,Senate,"Senate Third Reading: Passed Roll Call # 490",20,16,0,2,38
1690261,1277195,2023-03-15,House,"Reported With Recommendation With Substitute H-1",9,1,0,0,10
1690261,1277196,2023-03-16,House,"House Third Reading: Given Immediate Effect Roll Call # 28",81,22,0,0,103
1690335,1300745,2023-04-11,House,"Reported With Recommendation With Amendment(s)",12,0,0,0,12
1690335,1304520,2023-04-13,House,"House Third Reading: Given Immediate Effect Roll Call # 56",103,4,0,0,107
1690600,1277183,2023-03-15,House,"Reported With Recommendation With Substitute H-1",9,1,0,0,10
1690600,1277184,2023-03-16,House,"House Third Reading: Given Immediate Effect Roll Call # 27",80,23,0,0,103
1690600,1312221,2023-04-26,House,"House Third Reading: Roll Call # 64",85,23,0,0,108
1690600,1317124,2023-04-27,Senate,"Senate Third Reading: Roll Call: Roll Call # 138",32,5,0,1,38
1690600,1328921,2023-04-20,Senate,"Senate Third Reading: Given Immediate Effect Roll Call # 131",33,4,0,1,38
1690789,1443445,2024-05-15,House,"Reported With Recommendation With Substitute H-4",7,5,0,0,12
1690789,1463218,2024-06-27,House,"House Third Reading: Given Immediate Effect Roll Call # 261",56,54,0,0,110
1690789,1468608,2024-10-09,Senate,"Reported Favorably Without Amendment",8,3,0,0,11
1690789,1470126,2024-12-11,Senate,"Senate Third Reading: Passed Roll Call # 489",20,16,0,2,38
1692000,1275024,2023-03-08,Senate,"Reported Favorably Without Amendment",7,0,0,0,7
1692000,1278153,2023-03-15,Senate,"Senate Third Reading: Passed Roll Call # 75",35,2,0,1,38
1692000,1347089,2023-06-22,House,"Reported With Recommendation Without Amendment",6,2,0,0,8
1692000,1353552,2023-06-27,House,"House Third Reading: Given Immediate Effect Roll Call # 236",61,47,0,0,108
1692005,1331693,2023-05-17,House,"Reported With Recommendation With Substitute H-1",9,7,0,0,16
1692005,1348498,2023-06-22,House,"House Third Reading: Given Immediate Effect Roll Call # 214",56,53,0,0,109
1692186,1331745,2023-05-17,House,"Reported With Recommendation With Substitute H-1",10,1,0,0,11
1692756,1331746,2023-05-18,House,"Reported With Recommendation Without Amendment",14,3,0,0,17
1692756,1332940,2023-05-24,House,"House Third Reading: Given Immediate Effect Roll Call # 122",70,37,0,0,107
1692756,1355900,2023-10-05,Senate,"Reported Favorably With Substitute S-1",10,0,0,0,10
1692756,1355901,2023-10-11,Senate,"Senate Third Reading: Passed Roll Call # 519",36,2,0,0,38
1692756,1355941,2023-10-12,House,"House Third Reading: Roll Call # 347",72,38,0,0,110
1697562,1274903,2023-03-08,Senate,"Reported Favorably With Substitute S-1",8,0,0,0,8
1697562,1276869,2023-03-15,Senate,"Senate Third Reading: Passed Roll Call # 77",37,0,0,1,38
1697562,1354934,2023-09-06,House,"Reported With Recommendation Without Amendment",11,0,0,0,11
1697562,1356497,2023-10-19,Senate,"Senate Third Reading: Roll Call: Roll Call # 548",38,0,0,0,38
1697562,1362855,2023-10-18,House,"House Third Reading: Given Immediate Effect Roll Call # 381",86,24,0,0,110
1697651,1355912,2023-10-05,Senate,"Reported Favorably Without Amendment",10,0,0,0,10
1697651,1356204,2023-10-18,Senate,"Senate Third Reading: Passed Roll Call # 537",37,1,0,0,38
1697651,1390438,2024-02-14,House,"Reported With Recommendation Without Amendment",19,0,0,0,19
1697651,1397455,2024-02-27,House,"House Third Reading: Given Immediate Effect Roll Call # 14",87,18,0,0,105
1697741,1298541,2023-04-11,Senate,"Reported Favorably Without Amendment",5,1,0,0,6
1697741,1312941,2023-04-19,Senate,"Senate Third Reading: Passed Roll Call # 123",29,9,0,0,38
1697741,1348048,2023-06-14,House,"Reported With Recommendation Without Amendment",9,1,0,0,10
1697741,1348668,2023-06-28,House,"House Third Reading: Given Immediate Effect Roll Call # 265",82,26,0,0,108
1697785,1356110,2023-10-05,Senate,"Reported Favorably Without Amendment",10,0,0,0,10
1697785,1356199,2023-10-18,Senate,"Senate Third Reading: Passed Roll Call # 538",37,1,0,0,38
1697785,1390426,2024-02-14,House,"Reported With Recommendation Without Amendment",19,0,0,0,19
1697785,1397461,2024-02-27,House,"House Third Reading: Given Immediate Effect Roll Call # 15",88,17,0,0,105
1697910,1357608,2023-11-09,House,"House Third Reading: Given Immediate Effect Roll Call # 566",107,0,0,0,107
1699609,1298871,2023-04-11,Senate,"Reported Favorably Without Amendment",7,0,0,0,7
1699609,1305889,2023-04-19,Senate,"Senate Third Reading: Passed Roll Call # 124",38,0,0,0,38
1699609,1346517,2023-05-30,House,"Reported With Recommendation Without Amendment",16,0,0,0,16
1699609,1353579,2023-06-27,House,"House Third Reading: Given Immediate Effect Roll Call # 228",104,4,0,0,108
1701365,1470746,2024-12-13,Senate,"Senate Third Reading: Passed Roll Call # 600",33,0,0,5,38
1701470,1265103,2023-02-22,Senate,"Reported Favorably With Substitute S-1",6,1,0,0,7
1701470,1291362,2023-03-07,Senate,"Senate Third Reading: Passed Roll Call # 34",28,10,0,0,38
1701470,1306356,2023-04-11,House,"Reported With Recommendation Without Amendment",9,1,0,0,10
1701470,1312286,2023-04-20,House,"House Third Reading: Given Immediate Effect Roll Call # 62",61,45,0,0,106
1707994,1355216,2023-09-26,House,"Reported With Recommendation With Substitute H-4",6,4,0,0,10
1707994,1356603,2023-10-25,House,"House Third Reading: Given Immediate Effect Roll Call # 407",63,46,0,0,109
1707994,1357275,2023-11-08,Senate,"Reported Favorably With Substitute S-1",9,2,0,0,11
1708037,1470651,2024-12-10,House,"House Third Reading: Given Immediate Effect Roll Call # 388",94,15,0,0,109
1708119,1306380,2023-04-19,House,"Reported With Recommendation Without Amendment",10,0,0,0,10
1708119,1318321,2023-05-03,House,"House Third Reading: Given Immediate Effect Roll Call # 79",94,14,0,0,108
1708119,1342216,2023-06-08,Senate,"Reported Favorably Without Amendment",8,0,0,0,8
1708119,1348755,2023-06-28,Senate,"Senate Third Reading: Given Immediate Effect Roll Call # 417",37,0,0,1,38
1708200,1356407,2023-09-26,House,"Reported With Recommendation With Substitute H-3",6,4,0,0,10
1708200,1356602,2023-10-25,House,"House Third Reading: Given Immediate Effect Roll Call # 408",62,47,0,0,109
1708200,1357313,2023-11-08,Senate,"Reported Favorably With Substitute S-1",9,2,0,0,11
1708234,1346675,2023-06-20,House,"Reported With Recommendation Without Amendment",13,0,0,0,13
1708234,1353576,2023-06-27,House,"House Third Reading: Given Immediate Effect Roll Call # 232",106,2,0,0,108
1708234,1357145,2023-11-07,Senate,"Reported Favorably Without Amendment",4,0,0,0,4
1708234,1400040,2023-11-09,Senate,"Senate Third Reading: Passed Roll Call # 715",37,0,0,1,38
1708282,1469973,2024-12-10,House,"House Third Reading: Given Immediate Effect Roll Call # 389",93,16,0,0,109
1708297,1301377,2023-03-23,House,"Reported With Recommendation With Substitute H-2",7,2,0,0,9
1708764,1363322,2023-10-05,House,"Reported With Recommendation With Substitute H-1",18,0,0,0,18
1708764,1402365,2024-02-21,House,"House Third Reading: Given Immediate Effect Roll Call # 13",104,2,0,0,106
1708764,1413215,2024-03-14,Senate,"Reported Favorably Without Amendment",10,0,0,0,10
1708764,1443760,2024-05-15,Senate,"Senate Third Reading: Passed Roll Call # 193",36,0,0,2,38
1710620,1277247,2023-03-14,Senate,"Reported Favorably With Substitute S-1",5,2,0,0,7
1710620,1278625,2023-03-16,Senate,"Senate Third Reading: Passed Roll Call # 90",20,17,0,1,38
1710620,1300261,2023-04-12,House,"Reported With Recommendation With Substitute H-5",8,5,0,0,13
1710620,1301413,2023-04-13,House,"House Third Reading: Given Immediate Effect Roll Call # 55",56,51,0,0,107
1710620,1319863,2023-04-19,Senate,"Senate Third Reading: Roll Call: Roll Call # 118",20,17,0,1,38
1710665,1277288,2023-03-14,Senate,"Reported Favorably Without Amendment",5,2,0,0,7
1710665,1278558,2023-03-16,Senate,"Senate Third Reading: Passed Roll Call # 92",20,17,0,1,38
1710665,1319930,2023-04-12,House,"Reported With Recommendation With Substitute H-2",8,5,0,0,13
1710693,1277101,2023-03-14,Senate,"Reported Favorably With Substitute S-2",5,2,0,0,7
1710693,1278569,2023-03-16,Senate,"Senate Third Reading: Passed Roll Call # 84",20,17,0,1,38
1710693,1282224,2023-03-22,House,"Reported With Recommendation With Substitute H-1",7,5,0,0,12
1710693,1284705,2023-03-23,Senate,"Senate Third Reading: Roll Call: Roll Call # 113",20,18,0,0,38
1710693,1347157,2023-03-22,House,"House Third Reading: Given Immediate Effect Roll Call # 46",61,47,0,0,108
1710718,1277096,2023-03-14,Senate,"Reported Favorably With Substitute S-2",5,2,0,0,7
1710718,1277924,2023-03-16,Senate,"Senate Third Reading: Passed Roll Call # 80",20,17,0,1,38
1710769,1277301,2023-03-14,Senate,"Reported Favorably With Substitute S-1",7,0,0,0,7
1710769,1278862,2023-03-16,Senate,"Senate Third Reading: Passed Roll Call # 88",22,15,0,1,38
1710769,1282608,2023-03-22,House,"Reported With Recommendation Without Amendment",7,5,0,0,12
1710769,1347144,2023-03-22,House,"House Third Reading: Given Immediate Effect Roll Call # 49",64,44,0,0,108
1710797,1312418,2023-04-25,Senate,"Reported Favorably Without Amendment",7,0,0,0,7
1710797,1319155,2023-05-04,Senate,"Senate Third Reading: Passed Roll Call # 149",38,0,0,0,38
1710797,1345482,2023-06-13,House,"Reported With Recommendation Without Amendment",12,0,0,0,12
1710797,1346109,2023-06-21,House,"House Third Reading: Given Immediate Effect Roll Call # 194",105,4,0,0,109
1710822,1277198,2023-03-14,Senate,"Reported Favorably Without Amendment",5,2,0,0,7
1710822,1278499,2023-03-16,Senate,"Senate Third Reading: Passed Roll Call # 91",20,17,0,1,38
1710822,1312202,2023-04-12,House,"Reported With Recommendation Without Amendment",8,5,0,0,13
1710876,1312350,2023-04-25,Senate,"Reported Favorably Without Amendment",7,0,0,0,7
1710876,1319176,2023-05-04,Senate,"Senate Third Reading: Passed Roll Call # 148",37,1,0,0,38
1710876,1345370,2023-06-13,House,"Reported With Recommendation Without Amendment",12,0,0,0,12
1710876,1347657,2023-06-21,House,"House Third Reading: Given Immediate Effect Roll Call # 193",105,4,0,0,109
1710900,1276944,2023-03-14,Senate,"Reported Favorably With Substitute S-1",7,0,0,0,7
1710900,1278103,2023-03-16,Senate,"Senate Third Reading: Passed Roll Call # 87",22,15,0,1,38
1710900,1282218,2023-03-22,House,"Reported With Recommendation Without Amendment",7,5,0,0,12
1710900,1347164,2023-03-22,House,"House Third Reading: Given Immediate Effect Roll Call # 48",64,44,0,0,108
1710927,1312183,2023-04-25,Senate,"Reported Favorably Without Amendment",7,0,0,0,7
1710927,1319204,2023-05-04,Senate,"Senate Third Reading: Passed Roll Call # 155",38,0,0,0,38
1710927,1345731,2023-06-13,House,"Reported With Recommendation Without Amendment",12,0,0,0,12
1710927,1347652,2023-06-21,House,"House Third Reading: Given Immediate Effect Roll Call # 200",105,4,0,0,109
1710979,1276904,2023-03-14,Senate,"Reported Favorably Without Amendment",5,2,0,0,7
1710979,1278580,2023-03-16,Senate,"Senate Third Reading: Passed Roll Call # 82",20,17,0,1,38
1711006,1276952,2023-03-14,Senate,"Reported Favorably Without Amendment",5,2,0,0,7
1711006,1278573,2023-03-16,Senate,"Senate Third Reading: Passed Roll Call # 81",20,17,0,1,38
1711031,1312199,2023-04-25,Senate,"Reported Favorably Without Amendment",7,0,0,0,7
1711031,1318826,2023-05-04,Senate,"Senate Third Reading: Passed Roll Call # 151",38,0,0,0,38
1711031,1342213,2023-06-08,House,"Reported With Recommendation Without Amendment",18,0,0,0,18
1711031,1347783,2023-06-21,House,"House Third Reading: Given Immediate Effect Roll Call # 196",105,4,0,0,109
1711084,1309969,2023-04-25,Senate,"Reported Favorably Without Amendment",7,0,0,0,7
1711084,1319189,2023-05-04,Senate,"Senate Third Reading: Passed Roll Call # 153",38,0,0,0,38
1711084,1345359,2023-06-08,House,"Reported With Recommendation With Substitute H-1",18,0,0,0,18
1711084,1350110,2023-06-27,Senate,"Senate Third Reading: Roll Call: Roll Call # 386",37,0,0,1,38
1711084,1353098,2023-06-21,House,"House Third Reading: Given Immediate Effect Roll Call # 198",105,4,0,0,109
1711109,1277281,2023-03-14,Senate,"Reported Favorably Without Amendment",5,2,0,0,7
1711109,1278732,2023-03-16,Senate,"Senate Third Reading: Passed Roll Call # 93",20,17,0,1,38
1711109,1312263,2023-04-12,House,"Reported With Recommendation Without Amendment",8,5,0,0,13
1711161,1312497,2023-04-25,Senate,"Reported Favorably Without Amendment",7,0,0,0,7
1711161,1319393,2023-05-04,Senate,"Senate Third Reading: Passed Roll Call # 154",38,0,0,0,38
1711161,1345733,2023-06-08,House,"Reported With Recommendation Without Amendment",18,0,0,0,18
1711161,1346376,2023-06-21,House,"House Third Reading: Given Immediate Effect Roll Call # 199",105,4,0,0,109
1711188,1312196,2023-04-25,Senate,"Reported Favorably Without Amendment",7,0,0,0,7
1711188,1319169,2023-05-04,Senate,"Senate Third Reading: Passed Roll Call # 152",38,0,0,0,38
1711188,1345717,2023-06-08,House,"Reported With Recommendation Without Amendment",18,0,0,0,18
1711188,1346493,2023-06-21,House,"House Third Reading: Given Immediate Effect Roll Call # 197",105,4,0,0,109
1711238,1276942,2023-03-14,Senate,"Reported Favorably With Substitute S-1",5,2,0,0,7
1711238,1278102,2023-03-16,Senate,"Senate Third Reading: Passed Roll Call # 85",20,17,0,1,38
1711238,1282221,2023-03-22,House,"Reported With Recommendation With Substitute H-1",7,5,0,0,12
1711238,1284706,2023-03-23,Senate,"Senate Third Reading: Roll Call: Roll Call # 114",20,18,0,0,38
1711238,1347148,2023-03-22,House,"House Third Reading: Given Immediate Effect Roll Call # 47",61,47,0,0,108
1711261,1312184,2023-04-25,Senate,"Reported Favorably Without Amendment",7,0,0,0,7
1711261,1319207,2023-05-04,Senate,"Senate Third Reading: Passed Roll Call # 150",38,0,0,0,38
1711261,1345457,2023-06-13,House,"Reported With Recommendation Without Amendment",12,0,0,0,12
1711261,1346572,2023-06-21,House,"House Third Reading: Given Immediate Effect Roll Call # 195",105,4,0,0,109
1715943,1331657,2023-05-23,Senate,"Reported Favorably With Substitute S-1",3,1,0,0,4
1715943,1335093,2023-05-23,Senate,"Senate Third Reading: Passed Roll Call # 315",33,5,0,0,38
1715943,1341450,2023-06-06,House,"Reported With Recommendation Without Amendment",12,0,0,0,12
1715943,1343329,2023-06-08,House,"House Third Reading: Given Immediate Effect Roll Call # 142",100,7,0,0,107
1716225,1291500,2023-03-22,Senate,"Reported Favorably Without Amendment",12,0,0,0,12
1716225,1327470,2023-04-20,Senate,"Senate Third Reading: Passed Roll Call # 130",30,7,0,1,38
1716319,1280968,2023-03-21,Senate,"Reported Favorably Without Amendment",8,0,0,0,8
1716319,1281614,2023-03-22,Senate,"Senate Third Reading: Passed Roll Call # 106",32,6,0,0,38
1716417,1291509,2023-03-22,Senate,"Reported Favorably With Substitute S-1",12,0,0,0,12
1716417,1309502,2023-04-20,Senate,"Senate Third Reading: Passed Roll Call # 129",31,6,0,1,38
1716417,1356181,2023-10-12,House,"House Third Reading: Given Immediate Effect Roll Call # 351",56,54,0,0,110
1716417,1356364,2023-10-18,Senate,"Senate Third Reading: Roll Call: Roll Call # 534",29,9,0,0,38
1718035,1270826,2023-03-02,Senate,"Reported Favorably Without Amendment",6,4,0,0,10
1718035,1271614,2023-03-08,Senate,"Senate Third Reading: Passed Roll Call # 42",20,18,0,0,38
1718082,1302985,2023-03-07,House,"Reported With Recommendation With Substitute H-2",6,2,0,0,8
1718082,1363311,2023-11-09,House,"House Third Reading: Given Immediate Effect Roll Call # 545",56,53,0,0,109
1718082,1392025,2024-02-22,Senate,"Reported Favorably Without Amendment",5,2,0,0,7
1718082,1399792,2024-02-29,Senate,"Senate Third Reading: Passed Roll Call # 45",21,17,0,0,38
1718082,1399793,2024-02-29,Senate,"Senate Third Reading: Passed Roll Call # 46",20,18,0,0,38
1718102,1356740,2023-09-19,House,"Reported With Recommendation With Substitute H-1",6,2,0,0,8
1718102,1356875,2023-11-01,House,"House Third Reading: Given Immediate Effect Roll Call # 442",56,54,0,0,110
1718102,1357672,2023-11-09,Senate,"Reported Favorably Without Amendment",11,0,0,0,11
1718102,1399433,2023-11-09,Senate,"Senate Third Reading: Passed Roll Call # 726",21,16,0,1,38
1718124,1306587,2023-04-19,House,"Reported With Recommendation Without Amendment",13,0,0,0,13
1718124,1344421,2023-06-14,Senate,"Reported Favorably Without Amendment",7,3,0,0,10
1718124,1344422,2023-06-14,Senate,"Senate Third Reading: Given Immediate Effect Roll Call # 349",34,4,0,0,38
1718124,1350984,2023-05-24,House,"House Third Reading: Given Immediate Effect Roll Call # 123",102,5,0,0,107
1718164,1356726,2023-09-19,House,"Reported With Recommendation With Substitute H-1",6,2,0,0,8
1718164,1356894,2023-11-01,House,"House Third Reading: Given Immediate Effect Roll Call # 443",56,54,0,0,110
1718205,1306608,2023-04-19,House,"Reported With Recommendation Without Amendment",13,0,0,0,13
1718205,1333050,2023-05-24,House,"House Third Reading: Given Immediate Effect Roll Call # 126",102,5,0,0,107
1718205,1345804,2023-06-14,Senate,"Reported Favorably Without Amendment",7,3,0,0,10
1718205,1345805,2023-06-14,Senate,"Senate Third Reading: Given Immediate Effect Roll Call # 352",38,0,0,0,38
1718226,1306080,2023-04-19,House,"Reported With Recommendation With Substitute H-1",13,0,0,0,13
1718226,1332934,2023-05-24,House,"House Third Reading: Given Immediate Effect Roll Call # 128",97,10,0,0,107
1718226,1344387,2023-06-14,Senate,"Reported Favorably Without Amendment",7,3,0,0,10
1718226,1344388,2023-06-14,Senate,"Senate Third Reading: Given Immediate Effect Roll Call # 354",30,8,0,0,38
1718261,1357500,2023-11-09,House,"House Third Reading: Given Immediate Effect Roll Call # 562",72,35,0,0,107
1718261,1357908,2023-10-31,House,"Reported With Recommendation With Substitute H-2",11,0,0,0,11
1718261,1425026,2024-03-14,Senate,"Reported Favorably With Substitute S-2",10,0,0,0,10
1718261,1445733,2024-05-21,House,"House Third Reading: Roll Call # 115",98,9,0,0,107
1718261,1468581,2024-05-15,Senate,"Senate Third Reading: Passed Roll Call # 195",35,1,0,2,38
1718283,1303018,2023-04-11,House,"Reported With Recommendation Without Amendment",15,0,0,0,15
1718283,1347265,2023-06-22,House,"House Third Reading: Given Immediate Effect Roll Call # 219",68,41,0,0,109
1718283,1425078,2024-03-20,Senate,"Reported Favorably Without Amendment",7,2,0,0,9
1718283,1469146,2024-11-07,Senate,"Senate Third Reading: Passed Roll Call # 413",21,14,0,3,38
1718304,1302958,2023-04-11,House,"Reported With Recommendation With Substitute H-1",15,0,0,0,15
1718304,1347065,2023-06-22,House,"House Third Reading: Given Immediate Effect Roll Call # 218",67,42,0,0,109
1718304,1425046,2024-03-20,Senate,"Reported Favorably With Substitute S-1",7,2,0,0,9
1718304,1469148,2024-11-07,Senate,"Senate Third Reading: Passed Roll Call # 412",21,14,0,3,38
1718304,1469254,2024-11-13,House,"House Third Reading: Roll Call # 351",57,52,0,0,109
1718347,1306601,2023-04-19,House,"Reported With Recommendation Without Amendment",13,0,0,0,13
1718347,1333048,2023-05-24,House,"House Third Reading: Given Immediate Effect Roll Call # 125",107,0,0,0,107
1718347,1344414,2023-06-14,Senate,"Reported Favorably Without Amendment",7,3,0,0,10
1718347,1344415,2023-06-14,Senate,"Senate Third Reading: Given Immediate Effect Roll Call # 351",38,0,0,0,38
1718368,1306583,2023-04-19,House,"Reported With Recommendation Without Amendment",13,0,0,0,13
1718368,1344390,2023-06-14,Senate,"Reported Favorably Without Amendment",7,3,0,0,10
1718368,1344391,2023-06-14,Senate,"Senate Third Reading: Given Immediate Effect Roll Call # 350",38,0,0,0,38
1718368,1350982,2023-05-24,House,"House Third Reading: Given Immediate Effect Roll Call # 124",107,0,0,0,107
1718389,1306051,2023-04-19,House,"Reported With Recommendation Without Amendment",13,0,0,0,13
1718389,1333080,2023-05-24,House,"House Third Reading: Given Immediate Effect Roll Call # 127",102,5,0,0,107
1718389,1344633,2023-06-14,Senate,"Reported Favorably Without Amendment",7,3,0,0,10
1718389,1344634,2023-06-14,Senate,"Senate Third Reading: Given Immediate Effect Roll Call # 353",34,4,0,0,38
1718410,1303091,2023-03-07,House,"Reported With Recommendation Without Amendment",6,2,0,0,8
1718410,1363264,2023-11-09,House,"House Third Reading: Given Immediate Effect Roll Call # 546",56,53,0,0,109
1718410,1392096,2024-02-22,Senate,"Reported Favorably With Substitute S-1",5,2,0,0,7
1718410,1402917,2024-02-29,Senate,"Senate Third Reading: Passed Roll Call # 48",20,18,0,0,38
1718410,1469273,2024-11-13,House,"House Third Reading: Roll Call # 335",56,53,0,0,109
1718430,1355937,2023-09-19,House,"Reported With Recommendation Without Amendment",8,0,0,0,8
1718430,1355978,2023-10-12,House,"House Third Reading: Given Immediate Effect Roll Call # 356",92,18,0,0,110
1718430,1363803,2023-11-08,Senate,"Reported Favorably Without Amendment",9,2,0,0,11
1718430,1363804,2023-11-09,Senate,"Senate Third Reading: Given Immediate Effect Roll Call # 717",37,0,0,1,38
1722853,1282248,2023-03-22,House,"Reported With Recommendation With Substitute H-1",7,5,0,0,12
1722853,1347100,2023-03-22,House,"House Third Reading: Given Immediate Effect Roll Call # 45",61,47,0,0,108
1722868,1277185,2023-03-15,House,"Reported With Recommendation With Substitute H-1",8,3,0,0,11
1722868,1277186,2023-03-16,House,"House Third Reading: Given Immediate Effect Roll Call # 29",85,18,0,0,103
1722903,1282290,2023-03-22,House,"Reported With Recommendation With Substitute H-1",7,4,0,0,11
1722903,1282291,2023-03-22,House,"House Third Reading: Given Immediate Effect Roll Call # 42",61,47,0,0,108
1722922,1300776,2023-04-12,House,"Reported With Recommendation Without Amendment",8,5,0,0,13
1722922,1304513,2023-04-13,House,"House Third Reading: Given Immediate Effect Roll Call # 53",56,51,0,0,107
1722922,1304987,2023-04-19,Senate,"Senate Third Reading: Passed Roll Call # 127",20,18,0,0,38
1722922,1312229,2023-04-26,House,"House Third Reading: Senate Amendment(s) Concurred In Roll Call # 66",56,52,0,0,108
1722939,1271717,2023-03-08,House,"Reported With Recommendation Without Amendment",8,5,0,0,13
1722939,1271718,2023-03-08,House,"House Third Reading: Given Immediate Effect Roll Call # 25",56,53,0,0,109
1722939,1283773,2023-03-23,Senate,"Senate Third Reading: Passed Roll Call # 117",20,18,0,0,38
1722939,1301330,2023-04-13,House,"House Third Reading: Roll Call # 57",56,51,0,0,107
1722956,1271784,2023-03-08,House,"Reported With Recommendation Without Amendment",8,5,0,0,13
1722956,1271785,2023-03-08,House,"House Third Reading: Given Immediate Effect Roll Call # 24",56,53,0,0,109
1722956,1282747,2023-03-23,Senate,"Senate Third Reading: Passed Roll Call # 116",20,18,0,0,38
1723010,1300022,2023-04-12,House,"Reported With Recommendation With Substitute H-2",8,5,0,0,13
1723010,1304506,2023-04-13,House,"House Third Reading: Given Immediate Effect Roll Call # 54",56,51,0,0,107
1723010,1305053,2023-04-19,Senate,"Senate Third Reading: Passed Roll Call # 128",20,18,0,0,38
1723010,1350796,2023-04-26,House,"House Third Reading: Senate Amendment(s) Concurred In Roll Call # 67",56,52,0,0,108
1723032,1282404,2023-03-22,House,"Reported With Recommendation With Substitute H-2",7,4,0,0,11
1723032,1282405,2023-03-22,House,"House Third Reading: Given Immediate Effect Roll Call # 43",64,44,0,0,108
1723051,1331699,2023-05-23,House,"Reported With Recommendation With Substitute H-4",12,0,0,0,12
1723051,1344460,2023-06-14,House,"House Third Reading: Given Immediate Effect Roll Call # 149",95,14,0,0,109
1723051,1350361,2023-06-27,Senate,"Senate Third Reading: Given Immediate Effect Roll Call # 400",37,0,0,1,38
1723070,1356986,2023-11-02,House,"House Third Reading: Given Immediate Effect Roll Call # 474",109,0,0,0,109
1723070,1357904,2023-05-23,House,"Reported With Recommendation Without Amendment",12,0,0,0,12
1723070,1457183,2024-06-11,Senate,"Senate Third Reading: Passed Roll Call # 240",38,0,0,0,38
1723070,1468806,2024-05-22,Senate,"Reported Favorably Without Amendment",4,0,0,0,4
1723087,1282230,2023-03-22,House,"Reported With Recommendation With Substitute H-2",7,5,0,0,12
1723087,1282231,2023-03-22,House,"House Third Reading: Given Immediate Effect Roll Call # 44",63,45,0,0,108
1723105,1271786,2023-03-08,House,"Reported With Recommendation With Substitute H-1",8,5,0,0,13
1723105,1271787,2023-03-08,House,"House Third Reading: Given Immediate Effect Roll Call # 23",56,53,0,0,109
1723105,1292197,2023-03-23,Senate,"Senate Third Reading: Passed Roll Call # 115",20,18,0,0,38
1723143,1300628,2023-04-12,House,"Reported With Recommendation Without Amendment",8,5,0,0,13
1723143,1304865,2023-04-13,House,"House Third Reading: Given Immediate Effect Roll Call # 52",56,51,0,0,107
1723143,1307154,2023-04-19,Senate,"Senate Third Reading: Passed Roll Call # 126",20,18,0,0,38
1723143,1350733,2023-04-26,House,"House Third Reading: Roll Call # 65",56,52,0,0,108
1723163,1300730,2023-04-12,House,"Reported With Recommendation With Substitute H-5",7,5,0,0,12
1723163,1300731,2023-04-13,House,"House Third Reading: Given Immediate Effect Roll Call # 51",56,51,0,0,107
1723287,1334090,2023-05-25,Senate,"Reported Favorably Without Amendment",6,1,0,0,7
1723287,1348089,2023-06-08,Senate,"Senate Third Reading: Passed Roll Call # 338",25,13,0,0,38
1723287,1355859,2023-09-28,House,"Reported With Recommendation With Amendment(s)",8,1,0,0,9
1723287,1357258,2023-11-08,House,"House Third Reading: Given Immediate Effect Roll Call # 496",61,48,0,0,109
1723287,1398844,2023-11-09,Senate,"Senate Third Reading: House Amendment(s) Concurred In Roll Call # 706",24,13,1,0,38
1723333,1312219,2023-04-26,House,"House Third Reading: Given Immediate Effect Roll Call # 68",86,22,0,0,108
1723333,1314767,2023-04-27,Senate,"Senate Third Reading: House Amendment(s) Concurred In Roll Call # 139",32,5,0,1,38
1723333,1327343,2023-04-20,Senate,"Senate Third Reading: Passed Roll Call # 132",33,4,0,1,38
1723357,1312856,2023-04-26,Senate,"Reported Favorably With Substitute S-1",11,0,0,0,11
1723357,1324439,2023-05-10,Senate,"Senate Third Reading: Passed Roll Call # 187",38,0,0,0,38
1723357,1344335,2023-06-14,House,"House Third Reading: Given Immediate Effect Roll Call # 150",93,16,0,0,109
1723357,1350013,2023-06-27,Senate,"Senate Third Reading: Roll Call: Roll Call # 387",37,0,0,1,38
1723357,1357905,2023-05-23,House,"Reported With Recommendation With Substitute H-1",12,0,0,0,12
1723418,1312975,2023-04-26,Senate,"Reported Favorably With Substitute S-1",11,0,0,0,11
1723418,1324445,2023-05-10,Senate,"Senate Third Reading: Passed Roll Call # 186",38,0,0,0,38
1723440,1334020,2023-05-25,Senate,"Reported Favorably Without Amendment",6,1,0,0,7
1723440,1342288,2023-06-08,Senate,"Senate Third Reading: Passed Roll Call # 339",25,13,0,0,38
1723440,1355345,2023-09-28,House,"Reported With Recommendation Without Amendment",8,1,0,0,9
1723440,1357285,2023-11-08,House,"House Third Reading: Given Immediate Effect Roll Call # 497",61,48,0,0,109
1723536,1275470,2023-03-09,Senate,"Reported Favorably Without Amendment",10,0,0,0,10
1723536,1276861,2023-03-15,Senate,"Senate Third Reading: Passed Roll Call # 76",33,4,0,1,38
1723536,1307177,2023-03-23,House,"Reported With Recommendation Without Amendment",10,0,0,0,10
1723536,1312284,2023-04-20,House,"House Third Reading: Given Immediate Effect Roll Call # 60",102,4,0,0,106
1723562,1334089,2023-05-25,Senate,"Reported Favorably Without Amendment",6,1,0,0,7
1723562,1342486,2023-06-08,Senate,"Senate Third Reading: Passed Roll Call # 340",26,12,0,0,38
1723562,1355334,2023-09-28,House,"Reported With Recommendation Without Amendment",8,1,0,0,9
1723562,1357246,2023-11-08,House,"House Third Reading: Given Immediate Effect Roll Call # 498",62,47,0,0,109
1723608,1469568,2024-11-13,Senate,"Reported Favorably Without Amendment",7,2,0,0,9
1723608,1469695,2024-12-04,Senate,"Senate Third Reading: Passed Roll Call # 436",20,16,0,2,38
1724394,1334086,2023-05-25,Senate,"Reported Favorably Without Amendment",7,0,0,0,7
1725011,1270891,2023-03-07,House,"Reported With Recommendation Without Amendment",12,0,0,0,12
1725046,1280376,2023-03-15,Senate,"Reported Favorably With Substitute S-1",10,0,0,0,10
1725046,1281575,2023-03-22,Senate,"Senate Third Reading: Passed Roll Call # 105",38,0,0,0,38
1725046,1331692,2023-05-16,House,"Reported With Recommendation Without Amendment",8,0,0,0,8
1725046,1347093,2023-06-22,House,"House Third Reading: Given Immediate Effect Roll Call # 211",105,4,0,0,109
1725100,1355816,2023-09-28,Senate,"Reported Favorably With Substitute S-1",9,0,0,0,9
1725100,1357154,2023-11-02,House,"Reported With Recommendation Without Amendment",11,1,0,0,12
1725100,1357308,2023-11-08,House,"House Third Reading: Given Immediate Effect Roll Call # 520",69,40,0,0,109
1725100,1363869,2023-10-10,Senate,"Senate Third Reading: Passed Roll Call # 506",38,0,0,0,38
1725115,1296039,2023-03-22,Senate,"Reported Favorably With Substitute S-3",12,0,0,0,12
1725115,1296040,2023-03-23,Senate,"Senate Third Reading: Passed Roll Call # 109",25,13,0,0,38
1725115,1344062,2023-06-13,House,"Reported With Recommendation With Substitute H-4",7,0,0,0,7
1725115,1348097,2023-06-21,House,"House Third Reading: Given Immediate Effect Roll Call # 202",71,38,0,0,109
1725115,1348738,2023-06-28,Senate,"Senate Third Reading: Roll Call: Roll Call # 428",25,12,0,1,38
1725134,1282957,2023-03-23,Senate,"Senate Third Reading: Passed Roll Call # 110",25,13,0,0,38
1725134,1295950,2023-03-22,Senate,"Reported Favorably Without Amendment",12,0,0,0,12
1725134,1344084,2023-06-13,House,"Reported With Recommendation Without Amendment",7,0,0,0,7
1725134,1348108,2023-06-21,House,"House Third Reading: Given Immediate Effect Roll Call # 203",72,37,0,0,109
1725151,1292202,2023-03-23,Senate,"Senate Third Reading: Passed Roll Call # 112",25,13,0,0,38
1725151,1295951,2023-03-22,Senate,"Reported Favorably Without Amendment",12,0,0,0,12
1725151,1346338,2023-06-21,House,"House Third Reading: Given Immediate Effect Roll Call # 205",72,37,0,0,109
1725151,1353097,2023-06-13,House,"Reported With Recommendation Without Amendment",7,0,0,0,7
1725169,1315832,2023-04-27,Senate,"Reported Favorably Without Amendment",8,0,0,0,8
1725169,1319203,2023-05-03,Senate,"Senate Third Reading: Passed Roll Call # 146",33,5,0,0,38
1725169,1363313,2023-09-13,House,"Reported With Recommendation With Substitute H-1",7,0,0,0,7
1725169,1469292,2024-11-13,House,"House Third Reading: Given Immediate Effect Roll Call # 343",69,40,0,0,109
1725169,1469919,2024-12-05,Senate,"Senate Third Reading: Roll Call: Roll Call # 466",28,8,0,2,38
1725187,1315810,2023-04-27,Senate,"Reported Favorably With Substitute S-1",8,0,0,0,8
1725187,1317954,2023-05-03,Senate,"Senate Third Reading: Passed Roll Call # 147",35,3,0,0,38
1725238,1333008,2023-05-24,Senate,"Reported Favorably Without Amendment",7,0,0,0,7
1725238,1347733,2023-06-08,Senate,"Senate Third Reading: Passed Roll Call # 329",38,0,0,0,38
1725238,1348233,2023-06-27,House,"Reported With Recommendation Without Amendment",12,0,0,0,12
1725238,1353339,2023-09-06,House,"House Third Reading: Given Immediate Effect Roll Call # 273",82,25,0,0,107
1725273,1333264,2023-05-24,Senate,"Reported Favorably Without Amendment",7,0,0,0,7
1725273,1342141,2023-06-08,Senate,"Senate Third Reading: Passed Roll Call # 330",38,0,0,0,38
1725273,1348238,2023-06-27,House,"Reported With Recommendation Without Amendment",12,0,0,0,12
1725273,1353340,2023-09-06,House,"House Third Reading: Given Immediate Effect Roll Call # 274",82,25,0,0,107
1725288,1280351,2023-03-15,Senate,"Reported Favorably Without Amendment",10,0,0,0,10
1725288,1281573,2023-03-22,Senate,"Senate Third Reading: Passed Roll Call # 104",38,0,0,0,38
1725288,1326145,2023-05-16,House,"Reported With Recommendation Without Amendment",8,0,0,0,8
1725288,1347037,2023-06-22,House,"House Third Reading: Given Immediate Effect Roll Call # 210",105,4,0,0,109
1725320,1292517,2023-03-23,Senate,"Senate Third Reading: Passed Roll Call # 111",25,13,0,0,38
1725320,1296030,2023-03-22,Senate,"Reported Favorably Without Amendment",12,0,0,0,12
1725320,1344121,2023-06-13,House,"Reported With Recommendation Without Amendment",7,0,0,0,7
1725320,1346337,2023-06-21,House,"House Third Reading: Given Immediate Effect Roll Call # 204",72,37,0,0,109
1725392,1343522,2023-06-06,House,"Reported With Recommendation With Substitute H-2",8,1,0,0,9
1725392,1347092,2023-06-14,House,"House Third Reading: Given Immediate Effect Roll Call # 157",56,53,0,0,109
1725422,1356992,2023-11-02,House,"House Third Reading: Given Immediate Effect Roll Call # 472",106,3,0,0,109
1725422,1439954,2023-05-23,House,"Reported With Recommendation With Substitute H-1",12,0,0,0,12
1725451,1348006,2023-06-06,House,"Reported With Recommendation Without Amendment",6,2,0,0,8
1725515,1470088,2024-12-03,House,"Reported With Recommendation With Substitute H-3",8,4,0,0,12
1725582,1282927,2023-03-21,House,"Reported With Recommendation Without Amendment",13,0,0,0,13
1725582,1298573,2023-04-11,House,"House Third Reading: Given Immediate Effect Roll Call # 50",103,5,0,0,108
1725614,1335830,2023-05-30,House,"Reported With Recommendation Without Amendment",9,0,0,0,9
1725614,1344359,2023-06-14,House,"House Third Reading: Given Immediate Effect Roll Call # 152",67,42,0,0,109
1725646,1470087,2024-12-03,House,"Reported With Recommendation Without Amendment",8,4,0,0,12
1725707,1363254,2023-10-12,House,"Reported With Recommendation With Substitute H-1",19,0,0,0,19
1725707,1436779,2024-04-30,House,"House Third Reading: Given Immediate Effect Roll Call # 43",103,6,0,0,109
1725776,1470047,2024-12-03,House,"Reported With Recommendation With Substitute H-2",8,4,0,0,12
1725810,1470050,2024-12-03,House,"Reported With Recommendation With Substitute H-5",8,4,0,0,12
1725840,1363300,2023-10-12,House,"Reported With Recommendation With Substitute H-1",19,0,0,0,19
1725840,1439952,2024-04-30,House,"House Third Reading: Given Immediate Effect Roll Call # 44",103,6,0,0,109
1725874,1281537,2023-03-21,House,"Reported With Recommendation With Substitute H-1",8,5,0,0,13
1725874,1281538,2023-03-21,House,"House Third Reading: Given Immediate Effect Roll Call # 35",63,45,0,0,108
1725874,1312207,2023-04-26,Senate,"Reported Favorably Without Amendment",5,2,0,0,7
1725874,1319276,2023-05-03,Senate,"Senate Third Reading: Passed Roll Call # 144",18,20,0,0,38
1725874,1327590,2023-05-03,Senate,"Senate Third Reading: Passed Roll Call # 145",20,18,0,0,38
1725905,1281085,2023-03-16,House,"Reported With Recommendation With Substitute H-3",19,0,0,0,19
1725905,1282143,2023-03-22,House,"House Third Reading: Given Immediate Effect Roll Call # 41",88,20,0,0,108
1725905,1364260,2023-11-08,Senate,"Reported Favorably With Substitute S-1",9,1,0,0,10
1725935,1469585,2024-12-03,House,"Reported With Recommendation Without Amendment",8,4,0,0,12
1728610,1344374,2023-06-14,Senate,"Reported Favorably Without Amendment",4,0,0,0,4
1728610,1348633,2023-06-28,Senate,"Senate Third Reading: Passed Roll Call # 425",31,6,0,1,38
1728610,1357311,2023-10-04,House,"Reported With Recommendation With Substitute H-2",8,2,0,0,10
1728610,1357660,2023-11-09,House,"House Third Reading: Given Immediate Effect Roll Call # 582",67,39,0,0,106
1728610,1357661,2023-11-09,Senate,"Senate Third Reading: Roll Call: Roll Call # 739",25,11,0,2,38
1728722,1280973,2023-03-21,Senate,"Reported Favorably Without Amendment",8,0,0,0,8
1728722,1281652,2023-03-22,Senate,"Senate Third Reading: Passed Roll Call # 107",37,1,0,0,38
1728722,1347995,2023-06-13,House,"Reported With Recommendation Without Amendment",14,0,0,0,14
1728722,1348629,2023-06-28,House,"House Third Reading: Given Immediate Effect Roll Call # 258",103,5,0,0,108
1728750,1277969,2023-03-16,Senate,"Reported Favorably With Substitute S-1",5,2,0,0,7
1728750,1277970,2023-03-16,Senate,"Senate Third Reading: Passed Roll Call # 95",20,17,0,1,38
1728750,1306068,2023-04-19,House,"Reported With Recommendation With Substitute H-1",8,5,0,0,13
1728750,1318108,2023-05-03,House,"House Third Reading: Passed Roll Call # 77",57,51,0,0,108
1728750,1318109,2023-05-03,House,"House Third Reading: Given Immediate Effect Roll Call # 78",56,52,0,0,108
1728750,1319933,2023-05-04,Senate,"Senate Third Reading: Roll Call: Roll Call # 156",20,18,0,0,38
1728806,1296163,2023-03-22,Senate,"Reported Favorably With Substitute S-1",9,1,0,0,10
1728806,1315303,2023-04-27,Senate,"Senate Third Reading: Passed Roll Call # 137",27,10,0,1,38
1728832,1348003,2023-06-14,Senate,"Reported Favorably Without Amendment",4,0,0,0,4
1728832,1348634,2023-06-28,Senate,"Senate Third Reading: Passed Roll Call # 424",27,10,0,1,38
1728832,1357314,2023-10-04,House,"Reported With Recommendation Without Amendment",8,2,0,0,10
1728832,1357480,2023-11-09,House,"House Third Reading: Given Immediate Effect Roll Call # 581",63,43,0,0,106
1728832,1357481,2023-11-09,Senate,"Senate Third Reading: Roll Call: Roll Call # 738",25,11,0,2,38
1729346,1331727,2023-05-18,House,"Reported With Recommendation Without Amendment",8,1,0,0,9
1729346,1356848,2023-10-31,House,"House Third Reading: Given Immediate Effect Roll Call # 420",81,29,0,0,110
1729355,1312185,2023-04-11,House,"Reported With Recommendation Without Amendment",15,0,0,0,15
1729355,1317349,2023-05-02,House,"House Third Reading: Given Immediate Effect Roll Call # 75",102,5,0,0,107
1729364,1331772,2023-05-17,House,"Reported With Recommendation Without Amendment",13,0,0,0,13
1729384,1325592,2023-05-10,House,"Reported With Recommendation With Substitute H-3",13,0,0,0,13
1729384,1329042,2023-05-18,House,"House Third Reading: Given Immediate Effect Roll Call # 117",103,4,0,0,107
1729384,1339495,2023-06-06,Senate,"Senate Third Reading: Given Immediate Effect Roll Call # 323",37,1,0,0,38
1729398,1331659,2023-05-18,House,"Reported With Recommendation With Substitute H-1",6,3,0,0,9
1729398,1356820,2023-10-31,House,"House Third Reading: Given Immediate Effect Roll Call # 419",56,54,0,0,110
1729398,1389492,2024-02-20,Senate,"Reported Favorably With Substitute S-1",10,4,0,0,14
1729398,1403614,2024-02-27,Senate,"Senate Third Reading: Passed Roll Call # 32",22,16,0,0,38
1729398,1447576,2024-05-21,House,"House Third Reading: Roll Call # 117",56,51,0,0,107
1729418,1312396,2023-04-11,House,"Reported With Recommendation With Substitute H-1",8,0,0,0,8
1729418,1344367,2023-06-14,House,"House Third Reading: Given Immediate Effect Roll Call # 156",73,36,0,0,109
1729428,1331716,2023-05-18,House,"Reported With Recommendation With Substitute H-2",9,0,0,0,9
1729428,1356809,2023-10-31,House,"House Third Reading: Given Immediate Effect Roll Call # 416",73,37,0,0,110
1729428,1389507,2024-02-20,Senate,"Reported Favorably Without Amendment",9,5,0,0,14
1729428,1402714,2024-02-27,Senate,"Senate Third Reading: Passed Roll Call # 30",20,18,0,0,38
1729441,1331714,2023-05-17,House,"Reported With Recommendation Without Amendment",13,0,0,0,13
1729461,1331722,2023-05-17,House,"Reported With Recommendation Without Amendment",13,0,0,0,13
1729475,1355219,2023-09-19,House,"Reported With Recommendation Without Amendment",13,0,0,0,13
1729475,1355532,2023-09-27,House,"House Third Reading: Given Immediate Effect Roll Call # 313",106,4,0,0,110
1729475,1411927,2024-03-19,Senate,"Reported Favorably Without Amendment",10,0,0,0,10
1729475,1411928,2024-03-19,Senate,"Senate Third Reading: Given Immediate Effect Roll Call # 67",37,0,0,1,38
1729487,1354985,2023-09-19,House,"Reported With Recommendation Without Amendment",9,1,0,0,10
1729487,1458843,2024-06-20,House,"House Third Reading: Given Immediate Effect Roll Call # 200",56,53,0,0,109
1729487,1469518,2024-11-26,Senate,"Reported Favorably Without Amendment",6,1,0,0,7
1729509,1348225,2023-06-27,House,"Reported With Recommendation With Substitute H-1",16,0,0,0,16
1729509,1354459,2023-09-12,House,"House Third Reading: Given Immediate Effect Roll Call # 276",67,42,0,0,109
1729509,1354938,2023-09-19,Senate,"Senate Third Reading: Given Immediate Effect Roll Call # 452",27,10,0,1,38
1729518,1331717,2023-05-18,House,"Reported With Recommendation Without Amendment",8,1,0,0,9
1729518,1356849,2023-10-31,House,"House Third Reading: Given Immediate Effect Roll Call # 417",72,38,0,0,110
1729518,1389520,2024-02-20,Senate,"Reported Favorably With Substitute S-1",13,1,0,0,14
1729518,1396630,2024-02-27,Senate,"Senate Third Reading: Passed Roll Call # 31",21,17,0,0,38
1729518,1445744,2024-05-21,House,"House Third Reading: Roll Call # 116",68,39,0,0,107
1729532,1470229,2024-12-11,House,"Reported With Recommendation With Substitute H-1",7,5,0,0,12
1729542,1337443,2023-05-30,House,"Reported With Recommendation With Substitute H-1",12,0,0,0,12
1729542,1341812,2023-06-08,House,"House Third Reading: Given Immediate Effect Roll Call # 144",103,4,0,0,107
1729542,1357671,2023-11-09,Senate,"Reported Favorably Without Amendment",11,0,0,0,11
1729542,1400980,2023-11-09,Senate,"Senate Third Reading: Passed Roll Call # 724",37,0,0,1,38
1729563,1312436,2023-04-11,House,"Reported With Recommendation With Substitute H-1",8,0,0,0,8
1729563,1344365,2023-06-14,House,"House Third Reading: Given Immediate Effect Roll Call # 153",73,36,0,0,109
1729575,1331723,2023-05-18,House,"Reported With Recommendation Without Amendment",9,0,0,0,9
1729575,1356839,2023-10-31,House,"House Third Reading: Given Immediate Effect Roll Call # 421",83,27,0,0,110
1729575,1389442,2024-02-20,Senate,"Reported Favorably Without Amendment",13,1,0,0,14
1729575,1397674,2024-02-27,Senate,"Senate Third Reading: Passed Roll Call # 33",27,11,0,0,38
1729585,1278763,2023-03-15,House,"Reported With Recommendation Without Amendment",8,0,0,0,8
1729585,1282160,2023-03-22,House,"House Third Reading: Given Immediate Effect Roll Call # 39",102,6,0,0,108
1729585,1310979,2023-04-20,Senate,"Reported Favorably Without Amendment",4,0,0,0,4
1729585,1313268,2023-04-27,Senate,"Senate Third Reading: Given Immediate Effect Roll Call # 140",37,0,0,1,38
1729597,1304889,2023-03-21,House,"Reported With Recommendation Without Amendment",12,0,0,0,12
1729597,1306350,2023-04-19,House,"House Third Reading: Given Immediate Effect Roll Call # 59",103,5,0,0,108
1729597,1331790,2023-05-23,Senate,"Reported Favorably Without Amendment",6,0,0,0,6
1729597,1347976,2023-06-27,Senate,"Senate Third Reading: Given Immediate Effect Roll Call # 398",37,0,0,1,38
1729609,1331759,2023-05-17,House,"Reported With Recommendation Without Amendment",13,0,0,0,13
1729621,1331731,2023-05-18,House,"Reported With Recommendation Without Amendment",8,1,0,0,9
1729621,1356816,2023-10-31,House,"House Third Reading: Given Immediate Effect Roll Call # 418",68,42,0,0,110
1729631,1312243,2023-04-11,House,"Reported With Recommendation With Substitute H-1",8,0,0,0,8
1729631,1344356,2023-06-14,House,"House Third Reading: Given Immediate Effect Roll Call # 155",74,35,0,0,109
1729642,1312340,2023-04-11,House,"Reported With Recommendation With Substitute H-1",8,0,0,0,8
1729642,1344547,2023-06-14,House,"House Third Reading: Given Immediate Effect Roll Call # 154",73,36,0,0,109
1729651,1332164,2023-05-17,House,"Reported With Recommendation Without Amendment",13,0,0,0,13
1730122,1330296,2023-05-18,Senate,"Reported Favorably Without Amendment",7,0,0,0,7
1730122,1331697,2023-05-23,Senate,"Senate Third Reading: Passed Roll Call # 316",36,2,0,0,38
1730122,1356287,2023-10-18,House,"Reported With Recommendation Without Amendment",12,0,0,0,12
1730122,1465391,2024-06-27,House,"House Third Reading: Given Immediate Effect Roll Call # 266",104,6,0,0,110
1730767,1346570,2023-06-20,House,"Reported With Recommendation With Substitute H-1",5,1,0,0,6
1730767,1356058,2023-09-27,House,"House Third Reading: Given Immediate Effect Roll Call # 320",56,54,0,0,110
1730804,1357302,2023-10-31,House,"Reported With Recommendation With Substitute H-1",11,0,0,0,11
1730804,1357492,2023-11-09,House,"House Third Reading: Given Immediate Effect Roll Call # 561",75,32,0,0,107
1730804,1425008,2024-03-14,Senate,"Reported Favorably With Substitute S-1",10,0,0,0,10
1730804,1443626,2024-05-15,Senate,"Senate Third Reading: Passed Roll Call # 196",35,1,0,2,38
1730804,1445735,2024-05-21,House,"House Third Reading: Roll Call # 114",98,9,0,0,107
1730908,1277505,2023-03-14,House,"Reported With Recommendation Without Amendment",12,0,0,0,12
1730908,1277506,2023-03-16,House,"House Third Reading: Given Immediate Effect Roll Call # 32",93,10,0,0,103
1730908,1306358,2023-04-19,Senate,"Senate Third Reading: Given Immediate Effect Roll Call # 120",29,9,0,0,38
1731492,1278237,2023-03-16,Senate,"Senate Third Reading: Passed Roll Call # 97",36,1,0,1,38
1731543,1277689,2023-03-16,Senate,"Senate Third Reading: Passed Roll Call # 96",36,1,0,1,38
1731570,1295970,2023-03-22,Senate,"Reported Favorably With Substitute S-1",7,0,0,0,7
1731570,1308181,2023-04-19,Senate,"Senate Third Reading: Passed Roll Call # 121",37,1,0,0,38
1731570,1331661,2023-05-16,House,"Reported With Recommendation With Substitute H-1",13,0,0,0,13
1731570,1346943,2023-06-22,House,"House Third Reading: Given Immediate Effect Roll Call # 212",109,0,0,0,109
1731570,1348095,2023-06-27,Senate,"Senate Third Reading: Roll Call: Roll Call # 388",36,1,0,1,38
1731600,1354975,2023-09-19,Senate,"Reported Favorably With Substitute S-2",3,1,0,0,4
1731600,1469118,2024-10-30,Senate,"Senate Third Reading: Passed Roll Call # 397",25,12,0,1,38
1731655,1355008,2023-09-19,Senate,"Reported Favorably With Substitute S-1",3,1,0,0,4
1731655,1469136,2024-10-30,Senate,"Senate Third Reading: Passed Roll Call # 398",25,12,0,1,38
1731655,1470395,2024-12-12,House,"Reported With Recommendation Without Amendment",7,0,0,0,7
1731736,1296064,2023-03-22,Senate,"Reported Favorably With Substitute S-2",7,0,0,0,7
1731736,1308228,2023-04-19,Senate,"Senate Third Reading: Passed Roll Call # 122",38,0,0,0,38
1731736,1331538,2023-05-16,House,"Reported With Recommendation With Substitute H-1",13,0,0,0,13
1731736,1347660,2023-06-22,House,"House Third Reading: Given Immediate Effect Roll Call # 213",109,0,0,0,109
1731736,1350104,2023-06-27,Senate,"Senate Third Reading: Roll Call: Roll Call # 389",37,0,0,1,38
1731761,1325204,2023-05-09,Senate,"Reported Favorably Without Amendment",9,1,0,0,10
1731761,1331724,2023-05-17,Senate,"Senate Third Reading: Passed Roll Call # 296",20,18,0,0,38
1731761,1345791,2023-06-13,House,"Reported With Recommendation With Substitute H-1",12,0,0,0,12
1731761,1347088,2023-06-22,House,"House Third Reading: Given Immediate Effect Roll Call # 216",75,34,0,0,109
1731761,1348001,2023-06-27,Senate,"Senate Third Reading: Roll Call: Roll Call # 390",22,15,0,1,38
1731813,1278246,2023-03-16,Senate,"Senate Third Reading: Passed Roll Call # 98",36,1,0,1,38
1731813,1312220,2023-04-26,House,"House Third Reading: Given Immediate Effect Roll Call # 69",92,16,0,0,108
1731839,1309538,2023-04-20,House,"Reported With Recommendation With Substitute H-2",12,0,0,0,12
1731839,1317393,2023-05-02,House,"House Third Reading: Given Immediate Effect Roll Call # 74",68,39,0,0,107
1731839,1321820,2023-05-09,Senate,"Reported Favorably Without Amendment",13,6,0,0,19
1731839,1324444,2023-05-10,Senate,"Senate Third Reading: Given Immediate Effect Roll Call # 227",27,11,0,0,38
1731839,1350962,2023-05-11,House,"House Third Reading: Senate Amendment(s) Concurred In Roll Call # 105",70,37,0,0,107
1731851,1326256,2023-05-16,House,"Reported With Recommendation With Substitute H-1",6,2,0,0,8
1731851,1356901,2023-11-01,House,"House Third Reading: Given Immediate Effect Roll Call # 457",56,54,0,0,110
1731851,1399664,2023-11-09,Senate,"Senate Third Reading: Passed Roll Call # 733",20,16,0,2,38
1731864,1312240,2023-04-26,House,"Reported With Recommendation With Substitute H-1",17,2,0,0,19
1731864,1323149,2023-05-10,House,"House Third Reading: Given Immediate Effect Roll Call # 96",56,52,0,0,108
1731958,1319279,2023-05-04,House,"Reported With Recommendation With Substitute H-1",17,3,0,0,20
1731958,1323144,2023-05-10,House,"House Third Reading: Given Immediate Effect Roll Call # 88",56,52,0,0,108
1731958,1327265,2023-05-17,Senate,"Senate Third Reading: Passed Roll Call # 299",20,18,0,0,38
1731958,1340394,2023-06-06,House,"House Third Reading: Roll Call # 131",52,54,0,0,106
1732001,1319241,2023-05-04,House,"Reported With Recommendation With Substitute H-3",17,6,0,0,23
1732001,1323119,2023-05-10,House,"House Third Reading: Given Immediate Effect Roll Call # 92",56,52,0,0,108
1732033,1312210,2023-03-23,House,"Reported With Recommendation Without Amendment",12,7,0,0,19
1732033,1469280,2024-11-13,House,"House Third Reading: Given Immediate Effect Roll Call # 344",56,53,0,0,109
1732033,1470695,2024-12-11,Senate,"Reported Favorably Without Amendment",8,2,0,0,10
1732060,1355207,2023-09-26,Senate,"Reported Favorably Without Amendment",3,1,0,0,4
1732101,1326265,2023-05-16,House,"Reported With Recommendation Without Amendment",6,2,0,0,8
1732101,1356892,2023-11-01,House,"House Third Reading: Given Immediate Effect Roll Call # 456",56,54,0,0,110
1732101,1402503,2023-11-09,Senate,"Senate Third Reading: Passed Roll Call # 732",20,16,0,2,38
1732115,1312227,2023-04-26,House,"Reported With Recommendation With Substitute H-2",17,3,0,0,20
1732115,1323152,2023-05-10,House,"House Third Reading: Given Immediate Effect Roll Call # 97",56,52,0,0,108
1732115,1327264,2023-05-17,Senate,"Senate Third Reading: Passed Roll Call # 298",20,18,0,0,38
1732115,1340531,2023-06-06,House,"House Third Reading: Roll Call # 130",51,54,0,0,105
1732186,1363243,2023-09-19,Senate,"Reported Favorably With Substitute S-1",3,1,0,0,4
1732186,1469138,2024-10-30,Senate,"Senate Third Reading: Passed Roll Call # 396",25,12,0,1,38
1732186,1470339,2024-12-12,House,"Reported With Recommendation Without Amendment",7,0,0,0,7
1732211,1312234,2023-04-26,House,"Reported With Recommendation With Substitute H-2",17,12,0,0,29
1732211,1323139,2023-05-10,House,"House Third Reading: Given Immediate Effect Roll Call # 84",56,52,0,0,108
1732254,1309463,2023-04-20,House,"Reported With Recommendation With Substitute H-2",12,0,0,0,12
1732254,1317387,2023-05-02,House,"House Third Reading: Given Immediate Effect Roll Call # 73",66,41,0,0,107
1732254,1322663,2023-05-09,Senate,"Reported Favorably Without Amendment",13,6,0,0,19
1732254,1324332,2023-05-10,Senate,"Senate Third Reading: Given Immediate Effect Roll Call # 226",27,11,0,0,38
1732254,1350945,2023-05-11,House,"House Third Reading: Senate Amendment(s) Concurred In Roll Call # 104",69,38,0,0,107
1732323,1332017,2023-05-11,House,"Reported With Recommendation With Substitute H-1",7,2,0,0,9
1732323,1345548,2023-06-20,House,"House Third Reading: Given Immediate Effect Roll Call # 182",56,53,0,0,109
1732323,1348588,2023-06-28,Senate,"Reported Favorably Without Amendment",9,0,0,0,9
1732323,1348589,2023-06-28,Senate,"Senate Third Reading: Passed Roll Call # 438",21,16,0,1,38
1732348,1312239,2023-04-26,House,"Reported With Recommendation With Substitute H-1",18,0,0,0,18
1732348,1323150,2023-05-10,House,"House Third Reading: Given Immediate Effect Roll Call # 95",56,52,0,0,108
1732348,1327268,2023-05-17,Senate,"Senate Third Reading: Passed Roll Call # 297",20,18,0,0,38
1732348,1340407,2023-06-06,House,"House Third Reading: Roll Call # 129",51,54,0,0,105
1732374,1355209,2023-09-26,Senate,"Reported Favorably Without Amendment",3,1,0,0,4
1732374,1470448,2024-12-12,Senate,"Senate Third Reading: Passed Roll Call # 559",20,15,0,3,38
1732390,1331703,2023-05-23,Senate,"Reported Favorably With Substitute S-2",3,1,0,0,4
1732390,1342516,2023-06-08,Senate,"Senate Third Reading: Passed Roll Call # 337",20,18,0,0,38
1732390,1357336,2023-10-26,House,"Reported With Recommendation Without Amendment",7,3,0,0,10
1732390,1357925,2023-11-09,House,"House Third Reading: Given Immediate Effect Roll Call # 567",56,51,0,0,107
1732402,1309480,2023-04-20,House,"Reported With Recommendation With Substitute H-3",12,0,0,0,12
1732402,1317355,2023-05-02,House,"House Third Reading: Given Immediate Effect Roll Call # 72",68,39,0,0,107
1732402,1322551,2023-05-09,Senate,"Reported Favorably Without Amendment",13,6,0,0,19
1732402,1324470,2023-05-10,Senate,"Senate Third Reading: Given Immediate Effect Roll Call # 225",27,11,0,0,38
1732402,1350929,2023-05-11,House,"House Third Reading: Senate Amendment(s) Concurred In Roll Call # 103",71,36,0,0,107
1732414,1277173,2023-03-15,House,"Reported With Recommendation With Substitute H-1",9,2,0,0,11
1732414,1277174,2023-03-16,House,"House Third Reading: Given Immediate Effect Roll Call # 30",88,15,0,0,103
1732414,1281031,2023-03-21,Senate,"Senate Third Reading: Given Immediate Effect Roll Call # 103",35,1,0,2,38
1732425,1312228,2023-04-26,House,"Reported With Recommendation Without Amendment",26,0,0,0,26
1732425,1318318,2023-05-03,House,"House Third Reading: Given Immediate Effect Roll Call # 76",95,13,0,0,108
1739517,1319178,2023-05-04,Senate,"Reported Favorably With Substitute S-3",13,6,0,0,19
1739517,1325153,2023-05-11,Senate,"Senate Third Reading: Passed Roll Call # 289",20,17,0,1,38
1739517,1327262,2023-05-17,House,"House Third Reading: Given Immediate Effect Roll Call # 107",56,51,0,0,107
1739517,1335238,2023-05-23,Senate,"Senate Third Reading: Roll Call: Roll Call # 306",0,38,0,0,38
1739517,1350888,2023-06-28,Senate,"Senate Third Reading: Senate Adopted Conference Report With Immediate Effect Roll Call # 446",29,8,0,1,38
1739517,1353586,2023-06-28,House,"House Third Reading: Conference Report Adopted Roll Call # 268",58,50,0,0,108
1739532,1348050,2023-06-21,Senate,"Reported Favorably With Substitute S-3",8,0,0,0,8
1739532,1348785,2023-06-28,Senate,"Senate Third Reading: Passed Roll Call # 420",37,0,0,1,38
1739532,1355308,2023-09-19,House,"Reported With Recommendation With Amendment(s)",8,0,0,0,8
1739532,1355340,2023-09-28,House,"House Third Reading: Given Immediate Effect Roll Call # 325",103,5,0,0,108
1739532,1355786,2023-10-03,Senate,"Senate Third Reading: House Amendment(s) Concurred In Roll Call # 486",38,0,0,0,38
1739549,1356178,2023-10-05,Senate,"Reported Favorably With Substitute S-1",6,2,0,0,8
1739549,1356325,2023-10-19,Senate,"Senate Third Reading: Passed Roll Call # 556",21,17,0,0,38
1739549,1357309,2023-11-08,House,"Reported With Recommendation With Substitute H-1",7,4,0,0,11
1739549,1460949,2024-06-26,Senate,"Senate Third Reading: Roll Call: Roll Call # 319",20,18,0,0,38
1739549,1461340,2024-06-26,House,"House Third Reading: Given Immediate Effect Roll Call # 255",56,54,0,0,110
1739565,1324081,2023-05-11,Senate,"Senate Third Reading: Passed Roll Call # 263",20,18,0,0,38
1739565,1356841,2023-10-25,House,"House Third Reading: Given Immediate Effect Roll Call # 411",56,53,0,0,109
1739565,1356842,2023-10-26,Senate,"Senate Third Reading: Roll Call: Roll Call # 593",3,35,0,0,38
1739565,1357884,2023-11-02,Senate,"Senate Third Reading: Senate Adopted Conference Report Roll Call # 642",20,18,0,0,38
1739565,1370799,2023-11-02,House,"House Third Reading: Conference Report Adopted Roll Call # 482",56,52,0,0,108
1739603,1319418,2023-05-04,Senate,"Reported Favorably With Substitute S-2",13,6,0,0,19
1739603,1323135,2023-05-10,Senate,"Senate Third Reading: Passed Roll Call # 202",20,18,0,0,38
1739603,1327267,2023-05-17,House,"House Third Reading: Given Immediate Effect Roll Call # 108",56,51,0,0,107
1739603,1335170,2023-05-23,Senate,"Senate Third Reading: Roll Call: Roll Call # 307",0,38,0,0,38
1739920,1331653,2023-05-23,House,"Reported With Recommendation Without Amendment",12,0,0,0,12
1739920,1402622,2024-02-28,House,"House Third Reading: Given Immediate Effect Roll Call # 17",100,6,0,0,106
1739974,1356850,2023-09-13,House,"Reported With Recommendation With Substitute H-1",13,0,0,0,13
1739974,1356872,2023-11-01,House,"House Third Reading: Given Immediate Effect Roll Call # 458",106,4,0,0,110
1739994,1312242,2023-04-26,House,"Reported With Recommendation With Substitute H-3",17,11,0,0,28
1739994,1323151,2023-05-10,House,"House Third Reading: Given Immediate Effect Roll Call # 93",56,52,0,0,108
1740001,1356867,2023-09-13,House,"Reported With Recommendation With Substitute H-3",13,0,0,0,13
1740001,1356868,2023-11-01,House,"House Third Reading: Given Immediate Effect Roll Call # 459",106,4,0,0,110
1740049,1331654,2023-05-23,House,"Reported With Recommendation Without Amendment",14,0,0,0,14
1740049,1343434,2023-06-08,House,"House Third Reading: Given Immediate Effect Roll Call # 143",93,14,0,0,107
1740049,1356292,2023-10-11,Senate,"Reported Favorably With Substitute S-3",10,0,0,0,10
1740049,1356426,2023-10-24,Senate,"Senate Third Reading: Passed Roll Call # 580",28,10,0,0,38
1740049,1357265,2023-11-08,House,"House Third Reading: Roll Call # 502",96,12,0,0,108
1740123,1312226,2023-04-26,House,"Reported With Recommendation With Substitute H-1",17,7,0,0,24
1740123,1323156,2023-05-10,House,"House Third Reading: Given Immediate Effect Roll Call # 94",56,52,0,0,108
1740123,1327259,2023-05-17,Senate,"Senate Third Reading: Passed Roll Call # 300",20,18,0,0,38
1740123,1340421,2023-06-06,House,"House Third Reading: Roll Call # 132",52,54,0,0,106
1740139,1356463,2023-10-19,House,"Reported With Recommendation With Substitute H-3",17,0,0,0,17
1740139,1357292,2023-10-25,House,"House Third Reading: Given Immediate Effect Roll Call # 410",105,4,0,0,109
1740139,1400312,2023-11-09,Senate,"Senate Third Reading: Passed Roll Call # 731",36,0,0,2,38
1741672,1315811,2023-04-27,Senate,"Reported Favorably With Substitute S-2",13,6,0,0,19
1741672,1323102,2023-05-09,Senate,"Senate Third Reading: Passed Roll Call # 159",21,17,0,0,38
1741680,1317447,2023-04-27,Senate,"Reported Favorably With Substitute S-1",13,6,0,0,19
1741680,1322660,2023-05-09,Senate,"Senate Third Reading: Passed Roll Call # 185",20,18,0,0,38
1741689,1317747,2023-05-02,Senate,"Reported Favorably Without Amendment",10,0,0,0,10
1741689,1347027,2023-06-14,Senate,"Senate Third Reading: Passed By 3/4 Vote Roll Call # 347",29,9,0,0,38
1741689,1355858,2023-10-05,House,"House Third Reading: Given Immediate Effect Roll Call # 341",91,15,0,0,106
1741689,1356425,2023-10-03,House,"Reported With Recommendation Without Amendment",14,0,0,0,14
1741723,1317411,2023-04-27,Senate,"Reported Favorably With Substitute S-1",13,6,0,0,19
1741723,1322656,2023-05-09,Senate,"Senate Third Reading: Passed Roll Call # 183",20,18,0,0,38
1741723,1331427,2023-05-17,House,"House Third Reading: Given Immediate Effect Roll Call # 113",56,51,0,0,107
1741723,1335293,2023-05-23,Senate,"Senate Third Reading: Roll Call: Roll Call # 310",0,38,0,0,38
1741744,1319423,2023-05-04,Senate,"Reported Favorably With Substitute S-4",13,6,0,0,19
1741744,1323136,2023-05-10,Senate,"Senate Third Reading: Passed Roll Call # 224",20,18,0,0,38
1741744,1327109,2023-05-17,House,"House Third Reading: Given Immediate Effect Roll Call # 111",56,51,0,0,107
1741744,1335277,2023-05-23,Senate,"Senate Third Reading: Roll Call: Roll Call # 313",0,38,0,0,38
1741752,1319402,2023-05-04,Senate,"Reported Favorably With Substitute S-5",13,6,0,0,19
1741752,1324262,2023-05-10,Senate,"Senate Third Reading: Passed Roll Call # 214",20,18,0,0,38
1741770,1319398,2023-05-04,Senate,"Reported Favorably With Substitute S-3",13,6,0,0,19
1741770,1324196,2023-05-10,Senate,"Senate Third Reading: Passed Roll Call # 193",20,18,0,0,38
1741770,1327806,2023-05-17,House,"House Third Reading: Given Immediate Effect Roll Call # 115",56,51,0,0,107
1741770,1335276,2023-05-23,Senate,"Senate Third Reading: Roll Call: Roll Call # 314",0,38,0,0,38
1741778,1317452,2023-04-27,Senate,"Reported Favorably With Substitute S-1",13,6,0,0,19
1741778,1322839,2023-05-09,Senate,"Senate Third Reading: Passed Roll Call # 167",20,18,0,0,38
1741787,1317457,2023-05-02,Senate,"Reported Favorably With Substitute S-1",10,0,0,0,10
1741787,1346932,2023-06-14,Senate,"Senate Third Reading: Passed By 3/4 Vote Roll Call # 348",29,9,0,0,38
1741787,1355857,2023-10-05,House,"House Third Reading: Given Immediate Effect Roll Call # 342",90,15,0,0,105
1741787,1356444,2023-10-03,House,"Reported With Recommendation Without Amendment",14,0,0,0,14
1741797,1322679,2023-05-09,Senate,"Reported Favorably With Substitute S-3",13,6,0,0,19
1741797,1324431,2023-05-11,Senate,"Senate Third Reading: Passed Roll Call # 257",17,21,0,0,38
1741797,1324432,2023-05-11,Senate,"Senate Third Reading: Passed Roll Call # 262",20,18,0,0,38
1741797,1325217,2023-05-11,Senate,"Senate Third Reading: Passed Roll Call # 261",21,17,0,0,38
1741797,1326822,2023-05-17,House,"House Third Reading: Given Immediate Effect Roll Call # 109",56,51,0,0,107
1741797,1335080,2023-05-23,Senate,"Senate Third Reading: Roll Call: Roll Call # 309",0,38,0,0,38
1741804,1319415,2023-05-04,Senate,"Reported Favorably With Substitute S-1",13,6,0,0,19
1741804,1324052,2023-05-10,Senate,"Senate Third Reading: Passed Roll Call # 198",20,18,0,0,38
1741804,1327721,2023-05-17,House,"House Third Reading: Given Immediate Effect Roll Call # 112",56,51,0,0,107
1741804,1335338,2023-05-23,Senate,"Senate Third Reading: Roll Call: Roll Call # 308",1,37,0,0,38
1741812,1317720,2023-05-02,Senate,"Reported Favorably With Substitute S-3",13,6,0,0,19
1741812,1321695,2023-05-09,Senate,"Senate Third Reading: Passed Roll Call # 174",20,18,0,0,38
1741824,1319416,2023-05-04,Senate,"Reported Favorably With Substitute S-1",13,6,0,0,19
1741824,1323385,2023-05-10,Senate,"Senate Third Reading: Passed Roll Call # 197",20,18,0,0,38
1741832,1317458,2023-04-27,Senate,"Reported Favorably With Substitute S-1",13,6,0,0,19
1741832,1322649,2023-05-09,Senate,"Senate Third Reading: Passed Roll Call # 178",20,18,0,0,38
1741842,1319205,2023-05-04,Senate,"Reported Favorably With Substitute S-3",13,6,0,0,19
1741842,1324340,2023-05-10,Senate,"Senate Third Reading: Passed Roll Call # 207",20,18,0,0,38
1741842,1327396,2023-05-17,House,"House Third Reading: Given Immediate Effect Roll Call # 114",56,51,0,0,107
1741842,1335340,2023-05-23,Senate,"Senate Third Reading: Roll Call: Roll Call # 311",0,38,0,0,38
1741850,1310780,2023-04-25,Senate,"Reported Favorably With Substitute S-5",3,1,0,0,4
1741850,1312260,2023-04-26,Senate,"Senate Third Reading: Passed Roll Call # 135",20,17,0,1,38
1741850,1357335,2023-09-28,House,"Reported With Recommendation Without Amendment",7,3,0,0,10
1741850,1357926,2023-11-09,House,"House Third Reading: Given Immediate Effect Roll Call # 570",56,51,0,0,107
1741857,1316643,2023-04-27,Senate,"Reported Favorably With Substitute S-2",13,6,0,0,19
1741857,1323463,2023-05-10,Senate,"Senate Third Reading: Passed Roll Call # 254",20,18,0,0,38
1741857,1327769,2023-05-17,House,"House Third Reading: Given Immediate Effect Roll Call # 110",56,51,0,0,107
1741857,1335267,2023-05-23,Senate,"Senate Third Reading: Roll Call: Roll Call # 312",1,37,0,0,38
1741877,1321717,2023-05-09,Senate,"Reported Favorably With Substitute S-1",13,6,0,0,19
1741877,1324241,2023-05-10,Senate,"Senate Third Reading: Passed Roll Call # 245",20,18,0,0,38
1742235,1312236,2023-04-26,House,"Reported With Recommendation With Substitute H-1",17,12,0,0,29
1742235,1323146,2023-05-10,House,"House Third Reading: Given Immediate Effect Roll Call # 85",56,52,0,0,108
1742235,1327835,2023-05-17,Senate,"Senate Third Reading: Passed Roll Call # 301",20,18,0,0,38
1742235,1340419,2023-06-06,House,"House Third Reading: Roll Call # 133",52,54,0,0,106
1742272,1311421,2023-04-26,House,"Reported With Recommendation With Substitute H-3",16,7,0,0,23
1742272,1323145,2023-05-10,House,"House Third Reading: Given Immediate Effect Roll Call # 86",56,52,0,0,108
1742272,1327261,2023-05-17,Senate,"Senate Third Reading: Passed Roll Call # 302",21,17,0,0,38
1742272,1340572,2023-06-06,House,"House Third Reading: Roll Call # 134",52,54,0,0,106
1742304,1281010,2023-03-21,House,"Reported With Recommendation Without Amendment",8,5,0,0,13
1742304,1281011,2023-03-21,House,"House Third Reading: Given Immediate Effect Roll Call # 36",57,51,0,0,108
1742337,1319285,2023-05-04,House,"Reported With Recommendation With Substitute H-2",17,4,0,0,21
1742337,1323155,2023-05-10,House,"House Third Reading: Given Immediate Effect Roll Call # 81",56,52,0,0,108
1742362,1319339,2023-05-04,House,"Reported With Recommendation With Substitute H-2",17,5,0,0,22
1742362,1323123,2023-05-10,House,"House Third Reading: Given Immediate Effect Roll Call # 80",56,52,0,0,108
1742953,1346408,2023-06-21,Senate,"Reported Favorably With Substitute S-2",5,1,0,0,6
1742953,1346554,2023-06-22,Senate,"Senate Third Reading: Passed Roll Call # 371",34,3,0,1,38
1742990,1346409,2023-06-21,Senate,"Reported Favorably Without Amendment",5,1,0,0,6
1742990,1346557,2023-06-22,Senate,"Senate Third Reading: Passed Roll Call # 374",37,0,0,1,38
1743002,1346436,2023-06-21,Senate,"Reported Favorably Without Amendment",6,0,0,0,6
1743002,1346574,2023-06-22,Senate,"Senate Third Reading: Passed Roll Call # 376",37,0,0,1,38
1743015,1344840,2023-06-14,Senate,"Reported Favorably Without Amendment",7,3,0,0,10
1743015,1355909,2023-10-11,Senate,"Senate Third Reading: Passed Roll Call # 514",20,18,0,0,38
1743015,1443550,2024-05-15,House,"Reported With Recommendation With Substitute H-1",7,5,0,0,12
1743015,1461732,2024-06-27,House,"House Third Reading: Given Immediate Effect Roll Call # 264",56,54,0,0,110
1743015,1467632,2024-09-26,Senate,"Senate Third Reading: Roll Call: Roll Call # 357",20,17,0,1,38
1743024,1346411,2023-06-21,Senate,"Reported Favorably With Substitute S-2",5,1,0,0,6
1743024,1346558,2023-06-22,Senate,"Senate Third Reading: Passed Roll Call # 370",36,0,1,1,38
1743024,1348661,2023-06-28,House,"House Third Reading: Given Immediate Effect Roll Call # 249",103,5,0,0,108
1743024,1350867,2023-06-28,Senate,"Senate Third Reading: Roll Call: Roll Call # 429",36,0,1,1,38
1743033,1346492,2023-06-21,Senate,"Reported Favorably With Substitute S-1",5,1,0,0,6
1743033,1346766,2023-06-22,Senate,"Senate Third Reading: Passed Roll Call # 372",35,2,0,1,38
1743033,1348617,2023-06-28,House,"House Third Reading: Given Immediate Effect Roll Call # 250",103,5,0,0,108
1743033,1348618,2023-06-28,Senate,"Senate Third Reading: Roll Call: Roll Call # 430",36,1,0,1,38
1743049,1346509,2023-06-21,Senate,"Reported Favorably Without Amendment",5,0,0,0,5
1743049,1346803,2023-06-22,Senate,"Senate Third Reading: Passed Roll Call # 375",37,0,0,1,38
1743049,1348623,2023-06-28,House,"House Third Reading: Given Immediate Effect Roll Call # 252",103,5,0,0,108
1743058,1348084,2023-06-14,Senate,"Reported Favorably Without Amendment",7,3,0,0,10
1743058,1355913,2023-10-11,Senate,"Senate Third Reading: Passed Roll Call # 513",20,18,0,0,38
1743058,1443555,2024-05-15,House,"Reported With Recommendation With Substitute H-1",7,5,0,0,12
1743058,1461729,2024-06-27,House,"House Third Reading: Given Immediate Effect Roll Call # 263",56,54,0,0,110
1743058,1468607,2024-09-26,Senate,"Senate Third Reading: Roll Call: Roll Call # 356",20,17,0,1,38
1743079,1346414,2023-06-21,Senate,"Reported Favorably With Substitute S-2",5,0,0,0,5
1743079,1346564,2023-06-22,Senate,"Senate Third Reading: Passed Roll Call # 373",37,0,0,1,38
1743079,1348680,2023-06-28,House,"House Third Reading: Given Immediate Effect Roll Call # 251",103,5,0,0,108
1743090,1346537,2023-06-21,Senate,"Reported Favorably With Substitute S-2",5,1,0,0,6
1743090,1346538,2023-06-22,Senate,"Senate Third Reading: Passed Roll Call # 378",31,5,0,2,38
1743101,1348077,2023-06-14,Senate,"Reported Favorably Without Amendment",7,3,0,0,10
1743101,1355906,2023-10-11,Senate,"Senate Third Reading: Passed Roll Call # 515",20,18,0,0,38
1743101,1443557,2024-05-15,House,"Reported With Recommendation With Substitute H-1",7,5,0,0,12
1743101,1465392,2024-06-27,House,"House Third Reading: Given Immediate Effect Roll Call # 265",56,54,0,0,110
1743101,1467642,2024-09-26,Senate,"Senate Third Reading: Roll Call: Roll Call # 358",20,17,0,1,38
1743111,1346548,2023-06-21,Senate,"Reported Favorably Without Amendment",6,0,0,0,6
1743111,1346549,2023-06-22,Senate,"Senate Third Reading: Passed Roll Call # 379",36,0,0,2,38
1743145,1331741,2023-05-17,House,"Reported With Recommendation Without Amendment",13,0,0,0,13
1743145,1346462,2023-06-21,House,"House Third Reading: Given Immediate Effect Roll Call # 188",104,5,0,0,109
1743164,1331894,2023-05-17,House,"Reported With Recommendation Without Amendment",13,0,0,0,13
1743164,1346398,2023-06-21,House,"House Third Reading: Given Immediate Effect Roll Call # 189",104,5,0,0,109
1743164,1350370,2023-06-27,Senate,"Senate Third Reading: Given Immediate Effect Roll Call # 395",37,0,0,1,38
1743185,1332074,2023-05-17,House,"Reported With Recommendation Without Amendment",13,0,0,0,13
1743185,1345989,2023-06-21,House,"House Third Reading: Given Immediate Effect Roll Call # 187",104,5,0,0,109
1743203,1331777,2023-05-17,House,"Reported With Recommendation With Substitute H-2",13,0,0,0,13
1743203,1346465,2023-06-21,House,"House Third Reading: Given Immediate Effect Roll Call # 191",104,5,0,0,109
1743227,1332101,2023-05-17,House,"Reported With Recommendation With Substitute H-1",13,0,0,0,13
1743227,1346396,2023-06-21,House,"House Third Reading: Given Immediate Effect Roll Call # 186",104,5,0,0,109
1743227,1350362,2023-06-27,Senate,"Senate Third Reading: Given Immediate Effect Roll Call # 394",37,0,0,1,38
1743227,1353337,2023-09-06,House,"House Third Reading: Roll Call # 270",101,6,0,0,107
1743242,1331694,2023-05-17,House,"Reported With Recommendation With Substitute H-1",13,0,0,0,13
1743242,1346026,2023-06-21,House,"House Third Reading: Given Immediate Effect Roll Call # 183",104,5,0,0,109
1743262,1319280,2023-05-04,House,"Reported With Recommendation With Substitute H-2",17,3,0,0,20
1743262,1323460,2023-05-10,House,"House Third Reading: Given Immediate Effect Roll Call # 89",56,52,0,0,108
1743262,1327762,2023-05-17,Senate,"Senate Third Reading: Passed Roll Call # 303",20,18,0,0,38
1743262,1340439,2023-06-06,House,"House Third Reading: Roll Call # 135",52,54,0,0,106
1743262,1357875,2023-11-02,Senate,"Senate Third Reading: Senate Adopted Conference Report Roll Call # 655",21,17,0,0,38
1743262,1370227,2023-11-02,House,"House Third Reading: Conference Report Adopted Roll Call # 478",56,52,0,0,108
1743285,1331710,2023-05-17,House,"Reported With Recommendation With Substitute H-1",13,0,0,0,13
1743285,1345993,2023-06-21,House,"House Third Reading: Given Immediate Effect Roll Call # 184",98,11,0,0,109
1743285,1348029,2023-06-27,Senate,"Senate Third Reading: Given Immediate Effect Roll Call # 392",31,6,0,1,38
1743285,1348685,2023-06-28,Senate,"Senate Third Reading: Passed Roll Call # 427",31,6,0,1,38
1743285,1354905,2023-09-06,House,"House Third Reading: Roll Call # 272",99,8,0,0,107
1743307,1331778,2023-05-17,House,"Reported With Recommendation Without Amendment",13,0,0,0,13
1743307,1346483,2023-06-21,House,"House Third Reading: Given Immediate Effect Roll Call # 190",104,5,0,0,109
1743307,1350360,2023-06-27,Senate,"Senate Third Reading: Given Immediate Effect Roll Call # 396",37,0,0,1,38
1743329,1331958,2023-05-17,House,"Reported With Recommendation Without Amendment",13,0,0,0,13
1743329,1346466,2023-06-21,House,"House Third Reading: Given Immediate Effect Roll Call # 185",104,5,0,0,109
1743329,1348127,2023-06-27,Senate,"Senate Third Reading: Given Immediate Effect Roll Call # 393",34,3,0,1,38
1743329,1353341,2023-09-06,House,"House Third Reading: Roll Call # 269",102,5,0,0,107
1743352,1331729,2023-05-17,House,"Reported With Recommendation With Substitute H-1",13,0,0,0,13
1743352,1346472,2023-06-21,House,"House Third Reading: Given Immediate Effect Roll Call # 192",104,5,0,0,109
1743352,1350371,2023-06-27,Senate,"Senate Third Reading: Given Immediate Effect Roll Call # 397",37,0,0,1,38
1743352,1354068,2023-09-13,Senate,"Senate Third Reading: Roll Call: Roll Call # 451",36,0,0,2,38
1743352,1354896,2023-09-06,House,"House Third Reading: Roll Call # 271",102,5,0,0,107
1744689,1325736,2023-05-10,House,"Reported With Recommendation Without Amendment",5,0,0,0,5
1744714,1312411,2023-04-20,Senate,"Reported Favorably With Substitute S-1",10,0,0,0,10
1744714,1325780,2023-05-11,Senate,"Senate Third Reading: Passed Roll Call # 290",36,1,0,1,38
1744714,1347758,2023-06-22,House,"Reported With Recommendation With Substitute H-2",18,0,0,0,18
1744714,1350014,2023-06-27,Senate,"Senate Third Reading: Roll Call: Roll Call # 415",35,1,0,2,38
1744714,1354049,2023-06-27,House,"House Third Reading: Given Immediate Effect Roll Call # 237",96,12,0,0,108
1744753,1319295,2023-05-04,House,"Reported With Recommendation With Substitute H-2",17,5,0,0,22
1744753,1323337,2023-05-10,House,"House Third Reading: Given Immediate Effect Roll Call # 87",56,52,0,0,108
1744753,1327747,2023-05-17,Senate,"Senate Third Reading: Passed Roll Call # 304",21,17,0,0,38
1744753,1340423,2023-06-06,House,"House Third Reading: Roll Call # 136",52,54,0,0,106
1744784,1312233,2023-04-26,House,"Reported With Recommendation With Substitute H-1",17,3,0,0,20
1744784,1323153,2023-05-10,House,"House Third Reading: Given Immediate Effect Roll Call # 83",56,52,0,0,108
1744798,1312252,2023-04-26,House,"Reported With Recommendation With Substitute H-1",16,1,0,0,17
1744798,1323147,2023-05-10,House,"House Third Reading: Given Immediate Effect Roll Call # 82",56,52,0,0,108
1744882,1319277,2023-05-04,House,"Reported With Recommendation With Substitute H-2",17,2,0,0,19
1744882,1323154,2023-05-10,House,"House Third Reading: Given Immediate Effect Roll Call # 91",56,52,0,0,108
1744896,1355199,2023-09-19,House,"Reported With Recommendation Without Amendment",13,0,0,0,13
1744896,1355548,2023-09-27,House,"House Third Reading: Given Immediate Effect Roll Call # 314",106,4,0,0,110
1744896,1454647,2024-06-06,Senate,"Reported Favorably Without Amendment",10,0,0,0,10
1744896,1459881,2024-06-25,Senate,"Senate Third Reading: Passed Roll Call # 276",38,0,0,0,38
1744912,1357296,2023-10-25,House,"Reported With Recommendation Without Amendment",13,0,0,0,13
1744912,1390259,2024-02-20,House,"House Third Reading: Given Immediate Effect Roll Call # 11",88,18,0,0,106
1744928,1356609,2023-10-25,House,"Reported With Recommendation Without Amendment",13,0,0,0,13
1744928,1389950,2024-02-20,House,"House Third Reading: Given Immediate Effect Roll Call # 12",86,20,0,0,106
1745451,1389278,2024-02-20,Senate,"Reported Favorably With Substitute S-1",13,1,0,0,14
1745451,1402928,2024-02-27,Senate,"Senate Third Reading: Passed Roll Call # 35",25,13,0,0,38
1745451,1408347,2024-03-12,House,"Reported With Recommendation Without Amendment",7,0,0,0,7
1745451,1448031,2024-05-21,House,"House Third Reading: Given Immediate Effect Roll Call # 109",68,39,0,0,107
1745480,1389150,2024-02-20,Senate,"Reported Favorably With Substitute S-1",13,1,0,0,14
1745480,1402919,2024-02-27,Senate,"Senate Third Reading: Passed Roll Call # 34",26,12,0,0,38
1745480,1425761,2024-03-12,House,"Reported With Recommendation Without Amendment",7,0,0,0,7
1745480,1446876,2024-05-21,House,"House Third Reading: Given Immediate Effect Roll Call # 108",78,29,0,0,107
1745494,1355967,2023-10-12,Senate,"Reported Favorably With Substitute S-1",8,0,0,0,8
1745494,1356316,2023-10-18,Senate,"Senate Third Reading: Passed Roll Call # 536",38,0,0,0,38
1745494,1356355,2023-10-19,Senate,"Senate Third Reading: Passed Roll Call # 549",38,0,0,0,38
1745494,1357170,2023-11-02,House,"Reported With Recommendation Without Amendment",18,0,0,0,18
1745494,1357239,2023-11-08,House,"House Third Reading: Given Immediate Effect Roll Call # 512",105,4,0,0,109
1745494,1401243,2024-01-17,House,"House Third Reading: Defeated Roll Call # 2",52,52,0,0,104
1745494,1441697,2024-05-09,House,"House Third Reading: Given Immediate Effect Roll Call # 83",103,4,0,0,107
1745494,1442865,2024-05-14,Senate,"Senate Third Reading: Roll Call: Roll Call # 143",36,0,0,2,38
1745852,1346481,2023-06-21,House,"Reported With Recommendation With Substitute H-1",11,1,0,0,12
1745852,1348244,2023-06-27,Senate,"Reported Favorably Without Amendment",8,1,0,0,9
1745852,1348802,2023-06-28,Senate,"Senate Third Reading: Given Immediate Effect Roll Call # 418",27,10,0,1,38
1745852,1353549,2023-06-22,House,"House Third Reading: Given Immediate Effect Roll Call # 220",93,16,0,0,109
1745860,1346594,2023-06-21,House,"Reported With Recommendation Without Amendment",11,1,0,0,12
1745860,1346904,2023-06-22,House,"House Third Reading: Given Immediate Effect Roll Call # 221",92,17,0,0,109
1745860,1348009,2023-06-27,Senate,"Reported Favorably Without Amendment",8,1,0,0,9
1745860,1348657,2023-06-28,Senate,"Senate Third Reading: Given Immediate Effect Roll Call # 419",27,10,0,1,38
1745870,1326249,2023-05-16,House,"Reported With Recommendation Without Amendment",15,0,0,0,15
1745946,1357354,2023-10-05,House,"Reported With Recommendation With Amendment(s)",7,0,0,0,7
1745946,1357508,2023-11-09,House,"House Third Reading: Given Immediate Effect Roll Call # 568",103,4,0,0,107
1745946,1378523,2024-02-06,Senate,"Reported Favorably Without Amendment",13,0,0,0,13
1745946,1384377,2024-02-14,Senate,"Senate Third Reading: Passed Roll Call # 11",29,9,0,0,38
1745958,1349998,2023-06-27,House,"Reported With Recommendation With Substitute H-1",7,0,0,0,7
1745958,1356086,2023-10-12,House,"House Third Reading: Given Immediate Effect Roll Call # 349",110,0,0,0,110
1745958,1357250,2023-11-07,Senate,"Reported Favorably Without Amendment",7,0,0,0,7
1745958,1400305,2023-11-09,Senate,"Senate Third Reading: Passed Roll Call # 712",37,0,0,1,38
1746301,1334382,2023-05-25,Senate,"Reported Favorably Without Amendment",4,0,0,0,4
1746301,1340680,2023-06-07,Senate,"Senate Third Reading: Passed Roll Call # 326",38,0,0,0,38
1746301,1454085,2024-06-05,House,"Reported With Recommendation Without Amendment",5,0,0,0,5
1746301,1457186,2024-06-13,House,"House Third Reading: Given Immediate Effect Roll Call # 171",109,0,0,0,109
1746322,1326190,2023-05-16,House,"Reported With Recommendation With Substitute H-1",16,1,0,0,17
1746322,1355177,2023-09-20,House,"House Third Reading: Given Immediate Effect Roll Call # 291",76,34,0,0,110
1746322,1355902,2023-10-05,Senate,"Senate Third Reading: Given Immediate Effect Roll Call # 501",29,8,0,1,38
1746322,1355903,2023-10-11,Senate,"Senate Third Reading: Passed Roll Call # 512",28,10,0,0,38
1746322,1355947,2023-10-12,House,"House Third Reading: Roll Call # 346",74,36,0,0,110
1746347,1348056,2023-06-08,House,"Reported With Recommendation Without Amendment",12,0,0,0,12
1746347,1355864,2023-09-26,House,"House Third Reading: Given Immediate Effect Roll Call # 306",100,9,0,0,109
1746347,1429655,2024-04-17,Senate,"Reported Favorably With Substitute S-1",9,2,0,0,11
1746347,1437553,2024-05-01,Senate,"Senate Third Reading: Passed Roll Call # 106",24,14,0,0,38
1746347,1462147,2024-06-27,House,"House Third Reading: Roll Call # 292",96,14,0,0,110
1746367,1312198,2023-04-25,Senate,"Reported Favorably With Substitute S-1",7,0,0,0,7
1746367,1319208,2023-05-03,Senate,"Senate Third Reading: Passed Roll Call # 143",38,0,0,0,38
1746367,1345706,2023-06-14,House,"Reported With Recommendation Without Amendment",12,0,0,0,12
1746367,1346120,2023-06-21,House,"House Third Reading: Given Immediate Effect Roll Call # 201",105,4,0,0,109
1746377,1425032,2024-03-14,Senate,"Reported Favorably With Substitute S-5",6,1,0,0,7
1746377,1442002,2024-05-09,Senate,"Senate Third Reading: Passed Roll Call # 142",24,11,0,3,38
1746377,1467618,2024-09-25,House,"House Third Reading: Given Immediate Effect Roll Call # 297",56,41,0,0,97
1746432,1354939,2023-09-06,House,"Reported With Recommendation Without Amendment",8,0,0,0,8
1746432,1355863,2023-09-26,House,"House Third Reading: Given Immediate Effect Roll Call # 307",71,38,0,0,109
1746432,1429573,2024-04-17,Senate,"Reported Favorably Without Amendment",9,2,0,0,11
1746432,1439953,2024-05-01,Senate,"Senate Third Reading: Passed Roll Call # 107",22,16,0,0,38
1746432,1462142,2024-06-27,House,"House Third Reading: Roll Call # 282",69,41,0,0,110
1746515,1346431,2023-06-21,Senate,"Reported Favorably Without Amendment",5,0,0,0,5
1746515,1346658,2023-06-22,Senate,"Senate Third Reading: Passed Roll Call # 377",37,0,0,1,38
1746526,1470534,2024-12-13,House,"House Third Reading: Given Immediate Effect Roll Call # 535",56,0,0,0,56
1746542,1326186,2023-05-16,House,"Reported With Recommendation With Substitute H-1",15,1,0,0,16
1746542,1355057,2023-09-20,House,"House Third Reading: Given Immediate Effect Roll Call # 292",75,35,0,0,110
1746542,1355911,2023-10-05,Senate,"Senate Third Reading: Given Immediate Effect Roll Call # 502",29,8,0,1,38
1746563,1348191,2023-06-06,House,"Reported With Recommendation Without Amendment",12,0,0,0,12
1746563,1355312,2023-09-27,House,"House Third Reading: Given Immediate Effect Roll Call # 315",110,0,0,0,110
1746563,1356987,2023-11-02,Senate,"Reported Favorably Without Amendment",4,0,0,0,4
1746563,1357288,2023-11-08,Senate,"Senate Third Reading: Passed Roll Call # 693",35,0,0,3,38
1746587,1425037,2024-03-14,Senate,"Reported Favorably Without Amendment",6,1,0,0,7
1746622,1326192,2023-05-16,House,"Reported With Recommendation With Substitute H-2",16,1,0,0,17
1746632,1331658,2023-05-18,House,"Reported With Recommendation With Substitute H-1",13,0,0,0,13
1746632,1347086,2023-06-22,House,"House Third Reading: Given Immediate Effect Roll Call # 207",97,12,0,0,109
1746632,1406554,2024-03-07,Senate,"Reported Favorably With Substitute S-1",8,0,0,0,8
1746632,1425047,2024-03-14,Senate,"Senate Third Reading: Passed Roll Call # 59",38,0,0,0,38
1746632,1441771,2024-05-09,House,"House Third Reading: Roll Call # 81",96,11,0,0,107
1754528,1356395,2023-10-19,Senate,"Reported Favorably Without Amendment",10,0,0,0,10
1754528,1357877,2023-11-02,Senate,"Senate Third Reading: Passed Roll Call # 639",38,0,0,0,38
1754528,1437425,2024-05-01,House,"House Third Reading: Given Immediate Effect Roll Call # 48",101,4,0,0,105
1754528,1439949,2024-04-24,House,"Reported With Recommendation Without Amendment",5,0,0,0,5
1754541,1343975,2023-06-13,Senate,"Reported Favorably With Substitute S-2",7,0,0,0,7
1754541,1345334,2023-06-14,Senate,"Senate Third Reading: Passed Roll Call # 343",36,2,0,0,38
1754541,1346497,2023-06-20,House,"Reported With Recommendation Without Amendment",14,0,0,0,14
1754541,1348007,2023-06-27,Senate,"Senate Third Reading: Roll Call: Roll Call # 416",34,2,0,2,38
1754541,1353556,2023-06-27,House,"House Third Reading: Given Immediate Effect Roll Call # 231",85,23,0,0,108
1754553,1334085,2023-05-25,Senate,"Reported Favorably Without Amendment",11,0,0,0,11
1754553,1340872,2023-06-07,Senate,"Senate Third Reading: Passed Roll Call # 325",38,0,0,0,38
1754553,1355237,2023-09-26,House,"Reported With Recommendation With Substitute H-1",13,0,0,0,13
1754553,1457020,2024-06-12,House,"House Third Reading: Given Immediate Effect Roll Call # 162",110,0,0,0,110
1754553,1458694,2024-06-20,Senate,"Senate Third Reading: Roll Call: Roll Call # 251",38,0,0,0,38
1754556,1305063,2023-04-19,Senate,"Senate Third Reading: Passed Roll Call # 125",24,14,0,0,38
1754556,1311079,2023-04-25,House,"Reported With Recommendation Without Amendment",6,2,0,0,8
1754556,1313840,2023-04-27,Senate,"Senate Third Reading: Roll Call: Roll Call # 141",23,14,0,1,38
1754556,1319934,2023-04-18,Senate,"Reported Favorably With Substitute S-1",8,0,0,0,8
1754556,1350734,2023-04-26,House,"House Third Reading: Given Immediate Effect Roll Call # 70",56,52,0,0,108
1754562,1343958,2023-06-13,Senate,"Reported Favorably With Substitute S-1",7,0,0,0,7
1754562,1346617,2023-06-14,Senate,"Senate Third Reading: Passed Roll Call # 341",38,0,0,0,38
1754562,1355916,2023-10-11,House,"Reported With Recommendation With Substitute H-1",12,0,0,0,12
1754562,1470266,2024-11-14,House,"House Third Reading: Given Immediate Effect Roll Call # 354",99,3,0,0,102
1754574,1337575,2023-05-30,House,"Reported With Recommendation With Substitute H-1",6,3,0,0,9
1754574,1345787,2023-06-20,House,"House Third Reading: Given Immediate Effect Roll Call # 178",56,53,0,0,109
1754574,1348669,2023-06-28,Senate,"Reported Favorably Without Amendment",9,0,0,0,9
1754574,1348670,2023-06-28,Senate,"Senate Third Reading: Passed Roll Call # 443",20,17,0,1,38
1754574,1353345,2023-09-07,Senate,"Senate Third Reading: Passed Roll Call # 449",20,16,0,2,38
1754574,1355328,2023-09-27,House,"House Third Reading: Roll Call # 310",56,54,0,0,110
1754579,1325762,2023-05-10,House,"Reported With Recommendation With Substitute H-1",7,5,0,0,12
1754579,1348229,2023-06-22,House,"House Third Reading: Given Immediate Effect Roll Call # 209",56,53,0,0,109
1754579,1355194,2023-09-21,Senate,"Reported Favorably Without Amendment",5,3,0,0,8
1754579,1355309,2023-09-27,Senate,"Senate Third Reading: Passed Roll Call # 478",20,18,0,0,38
1754585,1319179,2023-05-04,House,"Reported With Recommendation With Substitute H-1",18,0,0,0,18
1754585,1331736,2023-05-11,House,"House Third Reading: Given Immediate Effect Roll Call # 101",103,4,0,0,107
1754585,1345439,2023-06-14,Senate,"Reported Favorably Without Amendment",10,0,0,0,10
1754585,1350584,2023-06-27,Senate,"Senate Third Reading: Given Immediate Effect Roll Call # 384",30,7,0,1,38
1754585,1398816,2023-06-27,House,"House Third Reading: Roll Call # 247",104,4,0,0,108
1754592,1325414,2023-05-10,House,"Reported With Recommendation With Substitute H-1",8,5,0,0,13
1754592,1327736,2023-05-17,House,"House Third Reading: Given Immediate Effect Roll Call # 116",57,50,0,0,107
1754592,1344917,2023-06-14,Senate,"Reported Favorably With Substitute S-1",7,3,0,0,10
1754592,1344918,2023-06-14,Senate,"Senate Third Reading: Passed Roll Call # 355",21,17,0,0,38
1754592,1347229,2023-06-22,House,"House Third Reading: Roll Call # 206",61,48,0,0,109
1754597,1408521,2024-03-06,House,"Reported With Recommendation With Substitute H-2",11,0,0,0,11
1754597,1467579,2024-09-25,House,"House Third Reading: Given Immediate Effect Roll Call # 315",92,17,0,0,109
1754597,1468701,2024-10-17,Senate,"Reported Favorably With Substitute S-1",19,0,0,0,19
1754597,1469120,2024-10-30,Senate,"Senate Third Reading: Passed Roll Call # 393",35,1,1,1,38
1754610,1343845,2023-05-30,House,"Reported With Recommendation With Substitute H-1",6,3,0,0,9
1754615,1356472,2023-09-27,House,"Reported With Recommendation Without Amendment",8,0,0,0,8
1754615,1356612,2023-10-25,House,"House Third Reading: Given Immediate Effect Roll Call # 406",86,23,0,0,109
1754615,1356990,2023-11-02,Senate,"Reported Favorably Without Amendment",6,0,0,0,6
1754615,1399500,2023-11-09,Senate,"Senate Third Reading: Passed Roll Call # 728",27,10,0,1,38
1754622,1319173,2023-05-04,House,"Reported With Recommendation Without Amendment",18,0,0,0,18
1754622,1331735,2023-05-11,House,"House Third Reading: Given Immediate Effect Roll Call # 102",103,4,0,0,107
1754622,1345282,2023-06-14,Senate,"Reported Favorably Without Amendment",10,0,0,0,10
1754622,1350590,2023-06-27,Senate,"Senate Third Reading: Given Immediate Effect Roll Call # 385",30,7,0,1,38
1754629,1425100,2024-02-14,House,"Reported With Recommendation Without Amendment",19,0,0,0,19
1754633,1326253,2023-05-16,House,"Reported With Recommendation With Substitute H-1",9,1,0,0,10
1754633,1347981,2023-06-27,House,"House Third Reading: Given Immediate Effect Roll Call # 226",56,52,0,0,108
1754633,1355200,2023-09-21,Senate,"Reported Favorably Without Amendment",10,1,0,0,11
1754633,1355587,2023-09-27,Senate,"Senate Third Reading: Given Immediate Effect Roll Call # 473",25,13,0,0,38
1754633,1356482,2023-10-03,House,"House Third Reading: Senate Amendment(s) Concurred In Roll Call # 331",56,53,0,0,109
1754638,1343479,2023-05-30,House,"Reported With Recommendation With Substitute H-1",6,3,0,0,9
1754638,1345789,2023-06-20,House,"House Third Reading: Given Immediate Effect Roll Call # 177",56,53,0,0,109
1754638,1348584,2023-06-28,Senate,"Reported Favorably Without Amendment",9,0,0,0,9
1754638,1348781,2023-06-28,Senate,"Senate Third Reading: Passed Roll Call # 441",20,17,0,1,38
1754644,1364166,2023-10-31,House,"House Third Reading: Given Immediate Effect Roll Call # 432",81,29,0,0,110
1754644,1367822,2023-10-31,House,"House Third Reading: Passed Roll Call # 431",80,30,0,0,110
1754644,1412066,2024-03-19,Senate,"Senate Third Reading: Passed Roll Call # 81",23,12,0,3,38
1754654,1313006,2023-04-20,House,"Reported With Recommendation For Referral To Committee On Tax Policy",16,0,0,0,16
1754654,1323148,2023-05-10,House,"Reported With Recommendation With Substitute H-1",7,5,0,0,12
1754654,1348086,2023-06-22,House,"House Third Reading: Given Immediate Effect Roll Call # 208",56,53,0,0,109
1754654,1355195,2023-09-21,Senate,"Reported Favorably Without Amendment",5,3,0,0,8
1754654,1355313,2023-09-27,Senate,"Senate Third Reading: Passed Roll Call # 477",20,18,0,0,38
1754656,1326207,2023-05-16,House,"Reported With Recommendation Without Amendment",9,1,0,0,10
1754656,1353553,2023-06-27,House,"House Third Reading: Given Immediate Effect Roll Call # 225",56,52,0,0,108
1754656,1355212,2023-09-21,Senate,"Reported Favorably Without Amendment",10,1,0,0,11
1754656,1355338,2023-09-27,Senate,"Senate Third Reading: Given Immediate Effect Roll Call # 472",26,12,0,0,38
1754656,1356559,2023-10-03,House,"House Third Reading: Senate Amendment(s) Concurred In Roll Call # 330",56,53,0,0,109
1754663,1346110,2023-06-21,House,"Reported With Recommendation With Substitute H-1",8,0,0,0,8
1754663,1363342,2023-11-09,House,"House Third Reading: Given Immediate Effect Roll Call # 558",76,30,0,0,106
1754663,1414366,2024-03-20,Senate,"Reported Favorably Without Amendment",6,0,0,0,6
1754663,1438438,2024-05-02,Senate,"Senate Third Reading: Passed Roll Call # 108",38,0,0,0,38
1754663,1456984,2024-06-12,House,"House Third Reading: Senate Amendment(s) Concurred In Roll Call # 168",79,31,0,0,110
1754663,1457054,2024-06-11,Senate,"Senate Third Reading: Passed Roll Call # 238",38,0,0,0,38
1754667,1319180,2023-05-04,House,"Reported With Recommendation With Substitute H-1",18,0,0,0,18
1754667,1331504,2023-05-11,House,"House Third Reading: Given Immediate Effect Roll Call # 100",102,5,0,0,107
1754667,1345015,2023-06-14,Senate,"Reported Favorably Without Amendment",10,0,0,0,10
1754667,1350602,2023-06-27,Senate,"Senate Third Reading: Given Immediate Effect Roll Call # 383",30,7,0,1,38
1754667,1353727,2023-06-27,House,"House Third Reading: Roll Call # 246",103,5,0,0,108
1754695,1312296,2023-04-20,House,"Reported With Recommendation With Substitute H-1",16,0,0,0,16
1754695,1331676,2023-05-11,House,"House Third Reading: Given Immediate Effect Roll Call # 99",83,24,0,0,107
1754695,1356257,2023-10-05,Senate,"Reported Favorably Without Amendment",8,0,0,0,8
1754695,1356354,2023-10-19,Senate,"Senate Third Reading: Passed Roll Call # 557",36,2,0,0,38
1754696,1363262,2023-11-09,House,"Reported With Recommendation With Substitute H-1",6,3,0,0,9
1754714,1343369,2023-05-30,House,"Reported With Recommendation With Substitute H-1",6,3,0,0,9
1754714,1345712,2023-06-20,House,"House Third Reading: Given Immediate Effect Roll Call # 179",56,53,0,0,109
1754714,1348773,2023-06-28,Senate,"Reported Favorably Without Amendment",9,0,0,0,9
1754714,1348774,2023-06-28,Senate,"Senate Third Reading: Passed Roll Call # 444",20,17,0,1,38
1754719,1425003,2024-02-14,House,"Reported With Recommendation Without Amendment",19,0,0,0,19
1754887,1331704,2023-05-23,Senate,"Reported Favorably With Substitute S-1",3,1,0,0,4
1754887,1335092,2023-05-23,Senate,"Senate Third Reading: Passed Roll Call # 317",38,0,0,0,38
1754887,1356755,2023-09-12,House,"Reported With Recommendation Without Amendment",13,0,0,0,13
1754887,1356883,2023-11-01,House,"House Third Reading: Given Immediate Effect Roll Call # 437",90,20,0,0,110
1755082,1343576,2023-06-06,House,"Reported With Recommendation With Substitute H-2",8,1,0,0,9
1755082,1344330,2023-06-14,House,"House Third Reading: Given Immediate Effect Roll Call # 158",56,53,0,0,109
1755090,1330399,2023-04-13,House,"House Third Reading: Roll Call # 58",56,51,0,0,107
1755093,1348054,2023-06-27,House,"Reported With Recommendation Without Amendment",7,0,0,0,7
1755093,1356093,2023-10-12,House,"House Third Reading: Given Immediate Effect Roll Call # 350",110,0,0,0,110
1755093,1357240,2023-11-07,Senate,"Reported Favorably Without Amendment",7,0,0,0,7
1755093,1357792,2023-11-09,Senate,"Senate Third Reading: Passed Roll Call # 711",36,0,2,0,38
1755093,1394191,2023-11-09,House,"House Third Reading: Roll Call # 578",107,0,0,0,107
1755297,1331707,2023-05-23,House,"Reported With Recommendation Without Amendment",13,0,0,0,13
1755297,1341357,2023-06-07,House,"House Third Reading: Given Immediate Effect Roll Call # 137",100,6,0,0,106
1755297,1355612,2023-10-03,Senate,"Reported Favorably Without Amendment",7,0,0,0,7
1755297,1356333,2023-10-19,Senate,"Senate Third Reading: Passed Roll Call # 550",32,6,0,0,38
1755307,1331700,2023-05-23,House,"Reported With Recommendation Without Amendment",13,0,0,0,13
1755307,1341321,2023-06-07,House,"House Third Reading: Given Immediate Effect Roll Call # 139",100,6,0,0,106
1755307,1356139,2023-10-03,Senate,"Reported Favorably Without Amendment",6,0,0,0,6
1755307,1356324,2023-10-19,Senate,"Senate Third Reading: Passed Roll Call # 552",29,9,0,0,38
1755315,1458851,2024-06-20,House,"House Third Reading: Given Immediate Effect Roll Call # 192",105,4,0,0,109
1755373,1331698,2023-05-23,House,"Reported With Recommendation Without Amendment",13,0,0,0,13
1755373,1341329,2023-06-07,House,"House Third Reading: Given Immediate Effect Roll Call # 140",105,1,0,0,106
1755373,1356098,2023-10-03,Senate,"Reported Favorably Without Amendment",7,0,0,0,7
1755373,1356332,2023-10-19,Senate,"Senate Third Reading: Passed Roll Call # 553",38,0,0,0,38
1755380,1326255,2023-05-16,House,"Reported With Recommendation Without Amendment",6,2,0,0,8
1755411,1340877,2023-06-07,House,"Reported With Recommendation With Substitute H-1",12,0,0,0,12
1755411,1356604,2023-10-25,House,"House Third Reading: Given Immediate Effect Roll Call # 405",109,0,0,0,109
1755411,1377863,2024-02-06,Senate,"Reported Favorably Without Amendment",6,4,0,0,10
1755411,1378588,2024-02-07,Senate,"Senate Third Reading: Given Immediate Effect Roll Call # 9",38,0,0,0,38
1755424,1348092,2023-06-07,House,"Reported With Recommendation Without Amendment",12,0,0,0,12
1755424,1356608,2023-10-25,House,"House Third Reading: Given Immediate Effect Roll Call # 404",109,0,0,0,109
1755424,1377868,2024-02-06,Senate,"Reported Favorably Without Amendment",6,4,0,0,10
1755424,1378595,2024-02-07,Senate,"Senate Third Reading: Given Immediate Effect Roll Call # 8",38,0,0,0,38
1755433,1331702,2023-05-17,House,"Reported With Recommendation With Substitute H-1",15,0,0,0,15
1755433,1463272,2024-06-27,House,"House Third Reading: Given Immediate Effect Roll Call # 279",56,54,0,0,110
1755442,1326188,2023-05-16,House,"Reported With Recommendation Without Amendment",13,0,0,0,13
1755442,1461331,2024-06-26,House,"House Third Reading: Given Immediate Effect Roll Call # 226",90,20,0,0,110
1755461,1348012,2023-06-07,House,"Reported With Recommendation Without Amendment",12,0,0,0,12
1755461,1356580,2023-10-25,House,"House Third Reading: Given Immediate Effect Roll Call # 402",109,0,0,0,109
1755461,1378152,2024-02-06,Senate,"Reported Favorably With Substitute S-2",6,4,0,0,10
1755461,1378153,2024-02-07,Senate,"Senate Third Reading: Given Immediate Effect Roll Call # 6",38,0,0,0,38
1755461,1385271,2024-02-14,House,"House Third Reading: Roll Call # 9",105,0,0,0,105
1755472,1348019,2023-06-07,House,"Reported With Recommendation With Substitute H-1",12,0,0,0,12
1755472,1356610,2023-10-25,House,"House Third Reading: Given Immediate Effect Roll Call # 403",109,0,0,0,109
1755472,1377884,2024-02-06,Senate,"Reported Favorably Without Amendment",6,4,0,0,10
1755472,1378646,2024-02-07,Senate,"Senate Third Reading: Given Immediate Effect Roll Call # 7",38,0,0,0,38
1755479,1331663,2023-05-23,House,"Reported With Recommendation Without Amendment",13,0,0,0,13
1755479,1341330,2023-06-07,House,"House Third Reading: Given Immediate Effect Roll Call # 138",105,1,0,0,106
1755479,1356100,2023-10-03,Senate,"Reported Favorably Without Amendment",7,0,0,0,7
1755479,1356339,2023-10-19,Senate,"Senate Third Reading: Passed Roll Call # 551",38,0,0,0,38
1756919,1356708,2023-10-26,Senate,"Reported Favorably With Substitute S-2",5,0,0,0,5
1756919,1357146,2023-11-03,House,"House Third Reading: Given Immediate Effect Roll Call # 487",56,52,0,0,108
1756919,1357286,2023-11-08,House,"House Third Reading: Passed Roll Call # 491",56,53,0,0,109
1756919,1357287,2023-11-08,Senate,"Senate Third Reading: Roll Call: Roll Call # 705",20,15,0,3,38
1756919,1370819,2023-11-01,House,"Reported With Recommendation Without Amendment",10,7,0,0,17
1756919,1407743,2023-10-26,Senate,"Senate Third Reading: Passed Roll Call # 602",20,18,0,0,38
1756973,1354935,2023-09-19,Senate,"Reported Favorably Without Amendment",3,1,0,0,4
1756973,1355211,2023-09-26,Senate,"Senate Third Reading: Passed Roll Call # 457",23,14,1,0,38
1756973,1356912,2023-10-25,House,"Reported With Recommendation Without Amendment",9,4,0,0,13
1756973,1356988,2023-11-03,House,"House Third Reading: Given Immediate Effect Roll Call # 490",56,51,0,0,107
1756973,1357261,2023-11-08,Senate,"Senate Third Reading: House Amendment(s) Concurred In Roll Call # 675",22,14,1,1,38
1756999,1343624,2023-06-13,Senate,"Reported Favorably With Substitute S-1",7,0,0,0,7
1756999,1346665,2023-06-14,Senate,"Senate Third Reading: Passed Roll Call # 342",38,0,0,0,38
1756999,1353874,2023-09-12,House,"Reported With Recommendation Without Amendment",13,0,0,0,13
1756999,1355504,2023-09-26,House,"House Third Reading: Given Immediate Effect Roll Call # 308",95,14,0,0,109
1757043,1356707,2023-10-26,Senate,"Reported Favorably With Substitute S-2",5,0,0,0,5
1757043,1356915,2023-11-01,House,"Reported With Recommendation Without Amendment",10,7,0,0,17
1757043,1357001,2023-11-03,House,"House Third Reading: Given Immediate Effect Roll Call # 486",56,51,0,0,107
1757043,1357281,2023-11-08,Senate,"Senate Third Reading: Roll Call: Roll Call # 674",20,17,0,1,38
1757043,1408359,2023-10-26,Senate,"Senate Third Reading: Passed Roll Call # 629",20,18,0,0,38
1757146,1331739,2023-05-11,House,"House Third Reading: Given Immediate Effect Roll Call # 106",57,50,0,0,107
1757146,1348081,2023-06-27,Senate,"Senate Third Reading: Passed Roll Call # 380",20,17,0,1,38
1757146,1350983,2023-06-28,House,"House Third Reading: Conference Report Adopted Roll Call # 263",61,47,0,0,108
1757146,1351537,2023-06-28,Senate,"Senate Third Reading: Senate Adopted Conference Report With Immediate Effect Roll Call # 445",26,10,1,1,38
1757146,1353551,2023-06-27,House,"House Third Reading: Roll Call # 224",52,56,0,0,108
1757187,1469629,2024-12-03,House,"Reported With Recommendation With Substitute H-2",8,2,0,0,10
1757206,1470005,2024-12-03,House,"Reported With Recommendation Without Amendment",8,2,0,0,10
1757248,1443069,2024-05-14,House,"Reported With Recommendation With Substitute H-5",8,3,0,0,11
1757248,1456731,2024-06-12,House,"House Third Reading: Given Immediate Effect Roll Call # 166",56,53,0,0,109
1757281,1470076,2024-12-03,House,"Reported With Recommendation Without Amendment",8,2,0,0,10
1757488,1363317,2023-11-09,Senate,"Reported Favorably With Substitute S-1",8,0,0,0,8
1757488,1385213,2024-02-14,Senate,"Senate Third Reading: Passed Roll Call # 12",30,8,0,0,38
1757571,1347987,2023-06-27,Senate,"Reported Favorably With Substitute S-1",8,1,0,0,9
1757571,1350051,2023-06-27,Senate,"Senate Third Reading: Passed Roll Call # 406",30,6,0,2,38
1757571,1354927,2023-09-14,House,"Reported With Recommendation Without Amendment",19,0,0,0,19
1757571,1356763,2023-10-24,House,"House Third Reading: Given Immediate Effect Roll Call # 394",85,24,0,0,109
1757571,1356967,2023-11-02,House,"House Third Reading: Passed Roll Call # 479",84,24,0,0,108
1757571,1357910,2023-11-07,Senate,"Senate Third Reading: Roll Call: Roll Call # 659",29,8,0,1,38
1757585,1348620,2023-06-28,Senate,"Reported Favorably With Substitute S-1",9,0,0,0,9
1757585,1348621,2023-06-28,Senate,"Senate Third Reading: Passed Roll Call # 426",36,1,0,1,38
1757585,1355006,2023-09-14,House,"Reported With Recommendation With Substitute H-1",19,0,0,0,19
1757585,1355808,2023-10-04,House,"House Third Reading: Given Immediate Effect Roll Call # 339",91,17,0,0,108
1757585,1355860,2023-10-05,Senate,"Senate Third Reading: Roll Call: Roll Call # 504",30,7,0,1,38
1757656,1348051,2023-06-06,House,"Reported With Recommendation With Substitute H-1",6,2,0,0,8
1757710,1326211,2023-05-16,House,"Reported With Recommendation Without Amendment",13,0,0,0,13
1757710,1331655,2023-05-23,House,"House Third Reading: Given Immediate Effect Roll Call # 120",90,16,0,0,106
1757710,1355337,2023-09-26,Senate,"Reported Favorably Without Amendment",4,0,0,0,4
1757710,1355717,2023-10-04,Senate,"Senate Third Reading: Given Immediate Effect Roll Call # 491",31,7,0,0,38
1757738,1326264,2023-05-16,House,"Reported With Recommendation Without Amendment",13,0,0,0,13
1757738,1331401,2023-05-23,House,"House Third Reading: Given Immediate Effect Roll Call # 119",88,18,0,0,106
1757738,1355327,2023-09-26,Senate,"Reported Favorably With Substitute S-1",4,0,0,0,4
1757738,1355723,2023-10-04,Senate,"Senate Third Reading: Given Immediate Effect Roll Call # 490",31,7,0,0,38
1757738,1355888,2023-10-10,House,"House Third Reading: Roll Call # 344",94,16,0,0,110
1758633,1348024,2023-06-27,Senate,"Reported Favorably Without Amendment",8,1,0,0,9
1758633,1348025,2023-06-27,Senate,"Senate Third Reading: Passed Roll Call # 407",36,0,0,2,38
1758653,1332935,2023-05-24,Senate,"Reported Favorably Without Amendment",7,0,0,0,7
1758653,1332936,2023-05-24,Senate,"Senate Third Reading: Passed Roll Call # 321",29,9,0,0,38
1758653,1346502,2023-06-21,House,"Reported With Recommendation Without Amendment",12,1,0,0,13
1758653,1347270,2023-06-22,House,"House Third Reading: Given Immediate Effect Roll Call # 217",87,22,0,0,109
1758659,1321718,2023-05-09,Senate,"Reported Favorably With Substitute S-1",9,0,0,0,9
1758659,1324447,2023-05-11,Senate,"Senate Third Reading: Passed Roll Call # 265",25,13,0,0,38
1758659,1344086,2023-06-13,House,"Reported With Recommendation With Substitute H-1",12,0,0,0,12
1758659,1345537,2023-06-20,House,"House Third Reading: Given Immediate Effect Roll Call # 171",90,19,0,0,109
1758659,1350356,2023-06-27,Senate,"Senate Third Reading: Roll Call: Roll Call # 391",25,12,0,1,38
1758678,1413357,2024-03-20,Senate,"Reported Favorably With Substitute S-2",5,1,0,0,6
1758678,1427874,2024-04-16,Senate,"Senate Third Reading: Passed Roll Call # 96",21,15,0,2,38
1758678,1470105,2024-12-10,House,"Reported With Recommendation Without Amendment",9,4,0,0,13
1758682,1324382,2023-05-11,Senate,"Senate Third Reading: Passed Roll Call # 264",20,18,0,0,38
1758701,1350764,2023-04-25,House,"House Third Reading: Roll Call # 63",56,53,0,0,109
1758717,1347949,2023-06-21,Senate,"Reported Favorably With Substitute S-1",9,0,0,0,9
1758717,1350357,2023-06-27,Senate,"Senate Third Reading: Passed Roll Call # 405",25,12,0,1,38
1758717,1356196,2023-10-03,House,"Reported With Recommendation Without Amendment",7,4,0,0,11
1758717,1375338,2023-11-08,House,"House Third Reading: Roll Call # 499",54,53,0,0,107
1758765,1348275,2023-06-14,House,"Reported With Recommendation Without Amendment",3,1,0,0,4
1758765,1354452,2023-09-13,House,"House Third Reading: Given Immediate Effect Roll Call # 278",70,38,0,0,108
1758832,1348223,2023-06-14,House,"Reported With Recommendation Without Amendment",5,0,0,0,5
1758832,1354454,2023-09-13,House,"House Third Reading: Given Immediate Effect Roll Call # 279",89,19,0,0,108
1758854,1345703,2023-06-13,House,"Reported With Recommendation Without Amendment",12,0,0,0,12
1758854,1347087,2023-06-22,House,"House Third Reading: Given Immediate Effect Roll Call # 215",77,32,0,0,109
1758854,1347996,2023-06-27,Senate,"Senate Third Reading: Passed Roll Call # 399",22,15,0,1,38
1758858,1344343,2023-06-14,House,"House Third Reading: Given Immediate Effect Roll Call # 148",105,4,0,0,109
1758858,1399336,2023-11-09,Senate,"Senate Third Reading: Passed Roll Call # 730",36,0,0,2,38
1758894,1348031,2023-06-14,House,"Reported With Recommendation Without Amendment",5,0,0,0,5
1758894,1354455,2023-09-13,House,"House Third Reading: Given Immediate Effect Roll Call # 281",88,20,0,0,108
1758929,1348179,2023-06-14,House,"Reported With Recommendation Without Amendment",5,0,0,0,5
1758929,1355109,2023-09-13,House,"House Third Reading: Given Immediate Effect Roll Call # 280",87,21,0,0,108
1759300,1344174,2023-06-13,House,"Reported With Recommendation With Substitute H-2",11,0,0,0,11
1759300,1345783,2023-06-20,House,"House Third Reading: Given Immediate Effect Roll Call # 175",83,26,0,0,109
1759300,1357279,2023-11-02,Senate,"Reported Favorably With Substitute S-3",5,2,0,0,7
1759300,1393391,2023-11-09,House,"House Third Reading: Roll Call # 577",89,18,0,0,107
1759300,1399780,2023-11-09,Senate,"Senate Third Reading: Passed Roll Call # 722",24,13,0,1,38
1759332,1344231,2023-06-13,House,"Reported With Recommendation With Substitute H-1",9,0,0,0,9
1759332,1345915,2023-06-20,House,"House Third Reading: Given Immediate Effect Roll Call # 174",59,50,0,0,109
1759363,1343885,2023-06-13,House,"Reported With Recommendation With Substitute H-1",11,0,0,0,11
1759363,1345910,2023-06-20,House,"House Third Reading: Given Immediate Effect Roll Call # 176",82,27,0,0,109
1759363,1357319,2023-11-02,Senate,"Reported Favorably Without Amendment",5,2,0,0,7
1759363,1357572,2023-11-09,Senate,"Senate Third Reading: Passed Roll Call # 723",24,13,0,1,38
1759363,1394205,2023-11-09,House,"House Third Reading: Roll Call # 579",88,19,0,0,107
1759377,1344057,2023-06-13,House,"Reported With Recommendation With Substitute H-2",9,0,0,0,9
1759377,1345767,2023-06-20,House,"House Third Reading: Given Immediate Effect Roll Call # 173",59,50,0,0,109
1759534,1332937,2023-05-24,Senate,"Reported Favorably Without Amendment",7,0,0,0,7
1759534,1332938,2023-05-24,Senate,"Senate Third Reading: Passed Roll Call # 319",24,14,0,0,38
1759534,1346610,2023-06-21,House,"Reported With Recommendation Without Amendment",10,7,0,0,17
1759534,1353578,2023-06-27,House,"House Third Reading: Given Immediate Effect Roll Call # 234",56,52,0,0,108
1759550,1333005,2023-05-24,Senate,"Reported Favorably Without Amendment",7,0,0,0,7
1759550,1333006,2023-05-24,Senate,"Senate Third Reading: Passed Roll Call # 320",24,14,0,0,38
1759550,1347004,2023-06-21,House,"Reported With Recommendation Without Amendment",10,7,0,0,17
1759550,1347777,2023-06-27,House,"House Third Reading: Given Immediate Effect Roll Call # 235",56,52,0,0,108
1759633,1470451,2024-12-12,Senate,"Reported Favorably With Substitute S-2",4,0,0,0,4
1759633,1470452,2024-12-12,Senate,"Senate Third Reading: Passed Roll Call # 537",20,15,0,3,38
1759654,1470521,2024-12-12,Senate,"Reported Favorably With Substitute S-1",4,0,0,0,4
1759654,1470982,2024-12-12,Senate,"Senate Third Reading: Passed Roll Call # 538",20,15,0,3,38
1759677,1363242,2023-10-31,House,"Reported With Recommendation With Substitute H-1",7,4,0,0,11
1759677,1463233,2024-06-27,House,"House Third Reading: Given Immediate Effect Roll Call # 273",56,54,0,0,110
1759700,1363263,2023-10-31,House,"Reported With Recommendation With Substitute H-3",7,4,0,0,11
1759700,1463230,2024-06-27,House,"House Third Reading: Given Immediate Effect Roll Call # 274",58,52,0,0,110
1759703,1363310,2023-10-31,House,"Reported With Recommendation With Substitute H-1",7,5,0,0,12
1759709,1363250,2023-10-31,House,"Reported With Recommendation With Substitute H-1",7,5,0,0,12
1759709,1461731,2024-06-27,House,"House Third Reading: Given Immediate Effect Roll Call # 275",57,53,0,0,110
1759727,1448136,2024-05-22,House,"Reported With Recommendation With Substitute H-2",7,5,0,0,12
1759733,1363265,2023-10-31,House,"Reported With Recommendation Without Amendment",7,4,0,0,11
1759752,1356807,2023-10-31,House,"Reported With Recommendation Without Amendment",7,4,0,0,11
1759760,1470388,2024-12-12,House,"Reported With Recommendation With Substitute H-2",6,2,0,0,8
1760656,1331743,2023-05-18,House,"Reported With Recommendation Without Amendment",12,0,0,0,12
1760656,1343939,2023-06-13,House,"House Third Reading: Given Immediate Effect Roll Call # 145",80,27,0,0,107
1760656,1347130,2023-06-21,Senate,"Reported Favorably With Substitute S-2",8,0,0,0,8
1760656,1350580,2023-06-27,Senate,"Senate Third Reading: Given Immediate Effect Roll Call # 381",25,12,0,1,38
1760656,1353548,2023-06-27,House,"House Third Reading: Roll Call # 248",81,27,0,0,108
1760710,1343818,2023-05-30,House,"Reported With Recommendation With Substitute H-4",16,0,0,0,16
1760710,1343928,2023-06-13,House,"House Third Reading: Given Immediate Effect Roll Call # 146",83,24,0,0,107
1760710,1347097,2023-06-21,Senate,"Reported Favorably Without Amendment",8,0,0,0,8
1760710,1350732,2023-06-27,Senate,"Senate Third Reading: Given Immediate Effect Roll Call # 382",25,12,0,1,38
1760989,1330188,2023-05-18,Senate,"Reported Favorably With Substitute S-2",7,0,0,0,7
1760989,1335299,2023-05-23,Senate,"Senate Third Reading: Passed Roll Call # 318",38,0,0,0,38
1760989,1346917,2023-06-21,House,"Reported With Recommendation Without Amendment",15,0,0,0,15
1760989,1353718,2023-06-22,House,"House Third Reading: Given Immediate Effect Roll Call # 223",106,3,0,0,109
1761321,1356265,2023-10-10,Senate,"Reported Favorably With Substitute S-1",9,1,0,0,10
1761321,1356356,2023-10-19,Senate,"Senate Third Reading: Passed Roll Call # 558",23,15,0,0,38
1761321,1425808,2024-02-27,House,"Reported With Recommendation Without Amendment",10,1,0,0,11
1761321,1458138,2024-06-18,House,"House Third Reading: Given Immediate Effect Roll Call # 180",60,49,0,0,109
1761376,1433495,2024-04-24,House,"Reported With Recommendation Without Amendment",5,0,0,0,5
1761376,1433496,2024-04-24,House,"House Third Reading: Given Immediate Effect Roll Call # 38",104,3,0,0,107
1761376,1457211,2024-06-12,Senate,"Senate Third Reading: Passed Roll Call # 243",38,0,0,0,38
1761376,1468610,2024-05-23,Senate,"Reported Favorably Without Amendment",10,0,0,0,10
1761378,1346751,2023-06-20,House,"Reported With Recommendation Without Amendment",12,0,0,0,12
1761378,1353575,2023-06-27,House,"House Third Reading: Given Immediate Effect Roll Call # 230",99,9,0,0,108
1761378,1356581,2023-10-24,Senate,"Reported Favorably With Substitute S-1",7,0,0,0,7
1761378,1356798,2023-10-26,Senate,"Senate Third Reading: Passed Roll Call # 597",22,16,0,0,38
1761378,1357469,2023-11-02,House,"House Third Reading: Roll Call # 470",97,12,0,0,109
1761391,1348002,2023-06-07,House,"Reported With Recommendation Without Amendment",8,0,0,0,8
1761391,1356837,2023-10-31,House,"House Third Reading: Given Immediate Effect Roll Call # 424",68,42,0,0,110
1761391,1388904,2024-02-20,Senate,"Reported Favorably Without Amendment",5,1,0,0,6
1761391,1393449,2024-02-22,Senate,"Senate Third Reading: Given Immediate Effect Roll Call # 26",32,5,0,1,38
1761403,1341308,2023-06-07,House,"Reported With Recommendation With Substitute H-1",8,0,0,0,8
1761403,1356813,2023-10-31,House,"House Third Reading: Given Immediate Effect Roll Call # 425",74,36,0,0,110
1761403,1388932,2024-02-20,Senate,"Reported Favorably With Substitute S-1",5,1,0,0,6
1761403,1393448,2024-02-22,Senate,"Senate Third Reading: Given Immediate Effect Roll Call # 27",32,5,0,1,38
1761403,1441855,2024-05-09,House,"House Third Reading: Roll Call # 80",71,36,0,0,107
1761414,1332726,2023-05-24,House,"Reported With Recommendation With Substitute H-1",13,0,0,0,13
1761414,1356821,2023-10-31,House,"House Third Reading: Given Immediate Effect Roll Call # 422",99,11,0,0,110
1761414,1388974,2024-02-20,Senate,"Reported Favorably Without Amendment",5,1,0,0,6
1761414,1393453,2024-02-22,Senate,"Senate Third Reading: Given Immediate Effect Roll Call # 24",35,2,0,1,38
1761419,1331701,2023-05-23,House,"Reported With Recommendation Without Amendment",13,0,0,0,13
1761419,1341349,2023-06-07,House,"House Third Reading: Given Immediate Effect Roll Call # 141",103,3,0,0,106
1761419,1356109,2023-10-03,Senate,"Reported Favorably Without Amendment",7,0,0,0,7
1761419,1356343,2023-10-19,Senate,"Senate Third Reading: Passed Roll Call # 554",38,0,0,0,38
1761423,1355229,2023-09-19,House,"Reported With Recommendation With Substitute H-1",11,0,0,0,11
1761423,1356080,2023-09-27,House,"House Third Reading: Given Immediate Effect Roll Call # 317",74,36,0,0,110
1761423,1389618,2024-02-14,Senate,"Reported Favorably Without Amendment",6,4,0,0,10
1761425,1346714,2023-06-20,House,"Reported With Recommendation Without Amendment",12,0,0,0,12
1761425,1353554,2023-06-27,House,"House Third Reading: Given Immediate Effect Roll Call # 229",97,11,0,0,108
1761425,1356611,2023-10-24,Senate,"Reported Favorably With Substitute S-1",7,0,0,0,7
1761425,1357465,2023-11-02,House,"House Third Reading: Roll Call # 469",97,12,0,0,109
1761425,1398819,2023-10-26,Senate,"Senate Third Reading: Passed Roll Call # 596",22,16,0,0,38
1761432,1355984,2023-10-12,House,"Reported With Recommendation With Substitute H-1",19,0,0,0,19
1761432,1438316,2024-05-02,House,"House Third Reading: Given Immediate Effect Roll Call # 53",97,7,0,0,104
1761436,1348000,2023-06-07,House,"Reported With Recommendation With Substitute H-1",8,0,0,0,8
1761436,1356827,2023-10-31,House,"House Third Reading: Given Immediate Effect Roll Call # 423",68,42,0,0,110
1761436,1388896,2024-02-20,Senate,"Reported Favorably With Substitute S-1",5,1,0,0,6
1761436,1393455,2024-02-22,Senate,"Senate Third Reading: Given Immediate Effect Roll Call # 25",34,3,0,1,38
1761436,1441760,2024-05-09,House,"House Third Reading: Roll Call # 79",67,40,0,0,107
1761457,1363247,2023-10-12,House,"Reported With Recommendation With Substitute H-1",18,0,0,0,18
1761457,1437963,2024-05-02,House,"House Third Reading: Given Immediate Effect Roll Call # 52",91,13,0,0,104
1761465,1326178,2023-05-16,House,"Reported With Recommendation Without Amendment",12,0,0,0,12
1761465,1344393,2023-06-14,House,"House Third Reading: Given Immediate Effect Roll Call # 151",79,30,0,0,109
1761465,1356705,2023-10-25,Senate,"Reported Favorably Without Amendment",9,2,0,0,11
1761465,1356857,2023-11-01,Senate,"Senate Third Reading: Passed Roll Call # 631",24,14,0,0,38
1761468,1355201,2023-09-19,House,"Reported With Recommendation Without Amendment",11,0,0,0,11
1761468,1355321,2023-09-27,House,"House Third Reading: Given Immediate Effect Roll Call # 316",68,42,0,0,110
1761468,1388453,2024-02-14,Senate,"Reported Favorably Without Amendment",6,4,0,0,10
1761468,1408943,2024-03-13,Senate,"Senate Third Reading: Passed Roll Call # 55",21,17,0,0,38
1762538,1363315,2023-09-13,House,"Reported With Recommendation With Substitute H-1",7,0,0,0,7
1762590,1425132,2024-02-07,House,"Reported With Recommendation With Substitute H-5",11,6,0,0,17
1762590,1469967,2024-12-10,House,"House Third Reading: Given Immediate Effect Roll Call # 396",56,52,0,0,108
1762641,1354078,2023-09-13,House,"Reported With Recommendation With Substitute H-1",7,0,0,0,7
1762658,1356430,2023-09-19,House,"Reported With Recommendation With Substitute H-1",6,0,0,0,6
1763476,1354473,2023-09-13,Senate,"Reported Favorably With Substitute S-1",7,0,0,0,7
1763476,1357198,2023-10-25,House,"Reported With Recommendation Without Amendment",13,0,0,0,13
1763476,1357871,2023-11-08,House,"House Third Reading: Given Immediate Effect Roll Call # 510",77,32,0,0,109
1763476,1362851,2023-09-26,Senate,"Senate Third Reading: Passed Roll Call # 454",38,0,0,0,38
1763483,1348017,2023-06-14,House,"Reported With Recommendation Without Amendment",5,0,0,0,5
1763483,1354457,2023-09-13,House,"House Third Reading: Given Immediate Effect Roll Call # 282",90,18,0,0,108
1763490,1355591,2023-09-13,House,"Reported With Recommendation Without Amendment",7,0,0,0,7
1763490,1355802,2023-10-04,House,"House Third Reading: Given Immediate Effect Roll Call # 332",75,33,0,0,108
1763490,1367154,2023-10-12,Senate,"Senate Third Reading: Given Immediate Effect Roll Call # 530",37,0,0,1,38
1763515,1346127,2023-06-21,Senate,"Reported Favorably With Substitute S-1",8,0,0,0,8
1763515,1348803,2023-06-28,Senate,"Senate Third Reading: Passed Roll Call # 421",37,0,0,1,38
1763515,1355306,2023-09-19,House,"Reported With Recommendation With Amendment(s)",8,0,0,0,8
1763515,1355344,2023-09-28,House,"House Third Reading: Given Immediate Effect Roll Call # 326",103,5,0,0,108
1763515,1355936,2023-10-03,Senate,"Senate Third Reading: House Amendment(s) Concurred In Roll Call # 487",38,0,0,0,38
1763531,1470688,2024-12-11,Senate,"Reported Favorably Without Amendment",8,3,0,0,11
1763550,1331662,2023-05-23,House,"Reported With Recommendation With Substitute H-1",10,1,0,0,11
1763559,1348093,2023-06-14,House,"Reported With Recommendation Without Amendment",5,0,0,0,5
1763559,1355119,2023-09-13,House,"House Third Reading: Given Immediate Effect Roll Call # 283",92,16,0,0,108
1763577,1355615,2023-09-13,House,"Reported With Recommendation With Substitute H-1",7,0,0,0,7
1763577,1355804,2023-10-04,House,"House Third Reading: Given Immediate Effect Roll Call # 333",76,32,0,0,108
1763577,1367146,2023-10-12,Senate,"Senate Third Reading: Given Immediate Effect Roll Call # 531",37,0,0,1,38
1763590,1363312,2023-10-17,House,"Reported With Recommendation With Substitute H-1",6,3,0,0,9
1763590,1470378,2024-12-12,House,"House Third Reading: Given Immediate Effect Roll Call # 472",56,53,0,0,109
1763598,1355151,2023-09-21,Senate,"Reported Favorably Without Amendment",8,0,0,0,8
1763598,1355296,2023-09-27,Senate,"Senate Third Reading: Passed Roll Call # 476",38,0,0,0,38
1763598,1355963,2023-10-11,House,"Reported With Recommendation Without Amendment",20,3,0,0,23
1763598,1355964,2023-10-12,House,"House Third Reading: Given Immediate Effect Roll Call # 357",78,32,0,0,110
1763604,1331706,2023-05-23,House,"Reported With Recommendation Without Amendment",9,0,0,0,9
1763604,1332990,2023-05-24,House,"House Third Reading: Given Immediate Effect Roll Call # 121",104,3,0,0,107
1763604,1341785,2023-06-08,Senate,"Reported Favorably Without Amendment",4,0,0,0,4
1763604,1341786,2023-06-08,Senate,"Senate Third Reading: Given Immediate Effect Roll Call # 328",38,0,0,0,38
1763611,1470624,2024-12-11,Senate,"Reported Favorably With Substitute S-1",8,3,0,0,11
1764780,1334114,2023-05-25,Senate,"Reported Favorably With Substitute S-2",7,0,0,0,7
1764780,1340768,2023-06-07,Senate,"Senate Third Reading: Passed Roll Call # 327",22,16,0,0,38
1764780,1346545,2023-06-20,House,"Reported With Recommendation Without Amendment",6,2,0,0,8
1764780,1347721,2023-06-27,House,"House Third Reading: Given Immediate Effect Roll Call # 238",56,52,0,0,108
1764896,1347956,2023-06-21,House,"Reported With Recommendation With Substitute H-1",13,1,0,0,14
1764896,1348784,2023-06-28,House,"House Third Reading: Given Immediate Effect Roll Call # 261",85,23,0,0,108
1764896,1356084,2023-10-10,Senate,"Reported Favorably With Substitute S-1",8,1,0,0,9
1764896,1356276,2023-10-18,Senate,"Senate Third Reading: Given Immediate Effect Roll Call # 543",32,6,0,0,38
1764896,1363241,2023-10-24,House,"House Third Reading: Roll Call # 392",80,29,0,0,109
1764920,1470060,2024-12-03,House,"Reported With Recommendation Without Amendment",8,4,0,0,12
1764923,1343531,2023-06-06,House,"Reported With Recommendation Without Amendment",6,2,0,0,8
1764923,1347977,2023-06-27,House,"House Third Reading: Given Immediate Effect Roll Call # 227",56,52,0,0,108
1764923,1357228,2023-11-02,Senate,"Senate Third Reading: Passed Roll Call # 653",20,18,0,0,38
1764923,1357777,2023-11-02,Senate,"Reported Favorably With Substitute S-2",5,2,0,0,7
1764923,1381682,2023-11-08,House,"House Third Reading: Roll Call # 503",56,53,0,0,109
1764935,1363329,2023-09-26,House,"Reported With Recommendation With Substitute H-1",6,1,0,0,7
1764949,1470020,2024-12-03,House,"Reported With Recommendation Without Amendment",8,4,0,0,12
1765002,1357297,2023-10-31,House,"Reported With Recommendation With Substitute H-1",11,0,0,0,11
1765002,1357499,2023-11-09,House,"House Third Reading: Given Immediate Effect Roll Call # 560",58,49,0,0,107
1765002,1425103,2024-03-14,Senate,"Reported Favorably Without Amendment",10,0,0,0,10
1765002,1443561,2024-05-15,Senate,"Senate Third Reading: Passed Roll Call # 198",35,1,0,2,38
1765007,1348032,2023-06-06,House,"Reported With Recommendation Without Amendment",6,2,0,0,8
1765007,1356052,2023-09-27,House,"House Third Reading: Given Immediate Effect Roll Call # 324",56,54,0,0,110
1765007,1356918,2023-11-02,Senate,"Senate Third Reading: Passed Roll Call # 654",20,18,0,0,38
1765007,1357770,2023-11-02,Senate,"Reported Favorably Without Amendment",5,2,0,0,7
1765014,1346097,2023-06-13,House,"Reported With Recommendation Without Amendment",14,0,0,0,14
1765014,1353550,2023-06-22,House,"House Third Reading: Given Immediate Effect Roll Call # 222",100,9,0,0,109
1765014,1356107,2023-10-10,Senate,"Reported Favorably Without Amendment",10,0,0,0,10
1765014,1356341,2023-10-19,Senate,"Senate Third Reading: Given Immediate Effect Roll Call # 555",36,2,0,0,38
1765018,1470019,2024-12-03,House,"Reported With Recommendation Without Amendment",8,4,0,0,12
1765030,1348063,2023-06-06,House,"Reported With Recommendation With Substitute H-1",6,2,0,0,8
1765030,1356033,2023-09-27,House,"House Third Reading: Given Immediate Effect Roll Call # 322",56,54,0,0,110
1765030,1356034,2023-10-12,Senate,"Reported Favorably Without Amendment",8,0,0,0,8
1765030,1356442,2023-10-24,Senate,"Senate Third Reading: Passed Roll Call # 581",20,18,0,0,38
1765046,1469631,2024-12-03,House,"Reported With Recommendation With Substitute H-1",8,4,0,0,12
1765066,1469580,2024-12-03,House,"Reported With Recommendation With Substitute H-2",8,4,0,0,12
1765073,1340367,2023-06-06,House,"Reported With Recommendation Without Amendment",6,2,0,0,8
1765073,1355506,2023-09-27,House,"House Third Reading: Given Immediate Effect Roll Call # 323",56,54,0,0,110
1765073,1356038,2023-10-12,Senate,"Reported Favorably Without Amendment",6,1,0,0,7
1765073,1356448,2023-10-24,Senate,"Senate Third Reading: Passed Roll Call # 585",20,18,0,0,38
1765091,1357303,2023-10-31,House,"Reported With Recommendation Without Amendment",11,0,0,0,11
1765091,1357487,2023-11-09,House,"House Third Reading: Given Immediate Effect Roll Call # 559",57,50,0,0,107
1765091,1412446,2024-03-14,Senate,"Reported Favorably With Substitute S-4",10,0,0,0,10
1765091,1445722,2024-05-15,Senate,"Senate Third Reading: Passed Roll Call # 197",35,1,0,2,38
1765091,1445723,2024-05-21,House,"House Third Reading: Roll Call # 113",98,9,0,0,107
1765803,1347998,2023-06-22,House,"Reported With Recommendation With Substitute H-4",5,1,0,0,6
1765803,1355800,2023-10-04,House,"House Third Reading: Given Immediate Effect Roll Call # 340",69,39,0,0,108
1765803,1424999,2024-03-06,Senate,"Reported Favorably Without Amendment",4,3,0,0,7
1765803,1428113,2024-04-16,Senate,"Senate Third Reading: Passed Roll Call # 95",23,13,0,2,38
1765852,1331672,2023-05-23,House,"Reported With Recommendation With Substitute H-1",6,2,0,0,8
1765894,1347275,2023-06-22,House,"Reported With Recommendation Without Amendment",16,0,0,0,16
1766239,1355326,2023-09-12,House,"Reported With Recommendation Without Amendment",11,0,0,0,11
1766333,1355336,2023-09-12,House,"Reported With Recommendation Without Amendment",11,0,0,0,11
1766376,1346718,2023-06-20,House,"Reported With Recommendation Without Amendment",13,0,0,0,13
1766376,1353555,2023-06-27,House,"House Third Reading: Given Immediate Effect Roll Call # 233",108,0,0,0,108
1766376,1355820,2023-09-28,Senate,"Reported Favorably Without Amendment",3,0,0,0,3
1766376,1355887,2023-10-10,Senate,"Senate Third Reading: Given Immediate Effect Roll Call # 505",38,0,0,0,38
1767472,1348047,2023-06-14,Senate,"Reported Favorably Without Amendment",7,3,0,0,10
1767476,1356357,2023-10-19,Senate,"Reported Favorably With Substitute S-1",17,2,0,0,19
1767476,1407911,2023-10-26,Senate,"Senate Third Reading: Passed Roll Call # 598",32,6,0,0,38
1767476,1407912,2024-03-06,House,"Reported With Recommendation Without Amendment",16,11,0,0,27
1767476,1461342,2024-06-26,House,"House Third Reading: Given Immediate Effect Roll Call # 243",56,53,0,0,109
1767479,1356099,2023-10-12,Senate,"Reported Favorably Without Amendment",7,0,0,0,7
1767479,1356254,2023-10-18,Senate,"Senate Third Reading: Passed Roll Call # 546",26,12,0,0,38
1767479,1448524,2024-05-22,House,"Reported With Recommendation Without Amendment",9,0,0,0,9
1767479,1467573,2024-09-25,House,"House Third Reading: Given Immediate Effect Roll Call # 322",83,26,0,0,109
1767496,1348085,2023-06-14,Senate,"Reported Favorably Without Amendment",7,3,0,0,10
1767505,1460976,2024-06-26,Senate,"Senate Third Reading: Passed Roll Call # 314",28,10,0,0,38
1767505,1469365,2024-11-13,House,"Reported With Recommendation With Substitute H-1",11,0,0,0,11
1767505,1470052,2024-12-10,House,"House Third Reading: Given Immediate Effect Roll Call # 384",57,50,0,0,107
1767505,1470119,2024-12-11,Senate,"Senate Third Reading: Roll Call: Roll Call # 501",25,11,0,2,38
1767510,1470871,2024-12-13,Senate,"Senate Third Reading: Passed Roll Call # 601",33,0,0,5,38
1767531,1425865,2023-09-19,House,"Reported With Recommendation Without Amendment",9,0,0,0,9
1767545,1348220,2023-06-21,House,"Reported With Recommendation With Substitute H-1",10,0,0,0,10
1767545,1348691,2023-06-28,House,"House Third Reading: Given Immediate Effect Roll Call # 254",84,24,0,0,108
1767545,1355831,2023-09-28,Senate,"Reported Favorably Without Amendment",7,3,0,0,10
1767545,1355946,2023-10-12,House,"House Third Reading: Roll Call # 348",84,26,0,0,110
1767545,1364302,2023-10-10,Senate,"Senate Third Reading: Passed Roll Call # 508",25,13,0,0,38
1767546,1355956,2023-09-19,House,"Reported With Recommendation Without Amendment",13,0,0,0,13
1767546,1362939,2023-10-17,House,"House Third Reading: Given Immediate Effect Roll Call # 373",92,18,0,0,110
1767546,1400013,2023-11-08,Senate,"Senate Third Reading: Passed Roll Call # 685",28,7,0,3,38
1767549,1346421,2023-06-21,House,"Reported With Recommendation Without Amendment",13,0,0,0,13
1767549,1347978,2023-06-27,House,"House Third Reading: Given Immediate Effect Roll Call # 244",104,4,0,0,108
1767549,1356300,2023-10-17,Senate,"Reported Favorably Without Amendment",7,0,0,0,7
1767549,1356409,2023-10-24,Senate,"Senate Third Reading: Passed Roll Call # 587",38,0,0,0,38
1767550,1363246,2023-09-26,House,"Reported With Recommendation Without Amendment",9,0,0,0,9
1767553,1363260,2023-09-26,House,"Reported With Recommendation With Substitute H-1",8,0,0,0,8
1767554,1363326,2023-10-24,House,"Reported With Recommendation Without Amendment",15,0,0,0,15
1767554,1382685,2024-02-07,House,"House Third Reading: Given Immediate Effect Roll Call # 5",100,6,0,0,106
1767554,1457100,2024-06-13,Senate,"Reported Favorably Without Amendment",4,0,0,0,4
1767554,1459771,2024-06-25,Senate,"Senate Third Reading: Given Immediate Effect Roll Call # 275",38,0,0,0,38
1767556,1390200,2024-02-20,House,"Reported With Recommendation With Substitute H-2",14,0,0,0,14
1767556,1408648,2024-03-13,House,"House Third Reading: Given Immediate Effect Roll Call # 25",95,11,0,0,106
1767556,1468587,2024-06-18,Senate,"Senate Third Reading: Passed Roll Call # 248",37,1,0,0,38
1767556,1468611,2024-05-23,Senate,"Reported Favorably Without Amendment",10,0,0,0,10
1767564,1355929,2023-09-26,House,"Reported With Recommendation With Substitute H-1",8,5,0,0,13
1767564,1362672,2023-10-17,House,"House Third Reading: Given Immediate Effect Roll Call # 369",58,52,0,0,110
1767564,1397447,2023-11-08,Senate,"Senate Third Reading: Passed Roll Call # 681",25,10,0,3,38
1767566,1347724,2023-06-21,House,"Reported With Recommendation Without Amendment",13,0,0,0,13
1767566,1347725,2023-06-27,House,"House Third Reading: Given Immediate Effect Roll Call # 245",104,4,0,0,108
1767566,1356167,2023-10-17,Senate,"Reported Favorably Without Amendment",7,0,0,0,7
1767566,1356422,2023-10-24,Senate,"Senate Third Reading: Passed Roll Call # 588",38,0,0,0,38
1767568,1343449,2023-06-08,House,"Reported With Recommendation Without Amendment",11,0,0,0,11
1767568,1344447,2023-06-14,House,"House Third Reading: Given Immediate Effect Roll Call # 168",56,53,0,0,109
1767568,1350576,2023-06-27,Senate,"Senate Third Reading: Passed Roll Call # 414",21,15,0,2,38
1767571,1363258,2023-09-19,House,"Reported With Recommendation With Substitute H-1",8,0,0,0,8
1767575,1354970,2023-09-19,House,"Reported With Recommendation Without Amendment",13,0,0,0,13
1767578,1348016,2023-06-21,House,"Reported With Recommendation Without Amendment",10,0,0,0,10
1767578,1348660,2023-06-28,House,"House Third Reading: Given Immediate Effect Roll Call # 253",67,41,0,0,108
1767578,1355342,2023-09-28,Senate,"Reported Favorably Without Amendment",7,3,0,0,10
1767578,1363862,2023-10-10,Senate,"Senate Third Reading: Passed Roll Call # 507",23,15,0,0,38
1767583,1363318,2023-09-12,House,"Reported With Recommendation Without Amendment",12,0,0,0,12
1767583,1432465,2024-04-23,House,"House Third Reading: Given Immediate Effect Roll Call # 37",83,24,0,0,107
1767589,1363325,2023-10-24,House,"Reported With Recommendation Without Amendment",15,0,0,0,15
1767589,1382614,2024-02-07,House,"House Third Reading: Given Immediate Effect Roll Call # 4",105,1,0,0,106
1767589,1457056,2024-06-13,Senate,"Reported Favorably With Substitute S-1",4,0,0,0,4
1767589,1459817,2024-06-25,Senate,"Senate Third Reading: Given Immediate Effect Roll Call # 274",38,0,0,0,38
1767589,1461733,2024-06-27,House,"House Third Reading: Roll Call # 290",110,0,0,0,110
1767591,1355930,2023-09-26,House,"Reported With Recommendation With Substitute H-2",8,0,0,0,8
1767591,1362673,2023-10-17,House,"House Third Reading: Given Immediate Effect Roll Call # 368",85,25,0,0,110
1767591,1470513,2024-12-12,Senate,"Senate Third Reading: Passed Roll Call # 517",26,10,0,2,38
1767596,1363259,2023-09-26,House,"Reported With Recommendation With Substitute H-2",8,0,0,0,8
1767599,1355938,2023-09-26,House,"Reported With Recommendation With Substitute H-1",8,0,0,0,8
1767599,1357270,2023-11-08,Senate,"Senate Third Reading: Passed Roll Call # 677",23,14,0,1,38
1767599,1362676,2023-10-17,House,"House Third Reading: Given Immediate Effect Roll Call # 364",72,38,0,0,110
1767610,1354971,2023-09-19,House,"Reported With Recommendation With Substitute H-1",8,3,0,0,11
1767611,1355958,2023-09-19,House,"Reported With Recommendation With Substitute H-1",8,5,0,0,13
1767611,1362944,2023-10-17,House,"House Third Reading: Given Immediate Effect Roll Call # 371",56,54,0,0,110
1767611,1400432,2023-11-08,Senate,"Senate Third Reading: Passed Roll Call # 683",26,9,0,3,38
1767614,1348113,2023-06-21,House,"Reported With Recommendation With Substitute H-1",10,0,0,0,10
1767614,1348742,2023-06-28,House,"House Third Reading: Given Immediate Effect Roll Call # 257",59,49,0,0,108
1767614,1355815,2023-09-28,Senate,"Reported Favorably Without Amendment",6,4,0,0,10
1767614,1357909,2023-10-10,Senate,"Senate Third Reading: Passed Roll Call # 511",20,18,0,0,38
1767616,1355932,2023-09-26,House,"Reported With Recommendation With Substitute H-1",8,0,0,0,8
1767616,1356179,2023-10-17,House,"House Third Reading: Given Immediate Effect Roll Call # 365",67,43,0,0,110
1767616,1357290,2023-11-08,Senate,"Senate Third Reading: Passed Roll Call # 678",24,13,0,1,38
1767622,1347073,2023-06-22,House,"Reported With Recommendation Without Amendment",13,0,0,0,13
1767622,1362783,2023-10-19,House,"House Third Reading: Given Immediate Effect Roll Call # 390",63,46,0,0,109
1767622,1402786,2024-02-29,Senate,"Reported Favorably Without Amendment",8,1,0,0,9
1767622,1425034,2024-04-10,Senate,"Senate Third Reading: Passed Roll Call # 90",26,11,0,1,38
1767625,1356796,2023-09-13,House,"Reported With Recommendation With Substitute H-2",7,0,0,0,7
1767625,1357291,2023-11-08,House,"House Third Reading: Given Immediate Effect Roll Call # 494",88,21,0,0,109
1767625,1372270,2023-11-02,House,"House Third Reading: Adverse Roll Call",7,1,0,0,8
1767625,1372271,2023-11-02,House,"House Third Reading: Roll Call # 477",52,51,0,0,103
1767628,1363245,2023-09-26,House,"Reported With Recommendation With Substitute H-1",8,0,0,0,8
1767636,1355985,2023-09-19,House,"Reported With Recommendation Without Amendment",13,0,0,0,13
1767636,1362674,2023-10-17,House,"House Third Reading: Given Immediate Effect Roll Call # 374",90,20,0,0,110
1767636,1400382,2023-11-08,Senate,"Senate Third Reading: Passed Roll Call # 686",28,7,0,3,38
1767638,1347632,2023-06-21,House,"Reported With Recommendation Without Amendment",13,0,0,0,13
1767638,1348020,2023-06-27,House,"House Third Reading: Given Immediate Effect Roll Call # 243",104,4,0,0,108
1767638,1356188,2023-10-17,Senate,"Reported Favorably Without Amendment",7,0,0,0,7
1767638,1356432,2023-10-24,Senate,"Senate Third Reading: Passed Roll Call # 586",38,0,0,0,38
1767643,1347992,2023-06-21,House,"Reported With Recommendation With Substitute H-1",10,0,0,0,10
1767643,1348779,2023-06-28,House,"House Third Reading: Given Immediate Effect Roll Call # 256",64,44,0,0,108
1767643,1355818,2023-09-28,Senate,"Reported Favorably Without Amendment",7,3,0,0,10
1767643,1363984,2023-10-10,Senate,"Senate Third Reading: Passed Roll Call # 510",21,17,0,0,38
1767645,1355933,2023-09-19,House,"Reported With Recommendation Without Amendment",13,0,0,0,13
1767645,1362671,2023-10-17,House,"House Third Reading: Given Immediate Effect Roll Call # 372",92,18,0,0,110
1767645,1397472,2023-11-08,Senate,"Senate Third Reading: Passed Roll Call # 684",28,7,0,3,38
1767646,1355778,2023-09-26,House,"Reported With Recommendation Without Amendment",15,0,0,0,15
1767646,1362278,2023-10-10,House,"House Third Reading: Given Immediate Effect Roll Call # 343",60,50,0,0,110
1767646,1454755,2024-06-06,Senate,"Reported Favorably Without Amendment",10,0,0,0,10
1767646,1461211,2024-06-26,Senate,"Senate Third Reading: Given Immediate Effect Roll Call # 284",37,1,0,0,38
1767648,1363319,2023-09-19,House,"Reported With Recommendation Without Amendment",13,0,0,0,13
1767655,1355942,2023-09-26,House,"Reported With Recommendation With Substitute H-1",8,2,0,0,10
1767655,1357429,2023-11-08,Senate,"Senate Third Reading: Passed Roll Call # 680",26,11,0,1,38
1767655,1362689,2023-10-17,House,"House Third Reading: Given Immediate Effect Roll Call # 367",61,49,0,0,110
1767661,1347989,2023-06-21,House,"Reported With Recommendation With Substitute H-1",10,0,0,0,10
1767661,1348702,2023-06-28,House,"House Third Reading: Given Immediate Effect Roll Call # 255",74,34,0,0,108
1767661,1355827,2023-09-28,Senate,"Reported Favorably Without Amendment",7,2,0,0,9
1767661,1364305,2023-10-10,Senate,"Senate Third Reading: Passed Roll Call # 509",23,14,1,0,38
1767663,1343393,2023-06-08,House,"Reported With Recommendation Without Amendment",11,0,0,0,11
1767663,1344386,2023-06-14,House,"House Third Reading: Given Immediate Effect Roll Call # 167",56,53,0,0,109
1767663,1348018,2023-06-27,Senate,"Senate Third Reading: Passed Roll Call # 411",21,15,0,2,38
1767665,1356787,2023-09-13,House,"Reported With Recommendation With Substitute H-2",7,0,0,0,7
1767665,1357253,2023-11-08,House,"House Third Reading: Given Immediate Effect Roll Call # 495",88,21,0,0,109
1767667,1348609,2023-06-13,House,"Reported With Recommendation Without Amendment",13,0,0,0,13
1767669,1355801,2023-09-19,House,"Reported With Recommendation With Substitute H-3",8,0,0,0,8
1767671,1355934,2023-09-26,House,"Reported With Recommendation With Substitute H-1",8,0,0,0,8
1767671,1357243,2023-11-08,Senate,"Senate Third Reading: Passed Roll Call # 679",26,11,0,1,38
1767671,1362675,2023-10-17,House,"House Third Reading: Given Immediate Effect Roll Call # 366",74,36,0,0,110
1767673,1355959,2023-09-19,House,"Reported With Recommendation With Substitute H-1",8,0,0,0,8
1767673,1357790,2023-11-08,Senate,"Senate Third Reading: Passed Roll Call # 682",25,10,0,3,38
1767673,1362945,2023-10-17,House,"House Third Reading: Given Immediate Effect Roll Call # 370",58,52,0,0,110
1767843,1345066,2023-06-14,Senate,"Reported Favorably Without Amendment",7,3,0,0,10
1767843,1345067,2023-06-14,Senate,"Senate Third Reading: Passed Roll Call # 357",23,15,0,0,38
1767843,1355923,2023-09-28,House,"House Third Reading: Adverse Roll Call",8,0,0,0,8
1767843,1355924,2023-10-05,House,"Reported With Recommendation Without Amendment",9,0,0,0,9
1767843,1355987,2023-10-12,House,"House Third Reading: Given Immediate Effect Roll Call # 361",56,54,0,0,110
1767873,1347034,2023-06-14,Senate,"Senate Third Reading: Passed Roll Call # 356",23,15,0,0,38
1767873,1347035,2023-06-14,Senate,"Reported Favorably Without Amendment",7,3,0,0,10
1767873,1347036,2023-06-14,Senate,"Senate Third Reading: Passed Roll Call # 356",23,15,0,0,38
1767873,1355951,2023-09-28,House,"House Third Reading: Adverse Roll Call",8,0,0,0,8
1767873,1355952,2023-10-05,House,"Reported With Recommendation Without Amendment",9,0,0,0,9
1767873,1355953,2023-10-12,House,"House Third Reading: Given Immediate Effect Roll Call # 360",56,54,0,0,110
1767886,1344548,2023-06-14,Senate,"Reported Favorably Without Amendment",7,3,0,0,10
1767886,1344549,2023-06-14,Senate,"Senate Third Reading: Passed Roll Call # 358",23,15,0,0,38
1767886,1355957,2023-09-28,House,"Reported With Recommendation With Substitute H-1",9,0,0,0,9
1767886,1355982,2023-10-12,House,"House Third Reading: Given Immediate Effect Roll Call # 362",56,54,0,0,110
1767886,1356293,2023-10-18,Senate,"Senate Third Reading: Roll Call: Roll Call # 535",22,16,0,0,38
1767899,1469066,2024-10-24,Senate,"Reported Favorably With Substitute S-3",6,0,0,0,6
1767899,1469719,2024-12-04,Senate,"Senate Third Reading: Passed Roll Call # 426",36,0,0,2,38
1768185,1347970,2023-06-21,Senate,"Reported Favorably With Substitute S-1",8,0,0,0,8
1768185,1348782,2023-06-28,Senate,"Senate Third Reading: Passed Roll Call # 422",37,0,0,1,38
1768185,1355307,2023-09-19,House,"Reported With Recommendation Without Amendment",8,0,0,0,8
1768185,1355922,2023-09-28,House,"House Third Reading: Given Immediate Effect Roll Call # 327",103,5,0,0,108
1768190,1344650,2023-06-14,Senate,"Reported Favorably Without Amendment",7,3,0,0,10
1768190,1344651,2023-06-14,Senate,"Senate Third Reading: Passed Roll Call # 360",21,17,0,0,38
1768190,1346423,2023-06-20,House,"Reported With Recommendation Without Amendment",9,5,0,0,14
1768190,1346424,2023-06-20,House,"House Third Reading: Given Immediate Effect Roll Call # 170",56,53,0,0,109
1768241,1470336,2024-12-12,House,"Reported With Recommendation Without Amendment",7,0,0,0,7
1768241,1470525,2024-12-13,House,"House Third Reading: Given Immediate Effect Roll Call # 496",56,0,0,0,56
1768256,1348111,2023-06-13,House,"Reported With Recommendation With Substitute H-1",6,0,0,0,6
1768256,1357528,2023-11-09,House,"House Third Reading: Given Immediate Effect Roll Call # 563",104,3,0,0,107
1768256,1357529,2023-11-09,House,"House Third Reading: Given Immediate Effect Roll Call # 563",104,3,0,0,107
1768256,1388976,2024-02-14,Senate,"Reported Favorably With Substitute S-1",10,0,0,0,10
1768256,1389992,2024-02-21,Senate,"Senate Third Reading: Passed Roll Call # 20",36,0,0,2,38
1768256,1407986,2024-03-12,House,"House Third Reading: Roll Call # 23",102,4,0,0,106
1768283,1348130,2023-06-13,House,"Reported With Recommendation Without Amendment",6,0,0,0,6
1768283,1357517,2023-11-09,House,"House Third Reading: Given Immediate Effect Roll Call # 565",104,3,0,0,107
1768283,1389169,2024-02-14,Senate,"Reported Favorably Without Amendment",10,0,0,0,10
1768283,1390197,2024-02-21,Senate,"Senate Third Reading: Passed Roll Call # 22",37,0,0,1,38
1768350,1363268,2023-11-01,House,"Reported With Recommendation With Substitute H-1",7,0,0,0,7
1768350,1446479,2024-05-21,House,"House Third Reading: Given Immediate Effect Roll Call # 110",58,49,0,0,107
1768350,1470985,2024-12-12,Senate,"Reported Favorably With Substitute S-1",5,3,0,0,8
1768365,1425087,2024-02-22,House,"Reported With Recommendation Without Amendment",7,0,0,0,7
1768365,1469621,2024-12-03,House,"House Third Reading: Given Immediate Effect Roll Call # 367",104,1,0,0,105
1768409,1470329,2024-12-12,House,"Reported With Recommendation Without Amendment",7,1,0,0,8
1768409,1470494,2024-12-13,House,"House Third Reading: Given Immediate Effect Roll Call # 497",56,0,0,0,56
1768441,1348064,2023-06-13,House,"Reported With Recommendation Without Amendment",14,0,0,0,14
1768456,1363314,2023-11-01,House,"Reported With Recommendation Without Amendment",7,0,0,0,7
1768456,1445638,2024-05-21,House,"House Third Reading: Given Immediate Effect Roll Call # 111",58,49,0,0,107
1768456,1471010,2024-12-19,Senate,"Senate Third Reading: Passed Roll Call # 643",20,18,0,0,38
1768486,1470347,2024-12-12,House,"Reported With Recommendation Without Amendment",7,0,0,0,7
1768486,1470502,2024-12-13,House,"House Third Reading: Given Immediate Effect Roll Call # 498",56,0,0,0,56
1768531,1357247,2023-10-25,House,"Reported With Recommendation With Substitute H-2",8,5,0,0,13
1768580,1348008,2023-06-13,House,"Reported With Recommendation With Substitute H-1",6,0,0,0,6
1768580,1357507,2023-11-09,House,"House Third Reading: Given Immediate Effect Roll Call # 564",104,3,0,0,107
1768580,1389028,2024-02-14,Senate,"Reported Favorably Without Amendment",10,0,0,0,10
1768580,1390048,2024-02-21,Senate,"Senate Third Reading: Passed Roll Call # 21",36,0,0,2,38
1769210,1389300,2024-02-20,Senate,"Reported Favorably Without Amendment",14,0,0,0,14
1769210,1394026,2024-02-22,Senate,"Senate Third Reading: Passed Roll Call # 28",32,5,0,1,38
1769210,1465420,2024-06-27,House,"House Third Reading: Given Immediate Effect Roll Call # 277",89,21,0,0,110
1769210,1467672,2024-09-26,Senate,"Senate Third Reading: House Amendment(s) Concurred In Roll Call # 359",30,7,0,1,38
1769210,1467673,2024-09-26,Senate,"Senate Third Reading: House Amendment(s) Concurred In Roll Call # 359",30,7,0,1,38
1769212,1363324,2023-11-02,House,"Reported With Recommendation With Substitute H-2",7,1,0,0,8
1769256,1343986,2023-06-06,House,"Reported With Recommendation Without Amendment",12,0,0,0,12
1769256,1345803,2023-06-20,House,"House Third Reading: Given Immediate Effect Roll Call # 180",109,0,0,0,109
1769256,1348744,2023-06-28,Senate,"Senate Third Reading: Given Immediate Effect Roll Call # 423",37,0,0,1,38
1770241,1347013,2023-06-14,Senate,"Reported Favorably Without Amendment",7,3,0,0,10
1770241,1347014,2023-06-14,Senate,"Senate Third Reading: Passed Roll Call # 368",32,6,0,0,38
1770241,1354974,2023-09-19,House,"Reported With Recommendation With Substitute H-1",6,0,0,0,6
1770241,1355807,2023-10-04,House,"House Third Reading: Given Immediate Effect Roll Call # 338",100,8,0,0,108
1770241,1357419,2023-11-09,House,"House Third Reading: Passed Roll Call # 551",56,53,0,0,109
1770241,1357420,2023-11-09,Senate,"Senate Third Reading: Roll Call: Roll Call # 707",30,8,0,0,38
1770244,1344360,2023-06-14,Senate,"Reported Favorably Without Amendment",7,3,0,0,10
1770244,1344361,2023-06-14,Senate,"Senate Third Reading: Passed Roll Call # 365",30,8,0,0,38
1770244,1345946,2023-06-20,House,"Reported With Recommendation Without Amendment",6,2,0,0,8
1770244,1347707,2023-06-27,House,"House Third Reading: Given Immediate Effect Roll Call # 241",56,52,0,0,108
1770246,1344362,2023-06-14,Senate,"Reported Favorably Without Amendment",7,3,0,0,10
1770246,1344363,2023-06-14,Senate,"Senate Third Reading: Passed Roll Call # 362",30,8,0,0,38
1770249,1344684,2023-06-14,Senate,"Reported Favorably With Substitute S-1",7,3,0,0,10
1770249,1344685,2023-06-14,Senate,"Senate Third Reading: Passed Roll Call # 367",22,16,0,0,38
1770249,1346394,2023-06-20,House,"Reported With Recommendation Without Amendment",6,2,0,0,8
1770249,1348129,2023-06-27,House,"House Third Reading: Given Immediate Effect Roll Call # 242",56,52,0,0,108
1770249,1348627,2023-06-28,Senate,"Senate Third Reading: House Amendment(s) Concurred In Roll Call # 434",22,15,0,1,38
1770251,1344338,2023-06-14,Senate,"Reported Favorably With Substitute S-1",7,3,0,0,10
1770251,1344339,2023-06-14,Senate,"Senate Third Reading: Passed Roll Call # 363",30,8,0,0,38
1770256,1346651,2023-06-14,Senate,"Reported Favorably With Substitute S-2",7,3,0,0,10
1770256,1346652,2023-06-14,Senate,"Senate Third Reading: Passed Roll Call # 366",30,8,0,0,38
1770259,1344643,2023-06-14,Senate,"Reported Favorably With Substitute S-1",7,3,0,0,10
1770259,1344644,2023-06-14,Senate,"Senate Third Reading: Passed Roll Call # 361",22,16,0,0,38
1770259,1346563,2023-06-20,House,"Reported With Recommendation Without Amendment",6,2,0,0,8
1770259,1348026,2023-06-27,House,"House Third Reading: Given Immediate Effect Roll Call # 239",56,52,0,0,108
1770259,1348671,2023-06-28,Senate,"Senate Third Reading: Roll Call: Roll Call # 431",23,14,0,1,38
1770259,1348672,2023-06-28,Senate,"Senate Third Reading: Roll Call: Roll Call # 433",22,15,0,1,38
1770261,1345383,2023-06-14,Senate,"Reported Favorably With Substitute S-1",7,3,0,0,10
1770261,1345384,2023-06-14,Senate,"Senate Third Reading: Passed Roll Call # 364",21,17,0,0,38
1770261,1345951,2023-06-20,House,"Reported With Recommendation Without Amendment",6,2,0,0,8
1770261,1348004,2023-06-27,House,"House Third Reading: Given Immediate Effect Roll Call # 240",56,52,0,0,108
1770261,1348793,2023-06-28,Senate,"Senate Third Reading: House Amendment(s) Concurred In Roll Call # 432",21,16,0,1,38
1770269,1343934,2023-06-13,House,"Reported With Recommendation With Substitute H-2",6,0,0,0,6
1770269,1353105,2023-06-14,House,"House Third Reading: Given Immediate Effect Roll Call # 164",56,53,0,0,109
1770281,1344033,2023-06-13,House,"Reported With Recommendation Without Amendment",6,0,0,0,6
1770281,1344645,2023-06-14,House,"House Third Reading: Given Immediate Effect Roll Call # 166",62,47,0,0,109
1770281,1350581,2023-06-27,Senate,"Senate Third Reading: Passed Roll Call # 404",31,6,0,1,38
1770294,1344113,2023-06-13,House,"Reported With Recommendation Without Amendment",6,0,0,0,6
1770294,1348759,2023-06-28,Senate,"Senate Third Reading: Passed Roll Call # 435",29,8,0,1,38
1770294,1350649,2023-06-27,Senate,"Senate Third Reading: Passed Roll Call # 401",29,8,0,1,38
1770294,1353099,2023-06-14,House,"House Third Reading: Given Immediate Effect Roll Call # 160",56,53,0,0,109
1770294,1353587,2023-06-28,House,"House Third Reading: Roll Call # 266",56,52,0,0,108
1770308,1344124,2023-06-13,House,"Reported With Recommendation With Substitute H-2",6,0,0,0,6
1770308,1350575,2023-06-27,Senate,"Senate Third Reading: Passed Roll Call # 403",27,10,0,1,38
1770308,1353104,2023-06-14,House,"House Third Reading: Given Immediate Effect Roll Call # 163",56,53,0,0,109
1770335,1344115,2023-06-13,House,"Reported With Recommendation With Substitute H-1",6,0,0,0,6
1770335,1344355,2023-06-14,House,"House Third Reading: Given Immediate Effect Roll Call # 161",56,53,0,0,109
1770335,1348246,2023-06-27,Senate,"Senate Third Reading: Passed Roll Call # 402",28,9,0,1,38
1770350,1344116,2023-06-13,House,"Reported With Recommendation With Substitute H-1",6,0,0,0,6
1770350,1353100,2023-06-14,House,"House Third Reading: Given Immediate Effect Roll Call # 159",56,53,0,0,109
1770350,1357426,2023-11-09,Senate,"Reported Favorably With Substitute S-2",11,0,0,0,11
1770350,1357427,2023-11-09,Senate,"Senate Third Reading: Passed Roll Call # 727",21,16,0,1,38
1770350,1393437,2023-11-09,House,"House Third Reading: Roll Call # 580",56,51,0,0,107
1770362,1344117,2023-06-13,House,"Reported With Recommendation With Substitute H-1",6,0,0,0,6
1770362,1347250,2023-06-14,House,"House Third Reading: Given Immediate Effect Roll Call # 162",56,53,0,0,109
1770362,1470625,2024-12-13,Senate,"Senate Third Reading: Passed Roll Call # 607",33,0,0,5,38
1770376,1343931,2023-06-13,House,"Reported With Recommendation Without Amendment",6,0,0,0,6
1770376,1344344,2023-06-14,House,"House Third Reading: Given Immediate Effect Roll Call # 165",56,53,0,0,109
1770551,1457045,2024-06-13,Senate,"Reported Favorably With Substitute S-1",8,0,0,0,8
1770551,1458751,2024-06-20,Senate,"Senate Third Reading: Passed Roll Call # 256",37,1,0,0,38
1770572,1344810,2023-06-14,Senate,"Reported Favorably With Substitute S-1",5,1,0,0,6
1770572,1346860,2023-06-22,Senate,"Senate Third Reading: Passed Roll Call # 369",24,13,0,1,38
1770572,1348788,2023-06-28,House,"House Third Reading: Given Immediate Effect Roll Call # 264",56,52,0,0,108
1770581,1348013,2023-06-14,Senate,"Reported Favorably With Substitute S-3",5,1,0,0,6
1770618,1399677,2024-02-06,House,"Reported With Recommendation Without Amendment",13,0,0,0,13
1770618,1403471,2024-03-05,House,"House Third Reading: Given Immediate Effect Roll Call # 19",104,3,0,0,107
1770630,1348185,2023-06-22,House,"Reported With Recommendation Without Amendment",15,0,0,0,15
1770630,1355931,2023-10-11,House,"House Third Reading: Given Immediate Effect Roll Call # 345",88,20,0,0,108
1770668,1347913,2023-06-20,House,"Reported With Recommendation With Substitute H-1",10,0,0,0,10
1770668,1348652,2023-06-28,House,"House Third Reading: Given Immediate Effect Roll Call # 259",100,8,0,0,108
1770668,1357216,2023-11-07,Senate,"Reported Favorably Without Amendment",7,0,0,0,7
1770668,1401389,2023-11-08,Senate,"Senate Third Reading: Given Immediate Effect Roll Call # 695",33,2,0,3,38
1770674,1348010,2023-06-21,House,"Reported With Recommendation Without Amendment",10,2,0,0,12
1770751,1347713,2023-06-13,House,"Reported With Recommendation Without Amendment",8,0,0,0,8
1770755,1347642,2023-06-13,House,"Reported With Recommendation Without Amendment",8,0,0,0,8
1770760,1355898,2023-09-27,Senate,"Reported Favorably Without Amendment",9,2,0,0,11
1770760,1362609,2023-11-01,House,"Reported With Recommendation Without Amendment",3,2,0,0,5
1770760,1364502,2023-10-12,Senate,"Senate Third Reading: Passed Roll Call # 533",24,13,0,1,38
1770765,1355346,2023-09-27,Senate,"Reported Favorably Without Amendment",9,2,0,0,11
1770765,1356911,2023-11-01,House,"Reported With Recommendation Without Amendment",3,2,0,0,5
1770765,1357913,2023-11-08,Senate,"Senate Third Reading: Roll Call: Roll Call # 671",24,13,1,0,38
1770765,1367122,2023-10-12,Senate,"Senate Third Reading: Passed Roll Call # 532",24,13,0,1,38
1770765,1375538,2023-11-02,House,"House Third Reading: Given Immediate Effect Roll Call # 480",56,52,0,0,108
1770826,1356773,2023-09-26,House,"Reported With Recommendation Without Amendment",13,0,0,0,13
1770826,1356903,2023-11-01,House,"House Third Reading: Given Immediate Effect Roll Call # 436",104,6,0,0,110
1770826,1454620,2024-06-06,Senate,"Reported Favorably With Substitute S-2",10,0,0,0,10
1770826,1459848,2024-06-25,Senate,"Senate Third Reading: Passed Roll Call # 277",38,0,0,0,38
1770826,1461730,2024-06-27,House,"House Third Reading: Roll Call # 291",104,6,0,0,110
1770837,1356550,2023-09-28,House,"Reported With Recommendation With Substitute H-1",7,0,0,0,7
1770837,1356815,2023-10-31,House,"House Third Reading: Given Immediate Effect Roll Call # 414",102,7,0,0,109
1770845,1363248,2023-10-31,House,"Reported With Recommendation Without Amendment",17,0,0,0,17
1770845,1461390,2024-06-26,House,"House Third Reading: Given Immediate Effect Roll Call # 228",103,6,0,0,109
1770845,1470988,2024-12-19,Senate,"Senate Third Reading: Passed Roll Call # 644",37,0,1,0,38
1770862,1356294,2023-10-18,House,"Reported With Recommendation Without Amendment",3,0,0,0,3
1770862,1357033,2023-11-02,House,"House Third Reading: Given Immediate Effect Roll Call # 481",56,52,0,0,108
1770862,1398785,2023-11-08,Senate,"Senate Third Reading: Passed Roll Call # 698",23,12,0,3,38
1770888,1356336,2023-10-19,House,"House Third Reading: Given Immediate Effect Roll Call # 391",56,53,0,0,109
1770888,1356372,2023-10-03,House,"Reported With Recommendation Without Amendment",7,0,0,0,7
1770888,1432474,2024-04-23,Senate,"Reported Favorably With Substitute S-1",5,0,0,0,5
1770888,1458637,2024-06-20,Senate,"Senate Third Reading: Passed Roll Call # 269",24,14,0,0,38
1770888,1462155,2024-06-27,House,"House Third Reading: Roll Call # 281",56,54,0,0,110
1770896,1354986,2023-09-19,House,"Reported With Recommendation With Substitute H-1",14,0,0,0,14
1770896,1355593,2023-09-27,House,"House Third Reading: Given Immediate Effect Roll Call # 319",93,17,0,0,110
1770896,1356811,2023-10-31,Senate,"Reported Favorably Without Amendment",10,0,0,0,10
1770896,1357143,2023-11-07,Senate,"Senate Third Reading: Passed Roll Call # 660",36,1,0,1,38
1770906,1356528,2023-10-24,House,"Reported With Recommendation With Substitute H-1",13,0,0,0,13
1770906,1356836,2023-10-31,House,"House Third Reading: Given Immediate Effect Roll Call # 415",108,2,0,0,110
1770912,1356289,2023-10-18,House,"Reported With Recommendation Without Amendment",3,0,0,0,3
1770954,1355298,2023-09-27,House,"Reported With Recommendation Without Amendment",3,0,0,0,3
1770954,1357052,2023-11-02,House,"House Third Reading: Given Immediate Effect Roll Call # 473",109,0,0,0,109
1770954,1398864,2023-11-08,Senate,"Senate Third Reading: Passed Roll Call # 699",35,0,0,3,38
1771378,1348214,2023-06-27,Senate,"Reported Favorably Without Amendment",8,1,0,0,9
1771378,1350372,2023-06-27,Senate,"Senate Third Reading: Passed Roll Call # 408",35,1,0,2,38
1771378,1356111,2023-10-05,House,"Reported With Recommendation Without Amendment",18,0,0,0,18
1771378,1362854,2023-10-18,House,"House Third Reading: Given Immediate Effect Roll Call # 375",104,6,0,0,110
1771388,1346735,2023-06-21,Senate,"Reported Favorably Without Amendment",7,0,0,0,7
1771388,1354065,2023-09-07,Senate,"Senate Third Reading: Passed Roll Call # 448",29,7,0,2,38
1771388,1356737,2023-09-26,House,"Reported With Recommendation Without Amendment",6,0,0,0,6
1771388,1356897,2023-11-01,House,"House Third Reading: Given Immediate Effect Roll Call # 453",93,17,0,0,110
1771398,1346660,2023-06-21,Senate,"Reported Favorably Without Amendment",7,0,0,0,7
1771410,1346379,2023-06-21,Senate,"Reported Favorably With Substitute S-1",5,1,0,0,6
1771453,1355955,2023-10-12,House,"Reported With Recommendation Without Amendment",9,1,0,0,10
1771454,1348112,2023-06-22,House,"Reported With Recommendation Without Amendment",16,0,0,0,16
1771454,1355954,2023-10-12,House,"House Third Reading: Given Immediate Effect Roll Call # 358",106,4,0,0,110
1771457,1348228,2023-06-21,House,"Reported With Recommendation Without Amendment",9,0,0,0,9
1771457,1356480,2023-10-24,House,"House Third Reading: Given Immediate Effect Roll Call # 400",106,3,0,0,109
1771458,1347134,2023-06-22,House,"Reported With Recommendation Without Amendment",16,0,0,0,16
1771458,1355988,2023-10-12,House,"House Third Reading: Given Immediate Effect Roll Call # 359",106,4,0,0,110
1771459,1348218,2023-06-21,House,"Reported With Recommendation Without Amendment",9,0,0,0,9
1771459,1356505,2023-10-24,House,"House Third Reading: Given Immediate Effect Roll Call # 401",105,4,0,0,109
1771467,1470332,2024-12-12,House,"House Third Reading: Given Immediate Effect Roll Call # 484",56,53,0,0,109
1771581,1356087,2023-10-05,Senate,"Reported Favorably Without Amendment",4,0,0,0,4
1771581,1356278,2023-10-18,Senate,"Senate Third Reading: Passed Roll Call # 541",38,0,0,0,38
1771581,1397670,2024-02-06,House,"Reported With Recommendation Without Amendment",9,0,0,0,9
1771581,1401432,2024-02-13,House,"House Third Reading: Defeated Roll Call # 7",52,49,0,0,101
1771581,1458738,2024-06-20,House,"House Third Reading: Given Immediate Effect Roll Call # 189",105,4,0,0,109
1771591,1355861,2023-10-05,Senate,"Reported Favorably With Substitute S-1",4,0,0,0,4
1771591,1356258,2023-10-18,Senate,"Senate Third Reading: Passed Roll Call # 542",38,0,0,0,38
1771591,1383037,2024-02-06,House,"Reported With Recommendation Without Amendment",9,0,0,0,9
1771591,1402570,2024-02-13,House,"House Third Reading: Defeated Roll Call # 8",52,48,0,0,100
1771591,1458850,2024-06-20,House,"House Third Reading: Given Immediate Effect Roll Call # 190",105,4,0,0,109
1771668,1470049,2024-12-10,House,"Reported With Recommendation With Substitute H-2",14,0,0,0,14
1771678,1348213,2023-06-20,House,"Reported With Recommendation With Substitute H-1",6,0,0,0,6
1771689,1347973,2023-06-27,House,"Reported With Recommendation With Substitute H-3",14,0,0,0,14
1771689,1348699,2023-06-28,House,"House Third Reading: Given Immediate Effect Roll Call # 262",100,8,0,0,108
1771689,1355010,2023-09-20,Senate,"Reported Favorably With Substitute S-5",6,0,0,0,6
1771689,1355918,2023-09-28,House,"House Third Reading: Roll Call # 329",102,6,0,0,108
1771689,1362262,2023-09-27,Senate,"Senate Third Reading: Given Immediate Effect Roll Call # 479",37,1,0,0,38
1771692,1469994,2024-12-10,House,"Reported With Recommendation Without Amendment",14,0,0,0,14
1771694,1348235,2023-06-20,House,"Reported With Recommendation Without Amendment",6,0,0,0,6
1771825,1348731,2023-06-28,Senate,"Reported Favorably Without Amendment",9,0,0,0,9
1771825,1354060,2023-06-28,Senate,"Senate Third Reading: Passed Roll Call # 447",24,13,0,1,38
1771825,1354061,2023-09-12,House,"Reported With Recommendation With Substitute H-1",7,5,0,0,12
1771825,1355568,2023-09-27,House,"House Third Reading: Given Immediate Effect Roll Call # 312",57,53,0,0,110
1771825,1355966,2023-10-03,Senate,"Senate Third Reading: Roll Call: Roll Call # 488",24,14,0,0,38
1771827,1356359,2023-10-19,Senate,"Senate Third Reading: Passed Roll Call # 571",20,18,0,0,38
1771827,1356377,2023-10-18,Senate,"Reported Favorably Without Amendment",5,2,0,0,7
1771827,1356826,2023-10-31,House,"Reported With Recommendation Without Amendment",9,4,0,0,13
1771827,1356907,2023-11-01,House,"House Third Reading: Given Immediate Effect Roll Call # 452",56,54,0,0,110
1771830,1356828,2023-10-31,Senate,"Reported Favorably Without Amendment",6,4,0,0,10
1771830,1363244,2023-11-02,Senate,"Senate Third Reading: Passed Roll Call # 649",20,18,0,0,38
1771830,1397672,2024-02-22,House,"Reported With Recommendation Without Amendment",5,2,0,0,7
1771830,1401478,2024-02-13,House,"House Third Reading: Adverse Roll Call",4,3,0,0,7
1771833,1356275,2023-10-18,Senate,"Reported Favorably With Substitute S-3",5,2,0,0,7
1771833,1356331,2023-10-19,Senate,"Senate Third Reading: Passed Roll Call # 570",20,18,0,0,38
1771833,1356808,2023-10-31,House,"Reported With Recommendation With Substitute H-2",9,4,0,0,13
1771833,1356908,2023-11-01,House,"House Third Reading: Given Immediate Effect Roll Call # 451",56,54,0,0,110
1771833,1356929,2023-11-02,Senate,"Senate Third Reading: Roll Call: Roll Call # 637",20,18,0,0,38
1771838,1356843,2023-10-31,Senate,"Reported Favorably With Substitute S-2",6,4,0,0,10
1771838,1363336,2023-11-02,Senate,"Senate Third Reading: Passed Roll Call # 650",20,18,0,0,38
1771838,1425136,2024-02-22,House,"Reported With Recommendation Without Amendment",5,2,0,0,7
1771865,1357163,2023-10-31,House,"Reported With Recommendation Without Amendment",6,3,0,0,9
1771865,1363335,2023-11-09,House,"House Third Reading: Given Immediate Effect Roll Call # 548",56,53,0,0,109
1771865,1378578,2024-02-06,Senate,"Reported Favorably Without Amendment",6,4,0,0,10
1771865,1389957,2024-02-20,Senate,"Senate Third Reading: Passed Roll Call # 17",20,17,0,1,38
1771911,1355914,2023-09-13,House,"Reported With Recommendation Without Amendment",12,0,0,0,12
1771911,1356088,2023-10-12,House,"House Third Reading: Given Immediate Effect Roll Call # 353",106,4,0,0,110
1771911,1357028,2023-11-02,Senate,"Reported Favorably Without Amendment",7,0,0,0,7
1771911,1400289,2023-11-08,Senate,"Senate Third Reading: Given Immediate Effect Roll Call # 690",35,0,0,3,38
1771967,1356844,2023-10-31,House,"Reported With Recommendation Without Amendment",6,3,0,0,9
1771967,1363323,2023-11-09,House,"House Third Reading: Given Immediate Effect Roll Call # 549",56,53,0,0,109
1771967,1383216,2024-02-06,Senate,"Reported Favorably Without Amendment",6,4,0,0,10
1771967,1389630,2024-02-20,Senate,"Senate Third Reading: Passed Roll Call # 18",20,17,0,1,38
1771972,1356806,2023-10-31,House,"Reported With Recommendation Without Amendment",6,3,0,0,9
1771972,1363249,2023-11-09,House,"House Third Reading: Given Immediate Effect Roll Call # 550",56,53,0,0,109
1771972,1383058,2024-02-06,Senate,"Reported Favorably Without Amendment",6,4,0,0,10
1771972,1389938,2024-02-20,Senate,"Senate Third Reading: Passed Roll Call # 19",20,17,0,1,38
1771996,1356193,2023-10-11,House,"Reported With Recommendation With Substitute H-4",9,2,0,0,11
1771996,1356322,2023-10-19,House,"House Third Reading: Given Immediate Effect Roll Call # 388",66,43,0,0,109
1772000,1345980,2023-06-20,House,"Reported With Recommendation With Substitute H-1",9,5,0,0,14
1772000,1345981,2023-06-20,House,"House Third Reading: Given Immediate Effect Roll Call # 169",56,53,0,0,109
1772000,1348792,2023-06-28,Senate,"Senate Third Reading: Passed Roll Call # 442",20,17,0,1,38
1772000,1353588,2023-06-28,House,"House Third Reading: Roll Call # 267",56,52,0,0,108
1772008,1348216,2023-06-21,House,"Reported With Recommendation Without Amendment",7,1,0,0,8
1772008,1353338,2023-09-06,House,"House Third Reading: Given Immediate Effect Roll Call # 275",74,33,0,0,107
1772008,1353717,2023-09-12,Senate,"Senate Third Reading: Given Immediate Effect Roll Call # 450",29,9,0,0,38
1772486,1410827,2024-02-27,Senate,"Reported Favorably With Substitute S-2",14,0,0,0,14
1772486,1411820,2024-03-19,Senate,"Senate Third Reading: Passed Roll Call # 62",20,17,0,1,38
1772486,1457095,2024-06-13,House,"Reported With Recommendation Without Amendment",6,0,0,0,6
1772486,1460880,2024-06-26,Senate,"Senate Third Reading: Roll Call: Roll Call # 320",21,17,0,0,38
1772486,1460881,2024-06-26,Senate,"Senate Third Reading: Roll Call: Roll Call # 322",20,18,0,0,38
1772486,1461644,2024-06-26,House,"House Third Reading: Given Immediate Effect Roll Call # 227",56,54,0,0,110
1772556,1355961,2023-10-12,House,"Reported With Recommendation With Substitute H-3",6,1,0,0,7
1772666,1458092,2024-06-18,Senate,"Reported Favorably With Substitute S-2",5,2,0,0,7
1772666,1467363,2024-09-17,Senate,"Senate Third Reading: Passed Roll Call # 335",20,16,0,2,38
1772670,1458078,2024-06-18,Senate,"Reported Favorably With Substitute S-3",5,2,0,0,7
1772670,1467329,2024-09-17,Senate,"Senate Third Reading: Passed Roll Call # 334",21,15,0,2,38
1772670,1467330,2024-09-17,Senate,"Senate Third Reading: Passed Roll Call # 340",20,16,0,2,38
1772670,1469579,2024-12-03,House,"Reported With Recommendation Without Amendment",6,2,0,0,8
1772674,1458080,2024-06-18,Senate,"Reported Favorably With Substitute S-3",5,2,0,0,7
1772674,1467364,2024-09-17,Senate,"Senate Third Reading: Passed Roll Call # 336",20,16,0,2,38
1772676,1458091,2024-06-18,Senate,"Reported Favorably With Substitute S-2",5,2,0,0,7
1772676,1467345,2024-09-17,Senate,"Senate Third Reading: Passed Roll Call # 339",20,16,0,2,38
1772680,1469536,2024-11-26,Senate,"Reported Favorably With Substitute S-1",15,3,0,0,18
1772682,1469670,2024-11-26,Senate,"Reported Favorably With Substitute S-1",15,3,0,0,18
1772682,1469812,2024-12-05,Senate,"Senate Third Reading: Passed Roll Call # 439",29,7,0,2,38
1772708,1398226,2024-02-14,House,"Reported With Recommendation Without Amendment",18,8,0,0,26
1772708,1431325,2024-04-18,House,"House Third Reading: Given Immediate Effect Roll Call # 32",83,22,0,0,105
1772708,1469051,2024-10-24,Senate,"Reported Favorably Without Amendment",8,0,0,0,8
1772708,1469991,2024-12-10,Senate,"Senate Third Reading: Passed Roll Call # 472",32,5,0,1,38
1772718,1470384,2024-12-10,House,"Reported With Recommendation Without Amendment",7,4,0,0,11
1772718,1470458,2024-12-13,House,"House Third Reading: Given Immediate Effect Roll Call # 534",56,0,0,0,56
1772724,1470139,2024-12-10,House,"Reported With Recommendation With Substitute H-2",14,0,0,0,14
1772724,1470506,2024-12-13,House,"House Third Reading: Given Immediate Effect Roll Call # 488",56,0,0,0,56
1772758,1356206,2023-10-11,House,"Reported With Recommendation With Substitute H-1",11,2,0,0,13
1772758,1356346,2023-10-19,House,"House Third Reading: Given Immediate Effect Roll Call # 387",86,23,0,0,109
1773139,1469097,2024-10-24,Senate,"Reported Favorably With Substitute S-2",5,3,0,0,8
1773139,1470526,2024-12-12,Senate,"Senate Third Reading: Passed Roll Call # 519",21,15,0,2,38
1773142,1354978,2023-09-20,Senate,"Reported Favorably Without Amendment",8,1,0,0,9
1773142,1355927,2023-10-03,Senate,"Senate Third Reading: Passed Roll Call # 489",26,12,0,0,38
1773142,1425007,2024-03-05,House,"Reported With Recommendation Without Amendment",8,0,0,0,8
1773142,1457019,2024-06-12,House,"House Third Reading: Given Immediate Effect Roll Call # 163",58,51,0,0,109
1773156,1363328,2023-11-09,Senate,"Reported Favorably Without Amendment",8,0,0,0,8
1773156,1371992,2024-01-25,Senate,"Senate Third Reading: Passed Roll Call # 5",37,0,0,1,38
1773156,1404762,2024-03-06,House,"Reported With Recommendation Without Amendment",10,0,0,0,10
1773156,1443098,2024-05-14,House,"House Third Reading: Given Immediate Effect Roll Call # 87",101,6,0,0,107
1773165,1363327,2023-11-09,Senate,"Reported Favorably Without Amendment",8,0,0,0,8
1773165,1372717,2024-01-25,Senate,"Senate Third Reading: Passed Roll Call # 4",37,0,0,1,38
1773165,1404922,2024-03-06,House,"Reported With Recommendation Without Amendment",10,0,0,0,10
1773165,1442917,2024-05-14,House,"House Third Reading: Given Immediate Effect Roll Call # 86",101,6,0,0,107
1773170,1356145,2023-10-17,Senate,"Reported Favorably Without Amendment",7,0,0,0,7
1773170,1356266,2023-10-18,Senate,"Senate Third Reading: Passed Roll Call # 547",30,8,0,0,38
1773170,1357231,2023-11-01,House,"Reported With Recommendation Without Amendment",9,0,0,0,9
1773170,1357282,2023-11-08,House,"House Third Reading: Given Immediate Effect Roll Call # 519",79,30,0,0,109
1773178,1469043,2024-10-24,Senate,"Reported Favorably With Substitute S-2",5,3,0,0,8
1773178,1470531,2024-12-12,Senate,"Senate Third Reading: Passed Roll Call # 518",22,14,0,2,38
1773202,1470356,2024-12-04,House,"Reported With Recommendation With Substitute H-2",9,0,0,0,9
1773204,1355262,2023-09-13,House,"Reported With Recommendation Without Amendment",12,0,0,0,12
1773204,1355920,2023-09-28,House,"House Third Reading: Given Immediate Effect Roll Call # 328",104,4,0,0,108
1773204,1356858,2023-11-01,Senate,"Senate Third Reading: Passed Roll Call # 632",28,10,0,0,38
1773208,1356389,2023-10-03,House,"Reported With Recommendation Without Amendment",13,0,0,0,13
1773208,1366540,2024-01-17,House,"House Third Reading: Given Immediate Effect Roll Call # 1",104,0,0,0,104
1773208,1384537,2024-02-13,Senate,"Reported Favorably Without Amendment",4,0,0,0,4
1773208,1384538,2024-02-14,Senate,"Senate Third Reading: Given Immediate Effect Roll Call # 15",38,0,0,0,38
1773225,1356285,2023-10-10,House,"Reported With Recommendation With Substitute H-1",13,0,0,0,13
1773225,1356318,2023-10-19,House,"House Third Reading: Given Immediate Effect Roll Call # 385",86,23,0,0,109
1773225,1356989,2023-11-02,Senate,"Reported Favorably Without Amendment",4,0,0,0,4
1773225,1401094,2023-11-08,Senate,"Senate Third Reading: Given Immediate Effect Roll Call # 694",35,0,0,3,38
1773231,1357235,2023-10-11,House,"Reported With Recommendation Without Amendment",13,0,0,0,13
1773231,1357315,2023-11-08,House,"House Third Reading: Given Immediate Effect Roll Call # 509",88,21,0,0,109
1773231,1396624,2024-02-21,Senate,"Reported Favorably Without Amendment",6,1,0,0,7
1773231,1399166,2024-02-28,Senate,"Senate Third Reading: Passed Roll Call # 40",24,14,0,0,38
1773306,1363333,2023-10-03,Senate,"Reported Favorably With Substitute S-1",6,1,0,0,7
1773308,1355806,2023-10-03,Senate,"Reported Favorably With Substitute S-1",5,1,0,0,6
1773308,1357178,2023-10-24,House,"Reported With Recommendation Without Amendment",8,2,0,0,10
1773308,1357326,2023-11-08,House,"House Third Reading: Given Immediate Effect Roll Call # 526",56,53,0,0,109
1773308,1367149,2023-10-12,Senate,"Senate Third Reading: Passed Roll Call # 525",26,11,0,1,38
1773310,1355830,2023-10-03,Senate,"Reported Favorably Without Amendment",6,1,0,0,7
1773316,1355892,2023-10-03,Senate,"Reported Favorably With Substitute S-1",6,1,0,0,7
1773316,1356715,2023-10-12,Senate,"Senate Third Reading: Passed Roll Call # 527",32,5,0,1,38
1773316,1356716,2023-10-24,House,"Reported With Recommendation Without Amendment",13,0,0,0,13
1773316,1357244,2023-11-08,House,"House Third Reading: Given Immediate Effect Roll Call # 528",100,9,0,0,109
1773320,1355776,2023-10-03,Senate,"Reported Favorably With Substitute S-1",5,1,0,0,6
1773322,1355894,2023-10-03,Senate,"Reported Favorably With Substitute S-1",6,1,0,0,7
1773322,1355960,2023-10-12,Senate,"Senate Third Reading: Passed Roll Call # 526",26,11,0,1,38
1773322,1357212,2023-10-24,House,"Reported With Recommendation Without Amendment",8,5,0,0,13
1773322,1357245,2023-11-08,House,"House Third Reading: Given Immediate Effect Roll Call # 527",56,53,0,0,109
1773324,1355706,2023-10-03,Senate,"Reported Favorably With Substitute S-1",5,1,0,0,6
1773324,1355940,2023-10-12,Senate,"Senate Third Reading: Passed Roll Call # 521",31,6,0,1,38
1773324,1357205,2023-10-24,House,"Reported With Recommendation Without Amendment",10,0,0,0,10
1773324,1357337,2023-11-08,House,"House Third Reading: Given Immediate Effect Roll Call # 522",90,19,0,0,109
1773326,1355644,2023-10-03,Senate,"Reported Favorably Without Amendment",6,1,0,0,7
1773331,1355907,2023-10-03,Senate,"Reported Favorably Without Amendment",6,1,0,0,7
1773331,1357153,2023-10-24,House,"Reported With Recommendation Without Amendment",11,0,0,0,11
1773331,1357260,2023-11-08,House,"House Third Reading: Given Immediate Effect Roll Call # 525",56,53,0,0,109
1773331,1367132,2023-10-12,Senate,"Senate Third Reading: Passed Roll Call # 524",28,9,0,1,38
1773335,1355893,2023-10-03,Senate,"Reported Favorably With Substitute S-1",6,1,0,0,7
1773335,1357148,2023-10-24,House,"Reported With Recommendation Without Amendment",8,0,0,0,8
1773335,1357256,2023-11-08,House,"House Third Reading: Given Immediate Effect Roll Call # 524",60,49,0,0,109
1773335,1367131,2023-10-12,Senate,"Senate Third Reading: Passed Roll Call # 523",26,11,0,1,38
1773340,1355570,2023-10-03,Senate,"Reported Favorably With Substitute S-1",6,1,0,0,7
1773340,1357208,2023-10-24,House,"Reported With Recommendation Without Amendment",8,1,0,0,9
1773340,1357342,2023-11-08,House,"House Third Reading: Given Immediate Effect Roll Call # 523",60,49,0,0,109
1773340,1367141,2023-10-12,Senate,"Senate Third Reading: Passed Roll Call # 522",31,6,0,1,38
1773342,1355896,2023-10-03,Senate,"Reported Favorably Without Amendment",6,1,0,0,7
1773342,1357160,2023-10-24,House,"Reported With Recommendation Without Amendment",13,0,0,0,13
1773342,1357255,2023-11-08,House,"House Third Reading: Given Immediate Effect Roll Call # 530",99,10,0,0,109
1773342,1367156,2023-10-12,Senate,"Senate Third Reading: Passed Roll Call # 529",34,3,0,1,38
1773344,1355684,2023-10-03,Senate,"Reported Favorably With Substitute S-1",6,1,0,0,7
1773346,1355703,2023-10-03,Senate,"Reported Favorably Without Amendment",6,1,0,0,7
1773346,1355962,2023-10-12,Senate,"Senate Third Reading: Passed Roll Call # 528",34,3,0,1,38
1773346,1357266,2023-10-24,House,"Reported With Recommendation Without Amendment",13,0,0,0,13
1773346,1357267,2023-11-08,House,"House Third Reading: Given Immediate Effect Roll Call # 529",98,11,0,0,109
1773350,1363320,2023-10-03,Senate,"Reported Favorably With Substitute S-1",6,1,0,0,7
1773352,1363261,2023-10-03,Senate,"Reported Favorably With Substitute S-1",6,1,0,0,7
1773354,1355775,2023-10-03,Senate,"Reported Favorably With Substitute S-1",6,1,0,0,7
1773356,1363332,2023-10-03,Senate,"Reported Favorably With Substitute S-1",5,1,0,0,6
1773358,1363330,2023-10-03,Senate,"Reported Favorably With Substitute S-1",6,1,0,0,7
1773363,1357269,2023-10-25,House,"Reported With Recommendation Without Amendment",13,0,0,0,13
1773363,1402188,2024-02-06,House,"House Third Reading: Defeated Roll Call # 3",54,49,0,0,103
1773363,1469347,2024-11-14,House,"House Third Reading: Given Immediate Effect Roll Call # 355",102,0,0,0,102
1773367,1356361,2023-10-03,House,"Reported With Recommendation With Substitute H-1",14,0,0,0,14
1773367,1356607,2023-10-25,House,"House Third Reading: Given Immediate Effect Roll Call # 409",107,2,0,0,109
1773368,1355705,2023-10-03,Senate,"Reported Favorably Without Amendment",6,1,0,0,7
1773375,1356881,2023-11-01,House,"House Third Reading: Given Immediate Effect Roll Call # 449",83,27,0,0,110
1773375,1357251,2023-11-08,Senate,"Reported Favorably With Substitute S-1",9,2,0,0,11
1773375,1357252,2023-11-08,Senate,"Senate Third Reading: Given Immediate Effect Roll Call # 700",32,3,0,3,38
1773375,1357906,2023-10-24,House,"Reported With Recommendation With Substitute H-1",15,0,0,0,15
1773375,1380766,2023-11-08,House,"House Third Reading: Roll Call # 506",84,25,0,0,109
1773388,1354888,2023-09-13,House,"Reported With Recommendation With Substitute H-1",10,0,0,0,10
1773388,1470027,2024-12-10,House,"House Third Reading: Passed Roll Call # 411",57,50,0,0,107
1773388,1470028,2024-12-10,House,"House Third Reading: Given Immediate Effect Roll Call # 412",56,52,0,0,108
1773395,1357294,2023-10-25,House,"Reported With Recommendation Without Amendment",13,0,0,0,13
1773395,1469358,2024-11-14,House,"House Third Reading: Given Immediate Effect Roll Call # 353",102,0,0,0,102
1773400,1356217,2023-10-11,House,"Reported With Recommendation With Substitute H-1",11,1,0,0,12
1773400,1356327,2023-10-19,House,"House Third Reading: Given Immediate Effect Roll Call # 382",83,26,0,0,109
1773400,1356979,2023-11-02,Senate,"Reported Favorably With Substitute S-1",5,2,0,0,7
1773400,1357136,2023-11-07,Senate,"Senate Third Reading: Given Immediate Effect Roll Call # 661",36,1,0,1,38
1773400,1385314,2023-11-08,House,"House Third Reading: Roll Call # 505",81,28,0,0,109
1773405,1356399,2023-10-19,Senate,"Reported Favorably Without Amendment",10,0,0,0,10
1773405,1396823,2023-10-25,Senate,"Senate Third Reading: Passed Roll Call # 590",38,0,0,0,38
1773405,1434795,2024-04-25,House,"Reported With Recommendation With Substitute H-1",17,0,0,0,17
1773405,1459824,2024-06-25,House,"House Third Reading: Given Immediate Effect Roll Call # 213",104,6,0,0,110
1773405,1460920,2024-06-26,Senate,"Senate Third Reading: Roll Call: Roll Call # 325",38,0,0,0,38
1773411,1468709,2024-10-17,Senate,"Reported Favorably Without Amendment",19,0,0,0,19
1773423,1470241,2024-12-11,Senate,"Reported Favorably With Substitute S-1",13,1,0,0,14
1773423,1470478,2024-12-12,Senate,"Senate Third Reading: Passed Roll Call # 528",20,16,0,2,38
1773426,1355709,2023-09-27,Senate,"Reported Favorably With Substitute S-1",6,1,0,0,7
1773426,1355915,2023-10-05,Senate,"Senate Third Reading: Passed Roll Call # 503",21,16,0,1,38
1773426,1357200,2023-10-31,House,"Reported With Recommendation Without Amendment",5,1,0,0,6
1773426,1357652,2023-11-09,House,"House Third Reading: Given Immediate Effect Roll Call # 576",87,20,0,0,107
1773426,1398676,2023-11-09,Senate,"Senate Third Reading: Roll Call: Roll Call # 740",23,13,0,2,38
1773436,1356441,2023-10-19,Senate,"Reported Favorably Without Amendment",10,0,0,0,10
1773436,1397157,2023-10-25,Senate,"Senate Third Reading: Passed Roll Call # 591",38,0,0,0,38
1773436,1435165,2024-04-25,House,"Reported With Recommendation With Substitute H-1",17,0,0,0,17
1773436,1459933,2024-06-25,House,"House Third Reading: Given Immediate Effect Roll Call # 214",104,6,0,0,110
1773436,1460952,2024-06-26,Senate,"Senate Third Reading: Roll Call: Roll Call # 326",38,0,0,0,38
1774634,1356851,2023-10-18,House,"Reported With Recommendation Without Amendment",11,0,0,0,11
1774634,1357236,2023-11-08,House,"House Third Reading: Given Immediate Effect Roll Call # 501",79,30,0,0,109
1774634,1425035,2024-03-14,Senate,"Reported Favorably With Substitute S-3",6,1,0,0,7
1774634,1444748,2024-05-16,Senate,"Senate Third Reading: Passed Roll Call # 207",22,11,0,5,38
1774635,1432622,2024-04-23,House,"Reported With Recommendation Without Amendment",10,0,0,0,10
1774637,1448437,2024-05-22,House,"Reported With Recommendation With Substitute H-2",15,2,0,0,17
1774639,1356299,2023-10-11,House,"Reported With Recommendation With Substitute H-1",9,0,0,0,9
1774639,1356483,2023-10-24,House,"House Third Reading: Given Immediate Effect Roll Call # 396",89,20,0,0,109
1774641,1355921,2023-10-11,House,"Reported With Recommendation With Substitute H-1",9,0,0,0,9
1774641,1356478,2023-10-24,House,"House Third Reading: Given Immediate Effect Roll Call # 397",91,18,0,0,109
1774641,1469552,2024-11-26,Senate,"Reported Favorably With Substitute S-2",4,2,0,0,6
1774643,1433086,2024-04-23,House,"Reported With Recommendation Without Amendment",10,0,0,0,10
1774645,1356317,2023-10-11,House,"Reported With Recommendation With Substitute H-1",9,0,0,0,9
1774645,1356539,2023-10-24,House,"House Third Reading: Given Immediate Effect Roll Call # 395",87,22,0,0,109
1774649,1354456,2023-09-13,House,"Reported With Recommendation Without Amendment",12,0,0,0,12
1774649,1356310,2023-10-12,House,"House Third Reading: Given Immediate Effect Roll Call # 354",106,4,0,0,110
1774649,1357024,2023-11-02,Senate,"Reported Favorably Without Amendment",7,0,0,0,7
1774649,1404443,2023-11-08,Senate,"Senate Third Reading: Given Immediate Effect Roll Call # 691",35,0,0,3,38
1774654,1357262,2023-10-24,House,"Reported With Recommendation With Substitute H-2",11,0,0,0,11
1774654,1357263,2023-11-08,House,"House Third Reading: Given Immediate Effect Roll Call # 515",68,41,0,0,109
1774654,1459877,2024-06-25,Senate,"Reported Favorably With Substitute S-1",5,2,0,0,7
1774654,1470127,2024-12-11,Senate,"Senate Third Reading: Passed Roll Call # 487",21,15,0,2,38
1774661,1357203,2023-10-24,House,"Reported With Recommendation With Substitute H-1",11,0,0,0,11
1774661,1375151,2023-11-08,House,"House Third Reading: Given Immediate Effect Roll Call # 517",70,39,0,0,109
1774661,1460135,2024-06-25,Senate,"Reported Favorably With Substitute S-1",5,2,0,0,7
1774661,1470297,2024-12-11,Senate,"Senate Third Reading: Passed Roll Call # 488",21,15,0,2,38
1774663,1356845,2023-10-18,House,"Reported With Recommendation Without Amendment",11,0,0,0,11
1774663,1357293,2023-11-08,House,"House Third Reading: Given Immediate Effect Roll Call # 500",80,29,0,0,109
1774663,1424998,2024-03-14,Senate,"Reported Favorably Without Amendment",6,1,0,0,7
1774665,1448495,2024-05-22,House,"Reported With Recommendation With Substitute H-2",8,3,0,0,11
1774665,1463278,2024-06-27,House,"House Third Reading: Given Immediate Effect Roll Call # 286",60,50,0,0,110
1774671,1356307,2023-10-11,House,"Reported With Recommendation With Substitute H-1",9,0,0,0,9
1774671,1356476,2023-10-24,House,"House Third Reading: Given Immediate Effect Roll Call # 398",92,17,0,0,109
1774671,1469537,2024-11-26,Senate,"Reported Favorably With Substitute S-2",4,2,0,0,6
1774673,1356288,2023-09-26,House,"Reported With Recommendation Without Amendment",13,0,0,0,13
1774673,1356351,2023-10-19,House,"House Third Reading: Given Immediate Effect Roll Call # 389",109,0,0,0,109
1774673,1398728,2023-11-08,Senate,"Reported Favorably Without Amendment",9,2,0,0,11
1774673,1402512,2023-11-09,Senate,"Senate Third Reading: Passed Roll Call # 718",37,0,0,1,38
1774674,1470524,2024-12-13,House,"House Third Reading: Given Immediate Effect Roll Call # 528",56,0,0,0,56
1774675,1470530,2024-12-13,House,"House Third Reading: Given Immediate Effect Roll Call # 529",56,0,0,0,56
1774819,1470267,2024-11-13,Senate,"Reported Favorably With Substitute S-1",8,0,0,0,8
1774837,1470239,2024-11-13,Senate,"Reported Favorably With Substitute S-1",8,0,0,0,8
1774891,1470394,2024-11-13,Senate,"Reported Favorably With Substitute S-2",8,0,0,0,8
1774891,1470537,2024-12-12,Senate,"Senate Third Reading: Passed Roll Call # 534",31,4,1,2,38
1774891,1470538,2024-12-12,Senate,"Senate Third Reading: Passed Roll Call # 535",32,4,0,2,38
1774907,1403931,2024-02-07,House,"Reported With Recommendation Without Amendment",12,0,0,0,12
1774907,1404920,2024-03-06,House,"House Third Reading: Given Immediate Effect Roll Call # 22",94,13,0,0,107
1774907,1459801,2024-06-25,Senate,"Reported Favorably With Substitute S-1",7,0,0,0,7
1774907,1468423,2024-10-08,Senate,"Senate Third Reading: Passed Roll Call # 367",35,1,0,2,38
1774907,1468424,2024-10-08,Senate,"Senate Third Reading: Passed Roll Call # 372",36,0,0,2,38
1774907,1469952,2024-12-10,House,"House Third Reading: Roll Call # 400",96,10,0,0,106
1774912,1356880,2023-11-01,House,"House Third Reading: Given Immediate Effect Roll Call # 450",82,28,0,0,110
1774912,1357907,2023-10-24,House,"Reported With Recommendation Without Amendment",15,0,0,0,15
1774912,1400334,2023-11-08,Senate,"Reported Favorably Without Amendment",9,2,0,0,11
1774912,1400335,2023-11-08,Senate,"Senate Third Reading: Given Immediate Effect Roll Call # 701",32,3,0,3,38
1776833,1354067,2023-09-06,House,"Reported With Recommendation Without Amendment",7,0,0,0,7
1776833,1355993,2023-09-27,House,"House Third Reading: Given Immediate Effect Roll Call # 321",105,5,0,0,110
1776833,1356393,2023-10-19,Senate,"Reported Favorably Without Amendment",8,0,0,0,8
1776833,1356551,2023-10-25,Senate,"Senate Third Reading: Passed Roll Call # 589",38,0,0,0,38
1776923,1357539,2023-11-09,House,"House Third Reading: Given Immediate Effect Roll Call # 574",79,28,0,0,107
1776923,1454626,2024-06-06,Senate,"Reported Favorably Without Amendment",6,3,0,0,9
1776923,1469144,2024-11-07,Senate,"Senate Third Reading: Passed Roll Call # 404",23,15,0,0,38
1776930,1391934,2023-11-09,House,"House Third Reading: Given Immediate Effect Roll Call # 575",80,27,0,0,107
1776930,1454609,2024-06-06,Senate,"Reported Favorably With Substitute S-1",6,3,0,0,9
1776930,1469153,2024-11-07,Senate,"Senate Third Reading: Passed Roll Call # 405",23,15,0,0,38
1776930,1469595,2024-12-03,House,"House Third Reading: Roll Call # 365",65,39,0,0,104
1776931,1408946,2024-03-13,House,"Reported With Recommendation With Substitute H-4",5,0,0,0,5
1776931,1413396,2024-03-19,House,"House Third Reading: Defeated Roll Call # 29",53,44,0,0,97
1776931,1458854,2024-06-20,House,"House Third Reading: Given Immediate Effect Roll Call # 191",106,3,0,0,109
1776936,1357488,2023-11-09,House,"House Third Reading: Given Immediate Effect Roll Call # 573",81,26,0,0,107
1776936,1454572,2024-06-06,Senate,"Reported Favorably With Substitute S-3",6,3,0,0,9
1776936,1469147,2024-11-07,Senate,"Senate Third Reading: Passed Roll Call # 403",23,15,0,0,38
1776936,1469599,2024-12-03,House,"House Third Reading: Roll Call # 364",65,39,0,0,104
1776938,1363255,2023-10-19,House,"Reported With Recommendation With Substitute H-1",7,1,0,0,8
1776949,1356605,2023-10-25,Senate,"Reported Favorably With Substitute S-2",5,2,0,0,7
1776949,1357864,2023-11-02,Senate,"Senate Third Reading: Passed Roll Call # 640",20,18,0,0,38
1776949,1357865,2023-11-02,Senate,"Senate Third Reading: Passed Roll Call # 640",20,18,0,0,38
1776951,1363343,2023-11-09,Senate,"Reported Favorably With Substitute S-1",11,0,0,0,11
1776951,1384030,2024-02-13,Senate,"Senate Third Reading: Passed Roll Call # 10",38,0,0,0,38
1776951,1456997,2024-06-12,House,"House Third Reading: Given Immediate Effect Roll Call # 161",80,29,0,0,109
1776951,1468809,2024-05-14,House,"Reported With Recommendation Without Amendment",11,0,0,0,11
1776954,1355917,2023-09-21,Senate,"Reported Favorably With Substitute S-2",10,1,0,0,11
1776954,1355949,2023-10-12,Senate,"Senate Third Reading: Passed Roll Call # 520",30,7,0,1,38
1776954,1356818,2023-10-31,House,"Reported With Recommendation Without Amendment",9,0,0,0,9
1776954,1357237,2023-11-08,House,"House Third Reading: Given Immediate Effect Roll Call # 514",103,6,0,0,109
1777239,1467590,2024-09-25,House,"Reported With Recommendation With Substitute H-1",17,1,0,0,18
1777239,1470547,2024-12-13,House,"House Third Reading: Given Immediate Effect Roll Call # 504",56,0,0,0,56
1777325,1356186,2023-10-10,Senate,"Reported Favorably Without Amendment",10,0,0,0,10
1777325,1356330,2023-10-19,Senate,"Senate Third Reading: Passed Roll Call # 577",36,2,0,0,38
1777325,1362008,2023-11-09,House,"House Third Reading: Given Immediate Effect Roll Call # 569",101,6,0,0,107
1777384,1355190,2023-09-14,Senate,"Reported Favorably Without Amendment",7,1,0,0,8
1777384,1355278,2023-09-27,Senate,"Senate Third Reading: Passed Roll Call # 475",21,17,0,0,38
1777384,1355981,2023-10-12,House,"House Third Reading: Given Immediate Effect Roll Call # 363",56,54,0,0,110
1777392,1355740,2023-10-03,Senate,"Reported Favorably With Substitute S-2",5,2,0,0,7
1777392,1355905,2023-10-11,Senate,"Senate Third Reading: Passed Roll Call # 516",22,16,0,0,38
1777392,1356537,2023-10-17,House,"Reported With Recommendation Without Amendment",8,4,0,0,12
1777392,1356886,2023-11-01,House,"House Third Reading: Given Immediate Effect Roll Call # 440",58,52,0,0,110
1777394,1356315,2023-10-18,Senate,"Reported Favorably With Substitute S-1",8,3,0,0,11
1777394,1356345,2023-10-19,Senate,"Senate Third Reading: Passed Roll Call # 568",20,18,0,0,38
1777394,1356887,2023-11-01,House,"House Third Reading: Given Immediate Effect Roll Call # 468",56,54,0,0,110
1777394,1357912,2023-11-07,Senate,"Senate Third Reading: Roll Call: Roll Call # 658",20,17,0,1,38
1777396,1356305,2023-10-18,Senate,"Reported Favorably With Substitute S-1",8,3,0,0,11
1777396,1356349,2023-10-19,Senate,"Senate Third Reading: Passed Roll Call # 565",20,18,0,0,38
1777400,1356303,2023-10-18,Senate,"Reported Favorably With Substitute S-3",8,3,0,0,11
1777400,1356348,2023-10-19,Senate,"Senate Third Reading: Passed Roll Call # 563",20,18,0,0,38
1777400,1356893,2023-11-01,House,"House Third Reading: Given Immediate Effect Roll Call # 466",56,54,0,0,110
1777400,1357911,2023-11-07,Senate,"Senate Third Reading: Roll Call: Roll Call # 656",20,17,0,1,38
1777404,1356301,2023-10-18,Senate,"Reported Favorably With Substitute S-1",8,3,0,0,11
1777404,1356347,2023-10-19,Senate,"Senate Third Reading: Passed Roll Call # 566",20,18,0,0,38
1777404,1357017,2023-11-01,House,"House Third Reading: Given Immediate Effect Roll Call # 467",56,54,0,0,110
1777404,1357147,2023-11-07,Senate,"Senate Third Reading: Roll Call: Roll Call # 657",20,17,0,1,38
1777406,1355897,2023-10-03,Senate,"Reported Favorably Without Amendment",5,0,0,0,5
1777406,1355908,2023-10-11,Senate,"Senate Third Reading: Passed Roll Call # 517",22,16,0,0,38
1777406,1356177,2023-10-17,House,"Reported With Recommendation Without Amendment",8,4,0,0,12
1777410,1356800,2023-10-10,House,"Reported With Recommendation With Substitute H-1",8,0,0,0,8
1777410,1356822,2023-10-31,House,"House Third Reading: Given Immediate Effect Roll Call # 412",57,52,0,0,109
1777410,1432390,2024-04-23,Senate,"Reported Favorably Without Amendment",5,2,0,0,7
1777411,1355928,2023-10-10,House,"Reported With Recommendation Without Amendment",8,0,0,0,8
1777411,1356819,2023-10-31,House,"House Third Reading: Given Immediate Effect Roll Call # 413",57,53,0,0,110
1777411,1432380,2024-04-23,Senate,"Reported Favorably Without Amendment",5,2,0,0,7
1777412,1355133,2023-09-20,House,"Reported With Recommendation Without Amendment",11,8,0,0,19
1777412,1356878,2023-11-01,House,"House Third Reading: Given Immediate Effect Roll Call # 465",56,54,0,0,110
1777412,1357134,2023-11-07,Senate,"Senate Third Reading: Passed Roll Call # 668",20,17,0,1,38
1777414,1425017,2024-02-13,House,"Reported With Recommendation With Substitute H-2",11,0,0,0,11
1777414,1469613,2024-12-03,House,"House Third Reading: Given Immediate Effect Roll Call # 368",76,29,0,0,105
1777416,1425235,2024-02-13,House,"Reported With Recommendation With Substitute H-3",11,0,0,0,11
1777416,1469582,2024-12-03,House,"House Third Reading: Given Immediate Effect Roll Call # 369",76,29,0,0,105
1777419,1363251,2023-09-20,House,"Reported With Recommendation Without Amendment",11,8,0,0,19
1777424,1355144,2023-09-20,House,"Reported With Recommendation Without Amendment",10,8,0,0,18
1777424,1356874,2023-11-01,House,"House Third Reading: Given Immediate Effect Roll Call # 462",56,54,0,0,110
1777424,1357172,2023-11-07,Senate,"Senate Third Reading: Passed Roll Call # 665",20,17,0,1,38
1777426,1363340,2023-10-19,House,"Reported With Recommendation Without Amendment",7,1,0,0,8
1777428,1355078,2023-09-20,House,"Reported With Recommendation Without Amendment",11,8,0,0,19
1777428,1356866,2023-11-01,House,"House Third Reading: Given Immediate Effect Roll Call # 460",56,54,0,0,110
1777428,1357128,2023-11-07,Senate,"Senate Third Reading: Passed Roll Call # 663",20,17,0,1,38
1777429,1356871,2023-11-01,House,"House Third Reading: Given Immediate Effect Roll Call # 461",56,54,0,0,110
1777429,1357130,2023-11-07,Senate,"Senate Third Reading: Passed Roll Call # 664",20,17,0,1,38
1777431,1355142,2023-09-20,House,"Reported With Recommendation Without Amendment",11,8,0,0,19
1777431,1356889,2023-11-01,House,"House Third Reading: Given Immediate Effect Roll Call # 463",56,54,0,0,110
1777431,1357127,2023-11-07,Senate,"Senate Third Reading: Passed Roll Call # 666",20,17,0,1,38
1777432,1356363,2023-10-03,House,"Reported With Recommendation With Substitute H-1",7,1,0,0,8
1777433,1355080,2023-09-20,House,"Reported With Recommendation Without Amendment",11,8,0,0,19
1777433,1356882,2023-11-01,House,"House Third Reading: Given Immediate Effect Roll Call # 464",56,54,0,0,110
1777433,1395910,2023-11-07,Senate,"Senate Third Reading: Passed Roll Call # 667",20,17,0,1,38
1777437,1356368,2023-10-03,House,"Reported With Recommendation Without Amendment",7,1,0,0,8
1777437,1356873,2023-11-01,House,"House Third Reading: Given Immediate Effect Roll Call # 439",58,52,0,0,110
1777437,1357226,2023-11-08,Senate,"Senate Third Reading: Passed Roll Call # 689",23,12,0,3,38
1777437,1357227,2023-11-08,Senate,"Senate Third Reading: Passed Roll Call # 704",22,13,0,3,38
1777437,1357599,2023-11-09,House,"House Third Reading: Roll Call # 547",58,51,0,0,109
1777438,1356277,2023-10-11,House,"Reported With Recommendation Without Amendment",3,0,0,0,3
1777438,1356329,2023-10-19,House,"House Third Reading: Given Immediate Effect Roll Call # 386",56,53,0,0,109
1777438,1357541,2023-11-09,Senate,"Senate Third Reading: Passed Roll Call # 713",20,17,0,1,38
1777593,1407839,2024-03-05,Senate,"Reported Favorably Without Amendment",9,1,0,0,10
1777593,1407840,2024-03-12,Senate,"Senate Third Reading: Passed Roll Call # 49",38,0,0,0,38
1777594,1357135,2023-11-07,Senate,"Reported Favorably Without Amendment",10,0,0,0,10
1777594,1398561,2023-11-09,Senate,"Senate Third Reading: Passed Roll Call # 716",37,0,0,1,38
1777594,1443585,2024-05-16,House,"Reported With Recommendation With Substitute H-1",15,0,0,0,15
1777594,1459831,2024-06-25,House,"House Third Reading: Given Immediate Effect Roll Call # 212",110,0,0,0,110
1777594,1460946,2024-06-26,Senate,"Senate Third Reading: Roll Call: Roll Call # 327",38,0,0,0,38
1777596,1357055,2023-11-02,Senate,"Reported Favorably With Substitute S-2",6,1,0,0,7
1777596,1395842,2023-11-08,Senate,"Senate Third Reading: Passed Roll Call # 692",30,5,0,3,38
1777597,1355500,2023-09-28,Senate,"Reported Favorably With Substitute S-1",5,2,0,0,7
1777597,1355741,2023-10-04,Senate,"Senate Third Reading: Passed Roll Call # 498",20,17,1,0,38
1777605,1355524,2023-09-28,Senate,"Reported Favorably Without Amendment",5,2,0,0,7
1777605,1355736,2023-10-04,Senate,"Senate Third Reading: Passed Roll Call # 500",20,17,1,0,38
1777607,1355347,2023-09-28,House,"Reported With Recommendation Without Amendment",7,0,0,0,7
1777610,1355522,2023-09-28,Senate,"Reported Favorably Without Amendment",5,2,0,0,7
1777610,1355716,2023-10-04,Senate,"Senate Third Reading: Passed Roll Call # 499",20,17,1,0,38
1777613,1355756,2023-09-28,House,"Reported With Recommendation Without Amendment",7,0,0,0,7
1777615,1356309,2023-10-10,House,"Reported With Recommendation Without Amendment",14,0,0,0,14
1777615,1356342,2023-10-19,House,"House Third Reading: Given Immediate Effect Roll Call # 384",79,30,0,0,109
1777619,1355339,2023-09-28,House,"Reported With Recommendation With Substitute H-2",7,0,0,0,7
1777622,1355737,2023-09-28,House,"Reported With Recommendation Without Amendment",7,0,0,0,7
1777624,1355752,2023-09-28,House,"Reported With Recommendation Without Amendment",7,0,0,0,7
1777644,1456778,2024-06-12,Senate,"Reported Favorably With Substitute S-1",8,3,0,0,11
1777668,1456784,2024-06-12,Senate,"Reported Favorably Without Amendment",8,3,0,0,11
1777678,1456798,2024-06-12,Senate,"Reported Favorably With Substitute S-1",8,3,0,0,11
1777698,1456768,2024-06-12,Senate,"Reported Favorably Without Amendment",8,3,0,0,11
1777726,1357207,2023-10-26,Senate,"Reported Favorably With Substitute S-1",5,0,0,0,5
1777726,1362021,2023-11-09,Senate,"Senate Third Reading: Passed Roll Call # 714",37,0,0,1,38
1777735,1456783,2024-06-12,Senate,"Reported Favorably Without Amendment",8,3,0,0,11
1777753,1357320,2023-10-25,House,"Reported With Recommendation Without Amendment",13,0,0,0,13
1777753,1403803,2024-03-05,House,"House Third Reading: Given Immediate Effect Roll Call # 20",94,13,0,0,107
1777757,1357249,2023-10-25,House,"Reported With Recommendation Without Amendment",13,0,0,0,13
1777757,1403804,2024-03-05,House,"House Third Reading: Given Immediate Effect Roll Call # 21",93,14,0,0,107
1777830,1363337,2023-09-27,Senate,"Reported Favorably Without Amendment",6,0,0,0,6
1777831,1357242,2023-11-08,Senate,"Reported Favorably With Substitute S-1",9,2,0,0,11
1777831,1397434,2023-11-09,Senate,"Senate Third Reading: Passed Roll Call # 719",23,14,0,1,38
1777831,1456125,2024-06-11,House,"Reported With Recommendation Without Amendment",10,0,0,0,10
1777831,1458635,2024-06-20,House,"House Third Reading: Given Immediate Effect Roll Call # 202",60,49,0,0,109
1777832,1356712,2023-10-26,Senate,"Reported Favorably With Substitute S-4",5,0,0,0,5
1777832,1356713,2023-10-26,Senate,"Senate Third Reading: Passed Roll Call # 613",20,18,0,0,38
1777832,1356914,2023-11-01,House,"Reported With Recommendation Without Amendment",10,7,0,0,17
1777832,1356998,2023-11-03,House,"House Third Reading: Given Immediate Effect Roll Call # 488",56,52,0,0,108
1777832,1357914,2023-11-08,Senate,"Senate Third Reading: Roll Call: Roll Call # 676",20,17,0,1,38
1777835,1457119,2024-06-13,Senate,"Reported Favorably With Substitute S-1",8,0,0,0,8
1777835,1458667,2024-06-20,Senate,"Senate Third Reading: Passed Roll Call # 257",38,0,0,0,38
1777836,1395720,2024-02-21,Senate,"Reported Favorably With Substitute S-1",11,0,0,0,11
1777836,1402691,2024-02-28,Senate,"Senate Third Reading: Passed Roll Call # 36",38,0,0,0,38
1777836,1445869,2024-05-21,House,"Reported With Recommendation Without Amendment",9,0,0,0,9
1777836,1456514,2024-06-11,House,"House Third Reading: Given Immediate Effect Roll Call # 148",90,19,0,0,109
1777837,1470138,2024-12-10,Senate,"Reported Favorably With Substitute S-4",5,1,0,0,6
1777843,1354962,2023-09-19,House,"Reported With Recommendation Without Amendment",17,11,0,0,28
1777843,1354963,2023-09-19,House,"House Third Reading: Given Immediate Effect Roll Call # 287",56,54,0,0,110
1777845,1355125,2023-09-20,House,"Reported With Recommendation With Substitute H-2",16,11,0,0,27
1777845,1355126,2023-09-20,House,"House Third Reading: Given Immediate Effect Roll Call # 301",56,54,0,0,110
1777845,1355289,2023-09-27,Senate,"Senate Third Reading: Given Immediate Effect Roll Call # 463",20,18,0,0,38
1777847,1355049,2023-09-20,House,"Reported With Recommendation With Substitute H-3",16,11,0,0,27
1777847,1355050,2023-09-20,House,"House Third Reading: Given Immediate Effect Roll Call # 294",56,54,0,0,110
1777849,1355105,2023-09-20,House,"Reported With Recommendation With Substitute H-1",16,10,0,0,26
1777849,1355106,2023-09-20,House,"House Third Reading: Given Immediate Effect Roll Call # 296",56,54,0,0,110
1777849,1362604,2023-09-27,Senate,"Senate Third Reading: Given Immediate Effect Roll Call # 482",20,18,0,0,38
1777854,1354952,2023-09-19,House,"Reported With Recommendation Without Amendment",17,12,0,0,29
1777854,1354953,2023-09-19,House,"House Third Reading: Given Immediate Effect Roll Call # 285",56,54,0,0,110
1777854,1356326,2023-10-19,Senate,"Senate Third Reading: Given Immediate Effect Roll Call # 576",20,18,0,0,38
1777856,1355803,2023-10-04,House,"House Third Reading: Given Immediate Effect Roll Call # 335",56,52,0,0,108
1777856,1356375,2023-10-03,House,"Reported With Recommendation With Substitute H-1",6,2,0,0,8
1777856,1356924,2023-11-02,Senate,"Senate Third Reading: Passed Roll Call # 643",20,18,0,0,38
1777856,1357789,2023-11-02,Senate,"Reported Favorably Without Amendment",5,2,0,0,7
1777858,1355149,2023-09-20,House,"Reported With Recommendation With Substitute H-3",16,11,0,0,27
1777858,1355150,2023-09-20,House,"House Third Reading: Given Immediate Effect Roll Call # 304",56,54,0,0,110
1777858,1356313,2023-09-27,House,"House Third Reading: Roll Call # 311",56,54,0,0,110
1777858,1362588,2023-09-27,Senate,"Senate Third Reading: Given Immediate Effect Roll Call # 483",20,18,0,0,38
1777859,1355805,2023-10-04,House,"House Third Reading: Given Immediate Effect Roll Call # 337",56,52,0,0,108
1777859,1356376,2023-10-03,House,"Reported With Recommendation With Substitute H-1",6,2,0,0,8
1777859,1356926,2023-11-02,Senate,"Senate Third Reading: Passed Roll Call # 652",20,18,0,0,38
1777859,1357783,2023-11-02,Senate,"Reported Favorably Without Amendment",5,2,0,0,7
1777861,1355029,2023-09-19,House,"Reported With Recommendation With Substitute H-1",17,12,0,0,29
1777861,1355030,2023-09-19,House,"House Third Reading: Given Immediate Effect Roll Call # 289",56,54,0,0,110
1777861,1362617,2023-09-27,Senate,"Senate Third Reading: Given Immediate Effect Roll Call # 484",20,18,0,0,38
1777862,1469322,2024-11-13,House,"Reported With Recommendation Without Amendment",10,3,0,0,13
1777864,1355809,2023-10-04,House,"House Third Reading: Given Immediate Effect Roll Call # 334",56,52,0,0,108
1777864,1356369,2023-10-03,House,"Reported With Recommendation With Substitute H-1",6,2,0,0,8
1777864,1357229,2023-11-02,Senate,"Senate Third Reading: Passed Roll Call # 641",24,14,0,0,38
1777864,1357259,2023-11-08,House,"House Third Reading: Roll Call # 504",56,53,0,0,109
1777864,1357780,2023-11-02,Senate,"Reported Favorably With Substitute S-1",5,2,0,0,7
1777866,1355107,2023-09-20,House,"Reported With Recommendation With Substitute H-1",16,11,0,0,27
1777866,1355108,2023-09-20,House,"House Third Reading: Given Immediate Effect Roll Call # 293",56,54,0,0,110
1777866,1355290,2023-09-27,Senate,"Senate Third Reading: Given Immediate Effect Roll Call # 458",20,18,0,0,38
1777870,1355120,2023-09-20,House,"House Third Reading: Given Immediate Effect Roll Call # 303",56,54,0,0,110
1777870,1355202,2023-09-20,House,"Reported With Recommendation With Substitute H-1",16,11,0,0,27
1777870,1355304,2023-09-27,Senate,"Senate Third Reading: Given Immediate Effect Roll Call # 465",20,18,0,0,38
1777871,1354981,2023-09-19,House,"Reported With Recommendation Without Amendment",17,12,0,0,29
1777871,1354982,2023-09-19,House,"House Third Reading: Given Immediate Effect Roll Call # 286",56,54,0,0,110
1777874,1354979,2023-09-19,House,"Reported With Recommendation With Substitute H-1",18,1,0,0,19
1777874,1354980,2023-09-19,House,"House Third Reading: Given Immediate Effect Roll Call # 288",69,41,0,0,110
1777876,1355265,2023-09-20,House,"Reported With Recommendation With Substitute H-2",16,11,0,0,27
1777876,1355266,2023-09-20,House,"House Third Reading: Given Immediate Effect Roll Call # 295",56,54,0,0,110
1777876,1362610,2023-09-27,Senate,"Senate Third Reading: Given Immediate Effect Roll Call # 481",20,18,0,0,38
1777878,1355044,2023-09-20,House,"House Third Reading: Given Immediate Effect Roll Call # 305",56,54,0,0,110
1777878,1355208,2023-09-20,House,"Reported With Recommendation With Substitute H-3",16,11,0,0,27
1777878,1362591,2023-09-27,Senate,"Senate Third Reading: Given Immediate Effect Roll Call # 485",20,18,0,0,38
1777880,1355810,2023-10-04,House,"House Third Reading: Given Immediate Effect Roll Call # 336",56,52,0,0,108
1777880,1356371,2023-10-03,House,"Reported With Recommendation With Substitute H-1",6,2,0,0,8
1777880,1356925,2023-11-02,Senate,"Senate Third Reading: Passed Roll Call # 651",20,18,0,0,38
1777880,1357778,2023-11-02,Senate,"Reported Favorably Without Amendment",5,2,0,0,7
1777886,1354972,2023-09-19,House,"Reported With Recommendation With Substitute H-1",17,12,0,0,29
1777886,1354973,2023-09-19,House,"House Third Reading: Given Immediate Effect Roll Call # 284",56,54,0,0,110
1777888,1355121,2023-09-20,House,"Reported With Recommendation With Substitute H-2",16,11,0,0,27
1777888,1355122,2023-09-20,House,"House Third Reading: Given Immediate Effect Roll Call # 300",56,54,0,0,110
1777888,1355322,2023-09-27,Senate,"Senate Third Reading: Given Immediate Effect Roll Call # 462",20,18,0,0,38
1777893,1355067,2023-09-20,House,"Reported With Recommendation With Substitute H-2",16,11,0,0,27
1777893,1355068,2023-09-20,House,"House Third Reading: Given Immediate Effect Roll Call # 299",56,54,0,0,110
1777893,1355299,2023-09-27,Senate,"Senate Third Reading: Given Immediate Effect Roll Call # 461",20,18,0,0,38
1777894,1356862,2023-10-10,House,"Reported With Recommendation With Substitute H-1",5,1,0,0,6
1777894,1356994,2023-11-02,House,"House Third Reading: Given Immediate Effect Roll Call # 475",79,30,0,0,109
1777896,1355096,2023-09-20,House,"Reported With Recommendation Without Amendment",13,0,0,0,13
1777896,1355097,2023-09-20,House,"House Third Reading: Given Immediate Effect Roll Call # 290",99,11,0,0,110
1777896,1362569,2023-09-27,Senate,"Senate Third Reading: Given Immediate Effect Roll Call # 480",37,1,0,0,38
1777898,1355075,2023-09-20,House,"Reported With Recommendation With Substitute H-2",16,11,0,0,27
1777898,1355076,2023-09-20,House,"House Third Reading: Given Immediate Effect Roll Call # 298",56,54,0,0,110
1777898,1355315,2023-09-27,Senate,"Senate Third Reading: Given Immediate Effect Roll Call # 460",20,18,0,0,38
1777900,1356320,2023-09-28,House,"Reported With Recommendation With Substitute H-1",7,0,0,0,7
1777900,1356477,2023-10-24,House,"House Third Reading: Given Immediate Effect Roll Call # 393",85,24,0,0,109
1777900,1391686,2024-02-15,Senate,"Reported Favorably Without Amendment",8,0,0,0,8
1777900,1393470,2024-02-22,Senate,"Senate Third Reading: Given Immediate Effect Roll Call # 23",31,6,0,1,38
1777902,1355152,2023-09-20,House,"House Third Reading: Given Immediate Effect Roll Call # 302",79,31,0,0,110
1777902,1355187,2023-09-20,House,"Reported With Recommendation With Substitute H-1",16,1,0,0,17
1777902,1355314,2023-09-27,Senate,"Senate Third Reading: Given Immediate Effect Roll Call # 464",34,4,0,0,38
1777903,1355110,2023-09-20,House,"Reported With Recommendation With Substitute H-2",16,11,0,0,27
1777903,1355111,2023-09-20,House,"House Third Reading: Given Immediate Effect Roll Call # 297",56,54,0,0,110
1777903,1355316,2023-09-27,Senate,"Senate Third Reading: Given Immediate Effect Roll Call # 459",20,18,0,0,38
1778179,1355910,2023-09-27,Senate,"Senate Third Reading: Passed Roll Call # 467",20,18,0,0,38
1778179,1356000,2023-10-11,House,"Reported With Recommendation Without Amendment",16,12,0,0,28
1778179,1362853,2023-10-18,House,"House Third Reading: Given Immediate Effect Roll Call # 377",56,54,0,0,110
1778181,1355323,2023-09-27,Senate,"Senate Third Reading: Passed Roll Call # 469",21,17,0,0,38
1778183,1357002,2023-11-02,Senate,"Senate Third Reading: Passed Roll Call # 644",20,18,0,0,38
1778183,1357670,2023-11-09,House,"House Third Reading: Given Immediate Effect Roll Call # 540",56,53,0,0,109
1778187,1412494,2024-03-19,Senate,"Reported Favorably Without Amendment",10,0,0,0,10
1778187,1412495,2024-03-19,Senate,"Senate Third Reading: Passed Roll Call # 65",35,2,0,1,38
1778187,1469336,2024-11-13,House,"Reported With Recommendation Without Amendment",13,0,0,0,13
1778187,1469833,2024-11-14,House,"House Third Reading: Given Immediate Effect Roll Call # 356",82,20,0,0,102
1778193,1355331,2023-09-27,Senate,"Senate Third Reading: Passed Roll Call # 466",20,18,0,0,38
1778193,1355965,2023-10-11,House,"Reported With Recommendation Without Amendment",16,12,0,0,28
1778193,1356272,2023-10-18,House,"House Third Reading: Given Immediate Effect Roll Call # 376",56,54,0,0,110
1778195,1355335,2023-09-27,Senate,"Senate Third Reading: Passed Roll Call # 471",24,14,0,0,38
1778195,1355992,2023-10-11,House,"Reported With Recommendation Without Amendment",18,1,0,0,19
1778195,1356291,2023-10-18,House,"House Third Reading: Given Immediate Effect Roll Call # 380",65,45,0,0,110
1778196,1355297,2023-09-27,Senate,"Senate Third Reading: Passed Roll Call # 468",20,18,0,0,38
1778196,1355986,2023-10-11,House,"Reported With Recommendation Without Amendment",16,12,0,0,28
1778196,1356273,2023-10-18,House,"House Third Reading: Given Immediate Effect Roll Call # 378",56,54,0,0,110
1778197,1355303,2023-09-27,Senate,"Senate Third Reading: Passed Roll Call # 470",21,17,0,0,38
1778197,1355995,2023-10-11,House,"Reported With Recommendation Without Amendment",16,12,0,0,28
1778197,1362852,2023-10-18,House,"House Third Reading: Given Immediate Effect Roll Call # 379",56,54,0,0,110
1778205,1430701,2024-04-18,House,"Reported With Recommendation With Substitute H-3",12,2,0,0,14
1778205,1469284,2024-11-13,House,"House Third Reading: Given Immediate Effect Roll Call # 338",57,52,0,0,109
1778217,1363252,2023-10-17,House,"Reported With Recommendation With Substitute H-1",13,0,0,0,13
1778308,1355509,2023-09-28,Senate,"Reported Favorably Without Amendment",10,0,0,0,10
1778308,1355768,2023-10-04,Senate,"Senate Third Reading: Passed Roll Call # 492",38,0,0,0,38
1778308,1356319,2023-10-19,House,"Reported With Recommendation Without Amendment",18,0,0,0,18
1778308,1356898,2023-11-01,House,"House Third Reading: Given Immediate Effect Roll Call # 438",104,6,0,0,110
1778311,1363338,2023-11-14,Senate,"Reported Favorably Without Amendment",6,0,0,0,6
1778311,1369923,2024-01-25,Senate,"Senate Third Reading: Passed Roll Call # 2",37,0,0,1,38
1778311,1470140,2024-12-11,House,"House Third Reading: Given Immediate Effect Roll Call # 439",56,53,0,0,109
1778313,1356218,2023-10-11,Senate,"Reported Favorably Without Amendment",7,0,0,0,7
1778313,1356344,2023-10-19,Senate,"Senate Third Reading: Passed Roll Call # 578",38,0,0,0,38
1778313,1396454,2024-02-13,House,"Reported With Recommendation Without Amendment",8,0,0,0,8
1778313,1441669,2024-05-09,House,"House Third Reading: Given Immediate Effect Roll Call # 84",107,0,0,0,107
1778314,1363339,2023-11-14,Senate,"Reported Favorably With Substitute S-1",6,0,0,0,6
1778314,1369918,2024-01-25,Senate,"Senate Third Reading: Passed Roll Call # 3",37,0,0,1,38
1778314,1470307,2024-12-11,House,"House Third Reading: Given Immediate Effect Roll Call # 440",56,53,0,0,109
1778315,1356616,2023-10-10,Senate,"Reported Favorably With Substitute S-2",3,1,0,0,4
1778315,1356919,2023-11-01,House,"Reported With Recommendation Without Amendment",10,7,0,0,17
1778315,1357047,2023-11-03,House,"House Third Reading: Given Immediate Effect Roll Call # 489",56,52,0,0,108
1778315,1410013,2023-10-26,Senate,"Senate Third Reading: Passed Roll Call # 603",20,18,0,0,38
1778319,1363316,2023-11-14,Senate,"Reported Favorably With Substitute S-1",6,0,0,0,6
1778319,1369917,2024-01-25,Senate,"Senate Third Reading: Passed Roll Call # 1",37,0,0,1,38
1778319,1470158,2024-12-11,House,"House Third Reading: Given Immediate Effect Roll Call # 438",56,53,0,0,109
1778327,1432638,2024-04-23,House,"Reported With Recommendation Without Amendment",7,0,0,0,7
1778327,1456821,2024-06-12,House,"House Third Reading: Given Immediate Effect Roll Call # 157",59,49,0,0,108
1778327,1469127,2024-10-31,Senate,"Reported Favorably Without Amendment",10,1,0,0,11
1778327,1471015,2024-12-19,Senate,"Senate Third Reading: Passed Roll Call # 626",24,14,0,0,38
1778331,1469759,2024-12-04,House,"Reported With Recommendation With Substitute H-2",11,0,0,0,11
1778331,1470151,2024-12-11,House,"House Third Reading: Given Immediate Effect Roll Call # 446",104,5,0,0,109
1778333,1432628,2024-04-23,House,"Reported With Recommendation Without Amendment",7,0,0,0,7
1778333,1456744,2024-06-12,House,"House Third Reading: Given Immediate Effect Roll Call # 159",60,48,0,0,108
1778333,1469903,2024-10-31,Senate,"Reported Favorably Without Amendment",9,2,0,0,11
1778333,1470995,2024-12-19,Senate,"Senate Third Reading: Passed Roll Call # 629",23,15,0,0,38
1778333,1470996,2024-12-19,Senate,"Senate Third Reading: Passed Roll Call # 629",23,15,0,0,38
1778334,1433210,2024-04-23,House,"Reported With Recommendation Without Amendment",7,0,0,0,7
1778334,1456986,2024-06-12,House,"House Third Reading: Given Immediate Effect Roll Call # 158",56,53,0,0,109
1778334,1469128,2024-10-31,Senate,"Reported Favorably Without Amendment",11,0,0,0,11
1778334,1470999,2024-12-19,Senate,"Senate Third Reading: Passed Roll Call # 627",26,12,0,0,38
1778339,1363257,2023-11-02,House,"Reported With Recommendation With Substitute H-1",13,0,0,0,13
1778339,1461365,2024-06-26,House,"House Third Reading: Given Immediate Effect Roll Call # 229",91,18,0,0,109
1778343,1356082,2023-10-12,House,"House Third Reading: Given Immediate Effect Roll Call # 352",56,54,0,0,110
1778343,1356384,2023-10-03,House,"Reported With Recommendation Without Amendment",9,4,0,0,13
1778343,1356977,2023-11-01,Senate,"Reported Favorably Without Amendment",5,2,0,0,7
1778343,1398739,2023-11-08,Senate,"Senate Third Reading: Passed Roll Call # 688",21,14,0,3,38
1778347,1356512,2023-10-19,House,"Reported With Recommendation With Substitute H-1",6,3,0,0,9
1778347,1356879,2023-11-01,House,"House Third Reading: Given Immediate Effect Roll Call # 435",56,54,0,0,110
1778347,1395748,2024-02-21,Senate,"Reported Favorably Without Amendment",8,3,0,0,11
1778347,1458649,2024-06-20,Senate,"Senate Third Reading: Passed Roll Call # 267",20,18,0,0,38
1778696,1448331,2024-05-22,House,"Reported With Recommendation Without Amendment",19,0,0,0,19
1778696,1456108,2024-06-11,House,"House Third Reading: Given Immediate Effect Roll Call # 150",105,4,0,0,109
1778697,1448989,2024-05-22,House,"Reported With Recommendation Without Amendment",19,0,0,0,19
1778697,1456510,2024-06-11,House,"House Third Reading: Given Immediate Effect Roll Call # 151",105,4,0,0,109
1778698,1356762,2023-10-17,House,"Reported With Recommendation With Substitute H-1",13,0,0,0,13
1778698,1356885,2023-11-01,House,"House Third Reading: Given Immediate Effect Roll Call # 434",104,6,0,0,110
1778698,1469135,2024-10-31,Senate,"Reported Favorably Without Amendment",5,1,0,0,6
1778698,1471008,2024-12-19,Senate,"Senate Third Reading: Passed Roll Call # 625",20,14,4,0,38
1778698,1471009,2024-12-19,Senate,"Senate Third Reading: Passed Roll Call # 628",24,14,0,0,38
1778704,1356337,2023-10-19,Senate,"Reported Favorably With Substitute S-2",5,3,0,0,8
1778704,1356338,2023-10-19,Senate,"Senate Third Reading: Passed Roll Call # 574",23,14,1,0,38
1778707,1355895,2023-10-04,House,"Reported With Recommendation With Substitute H-1",7,3,0,0,10
1778707,1356823,2023-10-31,House,"House Third Reading: Given Immediate Effect Roll Call # 426",66,44,0,0,110
1778707,1357306,2023-11-08,Senate,"Reported Favorably Without Amendment",9,2,0,0,11
1778707,1357307,2023-11-08,Senate,"Senate Third Reading: Given Immediate Effect Roll Call # 696",25,10,0,3,38
1778707,1357540,2023-11-09,House,"House Third Reading: Senate Amendment(s) Concurred In Roll Call # 557",68,38,0,0,106
1778711,1356306,2023-10-11,House,"Reported With Recommendation With Substitute H-1",9,0,0,0,9
1778711,1356479,2023-10-24,House,"House Third Reading: Given Immediate Effect Roll Call # 399",74,35,0,0,109
1778713,1356191,2023-10-10,Senate,"Reported Favorably With Substitute S-1",6,0,0,0,6
1778713,1356340,2023-10-19,Senate,"Senate Third Reading: Passed Roll Call # 569",20,18,0,0,38
1778713,1357202,2023-10-31,House,"Reported With Recommendation With Substitute H-1",6,2,0,0,8
1778713,1357280,2023-11-08,House,"House Third Reading: Given Immediate Effect Roll Call # 511",56,53,0,0,109
1778713,1357425,2023-11-09,Senate,"Senate Third Reading: Roll Call: Roll Call # 708",20,18,0,0,38
1778720,1355596,2023-10-03,Senate,"Reported Favorably Without Amendment",5,0,0,0,5
1778720,1355904,2023-10-11,Senate,"Senate Third Reading: Passed Roll Call # 518",22,16,0,0,38
1778720,1356540,2023-10-17,House,"Reported With Recommendation With Substitute H-1",9,0,0,0,9
1778720,1356884,2023-11-01,House,"House Third Reading: Given Immediate Effect Roll Call # 441",58,52,0,0,110
1778720,1357870,2023-11-02,Senate,"Senate Third Reading: Roll Call: Roll Call # 638",22,16,0,0,38
1778730,1356334,2023-10-19,Senate,"Reported Favorably With Substitute S-4",5,3,0,0,8
1778730,1356335,2023-10-19,Senate,"Senate Third Reading: Passed Roll Call # 573",23,14,1,0,38
1778795,1356180,2023-10-11,Senate,"Reported Favorably Without Amendment",11,0,0,0,11
1778795,1356328,2023-10-19,Senate,"Senate Third Reading: Passed Roll Call # 579",37,1,0,0,38
1778795,1357210,2023-10-31,House,"Reported With Recommendation Without Amendment",11,0,0,0,11
1778795,1357238,2023-11-08,House,"House Third Reading: Given Immediate Effect Roll Call # 516",103,6,0,0,109
1778807,1440232,2024-05-07,Senate,"Reported Favorably Without Amendment",9,0,0,0,9
1778807,1462386,2024-06-25,Senate,"Senate Third Reading: Passed Roll Call # 272",27,11,0,0,38
1778807,1469681,2024-12-04,House,"Reported With Recommendation Without Amendment",7,0,0,0,7
1778853,1440366,2024-05-07,Senate,"Reported Favorably Without Amendment",9,0,0,0,9
1778853,1462424,2024-06-25,Senate,"Senate Third Reading: Passed Roll Call # 273",27,11,0,0,38
1778853,1470037,2024-12-04,House,"Reported With Recommendation Without Amendment",7,0,0,0,7
1778900,1357151,2023-10-24,House,"Reported With Recommendation Without Amendment",13,0,0,0,13
1778900,1357264,2023-11-08,House,"House Third Reading: Given Immediate Effect Roll Call # 507",105,4,0,0,109
1778900,1454613,2024-06-06,Senate,"Reported Favorably With Substitute S-1",10,0,0,0,10
1778900,1462139,2024-06-27,House,"House Third Reading: Roll Call # 283",109,1,0,0,110
1778900,1462737,2024-06-25,Senate,"Senate Third Reading: Passed Roll Call # 278",38,0,0,0,38
1778902,1357209,2023-10-24,House,"Reported With Recommendation Without Amendment",13,0,0,0,13
1778902,1357271,2023-11-08,House,"House Third Reading: Given Immediate Effect Roll Call # 508",105,4,0,0,109
1778902,1454500,2024-06-06,Senate,"Reported Favorably With Substitute S-1",10,0,0,0,10
1778902,1461759,2024-06-27,House,"House Third Reading: Roll Call # 284",109,1,0,0,110
1778902,1462742,2024-06-25,Senate,"Senate Third Reading: Passed Roll Call # 279",38,0,0,0,38
1778904,1356465,2023-10-12,House,"Reported With Recommendation Without Amendment",16,0,0,0,16
1778999,1356367,2023-10-03,House,"Reported With Recommendation Without Amendment",13,0,0,0,13
1778999,1356980,2023-11-02,House,"House Third Reading: Given Immediate Effect Roll Call # 471",105,4,0,0,109
1779029,1433207,2024-04-23,House,"Reported With Recommendation Without Amendment",12,0,0,0,12
1779029,1459904,2024-06-25,House,"House Third Reading: Given Immediate Effect Roll Call # 215",110,0,0,0,110
1779029,1469902,2024-11-26,Senate,"Reported Favorably Without Amendment",7,0,0,0,7
1779029,1470115,2024-12-11,Senate,"Senate Third Reading: Passed Roll Call # 495",36,0,0,2,38
1779460,1449417,2024-05-23,Senate,"Reported Favorably With Substitute S-1",9,0,0,0,9
1779460,1456572,2024-06-12,Senate,"Senate Third Reading: Passed Roll Call # 242",38,0,0,0,38
1779467,1470460,2024-12-12,Senate,"Reported Favorably With Substitute S-1",4,0,0,0,4
1779467,1470461,2024-12-12,Senate,"Senate Third Reading: Passed Roll Call # 503",36,0,0,2,38
1779475,1425025,2024-03-06,House,"Reported With Recommendation Without Amendment",19,0,0,0,19
1779475,1434280,2024-04-24,House,"House Third Reading: Given Immediate Effect Roll Call # 39",96,11,0,0,107
1779475,1469137,2024-10-31,Senate,"Reported Favorably Without Amendment",10,0,0,0,10
1779475,1469993,2024-12-10,Senate,"Senate Third Reading: Passed Roll Call # 476",37,0,0,1,38
1779476,1403486,2024-03-05,Senate,"Reported Favorably Without Amendment",9,1,0,0,10
1779476,1408098,2024-03-12,Senate,"Senate Third Reading: Passed Roll Call # 51",26,12,0,0,38
1779476,1445599,2024-05-21,House,"Reported With Recommendation Without Amendment",13,0,0,0,13
1779476,1461658,2024-06-26,House,"House Third Reading: Given Immediate Effect Roll Call # 245",73,36,0,0,109
1779482,1412280,2024-03-19,Senate,"Reported Favorably Without Amendment",10,0,0,0,10
1779482,1412281,2024-03-19,Senate,"Senate Third Reading: Passed Roll Call # 63",37,0,0,1,38
1779495,1425030,2024-03-06,House,"Reported With Recommendation Without Amendment",19,0,0,0,19
1779495,1434688,2024-04-24,House,"House Third Reading: Given Immediate Effect Roll Call # 40",96,11,0,0,107
1779495,1469129,2024-10-31,Senate,"Reported Favorably Without Amendment",10,0,0,0,10
1779497,1356360,2023-10-19,Senate,"Reported Favorably Without Amendment",17,2,0,0,19
1779497,1356786,2023-10-26,Senate,"Senate Third Reading: Passed Roll Call # 599",32,6,0,0,38
1779497,1425009,2024-03-06,House,"Reported With Recommendation Without Amendment",16,11,0,0,27
1779497,1458852,2024-06-20,House,"House Third Reading: Given Immediate Effect Roll Call # 201",57,52,0,0,109
1779499,1404102,2024-03-05,Senate,"Reported Favorably With Substitute S-3",9,1,0,0,10
1779499,1407915,2024-03-12,Senate,"Senate Third Reading: Passed Roll Call # 50",26,12,0,0,38
1779499,1447000,2024-05-21,House,"Reported With Recommendation Without Amendment",13,0,0,0,13
1779499,1461343,2024-06-26,House,"House Third Reading: Given Immediate Effect Roll Call # 244",76,33,0,0,109
1779501,1468582,2024-10-03,Senate,"Reported Favorably Without Amendment",10,0,0,0,10
1779501,1470323,2024-12-12,House,"Reported With Recommendation Without Amendment",18,0,0,0,18
1779504,1356282,2023-10-11,House,"Reported With Recommendation Without Amendment",8,2,0,0,10
1779504,1356350,2023-10-19,House,"House Third Reading: Given Immediate Effect Roll Call # 383",63,46,0,0,109
1779504,1357230,2023-11-07,Senate,"Reported Favorably Without Amendment",9,1,0,0,10
1779504,1357284,2023-11-08,Senate,"Senate Third Reading: Passed Roll Call # 697",24,11,0,3,38
1779525,1356792,2023-10-26,Senate,"Reported Favorably Without Amendment",7,1,0,0,8
1779532,1356747,2023-10-26,Senate,"Reported Favorably Without Amendment",7,1,0,0,8
1779534,1356744,2023-10-26,Senate,"Reported Favorably With Substitute S-1",7,1,0,0,8
1779534,1412060,2024-03-19,Senate,"Senate Third Reading: Passed Roll Call # 87",20,15,0,3,38
1779534,1456132,2024-06-11,House,"Reported With Recommendation With Substitute H-1",8,3,0,0,11
1779538,1356754,2023-10-26,Senate,"Reported Favorably With Substitute S-2",7,1,0,0,8
1779538,1412157,2024-03-19,Senate,"Senate Third Reading: Passed Roll Call # 86",20,15,0,3,38
1779538,1456138,2024-06-11,House,"Reported With Recommendation With Substitute H-5",8,3,0,0,11
1779557,1363253,2023-10-31,House,"Reported With Recommendation Without Amendment",8,5,0,0,13
1779653,1404844,2024-02-21,Senate,"Reported Favorably With Substitute S-2",6,0,0,0,6
1779653,1407924,2024-03-12,Senate,"Senate Third Reading: Passed Roll Call # 54",38,0,0,0,38
1779653,1467574,2024-09-25,House,"Reported With Recommendation With Substitute H-2",11,1,0,0,12
1779653,1467575,2024-09-25,House,"House Third Reading: Given Immediate Effect Roll Call # 310",99,10,0,0,109
1779653,1467644,2024-09-26,Senate,"Senate Third Reading: Roll Call: Roll Call # 361",37,0,0,1,38
1779654,1404868,2024-02-21,Senate,"Reported Favorably With Substitute S-2",6,0,0,0,6
1779654,1407681,2024-03-12,Senate,"Senate Third Reading: Passed Roll Call # 53",37,1,0,0,38
1779654,1467565,2024-09-25,House,"Reported With Recommendation With Substitute H-5",12,1,0,0,13
1779654,1467566,2024-09-25,House,"House Third Reading: Given Immediate Effect Roll Call # 309",100,8,0,0,108
1779654,1468605,2024-09-26,Senate,"Senate Third Reading: Roll Call: Roll Call # 360",37,0,0,1,38
1779676,1443558,2024-05-15,House,"Reported With Recommendation With Substitute H-1",9,2,0,0,11
1779677,1356793,2023-10-25,House,"Reported With Recommendation With Substitute H-1",8,0,0,0,8
1779677,1356812,2023-10-31,House,"House Third Reading: Given Immediate Effect Roll Call # 427",72,38,0,0,110
1779677,1402953,2024-02-29,Senate,"Senate Third Reading: Given Immediate Effect Roll Call # 47",24,14,0,0,38
1779677,1441682,2024-05-09,House,"House Third Reading: Roll Call # 77",69,38,0,0,107
1779678,1356799,2023-10-25,House,"Reported With Recommendation Without Amendment",8,5,0,0,13
1779678,1356817,2023-10-31,House,"House Third Reading: Given Immediate Effect Roll Call # 433",77,33,0,0,110
1779678,1411988,2024-03-19,Senate,"Senate Third Reading: Passed Roll Call # 82",23,12,0,3,38
1779679,1364468,2023-10-31,House,"Reported With Recommendation Without Amendment",8,5,0,0,13
1779680,1366425,2023-10-31,House,"Reported With Recommendation Without Amendment",8,5,0,0,13
1779681,1356803,2023-10-25,House,"Reported With Recommendation Without Amendment",8,5,0,0,13
1779681,1364258,2023-10-31,House,"House Third Reading: Given Immediate Effect Roll Call # 428",79,31,0,0,110
1779681,1412419,2024-03-19,Senate,"Senate Third Reading: Passed Roll Call # 83",22,13,0,3,38
1779682,1356804,2023-10-25,House,"Reported With Recommendation Without Amendment",8,5,0,0,13
1779682,1368151,2023-10-31,House,"House Third Reading: Given Immediate Effect Roll Call # 430",80,30,0,0,110
1779682,1411876,2024-03-19,Senate,"Senate Third Reading: Passed Roll Call # 85",22,13,0,3,38
1779683,1357213,2023-10-24,House,"Reported With Recommendation Without Amendment",8,0,0,0,8
1779683,1374605,2023-11-08,House,"House Third Reading: Given Immediate Effect Roll Call # 513",60,49,0,0,109
1779683,1398230,2024-02-28,Senate,"Reported Favorably Without Amendment",10,0,0,0,10
1779683,1428109,2024-04-16,Senate,"Senate Third Reading: Passed Roll Call # 94",33,3,0,2,38
1779684,1368164,2023-10-31,House,"Reported With Recommendation With Substitute H-1",8,5,0,0,13
1779685,1364385,2023-10-31,House,"Reported With Recommendation With Substitute H-1",8,5,0,0,13
1779687,1356802,2023-10-25,House,"Reported With Recommendation Without Amendment",8,5,0,0,13
1779687,1367607,2023-10-31,House,"House Third Reading: Given Immediate Effect Roll Call # 429",79,31,0,0,110
1779687,1411934,2024-03-19,Senate,"Senate Third Reading: Passed Roll Call # 84",22,13,0,3,38
1779687,1470927,2024-11-13,House,"House Third Reading: Roll Call # 333",86,23,0,0,109
1779951,1356271,2023-10-18,Senate,"Senate Third Reading: Passed Roll Call # 540",30,8,0,0,38
1779951,1356846,2023-10-24,House,"Reported With Recommendation Without Amendment",8,0,0,0,8
1779951,1356904,2023-11-01,House,"House Third Reading: Given Immediate Effect Roll Call # 455",102,8,0,0,110
1779955,1356739,2023-10-26,Senate,"Reported Favorably Without Amendment",7,1,0,0,8
1779968,1356847,2023-10-31,Senate,"Reported Favorably Without Amendment",6,1,0,0,7
1779968,1356993,2023-11-02,Senate,"Senate Third Reading: Passed Roll Call # 645",20,18,0,0,38
1779968,1357869,2023-11-09,House,"House Third Reading: Given Immediate Effect Roll Call # 541",56,53,0,0,109
1779973,1356274,2023-10-18,Senate,"Senate Third Reading: Passed Roll Call # 539",30,8,0,0,38
1779973,1356801,2023-10-24,House,"Reported With Recommendation Without Amendment",8,0,0,0,8
1779973,1356913,2023-11-01,House,"House Third Reading: Given Immediate Effect Roll Call # 454",102,8,0,0,110
1779979,1425014,2024-03-21,Senate,"Reported Favorably With Substitute S-2",3,1,0,0,4
1779979,1437435,2024-05-01,Senate,"Senate Third Reading: Passed Roll Call # 105",20,18,0,0,38
1779979,1458707,2024-06-20,House,"Reported With Recommendation With Substitute H-1",6,3,0,0,9
1779979,1461330,2024-06-26,House,"House Third Reading: Given Immediate Effect Roll Call # 225",56,54,0,0,110
1779979,1463079,2024-06-26,Senate,"Senate Third Reading: Roll Call: Roll Call # 321",20,18,0,0,38
1779986,1454335,2024-06-05,House,"Reported With Recommendation Without Amendment",11,0,0,0,11
1779986,1457336,2024-06-13,House,"House Third Reading: Given Immediate Effect Roll Call # 170",109,0,0,0,109
1779988,1356259,2023-10-18,House,"Reported With Recommendation Without Amendment",9,7,0,0,16
1779990,1448864,2024-05-22,House,"Reported With Recommendation With Substitute H-3",10,0,0,0,10
1779997,1356917,2023-10-18,House,"Reported With Recommendation With Substitute H-1",9,7,0,0,16
1779997,1356995,2023-11-02,House,"House Third Reading: Given Immediate Effect Roll Call # 483",56,52,0,0,108
1779997,1357276,2023-11-08,Senate,"Senate Third Reading: Passed Roll Call # 669",20,18,0,0,38
1779997,1357277,2023-11-08,Senate,"Reported Favorably With Substitute S-1",9,2,0,0,11
1779997,1357278,2023-11-08,Senate,"Senate Third Reading: Passed Roll Call # 669",20,18,0,0,38
1779997,1374699,2023-11-08,House,"House Third Reading: Roll Call # 492",56,53,0,0,109
1779998,1356440,2023-10-18,House,"Reported With Recommendation Without Amendment",9,7,0,0,16
1779999,1356450,2023-10-18,House,"Reported With Recommendation Without Amendment",9,7,0,0,16
1779999,1356997,2023-11-02,House,"House Third Reading: Given Immediate Effect Roll Call # 484",56,52,0,0,108
1779999,1357272,2023-11-08,Senate,"Reported Favorably Without Amendment",9,2,0,0,11
1779999,1357273,2023-11-08,Senate,"Senate Third Reading: Passed Roll Call # 670",20,18,0,0,38
1779999,1374744,2023-11-08,House,"House Third Reading: Roll Call # 493",56,53,0,0,109
1780023,1356709,2023-10-26,Senate,"Reported Favorably With Substitute S-1",7,3,0,0,10
1780023,1411729,2024-03-19,Senate,"Senate Third Reading: Passed Roll Call # 78",20,15,2,1,38
1780023,1470097,2024-12-10,House,"Reported With Recommendation With Substitute H-2",8,3,0,0,11
1780025,1356719,2023-10-26,Senate,"Reported Favorably With Substitute S-1",7,3,0,0,10
1780025,1411752,2024-03-19,Senate,"Senate Third Reading: Passed Roll Call # 79",20,15,0,3,38
1780025,1470003,2024-12-10,House,"Reported With Recommendation Without Amendment",8,3,0,0,11
1780030,1356714,2023-10-26,Senate,"Reported Favorably With Substitute S-1",7,3,0,0,10
1780030,1411784,2024-03-19,Senate,"Senate Third Reading: Passed Roll Call # 80",20,15,0,3,38
1780030,1470212,2024-12-10,House,"Reported With Recommendation Without Amendment",8,3,0,0,11
1780034,1356352,2023-10-19,Senate,"Reported Favorably Without Amendment",5,3,0,0,8
1780034,1356353,2023-10-19,Senate,"Senate Third Reading: Passed Roll Call # 575",23,14,1,0,38
1780044,1400282,2024-02-07,House,"Reported With Recommendation With Substitute H-1",4,0,0,0,4
1780086,1408471,2024-03-05,House,"Reported With Recommendation Without Amendment",13,0,0,0,13
1780086,1440348,2024-05-07,House,"House Third Reading: Defeated Roll Call # 55",55,6,0,0,61
1780086,1445912,2024-05-21,House,"House Third Reading: Given Immediate Effect Roll Call # 112",103,4,0,0,107
1780086,1467459,2024-09-19,Senate,"Reported Favorably Without Amendment",4,0,0,0,4
1780086,1468450,2024-10-08,Senate,"Senate Third Reading: Passed Roll Call # 368",35,1,0,2,38
1780166,1356166,2023-10-17,House,"Reported With Recommendation Without Amendment",6,0,0,0,6
1780166,1356870,2023-11-01,House,"House Third Reading: Given Immediate Effect Roll Call # 447",60,50,0,0,110
1780166,1357663,2023-11-09,Senate,"Reported Favorably Without Amendment",11,0,0,0,11
1780166,1357664,2023-11-09,Senate,"Senate Third Reading: Passed Roll Call # 736",20,16,0,2,38
1780166,1357665,2023-11-09,House,"House Third Reading: Senate Amendment(s) Concurred In Roll Call # 586",61,45,0,0,106
1780175,1356761,2023-10-17,House,"Reported With Recommendation Without Amendment",6,0,0,0,6
1780175,1356888,2023-11-01,House,"House Third Reading: Given Immediate Effect Roll Call # 448",58,52,0,0,110
1780175,1357519,2023-11-09,Senate,"Reported Favorably Without Amendment",11,0,0,0,11
1780175,1392054,2023-11-09,House,"House Third Reading: Roll Call # 585",58,48,0,0,106
1780175,1399898,2023-11-09,Senate,"Senate Third Reading: Passed Roll Call # 737",20,16,0,2,38
1780182,1356730,2023-10-17,House,"Reported With Recommendation Without Amendment",6,0,0,0,6
1780182,1356863,2023-11-01,House,"House Third Reading: Given Immediate Effect Roll Call # 444",59,51,0,0,110
1780182,1357520,2023-11-09,Senate,"Reported Favorably With Substitute S-1",11,0,0,0,11
1780182,1357521,2023-11-09,Senate,"Senate Third Reading: Passed Roll Call # 734",20,16,0,2,38
1780182,1391999,2023-11-09,House,"House Third Reading: Roll Call # 583",60,46,0,0,106
1780190,1356160,2023-10-17,House,"Reported With Recommendation Without Amendment",6,0,0,0,6
1780190,1356876,2023-11-01,House,"House Third Reading: Given Immediate Effect Roll Call # 446",63,47,0,0,110
1780190,1357781,2023-11-09,Senate,"Reported Favorably With Substitute S-1",11,0,0,0,11
1780190,1357782,2023-11-09,Senate,"Senate Third Reading: Passed Roll Call # 735",20,16,0,2,38
1780190,1391773,2023-11-09,House,"House Third Reading: Roll Call # 584",61,45,0,0,106
1780196,1356746,2023-10-17,House,"Reported With Recommendation Without Amendment",6,0,0,0,6
1780196,1356877,2023-11-01,House,"House Third Reading: Given Immediate Effect Roll Call # 445",59,51,0,0,110
1780655,1467598,2024-09-25,House,"Reported With Recommendation Without Amendment",3,0,0,0,3
1780659,1356814,2023-10-31,Senate,"Reported Favorably With Substitute S-2",6,1,0,0,7
1780659,1357074,2023-11-02,Senate,"Senate Third Reading: Passed Roll Call # 647",20,18,0,0,38
1780659,1357729,2023-11-09,House,"House Third Reading: Given Immediate Effect Roll Call # 543",56,53,0,0,109
1780669,1356840,2023-10-31,Senate,"Reported Favorably With Substitute S-2",6,1,0,0,7
1780669,1357090,2023-11-02,Senate,"Senate Third Reading: Passed Roll Call # 646",20,18,0,0,38
1780669,1357693,2023-11-09,House,"House Third Reading: Given Immediate Effect Roll Call # 542",56,53,0,0,109
1780673,1356321,2023-10-18,Senate,"Reported Favorably Without Amendment",8,3,0,0,11
1780673,1408019,2023-10-26,Senate,"Senate Third Reading: Passed Roll Call # 595",20,18,0,0,38
1780677,1356481,2023-10-24,Senate,"Reported Favorably Without Amendment",7,0,0,0,7
1780677,1357149,2023-11-01,House,"Reported With Recommendation Without Amendment",12,0,0,0,12
1780677,1357305,2023-11-08,House,"House Third Reading: Given Immediate Effect Roll Call # 521",104,5,0,0,109
1780677,1395785,2023-10-25,Senate,"Senate Third Reading: Passed Roll Call # 592",38,0,0,0,38
1780703,1362714,2023-11-02,House,"Reported With Recommendation With Substitute H-1",17,0,0,0,17
1780703,1461391,2024-06-26,House,"House Third Reading: Given Immediate Effect Roll Call # 232",89,20,0,0,109
1780707,1425021,2024-02-29,House,"Reported With Recommendation Without Amendment",7,3,0,0,10
1780707,1469357,2024-11-13,House,"House Third Reading: Given Immediate Effect Roll Call # 350",57,52,0,0,109
1780708,1442854,2024-05-14,House,"Reported With Recommendation With Substitute H-1",11,0,0,0,11
1780709,1372186,2024-01-24,House,"Reported With Recommendation Without Amendment",12,0,0,0,12
1780709,1443099,2024-05-14,House,"House Third Reading: Given Immediate Effect Roll Call # 85",80,27,0,0,107
1780709,1470528,2024-12-12,Senate,"Reported Favorably Without Amendment",5,0,0,0,5
1780710,1362707,2023-11-02,House,"Reported With Recommendation With Substitute H-1",16,0,0,0,16
1780710,1461371,2024-06-26,House,"House Third Reading: Given Immediate Effect Roll Call # 233",102,7,0,0,109
1780710,1470990,2024-12-19,Senate,"Senate Third Reading: Passed Roll Call # 648",34,4,0,0,38
1780719,1357310,2023-11-08,House,"Reported With Recommendation With Substitute H-1",8,0,0,0,8
1780719,1357560,2023-11-09,House,"House Third Reading: Given Immediate Effect Roll Call # 572",99,8,0,0,107
1780722,1425113,2024-03-05,House,"Reported With Recommendation With Substitute H-1",12,0,0,0,12
1780723,1390141,2024-02-20,House,"Reported With Recommendation Without Amendment",13,0,0,0,13
1780723,1396914,2024-02-27,House,"House Third Reading: Given Immediate Effect Roll Call # 16",105,0,0,0,105
1780723,1457109,2024-06-13,Senate,"Reported Favorably Without Amendment",4,0,0,0,4
1780723,1462739,2024-06-25,Senate,"Senate Third Reading: Given Immediate Effect Roll Call # 280",38,0,0,0,38
1780725,1362711,2023-11-02,House,"Reported With Recommendation With Substitute H-1",11,3,0,0,14
1780725,1461366,2024-06-26,House,"House Third Reading: Given Immediate Effect Roll Call # 236",70,39,0,0,109
1780725,1471000,2024-12-19,Senate,"Senate Third Reading: Passed Roll Call # 651",20,18,0,0,38
1780727,1357268,2023-11-08,House,"Reported With Recommendation With Substitute H-1",7,0,0,0,7
1780727,1357535,2023-11-09,House,"House Third Reading: Given Immediate Effect Roll Call # 571",99,8,0,0,107
1780728,1362712,2023-11-02,House,"Reported With Recommendation With Substitute H-1",11,0,0,0,11
1780728,1461367,2024-06-26,House,"House Third Reading: Given Immediate Effect Roll Call # 235",97,12,0,0,109
1780728,1471007,2024-12-19,Senate,"Senate Third Reading: Passed Roll Call # 650",38,0,0,0,38
1780729,1362810,2023-10-31,House,"Reported With Recommendation Without Amendment",11,0,0,0,11
1780729,1461359,2024-06-26,House,"House Third Reading: Given Immediate Effect Roll Call # 230",87,22,0,0,109
1780729,1470989,2024-12-19,Senate,"Senate Third Reading: Passed Roll Call # 645",30,8,0,0,38
1780731,1425232,2024-02-29,House,"Reported With Recommendation Without Amendment",7,3,0,0,10
1780732,1362681,2023-11-02,House,"Reported With Recommendation With Substitute H-1",17,0,0,0,17
1780732,1461382,2024-06-26,House,"House Third Reading: Given Immediate Effect Roll Call # 231",101,8,0,0,109
1780732,1470992,2024-12-19,Senate,"Senate Third Reading: Passed Roll Call # 646",38,0,0,0,38
1780734,1469581,2024-12-03,House,"Reported With Recommendation With Substitute H-2",8,1,0,0,9
1780734,1470343,2024-12-12,House,"House Third Reading: Given Immediate Effect Roll Call # 483",56,53,0,0,109
1780736,1362685,2023-11-02,House,"Reported With Recommendation With Substitute H-3",13,0,0,0,13
1780736,1461341,2024-06-26,House,"House Third Reading: Given Immediate Effect Roll Call # 237",99,10,0,0,109
1780736,1471006,2024-12-19,Senate,"Senate Third Reading: Passed Roll Call # 652",38,0,0,0,38
1780737,1408401,2024-03-12,House,"Reported With Recommendation For Referral To Committee On Military, Veterans And Homeland Security",8,0,0,0,8
1780742,1469706,2024-12-04,House,"Reported With Recommendation Without Amendment",9,1,0,0,10
1780742,1470517,2024-12-13,House,"House Third Reading: Given Immediate Effect Roll Call # 522",56,0,0,0,56
1780746,1362682,2023-11-02,House,"Reported With Recommendation With Substitute H-1",13,0,0,0,13
1780746,1461375,2024-06-26,House,"House Third Reading: Given Immediate Effect Roll Call # 234",90,19,0,0,109
1780746,1470998,2024-12-19,Senate,"Senate Third Reading: Passed Roll Call # 649",37,0,1,0,38
1780795,1356825,2023-10-31,Senate,"Reported Favorably Without Amendment",6,0,0,0,6
1780795,1356996,2023-11-02,Senate,"Senate Third Reading: Passed Roll Call # 648",20,18,0,0,38
1780795,1357867,2023-11-09,House,"House Third Reading: Given Immediate Effect Roll Call # 544",56,53,0,0,109
1780828,1470376,2024-12-10,House,"Reported With Recommendation With Substitute H-1",11,2,0,0,13
1780828,1470529,2024-12-13,House,"House Third Reading: Given Immediate Effect Roll Call # 510",56,0,0,0,56
1780941,1404852,2024-03-06,House,"Reported With Recommendation Without Amendment",15,0,0,0,15
1780941,1457218,2024-06-13,House,"House Third Reading: Given Immediate Effect Roll Call # 169",77,32,0,0,109
1781160,1408743,2024-03-12,House,"Reported With Recommendation With Substitute H-2",13,0,0,0,13
1781160,1437509,2024-05-01,House,"House Third Reading: Given Immediate Effect Roll Call # 50",88,17,0,0,105
1781160,1459879,2024-06-25,Senate,"Reported Favorably Without Amendment",8,0,0,0,8
1781160,1463088,2024-06-26,Senate,"Senate Third Reading: Given Immediate Effect Roll Call # 296",38,0,0,0,38
1781186,1408738,2024-03-12,House,"Reported With Recommendation With Substitute H-1",13,0,0,0,13
1781186,1437785,2024-05-01,House,"House Third Reading: Given Immediate Effect Roll Call # 51",89,16,0,0,105
1781186,1459800,2024-06-25,Senate,"Reported Favorably Without Amendment",8,0,0,0,8
1781186,1460897,2024-06-26,Senate,"Senate Third Reading: Given Immediate Effect Roll Call # 297",38,0,0,0,38
1781202,1432568,2024-04-23,Senate,"Reported Favorably With Substitute S-1",5,2,0,0,7
1781202,1453169,2024-06-04,Senate,"Senate Third Reading: Passed Roll Call # 211",22,16,0,0,38
1781202,1458373,2024-06-18,House,"Reported With Recommendation With Substitute H-1",8,0,0,0,8
1781202,1461417,2024-06-26,House,"House Third Reading: Given Immediate Effect Roll Call # 242",60,49,0,0,109
1781202,1463078,2024-06-26,Senate,"Senate Third Reading: Roll Call: Roll Call # 323",22,16,0,0,38
1781208,1363344,2023-11-14,Senate,"Reported Favorably With Substitute S-2",5,2,0,0,7
1781208,1412335,2024-03-19,Senate,"Senate Third Reading: Passed Roll Call # 88",20,15,0,3,38
1781214,1363267,2023-11-14,Senate,"Reported Favorably With Substitute S-3",5,2,0,0,7
1781214,1412217,2024-03-19,Senate,"Senate Third Reading: Passed Roll Call # 89",20,15,0,3,38
1781446,1425013,2024-03-21,Senate,"Reported Favorably With Substitute S-1",5,2,0,0,7
1781446,1436759,2024-04-30,Senate,"Senate Third Reading: Passed Roll Call # 102",20,18,0,0,38
1781446,1445903,2024-05-21,House,"Reported With Recommendation Without Amendment",6,2,0,0,8
1781446,1457180,2024-06-13,House,"House Third Reading: Given Immediate Effect Roll Call # 173",56,53,0,0,109
1781450,1470619,2024-12-13,Senate,"Senate Third Reading: Passed Roll Call # 612",20,13,0,5,38
1781455,1470797,2024-12-13,Senate,"Senate Third Reading: Passed Roll Call # 613",20,13,0,5,38
1781459,1356855,2023-11-01,Senate,"Reported Favorably Without Amendment",5,2,0,0,7
1781459,1356856,2023-11-01,Senate,"Senate Third Reading: Passed Roll Call # 636",36,2,0,0,38
1781459,1357463,2023-11-09,House,"House Third Reading: Given Immediate Effect Roll Call # 555",62,46,0,0,108
1781464,1389280,2024-02-20,Senate,"Reported Favorably With Substitute S-1",10,0,0,0,10
1781464,1404094,2024-02-27,Senate,"Senate Third Reading: Passed Roll Call # 29",38,0,0,0,38
1781464,1442912,2024-05-14,House,"Reported With Recommendation Without Amendment",14,0,0,0,14
1781464,1461725,2024-06-26,House,"House Third Reading: Given Immediate Effect Roll Call # 246",103,7,0,0,110
1781472,1356899,2023-11-01,Senate,"Reported Favorably With Substitute S-2",5,2,0,0,7
1781472,1356900,2023-11-01,Senate,"Senate Third Reading: Passed Roll Call # 634",36,2,0,0,38
1781472,1357464,2023-11-09,House,"House Third Reading: Given Immediate Effect Roll Call # 553",61,47,0,0,108
1781472,1400259,2023-11-09,Senate,"Senate Third Reading: Roll Call: Roll Call # 710",36,2,0,0,38
1781483,1470659,2024-12-13,Senate,"Senate Third Reading: Passed Roll Call # 616",20,13,0,5,38
1781488,1356864,2023-11-01,Senate,"Reported Favorably Without Amendment",5,2,0,0,7
1781488,1356865,2023-11-01,Senate,"Senate Third Reading: Passed Roll Call # 635",36,2,0,0,38
1781488,1357779,2023-11-09,House,"House Third Reading: Given Immediate Effect Roll Call # 554",61,47,0,0,108
1781496,1356859,2023-11-01,Senate,"Senate Third Reading: Passed Roll Call # 633",36,2,0,0,38
1781496,1356860,2023-11-01,Senate,"Reported Favorably With Substitute S-2",5,2,0,0,7
1781496,1356861,2023-11-01,Senate,"Senate Third Reading: Passed Roll Call # 633",36,2,0,0,38
1781496,1357522,2023-11-09,House,"House Third Reading: Given Immediate Effect Roll Call # 552",59,49,0,0,108
1781496,1400177,2023-11-09,Senate,"Senate Third Reading: Roll Call: Roll Call # 709",36,2,0,0,38
1781501,1470755,2024-12-13,Senate,"Senate Third Reading: Passed Roll Call # 614",20,13,0,5,38
1781509,1425006,2024-03-21,Senate,"Reported Favorably With Substitute S-1",5,2,0,0,7
1781509,1436391,2024-04-30,Senate,"Senate Third Reading: Passed Roll Call # 101",20,18,0,0,38
1781509,1445808,2024-05-21,House,"Reported With Recommendation With Substitute H-2",6,2,0,0,8
1781509,1457198,2024-06-13,House,"House Third Reading: Given Immediate Effect Roll Call # 172",56,53,0,0,109
1781509,1468600,2024-06-18,Senate,"Senate Third Reading: Roll Call: Roll Call # 249",20,18,0,0,38
1781515,1357211,2023-11-01,House,"Reported With Recommendation Without Amendment",8,3,0,0,11
1781515,1363239,2023-11-09,House,"House Third Reading: Given Immediate Effect Roll Call # 532",56,53,0,0,109
1781515,1411788,2024-03-19,Senate,"Reported Favorably Without Amendment",10,0,0,0,10
1781515,1411789,2024-03-19,Senate,"Senate Third Reading: Passed Roll Call # 70",22,15,0,1,38
1781516,1443598,2024-05-16,House,"Reported With Recommendation Without Amendment",12,0,0,0,12
1781516,1460137,2024-06-25,House,"House Third Reading: Given Immediate Effect Roll Call # 216",106,4,0,0,110
1781517,1457008,2024-06-12,House,"Reported With Recommendation Without Amendment",9,0,0,0,9
1781517,1458715,2024-06-20,House,"House Third Reading: Given Immediate Effect Roll Call # 206",76,33,0,0,109
1781517,1469296,2024-11-13,Senate,"Reported Favorably Without Amendment",6,1,0,0,7
1781517,1470135,2024-12-11,Senate,"Senate Third Reading: Passed Roll Call # 493",23,13,0,2,38
1781518,1443599,2024-05-16,House,"Reported With Recommendation Without Amendment",12,0,0,0,12
1781518,1460230,2024-06-25,House,"House Third Reading: Given Immediate Effect Roll Call # 221",106,4,0,0,110
1781519,1357254,2023-11-08,House,"Reported With Recommendation With Substitute H-1",10,0,0,0,10
1781521,1357233,2023-11-01,House,"Reported With Recommendation Without Amendment",8,3,0,0,11
1781521,1363064,2023-11-09,House,"House Third Reading: Given Immediate Effect Roll Call # 537",56,53,0,0,109
1781521,1412287,2024-03-19,Senate,"Reported Favorably Without Amendment",10,0,0,0,10
1781521,1412288,2024-03-19,Senate,"Senate Third Reading: Passed Roll Call # 75",22,15,0,1,38
1781523,1357330,2023-11-08,House,"Reported With Recommendation With Substitute H-1",11,3,0,0,14
1781526,1357218,2023-11-01,House,"Reported With Recommendation Without Amendment",8,3,0,0,11
1781526,1363178,2023-11-09,House,"House Third Reading: Given Immediate Effect Roll Call # 538",56,53,0,0,109
1781526,1412263,2024-03-19,Senate,"Reported Favorably Without Amendment",10,0,0,0,10
1781526,1412264,2024-03-19,Senate,"Senate Third Reading: Passed Roll Call # 76",22,15,0,1,38
1781528,1457009,2024-06-12,House,"Reported With Recommendation With Substitute H-2",9,0,0,0,9
1781528,1458654,2024-06-20,House,"House Third Reading: Given Immediate Effect Roll Call # 204",76,33,0,0,109
1781528,1469904,2024-11-13,Senate,"Reported Favorably Without Amendment",6,1,0,0,7
1781528,1470123,2024-12-11,Senate,"Senate Third Reading: Passed Roll Call # 491",24,12,0,2,38
1781530,1407781,2024-03-06,House,"Reported With Recommendation Without Amendment",13,0,0,0,13
1781530,1409293,2024-03-13,House,"House Third Reading: Given Immediate Effect Roll Call # 26",94,12,0,0,106
1781530,1456769,2024-06-12,Senate,"Reported Favorably With Substitute S-1",6,1,0,0,7
1781530,1470152,2024-12-11,Senate,"Senate Third Reading: Passed Roll Call # 498",21,15,0,2,38
1781531,1443605,2024-05-16,House,"Reported With Recommendation Without Amendment",12,0,0,0,12
1781531,1460140,2024-06-25,House,"House Third Reading: Given Immediate Effect Roll Call # 217",106,4,0,0,110
1781532,1443648,2024-05-16,House,"Reported With Recommendation With Substitute H-1",12,0,0,0,12
1781532,1460303,2024-06-25,House,"House Third Reading: Given Immediate Effect Roll Call # 222",106,4,0,0,110
1781535,1425402,2024-02-07,House,"Reported With Recommendation Without Amendment",12,0,0,0,12
1781535,1467609,2024-09-25,House,"House Third Reading: Given Immediate Effect Roll Call # 319",109,0,0,0,109
1781535,1468950,2024-10-24,Senate,"Reported Favorably Without Amendment",6,0,0,0,6
1781535,1470233,2024-12-11,Senate,"Senate Third Reading: Passed Roll Call # 500",36,0,0,2,38
1781536,1357219,2023-11-01,House,"Reported With Recommendation Without Amendment",8,3,0,0,11
1781536,1363184,2023-11-09,House,"House Third Reading: Given Immediate Effect Roll Call # 534",56,53,0,0,109
1781536,1412410,2024-03-19,Senate,"Reported Favorably Without Amendment",10,0,0,0,10
1781536,1412411,2024-03-19,Senate,"Senate Third Reading: Passed Roll Call # 72",22,15,0,1,38
1781539,1356797,2023-10-25,House,"Reported With Recommendation Without Amendment",8,3,0,0,11
1781539,1366458,2023-10-31,House,"Reported With Recommendation With Substitute H-2",8,0,0,0,8
1781540,1357173,2023-11-01,House,"Reported With Recommendation Without Amendment",8,3,0,0,11
1781540,1363240,2023-11-09,House,"House Third Reading: Given Immediate Effect Roll Call # 535",56,53,0,0,109
1781540,1412403,2024-03-19,Senate,"Reported Favorably Without Amendment",10,0,0,0,10
1781540,1412404,2024-03-19,Senate,"Senate Third Reading: Passed Roll Call # 73",23,14,0,1,38
1781541,1357150,2023-11-01,House,"Reported With Recommendation Without Amendment",8,3,0,0,11
1781541,1363059,2023-11-09,House,"House Third Reading: Given Immediate Effect Roll Call # 536",56,53,0,0,109
1781541,1411795,2024-03-19,Senate,"Reported Favorably Without Amendment",10,0,0,0,10
1781541,1411796,2024-03-19,Senate,"Senate Third Reading: Passed Roll Call # 74",22,15,0,1,38
1781542,1357232,2023-11-01,House,"Reported With Recommendation Without Amendment",8,3,0,0,11
1781542,1357862,2023-11-09,House,"House Third Reading: Given Immediate Effect Roll Call # 533",56,53,0,0,109
1781542,1412407,2024-03-19,Senate,"Reported Favorably Without Amendment",10,0,0,0,10
1781542,1412408,2024-03-19,Senate,"Senate Third Reading: Passed Roll Call # 71",22,15,0,1,38
1781544,1357241,2023-11-08,House,"Reported With Recommendation Without Amendment",10,0,0,0,10
1781547,1443600,2024-05-16,House,"Reported With Recommendation Without Amendment",12,0,0,0,12
1781547,1460141,2024-06-25,House,"House Third Reading: Given Immediate Effect Roll Call # 220",106,4,0,0,110
1781548,1443597,2024-05-16,House,"Reported With Recommendation With Substitute H-1",12,0,0,0,12
1781548,1460267,2024-06-25,House,"House Third Reading: Given Immediate Effect Roll Call # 219",106,4,0,0,110
1781549,1457011,2024-06-12,House,"Reported With Recommendation Without Amendment",9,0,0,0,9
1781549,1458670,2024-06-20,House,"House Third Reading: Given Immediate Effect Roll Call # 205",76,33,0,0,109
1781549,1469258,2024-11-13,Senate,"Reported Favorably Without Amendment",6,1,0,0,7
1781549,1470245,2024-12-11,Senate,"Senate Third Reading: Passed Roll Call # 492",24,12,0,2,38
1781553,1357257,2023-11-08,House,"Reported With Recommendation With Substitute H-1",10,2,0,0,12
1781555,1443601,2024-05-16,House,"Reported With Recommendation Without Amendment",12,0,0,0,12
1781555,1460138,2024-06-25,House,"House Third Reading: Given Immediate Effect Roll Call # 218",106,4,0,0,110
1781559,1357168,2023-11-01,House,"Reported With Recommendation Without Amendment",8,3,0,0,11
1781559,1363017,2023-11-09,House,"House Third Reading: Given Immediate Effect Roll Call # 531",56,53,0,0,109
1781559,1411766,2024-03-19,Senate,"Reported Favorably Without Amendment",10,0,0,0,10
1781559,1411767,2024-03-19,Senate,"Senate Third Reading: Passed Roll Call # 69",22,15,0,1,38
1781600,1441772,2024-05-09,Senate,"Reported Favorably With Substitute S-1",6,0,0,0,6
1781600,1454401,2024-06-05,Senate,"Senate Third Reading: Passed Roll Call # 237",29,9,0,0,38
1781619,1357222,2023-11-01,House,"Reported With Recommendation Without Amendment",8,3,0,0,11
1781619,1363014,2023-11-09,House,"House Third Reading: Given Immediate Effect Roll Call # 539",56,53,0,0,109
1781619,1412497,2024-03-19,Senate,"Reported Favorably Without Amendment",10,0,0,0,10
1781619,1412498,2024-03-19,Senate,"Senate Third Reading: Passed Roll Call # 77",22,15,0,1,38
1781628,1441780,2024-05-09,Senate,"Reported Favorably Without Amendment",6,0,0,0,6
1781628,1454024,2024-06-05,Senate,"Senate Third Reading: Passed Roll Call # 236",29,9,0,0,38
1781628,1469214,2024-11-12,House,"Reported With Recommendation With Substitute H-3",8,0,0,0,8
1781675,1432827,2024-04-23,House,"Reported With Recommendation With Substitute H-1",8,4,0,0,12
1781675,1448105,2024-05-22,House,"House Third Reading: Given Immediate Effect Roll Call # 141",56,47,0,0,103
1781675,1469523,2024-11-26,Senate,"Reported Favorably Without Amendment",4,1,0,0,5
1781675,1471004,2024-12-19,Senate,"Senate Third Reading: Passed Roll Call # 631",20,18,0,0,38
1781676,1470450,2024-12-13,House,"House Third Reading: Given Immediate Effect Roll Call # 518",56,0,0,0,56
1781678,1432798,2024-04-23,House,"Reported With Recommendation With Substitute H-1",8,4,0,0,12
1781678,1448070,2024-05-22,House,"House Third Reading: Given Immediate Effect Roll Call # 142",56,47,0,0,103
1781678,1470662,2024-11-26,Senate,"Reported Favorably Without Amendment",4,2,0,0,6
1781678,1471002,2024-12-19,Senate,"Senate Third Reading: Passed Roll Call # 632",20,18,0,0,38
1781679,1432813,2024-04-23,House,"Reported With Recommendation With Substitute H-1",8,4,0,0,12
1781679,1448318,2024-05-22,House,"House Third Reading: Given Immediate Effect Roll Call # 143",56,47,0,0,103
1781679,1470707,2024-11-26,Senate,"Reported Favorably Without Amendment",4,2,0,0,6
1781679,1470997,2024-12-19,Senate,"Senate Third Reading: Passed Roll Call # 633",20,18,0,0,38
1781687,1443108,2024-05-14,House,"Reported With Recommendation With Substitute H-1",11,0,0,0,11
1781687,1453239,2024-06-04,House,"House Third Reading: Given Immediate Effect Roll Call # 146",79,29,0,0,108
1781692,1443109,2024-05-14,House,"Reported With Recommendation Without Amendment",11,0,0,0,11
1781692,1453300,2024-06-04,House,"House Third Reading: Given Immediate Effect Roll Call # 147",78,30,0,0,108
1781693,1432825,2024-04-23,House,"Reported With Recommendation With Substitute H-1",8,4,0,0,12
1781693,1463699,2024-05-22,House,"House Third Reading: Given Immediate Effect Roll Call # 140",56,47,0,0,103
1781693,1470683,2024-11-26,Senate,"Reported Favorably Without Amendment",4,1,0,0,5
1781693,1470993,2024-12-19,Senate,"Senate Third Reading: Passed Roll Call # 630",20,18,0,0,38
1781733,1456249,2024-06-11,House,"Reported With Recommendation With Substitute H-1",9,0,0,0,9
1781733,1458703,2024-06-20,House,"House Third Reading: Given Immediate Effect Roll Call # 184",98,11,0,0,109
1781763,1469957,2024-12-10,House,"Reported With Recommendation With Substitute H-1",13,1,0,0,14
1781763,1470390,2024-12-12,House,"House Third Reading: Given Immediate Effect Roll Call # 474",61,48,0,0,109
1781765,1456268,2024-06-11,House,"Reported With Recommendation With Substitute H-1",9,0,0,0,9
1781765,1458706,2024-06-20,House,"House Third Reading: Given Immediate Effect Roll Call # 181",89,20,0,0,109
1781779,1363341,2023-11-01,House,"Reported With Recommendation With Substitute H-1",3,0,0,0,3
1781784,1363331,2023-11-01,House,"Reported With Recommendation Without Amendment",3,0,0,0,3
1781791,1456198,2024-06-11,House,"Reported With Recommendation With Substitute H-2",9,0,0,0,9
1781791,1458682,2024-06-20,House,"House Third Reading: Given Immediate Effect Roll Call # 182",91,18,0,0,109
1781796,1410023,2024-03-12,House,"Reported With Recommendation With Substitute H-1",8,3,0,0,11
1781796,1470026,2024-12-10,House,"House Third Reading: Given Immediate Effect Roll Call # 413",56,52,0,0,108
1781799,1470067,2024-12-10,House,"Reported With Recommendation With Substitute H-1",13,1,0,0,14
1781799,1470689,2024-12-12,House,"House Third Reading: Given Immediate Effect Roll Call # 475",63,46,0,0,109
1781820,1363334,2023-11-01,House,"Reported With Recommendation Without Amendment",3,0,0,0,3
1781837,1432826,2024-04-23,House,"Reported With Recommendation Without Amendment",8,0,0,0,8
1781837,1463700,2024-05-22,House,"House Third Reading: Given Immediate Effect Roll Call # 144",56,47,0,0,103
1781837,1470959,2024-11-26,Senate,"Reported Favorably Without Amendment",4,2,0,0,6
1781842,1363321,2023-11-01,House,"Reported With Recommendation With Substitute H-1",3,0,0,0,3
1781845,1456251,2024-06-11,House,"Reported With Recommendation With Substitute H-1",10,0,0,0,10
1781845,1458702,2024-06-20,House,"House Third Reading: Given Immediate Effect Roll Call # 183",97,12,0,0,109
1782279,1405389,2024-03-07,Senate,"Reported Favorably Without Amendment",6,1,0,0,7
1782279,1410028,2024-03-14,Senate,"Senate Third Reading: Passed Roll Call # 58",24,13,1,0,38
1782286,1425044,2024-03-14,Senate,"Reported Favorably Without Amendment",6,4,0,0,10
1782286,1461352,2024-06-26,Senate,"Senate Third Reading: Passed Roll Call # 305",20,18,0,0,38
1782292,1425002,2024-03-14,Senate,"Reported Favorably With Substitute S-2",6,4,0,0,10
1782292,1460942,2024-06-26,Senate,"Senate Third Reading: Passed Roll Call # 308",20,18,0,0,38
1782293,1412780,2024-03-14,Senate,"Reported Favorably Without Amendment",6,4,0,0,10
1782293,1461008,2024-06-26,Senate,"Senate Third Reading: Passed Roll Call # 309",20,18,0,0,38
1782299,1425056,2024-03-14,Senate,"Reported Favorably With Substitute S-1",6,4,0,0,10
1782299,1460947,2024-06-26,Senate,"Senate Third Reading: Passed Roll Call # 307",20,18,0,0,38
1782301,1425065,2024-03-14,Senate,"Reported Favorably With Substitute S-1",6,4,0,0,10
1782301,1460957,2024-06-26,Senate,"Senate Third Reading: Passed Roll Call # 306",20,18,0,0,38
1782302,1425105,2024-03-14,Senate,"Reported Favorably With Substitute S-3",6,4,0,0,10
1782302,1460951,2024-06-26,Senate,"Senate Third Reading: Passed Roll Call # 304",20,18,0,0,38
1782486,1432734,2024-04-23,House,"Reported With Recommendation With Substitute H-1",13,0,0,0,13
1782490,1425033,2024-02-14,House,"Reported With Recommendation Without Amendment",8,4,0,0,12
1782490,1470508,2024-12-13,House,"House Third Reading: Given Immediate Effect Roll Call # 501",56,0,0,0,56
1782491,1425004,2024-02-14,House,"Reported With Recommendation With Substitute H-1",8,4,0,0,12
1782491,1470500,2024-12-13,House,"House Third Reading: Given Immediate Effect Roll Call # 500",56,0,0,0,56
1782492,1399486,2024-02-14,House,"Reported With Recommendation With Substitute H-1",8,4,0,0,12
1782492,1470532,2024-12-13,House,"House Third Reading: Given Immediate Effect Roll Call # 502",56,0,0,0,56
1782493,1425042,2024-02-14,House,"Reported With Recommendation Without Amendment",8,4,0,0,12
1782493,1470558,2024-12-13,House,"House Third Reading: Given Immediate Effect Roll Call # 499",56,0,0,0,56
1783491,1469751,2024-12-04,Senate,"Reported Favorably Without Amendment",6,2,0,0,8
1783493,1439946,2024-03-13,Senate,"Reported Favorably Without Amendment",9,5,0,0,14
1783493,1460956,2024-06-26,Senate,"Senate Third Reading: Passed Roll Call # 300",20,18,0,0,38
1783495,1470601,2024-12-13,Senate,"Senate Third Reading: Passed Roll Call # 608",32,1,0,5,38
1783495,1470984,2024-12-12,Senate,"Reported Favorably With Substitute S-1",6,0,0,0,6
1783500,1459775,2024-06-25,Senate,"Reported Favorably Without Amendment",7,0,0,0,7
1783500,1470770,2024-12-13,Senate,"Senate Third Reading: Passed Roll Call # 617",33,0,0,5,38
1783503,1468613,2024-10-10,Senate,"Reported Favorably With Substitute S-2",9,0,0,0,9
1783503,1470033,2024-12-10,House,"Reported With Recommendation Without Amendment",12,0,0,0,12
1783506,1448340,2024-05-22,House,"Reported With Recommendation Without Amendment",10,1,0,0,11
1783506,1467638,2024-09-25,House,"House Third Reading: Given Immediate Effect Roll Call # 311",61,46,0,0,107
1783506,1468870,2024-10-17,Senate,"Reported Favorably Without Amendment",18,1,0,0,19
1783506,1469122,2024-10-30,Senate,"Senate Third Reading: Passed Roll Call # 394",35,2,0,1,38
1783511,1412769,2024-03-14,Senate,"Reported Favorably With Substitute S-1",5,0,0,0,5
1783511,1460944,2024-06-26,Senate,"Senate Third Reading: Passed Roll Call # 312",36,2,0,0,38
1783514,1470773,2024-12-12,Senate,"Reported Favorably With Substitute S-2",4,0,0,0,4
1783528,1403207,2024-03-05,Senate,"Reported Favorably Without Amendment",5,0,0,0,5
1783528,1458065,2024-06-18,Senate,"Senate Third Reading: Passed Roll Call # 247",27,11,0,0,38
1783533,1469777,2024-12-04,Senate,"Reported Favorably With Substitute S-2",6,2,0,0,8
1783533,1469824,2024-12-05,Senate,"Senate Third Reading: Passed Roll Call # 461",20,16,0,2,38
1783534,1425000,2024-03-14,Senate,"Reported Favorably With Substitute S-1",5,0,0,0,5
1783534,1460982,2024-06-26,Senate,"Senate Third Reading: Passed Roll Call # 310",36,2,0,0,38
1783540,1395564,2024-02-21,Senate,"Reported Favorably With Substitute S-2",6,1,0,0,7
1783540,1397630,2024-02-28,Senate,"Senate Third Reading: Passed Roll Call # 37",23,15,0,0,38
1783540,1457094,2024-06-13,House,"Reported With Recommendation With Substitute H-3",6,0,0,0,6
1783540,1460884,2024-06-26,Senate,"Senate Third Reading: Roll Call: Roll Call # 324",20,18,0,0,38
1783540,1461405,2024-06-26,House,"House Third Reading: Given Immediate Effect Roll Call # 259",68,42,0,0,110
1783541,1469749,2024-12-04,Senate,"Reported Favorably Without Amendment",6,2,0,0,8
1783545,1469754,2024-12-04,Senate,"Reported Favorably Without Amendment",6,2,0,0,8
1783547,1425005,2024-03-05,Senate,"Reported Favorably Without Amendment",5,0,0,0,5
1783547,1458064,2024-06-18,Senate,"Senate Third Reading: Passed Roll Call # 246",27,10,1,0,38
1783547,1469575,2024-12-03,House,"Reported With Recommendation With Substitute H-1",12,0,0,0,12
1783806,1391904,2024-02-07,House,"Reported With Recommendation With Substitute H-2",11,6,0,0,17
1783806,1469976,2024-12-10,House,"House Third Reading: Given Immediate Effect Roll Call # 394",56,52,0,0,108
1783809,1445810,2024-05-21,House,"Reported With Recommendation Without Amendment",12,0,0,0,12
1783811,1445818,2024-05-21,House,"Reported With Recommendation Without Amendment",12,0,0,0,12
1783812,1449470,2024-05-23,House,"Reported With Recommendation Without Amendment",9,6,0,0,15
1783815,1449468,2024-05-23,House,"Reported With Recommendation Without Amendment",9,6,0,0,15
1783818,1449467,2024-05-23,House,"Reported With Recommendation Without Amendment",9,6,0,0,15
1783823,1449472,2024-05-23,House,"Reported With Recommendation Without Amendment",9,6,0,0,15
1783825,1391854,2024-02-21,House,"Reported With Recommendation Without Amendment",13,0,0,0,13
1783825,1436781,2024-04-30,House,"House Third Reading: Given Immediate Effect Roll Call # 45",104,5,0,0,109
1783825,1456771,2024-06-12,Senate,"Reported Favorably Without Amendment",11,0,0,0,11
1783827,1449428,2024-05-23,House,"Reported With Recommendation Without Amendment",9,6,0,0,15
1783834,1449422,2024-05-23,House,"Reported With Recommendation Without Amendment",9,6,0,0,15
1783837,1463825,2024-05-23,House,"Reported With Recommendation Without Amendment",9,6,0,0,15
1783840,1449474,2024-05-23,House,"Reported With Recommendation Without Amendment",9,6,0,0,15
1783847,1449477,2024-05-23,House,"Reported With Recommendation Without Amendment",9,6,0,0,15
1783848,1470124,2024-12-10,House,"Reported With Recommendation With Substitute H-1",14,0,0,0,14
1783848,1470364,2024-12-12,House,"House Third Reading: Given Immediate Effect Roll Call # 478",77,32,0,0,109
1783862,1449469,2024-05-23,House,"Reported With Recommendation Without Amendment",9,6,0,0,15
1783865,1391791,2024-02-07,House,"Reported With Recommendation With Substitute H-2",11,3,0,0,14
1783865,1469983,2024-12-10,House,"House Third Reading: Given Immediate Effect Roll Call # 395",56,52,0,0,108
1783868,1470195,2024-12-10,House,"Reported With Recommendation With Substitute H-3",11,0,0,0,11
1783868,1470668,2024-12-12,House,"House Third Reading: Given Immediate Effect Roll Call # 477",68,41,0,0,109
1783869,1449453,2024-05-23,House,"Reported With Recommendation Without Amendment",9,6,0,0,15
1783873,1391774,2024-02-14,House,"Reported With Recommendation With Substitute H-1",9,0,0,0,9
1783876,1391371,2024-02-14,House,"Reported With Recommendation With Substitute H-1",9,0,0,0,9
1783877,1392039,2024-02-21,House,"Reported With Recommendation Without Amendment",13,0,0,0,13
1783877,1439951,2024-04-30,House,"House Third Reading: Given Immediate Effect Roll Call # 46",104,5,0,0,109
1783877,1456795,2024-06-12,Senate,"Reported Favorably Without Amendment",11,0,0,0,11
1783880,1449426,2024-05-23,House,"Reported With Recommendation Without Amendment",9,6,0,0,15
1783881,1391617,2024-02-21,House,"Reported With Recommendation Without Amendment",13,0,0,0,13
1783881,1436780,2024-04-30,House,"House Third Reading: Given Immediate Effect Roll Call # 47",104,5,0,0,109
1783881,1456796,2024-06-12,Senate,"Reported Favorably Without Amendment",11,0,0,0,11
1783885,1408483,2024-02-27,House,"Reported With Recommendation With Substitute H-1",13,0,0,0,13
1783885,1411308,2024-03-19,House,"House Third Reading: Given Immediate Effect Roll Call # 27",98,5,0,0,103
1783886,1449478,2024-05-23,House,"Reported With Recommendation Without Amendment",9,6,0,0,15
1783889,1449440,2024-05-23,House,"Reported With Recommendation Without Amendment",9,6,0,0,15
1783890,1408585,2024-02-27,House,"Reported With Recommendation With Substitute H-1",13,0,0,0,13
1783890,1412795,2024-03-19,House,"House Third Reading: Defeated Roll Call # 28",53,45,0,0,98
1783890,1456485,2024-06-11,House,"House Third Reading: Given Immediate Effect Roll Call # 155",100,9,0,0,109
1783890,1469282,2024-10-17,Senate,"Reported Favorably Without Amendment",10,0,0,0,10
1783890,1469968,2024-12-10,Senate,"Senate Third Reading: Passed Roll Call # 470",37,0,0,1,38
1809996,1410027,2024-03-13,House,"Reported With Recommendation With Substitute H-1",13,0,0,0,13
1809996,1430894,2024-04-18,House,"House Third Reading: Given Immediate Effect Roll Call # 34",99,6,0,0,105
1809996,1433955,2024-04-24,Senate,"Senate Third Reading: Given Immediate Effect Roll Call # 99",34,3,0,1,38
1809996,1439950,2024-04-24,House,"House Third Reading: Roll Call # 42",101,6,0,0,107
1810933,1439947,2024-03-13,Senate,"Reported Favorably With Substitute S-1",12,2,0,0,14
1811102,1441783,2024-05-09,Senate,"Reported Favorably With Substitute S-2",6,0,0,0,6
1811102,1460892,2024-06-26,Senate,"Senate Third Reading: Passed Roll Call # 283",34,4,0,0,38
1811216,1425029,2024-04-10,Senate,"Reported Favorably With Substitute S-3",8,2,0,0,10
1811216,1427834,2024-04-16,Senate,"Senate Third Reading: Passed Roll Call # 93",31,5,0,2,38
1811216,1442907,2024-05-14,House,"Reported With Recommendation Without Amendment",12,1,0,0,13
1811216,1456078,2024-06-11,House,"House Third Reading: Given Immediate Effect Roll Call # 154",65,44,0,0,109
1811216,1468808,2024-06-18,Senate,"Senate Third Reading: Roll Call: Roll Call # 250",31,7,0,0,38
1813918,1383938,2024-02-06,House,"Reported With Recommendation Without Amendment",8,4,0,0,12
1813918,1456584,2024-06-11,House,"House Third Reading: Given Immediate Effect Roll Call # 153",56,53,0,0,109
1813918,1467474,2024-09-19,Senate,"Reported Favorably Without Amendment",6,0,0,0,6
1813918,1467597,2024-09-25,Senate,"Senate Third Reading: Given Immediate Effect Roll Call # 343",28,10,0,0,38
1814033,1443401,2024-05-15,House,"Reported With Recommendation Without Amendment",11,0,0,0,11
1814033,1467612,2024-09-25,House,"House Third Reading: Given Immediate Effect Roll Call # 317",99,10,0,0,109
1819809,1425061,2024-02-13,Senate,"Reported Favorably Without Amendment",4,1,0,0,5
1819809,1453988,2024-06-05,Senate,"Senate Third Reading: Passed Roll Call # 232",20,18,0,0,38
1819878,1425001,2024-02-13,Senate,"Reported Favorably With Substitute S-1",4,1,0,0,5
1819878,1453974,2024-06-05,Senate,"Senate Third Reading: Passed Roll Call # 231",20,18,0,0,38
1819949,1407655,2024-03-06,Senate,"Reported Favorably With Substitute S-1",7,0,0,0,7
1819949,1439948,2024-03-13,Senate,"Senate Third Reading: Passed Roll Call # 57",38,0,0,0,38
1819949,1443554,2024-05-15,House,"Reported With Recommendation Without Amendment",13,0,0,0,13
1819949,1463826,2024-05-22,House,"House Third Reading: Given Immediate Effect Roll Call # 138",103,0,0,0,103
1820018,1425036,2024-02-13,Senate,"Reported Favorably With Substitute S-1",4,0,0,0,4
1820018,1453980,2024-06-05,Senate,"Senate Third Reading: Passed Roll Call # 233",20,18,0,0,38
1820160,1425049,2024-02-13,Senate,"Reported Favorably Without Amendment",4,0,0,0,4
1820160,1454056,2024-06-05,Senate,"Senate Third Reading: Passed Roll Call # 234",20,18,0,0,38
1820228,1393722,2024-02-22,Senate,"Reported Favorably Without Amendment",4,0,0,0,4
1820228,1402644,2024-02-29,Senate,"Senate Third Reading: Passed Roll Call # 42",38,0,0,0,38
1820228,1442914,2024-05-14,House,"Reported With Recommendation Without Amendment",6,0,0,0,6
1820228,1456245,2024-06-11,House,"House Third Reading: Given Immediate Effect Roll Call # 149",104,5,0,0,109
1820235,1432816,2024-04-23,House,"Reported With Recommendation With Substitute H-1",8,0,0,0,8
1820235,1469291,2024-11-13,House,"House Third Reading: Given Immediate Effect Roll Call # 336",57,52,0,0,109
1820711,1432809,2024-04-23,House,"Reported With Recommendation With Substitute H-1",8,0,0,0,8
1820711,1469285,2024-11-13,House,"House Third Reading: Given Immediate Effect Roll Call # 337",57,52,0,0,109
1825592,1470099,2024-12-10,House,"Reported With Recommendation With Substitute H-1",11,0,0,0,11
1825592,1470527,2024-12-13,House,"House Third Reading: Given Immediate Effect Roll Call # 517",56,0,0,0,56
1831969,1470007,2024-12-10,House,"Reported With Recommendation With Substitute H-3",8,3,0,0,11
1834665,1470111,2024-12-11,Senate,"Reported Favorably Without Amendment",10,0,0,0,10
1834693,1411051,2024-03-14,Senate,"Reported Favorably With Substitute S-1",5,0,0,0,5
1834693,1414155,2024-03-19,Senate,"Senate Third Reading: Passed Roll Call # 61",26,11,0,1,38
1834693,1444762,2024-05-14,House,"Reported With Recommendation Without Amendment",14,0,0,0,14
1834693,1456983,2024-06-12,House,"House Third Reading: Given Immediate Effect Roll Call # 160",93,16,0,0,109
1834722,1467407,2024-09-17,Senate,"Senate Third Reading: Passed Roll Call # 332",36,0,0,2,38
1834722,1467600,2024-09-25,House,"House Third Reading: Given Immediate Effect Roll Call # 314",104,5,0,0,109
1834840,1443349,2024-05-15,Senate,"Reported Favorably With Substitute S-1",6,0,0,0,6
1834840,1453126,2024-06-04,Senate,"Senate Third Reading: Passed Roll Call # 212",25,13,0,0,38
1834840,1470004,2024-12-10,House,"Reported With Recommendation Without Amendment",8,0,0,0,8
1838160,1412683,2024-03-20,Senate,"Reported Favorably With Substitute S-1",10,0,0,0,10
1838160,1425010,2024-04-10,Senate,"Senate Third Reading: Passed Roll Call # 91",36,0,1,1,38
1838160,1456137,2024-06-11,House,"Reported With Recommendation With Substitute H-1",11,0,0,0,11
1838160,1458668,2024-06-20,House,"House Third Reading: Given Immediate Effect Roll Call # 187",109,0,0,0,109
1838160,1460926,2024-06-26,Senate,"Senate Third Reading: Roll Call: Roll Call # 282",38,0,0,0,38
1838187,1469530,2024-11-26,Senate,"Reported Favorably With Substitute S-2",5,0,0,0,5
1838187,1470752,2024-12-12,Senate,"Senate Third Reading: Passed Roll Call # 531",20,16,0,2,38
1838264,1453910,2024-06-05,Senate,"Reported Favorably With Substitute S-2",7,0,0,0,7
1838264,1458712,2024-06-20,Senate,"Senate Third Reading: Passed Roll Call # 252",38,0,0,0,38
1838264,1469319,2024-11-13,House,"Reported With Recommendation Without Amendment",13,0,0,0,13
1839407,1384344,2024-02-14,Senate,"Senate Third Reading: Passed Roll Call # 13",31,7,0,0,38
1839493,1412230,2024-03-19,Senate,"Reported Favorably Without Amendment",10,0,0,0,10
1839493,1412231,2024-03-19,Senate,"Senate Third Reading: Passed Roll Call # 68",37,0,0,1,38
1839493,1456126,2024-06-11,House,"Reported With Recommendation Without Amendment",13,0,0,0,13
1839493,1458673,2024-06-20,House,"House Third Reading: Given Immediate Effect Roll Call # 203",109,0,0,0,109
1839493,1463086,2024-06-27,House,"House Third Reading: Given Immediate Effect Roll Call # 293",110,0,0,0,110
1839493,1467646,2024-09-26,Senate,"Senate Third Reading: House Amendment(s) Concurred In Roll Call # 362",37,0,0,1,38
1839697,1384622,2024-02-14,Senate,"Senate Third Reading: Passed Roll Call # 14",31,7,0,0,38
1839697,1469354,2024-11-14,House,"Reported With Recommendation Without Amendment",10,0,0,0,10
1839872,1425028,2024-03-06,House,"Reported With Recommendation Without Amendment",7,0,0,0,7
1839872,1459849,2024-06-25,Senate,"Reported Favorably With Substitute S-1",8,0,0,0,8
1839872,1460289,2024-05-21,House,"House Third Reading: Given Immediate Effect Roll Call # 107",97,10,0,0,107
1839872,1462153,2024-06-27,House,"House Third Reading: Roll Call # 285",99,11,0,0,110
1839872,1463085,2024-06-26,Senate,"Senate Third Reading: Given Immediate Effect Roll Call # 299",35,3,0,0,38
1839872,1467595,2024-09-25,Senate,"Senate Third Reading: Passed Roll Call # 350",35,3,0,0,38
1839872,1467596,2024-09-25,House,"House Third Reading: Roll Call # 325",96,13,0,0,109
1839991,1470654,2024-12-12,House,"House Third Reading: Given Immediate Effect Roll Call # 467",56,53,0,0,109
1840114,1425019,2024-03-12,House,"Reported With Recommendation With Substitute H-1",8,3,0,0,11
1840114,1470103,2024-12-10,House,"House Third Reading: Given Immediate Effect Roll Call # 409",56,52,0,0,108
1845514,1430921,2024-04-18,House,"Reported With Recommendation With Substitute H-1",12,3,0,0,15
1845514,1469293,2024-11-13,House,"House Third Reading: Given Immediate Effect Roll Call # 339",56,53,0,0,109
1845514,1471003,2024-12-19,Senate,"Senate Third Reading: Passed Roll Call # 653",20,18,0,0,38
1845588,1430493,2024-04-18,House,"Reported With Recommendation With Substitute H-2",12,5,0,0,17
1845588,1469304,2024-11-13,House,"House Third Reading: Given Immediate Effect Roll Call # 340",56,53,0,0,109
1845588,1471019,2024-12-19,Senate,"Senate Third Reading: Passed Roll Call # 654",20,17,1,0,38
1845723,1425072,2024-03-19,House,"Reported With Recommendation With Substitute H-1",6,0,0,0,6
1845821,1402203,2024-02-27,House,"Reported With Recommendation Without Amendment",13,0,0,0,13
1845821,1440045,2024-05-07,House,"House Third Reading: Given Immediate Effect Roll Call # 54",56,1,0,0,57
1845821,1467457,2024-09-19,Senate,"Reported Favorably Without Amendment",4,0,0,0,4
1845821,1467564,2024-09-25,Senate,"Senate Third Reading: Given Immediate Effect Roll Call # 347",38,0,0,0,38
1846508,1403334,2024-02-14,House,"House Third Reading: Roll Call # 10",98,5,0,0,103
1846644,1443091,2024-05-14,House,"Reported With Recommendation With Substitute H-2",9,4,0,0,13
1846644,1469305,2024-11-13,House,"House Third Reading: Given Immediate Effect Roll Call # 342",56,53,0,0,109
1846644,1470691,2024-12-12,Senate,"Reported Favorably Without Amendment",5,0,0,0,5
1846644,1471021,2024-12-19,Senate,"Senate Third Reading: Passed Roll Call # 642",20,18,0,0,38
1846664,1443087,2024-05-14,House,"Reported With Recommendation With Substitute H-3",9,4,0,0,13
1846664,1469268,2024-11-13,House,"House Third Reading: Given Immediate Effect Roll Call # 341",56,53,0,0,109
1846664,1470697,2024-12-12,Senate,"Reported Favorably Without Amendment",5,0,0,0,5
1846664,1471023,2024-12-19,Senate,"Senate Third Reading: Passed Roll Call # 640",20,18,0,0,38
1847716,1392384,2024-02-21,Senate,"Reported Favorably Without Amendment",7,0,0,0,7
1847716,1402628,2024-02-29,Senate,"Senate Third Reading: Passed Roll Call # 41",38,0,0,0,38
1847716,1407879,2024-03-06,House,"Reported With Recommendation Without Amendment",8,0,0,0,8
1847716,1410029,2024-03-12,House,"House Third Reading: Given Immediate Effect Roll Call # 24",106,0,0,0,106
1851090,1425121,2024-03-06,House,"Reported With Recommendation Without Amendment",10,5,0,0,15
1851700,1467594,2024-09-25,House,"Reported With Recommendation With Substitute H-1",6,3,0,0,9
1851759,1443017,2024-05-14,House,"Reported With Recommendation With Substitute H-3",14,0,0,0,14
1851759,1449362,2024-05-23,House,"House Third Reading: Given Immediate Effect Roll Call # 145",80,27,0,0,107
1851759,1459876,2024-06-25,Senate,"Reported Favorably Without Amendment",8,0,0,0,8
1851759,1460889,2024-06-26,Senate,"Senate Third Reading: Given Immediate Effect Roll Call # 291",36,2,0,0,38
1851818,1442897,2024-05-14,House,"Reported With Recommendation With Substitute H-1",13,0,0,0,13
1851818,1443358,2024-05-15,House,"House Third Reading: Given Immediate Effect Roll Call # 88",107,0,0,0,107
1851818,1457112,2024-06-13,Senate,"Reported Favorably Without Amendment",4,0,0,0,4
1851818,1462761,2024-06-25,Senate,"Senate Third Reading: Given Immediate Effect Roll Call # 281",38,0,0,0,38
1852610,1438132,2024-05-02,House,"Reported With Recommendation With Substitute H-1",17,9,0,0,26
1852610,1441728,2024-05-08,House,"House Third Reading: Given Immediate Effect Roll Call # 58",56,50,0,0,106
1852610,1443694,2024-05-15,Senate,"Senate Third Reading: Passed Roll Call # 175",20,16,0,2,38
1852610,1448333,2024-05-22,House,"House Third Reading: Roll Call # 119",51,54,0,0,105
1852631,1433923,2024-04-24,House,"Reported With Recommendation With Substitute H-1",17,7,0,0,24
1852631,1441524,2024-05-08,House,"House Third Reading: Given Immediate Effect Roll Call # 68",56,49,0,0,105
1852631,1443395,2024-05-15,Senate,"Senate Third Reading: Passed Roll Call # 186",20,16,0,2,38
1852631,1448111,2024-05-22,House,"House Third Reading: Roll Call # 129",51,55,0,0,106
1852717,1433927,2024-04-24,House,"Reported With Recommendation With Substitute H-1",17,4,0,0,21
1852717,1441515,2024-05-08,House,"House Third Reading: Given Immediate Effect Roll Call # 61",56,50,0,0,106
1852717,1445384,2024-05-15,Senate,"Senate Third Reading: Passed Roll Call # 179",20,16,0,2,38
1852717,1448990,2024-05-22,House,"House Third Reading: Roll Call # 123",51,55,0,0,106
1852724,1433891,2024-04-24,House,"Reported With Recommendation With Substitute H-1",17,2,0,0,19
1852724,1441709,2024-05-08,House,"House Third Reading: Given Immediate Effect Roll Call # 64",57,48,0,0,105
1852724,1448326,2024-05-15,Senate,"Senate Third Reading: Passed Roll Call # 183",20,16,0,2,38
1852724,1448327,2024-05-22,House,"House Third Reading: Roll Call # 126",51,55,0,0,106
1852759,1438302,2024-05-02,House,"Reported With Recommendation With Substitute H-2",17,3,0,0,20
1852759,1441539,2024-05-08,House,"House Third Reading: Given Immediate Effect Roll Call # 70",56,49,0,0,105
1852759,1447955,2024-05-15,Senate,"Senate Third Reading: Passed Roll Call # 190",20,16,0,2,38
1852759,1448977,2024-05-22,House,"House Third Reading: Roll Call # 133",47,55,0,0,102
1852786,1433928,2024-04-24,House,"Reported With Recommendation With Substitute H-1",17,5,0,0,22
1852786,1441520,2024-05-08,House,"House Third Reading: Given Immediate Effect Roll Call # 65",56,49,0,0,105
1852786,1445626,2024-05-15,Senate,"Senate Third Reading: Passed Roll Call # 185",20,16,0,2,38
1852786,1448939,2024-05-22,House,"House Third Reading: Roll Call # 128",51,55,0,0,106
1852794,1470078,2024-12-10,House,"Reported With Recommendation With Substitute H-3",7,3,0,0,10
1852804,1433934,2024-04-24,House,"Reported With Recommendation With Substitute H-1",17,8,0,0,25
1852804,1441654,2024-05-08,House,"House Third Reading: Given Immediate Effect Roll Call # 74",56,49,0,0,105
1852804,1445554,2024-05-15,Senate,"Senate Third Reading: Passed Roll Call # 188",20,16,0,2,38
1852804,1448115,2024-05-22,House,"House Third Reading: Roll Call # 131",48,55,0,0,103
1852813,1438295,2024-05-02,House,"Reported With Recommendation Without Amendment",17,1,0,0,18
1852813,1441575,2024-05-08,House,"House Third Reading: Given Immediate Effect Roll Call # 57",56,50,0,0,106
1852813,1445763,2024-05-15,Senate,"Senate Third Reading: Passed Roll Call # 181",20,16,0,2,38
1852813,1448112,2024-05-22,House,"House Third Reading: Roll Call # 137",47,56,0,0,103
1852813,1461471,2024-06-27,House,"House Third Reading: Conference Report Adopted Roll Call # 269",56,54,0,0,110
1852813,1462133,2024-06-27,Senate,"Senate Third Reading: Senate Adopted Conference Report With Immediate Effect Roll Call # 331",20,18,0,0,38
1852839,1433925,2024-04-24,House,"Reported With Recommendation With Substitute H-1",17,2,0,0,19
1852839,1441547,2024-05-08,House,"House Third Reading: Given Immediate Effect Roll Call # 62",56,47,0,0,103
1852839,1445404,2024-05-15,Senate,"Senate Third Reading: Passed Roll Call # 178",20,16,0,2,38
1852839,1448832,2024-05-22,House,"House Third Reading: Roll Call # 122",51,55,0,0,106
1852856,1438407,2024-05-02,House,"Reported With Recommendation With Substitute H-2",17,0,0,0,17
1852856,1441555,2024-05-08,House,"House Third Reading: Given Immediate Effect Roll Call # 66",56,49,0,0,105
1852856,1445474,2024-05-15,Senate,"Senate Third Reading: Passed Roll Call # 182",20,16,0,2,38
1852856,1448838,2024-05-22,House,"House Third Reading: Roll Call # 125",51,55,0,0,106
1852887,1433919,2024-04-24,House,"Reported With Recommendation With Substitute H-1",17,3,0,0,20
1852887,1441530,2024-05-08,House,"House Third Reading: Given Immediate Effect Roll Call # 67",56,49,0,0,105
1852887,1445552,2024-05-15,Senate,"Senate Third Reading: Passed Roll Call # 184",20,16,0,2,38
1852887,1448117,2024-05-22,House,"House Third Reading: Roll Call # 127",51,55,0,0,106
1852896,1438024,2024-05-02,House,"Reported With Recommendation With Substitute H-2",17,8,0,0,25
1852896,1441566,2024-05-08,House,"House Third Reading: Given Immediate Effect Roll Call # 63",56,49,0,0,105
1852896,1444739,2024-05-15,Senate,"Senate Third Reading: Passed Roll Call # 173",20,16,0,2,38
1852896,1448834,2024-05-22,House,"House Third Reading: Roll Call # 118",52,53,0,0,105
1852929,1433932,2024-04-24,House,"Reported With Recommendation With Substitute H-2",17,1,0,0,18
1852929,1441535,2024-05-08,House,"House Third Reading: Given Immediate Effect Roll Call # 75",56,49,0,0,105
1852929,1443393,2024-05-15,Senate,"Senate Third Reading: Passed Roll Call # 187",20,16,0,2,38
1852929,1448211,2024-05-22,House,"House Third Reading: Roll Call # 130",51,55,0,0,106
1852947,1438150,2024-05-02,House,"Reported With Recommendation With Substitute H-1",17,4,0,0,21
1852947,1441708,2024-05-08,House,"House Third Reading: Given Immediate Effect Roll Call # 71",56,49,0,0,105
1852947,1447943,2024-05-15,Senate,"Senate Third Reading: Passed Roll Call # 191",20,16,0,2,38
1852947,1448980,2024-05-22,House,"House Third Reading: Roll Call # 134",47,55,0,0,102
1852956,1448937,2024-05-22,House,"Reported With Recommendation With Substitute H-1",15,2,0,0,17
1852972,1438368,2024-05-02,House,"Reported With Recommendation With Substitute H-2",17,3,0,0,20
1852972,1441511,2024-05-08,House,"House Third Reading: Given Immediate Effect Roll Call # 69",56,49,0,0,105
1852972,1448130,2024-05-15,Senate,"Senate Third Reading: Passed Roll Call # 189",20,16,0,2,38
1852972,1448131,2024-05-22,House,"House Third Reading: Roll Call # 132",47,55,0,0,102
1852983,1438223,2024-05-02,House,"Reported With Recommendation With Substitute H-2",17,3,0,0,20
1852983,1441589,2024-05-08,House,"House Third Reading: Given Immediate Effect Roll Call # 60",56,50,0,0,106
1852983,1445408,2024-05-15,Senate,"Senate Third Reading: Passed Roll Call # 177",20,16,0,2,38
1852983,1448086,2024-05-22,House,"House Third Reading: Roll Call # 121",51,55,0,0,106
1852983,1468580,2024-09-25,House,"House Third Reading: Conference Report Adopted Roll Call # 306",98,11,0,0,109
1852983,1468603,2024-09-25,Senate,"Senate Third Reading: Senate Adopted Conference Report Roll Call # 353",22,14,2,0,38
1852983,1468604,2024-09-25,Senate,"Senate Third Reading: Senate Adopted Conference Report Roll Call # 354",23,15,0,0,38
1853027,1432479,2024-04-23,House,"Reported With Recommendation Without Amendment",12,0,0,0,12
1853027,1459923,2024-06-25,House,"House Third Reading: Given Immediate Effect Roll Call # 223",84,26,0,0,110
1853027,1469998,2024-11-26,Senate,"Reported Favorably Without Amendment",7,0,0,0,7
1853027,1470121,2024-12-11,Senate,"Senate Third Reading: Passed Roll Call # 496",29,7,0,2,38
1853077,1438177,2024-05-02,House,"Reported With Recommendation With Substitute H-1",17,4,0,0,21
1853077,1441568,2024-05-08,House,"House Third Reading: Given Immediate Effect Roll Call # 76",56,49,0,0,105
1853077,1445556,2024-05-15,Senate,"Senate Third Reading: Passed Roll Call # 180",20,16,0,2,38
1853077,1448498,2024-05-22,House,"House Third Reading: Roll Call # 124",51,55,0,0,106
1853094,1438175,2024-05-02,House,"Reported With Recommendation With Substitute H-3",17,9,0,0,26
1853094,1441559,2024-05-08,House,"House Third Reading: Given Immediate Effect Roll Call # 73",56,49,0,0,105
1853094,1445405,2024-05-15,Senate,"Senate Third Reading: Passed Roll Call # 176",21,15,0,2,38
1853094,1448501,2024-05-22,House,"House Third Reading: Roll Call # 120",51,55,0,0,106
1853111,1438299,2024-05-02,House,"Reported With Recommendation Without Amendment",17,1,0,0,18
1853111,1441567,2024-05-08,House,"House Third Reading: Given Immediate Effect Roll Call # 56",56,50,0,0,106
1853111,1443847,2024-05-15,Senate,"Senate Third Reading: Passed Roll Call # 174",20,16,0,2,38
1853111,1448095,2024-05-22,House,"House Third Reading: Roll Call # 136",47,56,0,0,103
1853119,1425011,2024-03-06,House,"Reported With Recommendation Without Amendment",10,1,0,0,11
1853119,1441732,2024-05-09,House,"House Third Reading: Given Immediate Effect Roll Call # 82",69,38,0,0,107
1853119,1468887,2024-10-17,Senate,"Reported Favorably Without Amendment",16,3,0,0,19
1853119,1469115,2024-10-30,Senate,"Senate Third Reading: Passed Roll Call # 395",27,10,0,1,38
1854986,1425038,2024-03-14,Senate,"Reported Favorably Without Amendment",4,1,0,0,5
1854986,1454026,2024-06-05,Senate,"Senate Third Reading: Passed Roll Call # 235",20,18,0,0,38
1854986,1469586,2024-12-03,House,"Reported With Recommendation Without Amendment",6,0,0,0,6
1855787,1456565,2024-06-12,Senate,"Reported Favorably With Substitute S-2",10,0,0,0,10
1855787,1460898,2024-06-26,Senate,"Senate Third Reading: Passed Roll Call # 285",35,3,0,0,38
1855916,1456626,2024-06-12,Senate,"Reported Favorably With Substitute S-2",10,0,0,0,10
1855916,1460948,2024-06-26,Senate,"Senate Third Reading: Passed Roll Call # 287",36,2,0,0,38
1855981,1456633,2024-06-12,Senate,"Reported Favorably With Substitute S-2",10,0,0,0,10
1855981,1461007,2024-06-26,Senate,"Senate Third Reading: Passed Roll Call # 286",36,2,0,0,38
1855981,1470215,2024-12-10,House,"Reported With Recommendation Without Amendment",12,0,0,0,12
1857206,1408626,2024-03-12,House,"Reported With Recommendation With Substitute H-2",15,0,0,0,15
1857206,1411492,2024-03-19,House,"House Third Reading: Given Immediate Effect Roll Call # 30",55,29,0,0,84
1857206,1430850,2024-04-18,Senate,"Reported Favorably With Substitute S-2",9,0,0,0,9
1857206,1432348,2024-04-23,Senate,"Senate Third Reading: Passed Roll Call # 97",31,6,0,1,38
1857206,1432806,2024-04-23,House,"House Third Reading: Roll Call # 35",77,30,0,0,107
1857280,1425015,2024-03-12,House,"Reported With Recommendation Without Amendment",15,0,0,0,15
1857347,1408767,2024-03-12,House,"Reported With Recommendation With Substitute H-1",15,0,0,0,15
1857347,1411493,2024-03-19,House,"House Third Reading: Given Immediate Effect Roll Call # 31",55,41,0,0,96
1857347,1430405,2024-04-18,Senate,"Reported Favorably With Substitute S-2",9,0,0,0,9
1857347,1432461,2024-04-23,Senate,"Senate Third Reading: Passed Roll Call # 98",32,5,0,1,38
1857347,1432462,2024-04-23,House,"House Third Reading: Roll Call # 36",77,30,0,0,107
1859664,1410235,2024-03-13,House,"Reported With Recommendation With Substitute H-1",8,0,0,0,8
1859664,1431208,2024-04-18,House,"House Third Reading: Given Immediate Effect Roll Call # 33",58,47,0,0,105
1859664,1433567,2024-04-24,Senate,"Senate Third Reading: Passed Roll Call # 100",20,17,0,1,38
1859664,1433568,2024-04-24,House,"House Third Reading: Roll Call # 41",53,52,0,0,105
1859664,1441681,2024-05-09,House,"House Third Reading: Roll Call # 78",56,51,0,0,107
1859697,1458121,2024-06-18,House,"Reported With Recommendation Without Amendment",13,0,0,0,13
1859697,1463258,2024-06-27,House,"House Third Reading: Given Immediate Effect Roll Call # 288",90,20,0,0,110
1859767,1458119,2024-06-18,House,"Reported With Recommendation Without Amendment",13,0,0,0,13
1859767,1461763,2024-06-27,House,"House Third Reading: Given Immediate Effect Roll Call # 289",88,22,0,0,110
1859783,1445811,2024-05-21,House,"Reported With Recommendation Without Amendment",13,0,0,0,13
1859783,1457038,2024-06-12,House,"House Third Reading: Given Immediate Effect Roll Call # 167",103,7,0,0,110
1860129,1412278,2024-03-19,Senate,"Reported Favorably With Substitute S-1",10,0,0,0,10
1860129,1412279,2024-03-19,Senate,"Senate Third Reading: Passed Roll Call # 66",20,17,0,1,38
1860129,1442948,2024-05-14,House,"Reported With Recommendation Without Amendment",9,4,0,0,13
1860129,1448336,2024-05-22,House,"House Third Reading: Given Immediate Effect Roll Call # 139",56,47,0,0,103
1860143,1458054,2024-06-18,Senate,"Reported Favorably With Substitute S-1",3,1,0,0,4
1860143,1463087,2024-06-26,Senate,"Senate Third Reading: Passed Roll Call # 288",20,18,0,0,38
1860143,1467576,2024-09-25,House,"Reported With Recommendation Without Amendment",7,3,0,0,10
1860143,1469295,2024-11-13,House,"House Third Reading: Given Immediate Effect Roll Call # 348",56,53,0,0,109
1860294,1425020,2024-03-19,House,"Reported With Recommendation Without Amendment",6,2,0,0,8
1860332,1425031,2024-03-19,House,"Reported With Recommendation Without Amendment",6,2,0,0,8
1860332,1467604,2024-09-25,House,"House Third Reading: Given Immediate Effect Roll Call # 326",56,50,0,0,106
1860370,1470002,2024-12-10,House,"House Third Reading: Given Immediate Effect Roll Call # 390",57,51,0,0,108
1860956,1438971,2024-05-02,Senate,"Reported Favorably With Substitute S-1",13,6,0,0,19
1860956,1438972,2024-05-02,Senate,"Senate Third Reading: Passed Roll Call # 113",20,18,0,0,38
1860956,1447046,2024-05-21,House,"House Third Reading: Given Immediate Effect Roll Call # 103",56,51,0,0,107
1860956,1468589,2024-06-04,Senate,"Senate Third Reading: Roll Call: Roll Call # 225",0,38,0,0,38
1860964,1456797,2024-06-12,Senate,"Senate Third Reading: Passed Roll Call # 241",20,18,0,0,38
1860964,1458744,2024-06-20,House,"House Third Reading: Given Immediate Effect Roll Call # 209",56,53,0,0,109
1860964,1461406,2024-06-27,Senate,"Senate Third Reading: Senate Adopted Conference Report With Immediate Effect Roll Call # 330",21,17,0,0,38
1860964,1461407,2024-06-27,House,"House Third Reading: Conference Report Adopted Roll Call # 294",56,54,0,0,110
1860964,1468601,2024-06-20,Senate,"Senate Third Reading: Roll Call: Roll Call # 271",0,37,0,1,38
1860968,1436848,2024-04-30,Senate,"Reported Favorably With Substitute S-1",13,5,0,0,18
1860968,1441777,2024-05-09,Senate,"Senate Third Reading: Passed Roll Call # 133",20,16,0,2,38
1860968,1445814,2024-05-21,House,"House Third Reading: Given Immediate Effect Roll Call # 105",56,51,0,0,107
1860968,1468594,2024-06-04,Senate,"Senate Third Reading: Roll Call: Roll Call # 229",0,38,0,0,38
1860977,1438129,2024-05-02,Senate,"Reported Favorably With Substitute S-1",13,6,0,0,19
1860977,1441713,2024-05-09,Senate,"Senate Third Reading: Passed Roll Call # 134",20,16,0,2,38
1860977,1446467,2024-05-21,House,"House Third Reading: Given Immediate Effect Roll Call # 94",56,51,0,0,107
1860977,1453277,2024-06-04,Senate,"Senate Third Reading: Roll Call: Roll Call # 213",1,37,0,0,38
1860980,1436977,2024-04-30,Senate,"Reported Favorably With Substitute S-1",13,5,0,0,18
1860980,1441805,2024-05-09,Senate,"Senate Third Reading: Passed Roll Call # 121",20,16,0,2,38
1860980,1445807,2024-05-21,House,"House Third Reading: Given Immediate Effect Roll Call # 97",56,51,0,0,107
1860980,1453271,2024-06-04,Senate,"Senate Third Reading: Roll Call: Roll Call # 218",0,38,0,0,38
1860982,1436918,2024-04-30,Senate,"Reported Favorably With Substitute S-1",13,5,0,0,18
1860982,1441726,2024-05-09,Senate,"Senate Third Reading: Passed Roll Call # 124",20,16,0,2,38
1860982,1445748,2024-05-21,House,"House Third Reading: Given Immediate Effect Roll Call # 96",56,51,0,0,107
1860982,1468590,2024-06-04,Senate,"Senate Third Reading: Roll Call: Roll Call # 217",0,38,0,0,38
1860992,1436952,2024-04-30,Senate,"Reported Favorably With Substitute S-4",13,5,0,0,18
1860992,1438292,2024-05-02,Senate,"Senate Third Reading: Passed Roll Call # 110",28,10,0,0,38
1860992,1445614,2024-05-21,House,"House Third Reading: Given Immediate Effect Roll Call # 98",56,51,0,0,107
1860992,1453327,2024-06-04,Senate,"Senate Third Reading: Roll Call: Roll Call # 219",0,38,0,0,38
1860997,1438135,2024-05-02,Senate,"Reported Favorably With Substitute S-2",13,6,0,0,19
1860997,1438136,2024-05-02,Senate,"Senate Third Reading: Passed Roll Call # 114",20,18,0,0,38
1860997,1445865,2024-05-21,House,"House Third Reading: Given Immediate Effect Roll Call # 104",56,51,0,0,107
1860997,1453112,2024-06-04,Senate,"Senate Third Reading: Roll Call: Roll Call # 226",0,38,0,0,38
1861002,1438173,2024-05-02,Senate,"Reported Favorably With Substitute S-2",13,6,0,0,19
1861002,1442932,2024-05-14,Senate,"Senate Third Reading: Passed Roll Call # 158",20,16,0,2,38
1861002,1445694,2024-05-21,House,"House Third Reading: Given Immediate Effect Roll Call # 92",56,51,0,0,107
1861002,1468597,2024-06-04,Senate,"Senate Third Reading: Roll Call: Roll Call # 227",1,37,0,0,38
1861008,1437903,2024-05-02,Senate,"Reported Favorably With Substitute S-2",13,6,0,0,19
1861008,1443369,2024-05-14,Senate,"Senate Third Reading: Passed Roll Call # 145",20,16,0,2,38
1861008,1445858,2024-05-21,House,"House Third Reading: Given Immediate Effect Roll Call # 90",56,51,0,0,107
1861008,1453180,2024-06-04,Senate,"Senate Third Reading: Roll Call: Roll Call # 216",0,38,0,0,38
1861020,1438172,2024-05-02,Senate,"Reported Favorably With Substitute S-1",13,6,0,0,19
1861020,1441766,2024-05-09,Senate,"Senate Third Reading: Passed Roll Call # 126",20,16,0,2,38
1861020,1446917,2024-05-21,House,"House Third Reading: Given Immediate Effect Roll Call # 106",56,51,0,0,107
1861020,1468595,2024-06-04,Senate,"Senate Third Reading: Roll Call: Roll Call # 230",0,38,0,0,38
1861025,1438171,2024-05-02,Senate,"Reported Favorably With Substitute S-1",15,4,0,0,19
1861025,1441798,2024-05-09,Senate,"Senate Third Reading: Passed Roll Call # 129",22,14,0,2,38
1861025,1447030,2024-05-21,House,"House Third Reading: Given Immediate Effect Roll Call # 100",56,51,0,0,107
1861025,1468591,2024-06-04,Senate,"Senate Third Reading: Roll Call: Roll Call # 222",0,38,0,0,38
1861030,1438167,2024-05-02,Senate,"Reported Favorably With Substitute S-1",13,6,0,0,19
1861030,1443078,2024-05-14,Senate,"Senate Third Reading: Passed Roll Call # 171",20,16,0,2,38
1861030,1446143,2024-05-21,House,"House Third Reading: Given Immediate Effect Roll Call # 91",56,51,0,0,107
1861030,1468596,2024-06-04,Senate,"Senate Third Reading: Roll Call: Roll Call # 221",0,38,0,0,38
1861035,1436544,2024-04-30,Senate,"Reported Favorably With Substitute S-1",13,5,0,0,18
1861035,1444769,2024-05-15,Senate,"Senate Third Reading: Passed Roll Call # 206",20,16,0,2,38
1861035,1445839,2024-05-21,House,"House Third Reading: Given Immediate Effect Roll Call # 89",56,51,0,0,107
1861035,1468599,2024-06-04,Senate,"Senate Third Reading: Roll Call: Roll Call # 214",0,38,0,0,38
1861041,1438176,2024-05-02,Senate,"Reported Favorably With Substitute S-2",13,6,0,0,19
1861041,1442921,2024-05-14,Senate,"Senate Third Reading: Passed Roll Call # 172",20,16,0,2,38
1861042,1456630,2024-06-12,Senate,"Reported Favorably With Substitute S-1",7,0,0,0,7
1861042,1458671,2024-06-20,Senate,"Senate Third Reading: Passed Roll Call # 255",38,0,0,0,38
1861052,1436932,2024-04-30,Senate,"Reported Favorably With Substitute S-1",13,5,0,0,18
1861052,1441758,2024-05-09,Senate,"Senate Third Reading: Passed Roll Call # 120",20,16,0,2,38
1861052,1445805,2024-05-21,House,"House Third Reading: Given Immediate Effect Roll Call # 102",56,51,0,0,107
1861052,1468593,2024-06-04,Senate,"Senate Third Reading: Roll Call: Roll Call # 224",0,38,0,0,38
1861054,1437906,2024-05-02,Senate,"Reported Favorably With Substitute S-2",13,6,0,0,19
1861054,1441757,2024-05-09,Senate,"Senate Third Reading: Passed Roll Call # 141",20,16,0,2,38
1861054,1446175,2024-05-21,House,"House Third Reading: Given Immediate Effect Roll Call # 95",56,51,0,0,107
1861054,1453193,2024-06-04,Senate,"Senate Third Reading: Roll Call: Roll Call # 215",0,38,0,0,38
1861060,1436871,2024-04-30,Senate,"Reported Favorably With Substitute S-1",13,5,0,0,18
1861060,1438303,2024-05-02,Senate,"Senate Third Reading: Passed Roll Call # 111",20,18,0,0,38
1861060,1445887,2024-05-21,House,"House Third Reading: Given Immediate Effect Roll Call # 99",56,51,0,0,107
1861060,1468588,2024-06-04,Senate,"Senate Third Reading: Roll Call: Roll Call # 220",1,37,0,0,38
1861068,1437954,2024-05-02,Senate,"Reported Favorably With Substitute S-1",13,6,0,0,19
1861068,1442910,2024-05-14,Senate,"Senate Third Reading: Passed Roll Call # 164",20,16,0,2,38
1861068,1445851,2024-05-21,House,"House Third Reading: Given Immediate Effect Roll Call # 93",56,51,0,0,107
1861068,1468598,2024-06-04,Senate,"Senate Third Reading: Roll Call: Roll Call # 228",0,38,0,0,38
1861070,1436877,2024-04-30,Senate,"Reported Favorably With Substitute S-1",13,5,0,0,18
1861070,1441712,2024-05-09,Senate,"Senate Third Reading: Passed Roll Call # 118",20,16,0,2,38
1861070,1445809,2024-05-21,House,"House Third Reading: Given Immediate Effect Roll Call # 101",56,51,0,0,107
1861070,1468592,2024-06-04,Senate,"Senate Third Reading: Roll Call: Roll Call # 223",0,38,0,0,38
1863099,1438109,2024-05-02,House,"Reported With Recommendation With Substitute H-2",17,6,0,0,23
1863099,1441600,2024-05-08,House,"House Third Reading: Given Immediate Effect Roll Call # 59",56,50,0,0,106
1863099,1445662,2024-05-15,Senate,"Senate Third Reading: Passed Roll Call # 192",20,16,0,2,38
1863099,1448261,2024-05-22,House,"House Third Reading: Roll Call # 135",47,56,0,0,103
1863135,1456140,2024-06-11,House,"Reported With Recommendation Without Amendment",12,0,0,0,12
1863135,1458853,2024-06-20,House,"House Third Reading: Given Immediate Effect Roll Call # 207",68,41,0,0,109
1863135,1468536,2024-10-09,Senate,"Reported Favorably Without Amendment",5,2,0,0,7
1863135,1468907,2024-10-23,Senate,"Senate Third Reading: Passed Roll Call # 377",24,14,0,0,38
1863449,1465312,2024-06-11,Senate,"Senate Third Reading: Passed Roll Call # 239",38,0,0,0,38
1863449,1468609,2024-05-22,Senate,"Reported Favorably Without Amendment",4,0,0,0,4
1863449,1469152,2024-11-07,House,"House Third Reading: Given Immediate Effect Roll Call # 328",59,49,0,0,108
1863467,1412395,2024-03-19,Senate,"Reported Favorably With Substitute S-1",10,0,0,0,10
1863467,1412396,2024-03-19,Senate,"Senate Third Reading: Passed Roll Call # 64",37,0,0,1,38
1863467,1456521,2024-06-11,House,"Reported With Recommendation Without Amendment",14,0,0,0,14
1863467,1458711,2024-06-20,House,"House Third Reading: Given Immediate Effect Roll Call # 186",99,10,0,0,109
1863617,1458369,2024-06-18,House,"Reported With Recommendation With Substitute H-3",6,2,0,0,8
1863617,1461383,2024-06-26,House,"House Third Reading: Given Immediate Effect Roll Call # 251",56,54,0,0,110
1863617,1470134,2024-12-10,Senate,"Reported Favorably Without Amendment",5,1,0,0,6
1863617,1471012,2024-12-19,Senate,"Senate Third Reading: Passed Roll Call # 659",20,18,0,0,38
1863625,1458123,2024-06-18,House,"Reported With Recommendation With Substitute H-2",6,2,0,0,8
1863625,1461317,2024-06-26,House,"House Third Reading: Given Immediate Effect Roll Call # 252",56,54,0,0,110
1863625,1470061,2024-12-10,Senate,"Reported Favorably Without Amendment",5,1,0,0,6
1863625,1471014,2024-12-19,Senate,"Senate Third Reading: Passed Roll Call # 660",20,17,1,0,38
1863639,1447066,2024-05-21,House,"Reported With Recommendation Without Amendment",12,0,0,0,12
1863639,1456831,2024-06-12,House,"House Third Reading: Given Immediate Effect Roll Call # 165",108,2,0,0,110
1863649,1458368,2024-06-18,House,"Reported With Recommendation With Substitute H-3",6,2,0,0,8
1863649,1461387,2024-06-26,House,"House Third Reading: Given Immediate Effect Roll Call # 250",56,54,0,0,110
1863649,1469982,2024-12-10,Senate,"Reported Favorably Without Amendment",5,1,0,0,6
1863649,1471017,2024-12-19,Senate,"Senate Third Reading: Passed Roll Call # 658",20,18,0,0,38
1863656,1454053,2024-06-05,House,"Reported With Recommendation Without Amendment",10,7,0,0,17
1863656,1463227,2024-06-27,House,"House Third Reading: Given Immediate Effect Roll Call # 278",56,54,0,0,110
1863669,1446994,2024-05-21,House,"Reported With Recommendation With Substitute H-2",12,0,0,0,12
1863669,1457028,2024-06-12,House,"House Third Reading: Given Immediate Effect Roll Call # 164",108,2,0,0,110
1863677,1458125,2024-06-18,House,"Reported With Recommendation Without Amendment",6,2,0,0,8
1863677,1461385,2024-06-26,House,"House Third Reading: Given Immediate Effect Roll Call # 248",56,54,0,0,110
1863677,1470070,2024-12-10,Senate,"Reported Favorably Without Amendment",5,1,0,0,6
1863677,1471020,2024-12-19,Senate,"Senate Third Reading: Passed Roll Call # 656",20,17,1,0,38
1863692,1458110,2024-06-18,House,"Reported With Recommendation With Substitute H-3",6,2,0,0,8
1863692,1461350,2024-06-26,House,"House Third Reading: Given Immediate Effect Roll Call # 247",56,54,0,0,110
1863692,1470064,2024-12-10,Senate,"Reported Favorably Without Amendment",5,1,0,0,6
1863699,1458120,2024-06-18,House,"Reported With Recommendation With Substitute H-3",6,2,0,0,8
1863699,1461389,2024-06-26,House,"House Third Reading: Given Immediate Effect Roll Call # 249",56,54,0,0,110
1863699,1469980,2024-12-10,Senate,"Reported Favorably Without Amendment",5,1,0,0,6
1863699,1471013,2024-12-19,Senate,"Senate Third Reading: Passed Roll Call # 657",20,18,0,0,38
1863952,1460919,2024-06-26,Senate,"Senate Third Reading: Passed Roll Call # 328",20,18,0,0,38
1863952,1467601,2024-09-25,House,"Reported With Recommendation With Substitute H-1",17,12,0,0,29
1863952,1467602,2024-09-25,House,"House Third Reading: Given Immediate Effect Roll Call # 302",56,53,0,0,109
1863952,1467603,2024-09-25,Senate,"Senate Third Reading: Roll Call: Roll Call # 351",20,18,0,0,38
1864032,1412269,2024-03-20,Senate,"Reported Favorably Without Amendment",10,0,0,0,10
1864032,1425016,2024-04-10,Senate,"Senate Third Reading: Passed Roll Call # 92",37,0,0,1,38
1864032,1456136,2024-06-11,House,"Reported With Recommendation Without Amendment",11,0,0,0,11
1864032,1458714,2024-06-20,House,"House Third Reading: Given Immediate Effect Roll Call # 188",109,0,0,0,109
1864072,1460882,2024-06-26,Senate,"Senate Third Reading: Passed Roll Call # 329",20,18,0,0,38
1864072,1467591,2024-09-25,House,"Reported With Recommendation With Substitute H-1",17,12,0,0,29
1864072,1467592,2024-09-25,House,"House Third Reading: Given Immediate Effect Roll Call # 303",56,53,0,0,109
1864072,1467593,2024-09-25,Senate,"Senate Third Reading: Roll Call: Roll Call # 352",20,18,0,0,38
1864105,1453299,2024-06-04,House,"Reported With Recommendation Without Amendment",12,0,0,0,12
1864105,1458690,2024-06-20,House,"House Third Reading: Given Immediate Effect Roll Call # 197",100,9,0,0,109
1864118,1470396,2024-11-14,House,"Reported With Recommendation Without Amendment",7,0,0,0,7
1864118,1470543,2024-12-13,House,"House Third Reading: Given Immediate Effect Roll Call # 520",56,0,0,0,56
1864156,1453301,2024-06-04,House,"Reported With Recommendation With Substitute H-1",12,0,0,0,12
1864156,1458683,2024-06-20,House,"House Third Reading: Given Immediate Effect Roll Call # 195",101,8,0,0,109
1864196,1453298,2024-06-04,House,"Reported With Recommendation Without Amendment",12,0,0,0,12
1864196,1458677,2024-06-20,House,"House Third Reading: Given Immediate Effect Roll Call # 196",100,9,0,0,109
1864234,1469342,2024-11-14,House,"Reported With Recommendation Without Amendment",6,0,0,0,6
1864259,1467567,2024-09-25,House,"House Third Reading: Given Immediate Effect Roll Call # 316",56,53,0,0,109
1864283,1470385,2024-12-12,House,"Reported With Recommendation With Substitute H-2",6,0,0,0,6
1864296,1453296,2024-06-04,House,"Reported With Recommendation Without Amendment",12,0,0,0,12
1864296,1458664,2024-06-20,House,"House Third Reading: Given Immediate Effect Roll Call # 194",101,8,0,0,109
1864307,1453304,2024-06-04,House,"Reported With Recommendation Without Amendment",12,0,0,0,12
1864307,1458658,2024-06-20,House,"House Third Reading: Given Immediate Effect Roll Call # 198",100,9,0,0,109
1864329,1453293,2024-06-04,House,"Reported With Recommendation Without Amendment",12,0,0,0,12
1864329,1458684,2024-06-20,House,"House Third Reading: Given Immediate Effect Roll Call # 199",102,7,0,0,109
1864337,1453312,2024-06-04,House,"Reported With Recommendation Without Amendment",12,0,0,0,12
1864337,1458680,2024-06-20,House,"House Third Reading: Given Immediate Effect Roll Call # 193",101,8,0,0,109
1865215,1445428,2024-05-21,Senate,"Reported Favorably Without Amendment",5,2,0,0,7
1865229,1469832,2024-12-05,Senate,"Reported Favorably Without Amendment",10,0,0,0,10
1865854,1470277,2024-12-10,House,"Reported With Recommendation With Substitute H-1",14,0,0,0,14
1865854,1470328,2024-12-12,House,"House Third Reading: Given Immediate Effect Roll Call # 476",108,1,0,0,109
1865863,1470370,2024-12-12,House,"Reported With Recommendation Without Amendment",7,2,0,0,9
1865867,1470387,2024-12-12,House,"Reported With Recommendation Without Amendment",7,1,0,0,8
1865875,1467614,2024-09-25,House,"Reported With Recommendation Without Amendment",5,0,0,0,5
1865875,1467615,2024-09-25,House,"House Third Reading: Given Immediate Effect Roll Call # 320",87,22,0,0,109
1865875,1469546,2024-11-26,Senate,"Reported Favorably Without Amendment",17,1,0,0,18
1865875,1470181,2024-12-11,Senate,"Senate Third Reading: Passed Roll Call # 494",33,3,0,2,38
1865881,1457007,2024-06-12,House,"Reported With Recommendation Without Amendment",13,0,0,0,13
1865881,1457106,2024-06-13,House,"House Third Reading: Given Immediate Effect Roll Call # 175",109,0,0,0,109
1865881,1468458,2024-10-09,Senate,"Reported Favorably Without Amendment",7,0,0,0,7
1865888,1470337,2024-12-12,House,"Reported With Recommendation Without Amendment",7,2,0,0,9
1865889,1470371,2024-12-12,House,"Reported With Recommendation Without Amendment",7,1,0,0,8
1865901,1470361,2024-12-12,House,"Reported With Recommendation Without Amendment",7,2,0,0,9
1865911,1470341,2024-12-12,House,"Reported With Recommendation Without Amendment",7,1,0,0,8
1865913,1470369,2024-12-12,House,"Reported With Recommendation Without Amendment",7,2,0,0,9
1865918,1470367,2024-12-12,House,"Reported With Recommendation Without Amendment",7,1,0,0,8
1865921,1470377,2024-12-12,House,"Reported With Recommendation Without Amendment",7,1,0,0,8
1865937,1470372,2024-12-12,House,"Reported With Recommendation Without Amendment",7,2,0,0,9
1865947,1457010,2024-06-12,House,"Reported With Recommendation With Substitute H-1",13,0,0,0,13
1865947,1457107,2024-06-13,House,"House Third Reading: Given Immediate Effect Roll Call # 174",109,0,0,0,109
1865947,1468457,2024-10-09,Senate,"Reported Favorably Without Amendment",7,0,0,0,7
1871672,1469110,2024-10-17,Senate,"Reported Favorably With Substitute S-1",9,0,0,0,9
1871672,1469591,2024-12-03,Senate,"Senate Third Reading: Passed Roll Call # 419",23,14,0,1,38
1871675,1432587,2024-04-23,Senate,"Reported Favorably Without Amendment",5,0,0,0,5
1871676,1468954,2024-10-24,Senate,"Reported Favorably With Substitute S-2",5,2,0,0,7
1871676,1469150,2024-11-07,Senate,"Senate Third Reading: Passed Roll Call # 411",24,11,0,3,38
1871676,1470980,2024-12-11,House,"Reported With Recommendation Without Amendment",9,0,0,0,9
1871677,1469108,2024-10-17,Senate,"Reported Favorably Without Amendment",8,2,0,0,10
1871677,1469918,2024-12-03,Senate,"Senate Third Reading: Passed Roll Call # 421",20,17,0,1,38
1871678,1468050,2024-10-02,Senate,"Reported Favorably Without Amendment",4,1,0,0,5
1871678,1468436,2024-10-08,Senate,"Senate Third Reading: Passed Roll Call # 369",35,1,0,2,38
1871679,1469116,2024-10-17,Senate,"Reported Favorably Without Amendment",9,2,0,0,11
1871679,1469906,2024-12-03,Senate,"Senate Third Reading: Passed Roll Call # 422",24,13,0,1,38
1871680,1468708,2024-10-17,Senate,"Reported Favorably Without Amendment",11,0,0,0,11
1871680,1469594,2024-12-03,Senate,"Senate Third Reading: Passed Roll Call # 423",37,0,0,1,38
1871683,1469111,2024-10-17,Senate,"Reported Favorably With Substitute S-1",9,0,0,0,9
1871683,1469627,2024-12-03,Senate,"Senate Third Reading: Passed Roll Call # 416",23,14,0,1,38
1871686,1469113,2024-10-17,Senate,"Reported Favorably With Substitute S-1",9,0,0,0,9
1871686,1469632,2024-12-03,Senate,"Senate Third Reading: Passed Roll Call # 418",23,14,0,1,38
1871688,1469540,2024-11-26,Senate,"Reported Favorably With Substitute S-1",8,0,0,0,8
1871690,1443107,2024-05-14,House,"Reported With Recommendation Without Amendment",13,0,0,0,13
1871690,1463254,2024-06-27,House,"House Third Reading: Given Immediate Effect Roll Call # 295",110,0,0,0,110
1871691,1469130,2024-10-31,Senate,"Reported Favorably Without Amendment",5,2,0,0,7
1871695,1429329,2024-04-17,Senate,"Reported Favorably With Substitute S-1",18,0,0,0,18
1871695,1438163,2024-05-02,Senate,"Senate Third Reading: Passed Roll Call # 109",38,0,0,0,38
1871695,1441740,2024-05-08,House,"House Third Reading: Given Immediate Effect Roll Call # 72",98,7,0,0,105
1871695,1467613,2024-09-25,House,"House Third Reading: Given Immediate Effect Roll Call # 324",99,10,0,0,109
1871695,1467645,2024-09-26,Senate,"Senate Third Reading: Roll Call: Roll Call # 363",37,0,0,1,38
1871696,1467453,2024-09-19,Senate,"Reported Favorably With Substitute S-1",9,1,0,0,10
1871699,1468710,2024-10-17,Senate,"Reported Favorably Without Amendment",11,0,0,0,11
1871699,1469590,2024-12-03,Senate,"Senate Third Reading: Passed Roll Call # 420",37,0,0,1,38
1871700,1432562,2024-04-23,Senate,"Reported Favorably Without Amendment",7,0,0,0,7
1872776,1458057,2024-06-18,Senate,"Reported Favorably Without Amendment",3,1,0,0,4
1872776,1461157,2024-06-26,Senate,"Senate Third Reading: Passed Roll Call # 290",20,18,0,0,38
1872793,1458142,2024-06-18,Senate,"Reported Favorably Without Amendment",3,1,0,0,4
1872793,1461313,2024-06-26,Senate,"Senate Third Reading: Passed Roll Call # 289",20,18,0,0,38
1873215,1470288,2024-12-10,House,"Reported With Recommendation With Substitute H-2",11,3,0,0,14
1873215,1470671,2024-12-12,House,"House Third Reading: Given Immediate Effect Roll Call # 470",56,53,0,0,109
1873285,1470132,2024-12-11,Senate,"Reported Favorably Without Amendment",8,0,0,0,8
1873325,1470133,2024-12-11,Senate,"Reported Favorably Without Amendment",8,0,0,0,8
1873333,1467270,2024-09-11,Senate,"Reported Favorably Without Amendment",4,0,0,0,4
1873333,1467379,2024-09-17,Senate,"Senate Third Reading: Passed Roll Call # 333",36,0,0,2,38
1873333,1467572,2024-09-25,House,"House Third Reading: Given Immediate Effect Roll Call # 313",104,5,0,0,109
1873333,1467643,2024-09-26,Senate,"Senate Third Reading: Roll Call: Roll Call # 364",37,0,0,1,38
1873342,1470318,2024-12-11,Senate,"Reported Favorably Without Amendment",8,0,0,0,8
1873342,1470687,2024-12-13,Senate,"Senate Third Reading: Passed Roll Call # 605",22,11,0,5,38
1873356,1469987,2024-12-10,Senate,"Reported Favorably With Substitute S-2",5,1,0,0,6
1873356,1470777,2024-12-12,Senate,"Senate Third Reading: Passed Roll Call # 563",20,15,0,3,38
1873962,1454512,2024-06-06,Senate,"Reported Favorably Without Amendment",10,0,0,0,10
1873962,1469655,2024-12-04,Senate,"Senate Third Reading: Passed Roll Call # 433",33,3,0,2,38
1873988,1433492,2024-04-24,House,"Reported With Recommendation Without Amendment",17,8,0,0,25
1874023,1453287,2024-06-04,House,"Reported With Recommendation With Substitute H-2",8,0,0,0,8
1874023,1469311,2024-11-13,House,"House Third Reading: Given Immediate Effect Roll Call # 347",71,38,0,0,109
1874023,1470693,2024-12-11,Senate,"Reported Favorably Without Amendment",8,1,0,0,9
1874047,1453236,2024-06-04,House,"Reported With Recommendation With Substitute H-1",12,0,0,0,12
1874047,1458061,2024-06-18,House,"House Third Reading: Given Immediate Effect Roll Call # 179",87,22,0,0,109
1874047,1469109,2024-10-24,Senate,"Reported Favorably Without Amendment",5,0,0,0,5
1874047,1469981,2024-12-10,Senate,"Senate Third Reading: Passed Roll Call # 473",23,14,0,1,38
1874079,1453290,2024-06-04,House,"Reported With Recommendation With Substitute H-1",8,0,0,0,8
1874079,1469313,2024-11-13,House,"House Third Reading: Given Immediate Effect Roll Call # 346",71,38,0,0,109
1874079,1470304,2024-12-11,Senate,"Reported Favorably Without Amendment",8,1,0,0,9
1874118,1458130,2024-06-18,House,"Reported With Recommendation With Substitute H-1",14,0,0,0,14
1874118,1469956,2024-12-10,House,"House Third Reading: Given Immediate Effect Roll Call # 404",70,38,0,0,108
1874127,1453229,2024-06-04,House,"Reported With Recommendation With Substitute H-1",8,0,0,0,8
1874127,1469314,2024-11-13,House,"House Third Reading: Given Immediate Effect Roll Call # 345",74,35,0,0,109
1874127,1470320,2024-12-11,Senate,"Reported Favorably Without Amendment",8,1,0,0,9
1874143,1469701,2024-12-04,House,"Reported With Recommendation Without Amendment",11,0,0,0,11
1874219,1445385,2024-05-21,Senate,"Reported Favorably With Substitute S-1",7,0,0,0,7
1874219,1453273,2024-06-04,Senate,"Senate Third Reading: Passed Roll Call # 208",38,0,0,0,38
1874219,1457013,2024-06-12,House,"Reported With Recommendation Without Amendment",13,0,0,0,13
1874219,1457108,2024-06-13,House,"House Third Reading: Given Immediate Effect Roll Call # 176",109,0,0,0,109
1874234,1445410,2024-05-21,Senate,"Reported Favorably Without Amendment",7,0,0,0,7
1874234,1453272,2024-06-04,Senate,"Senate Third Reading: Passed Roll Call # 209",38,0,0,0,38
1874234,1457006,2024-06-12,House,"Reported With Recommendation Without Amendment",13,0,0,0,13
1874234,1457099,2024-06-13,House,"House Third Reading: Given Immediate Effect Roll Call # 177",109,0,0,0,109
1874253,1445789,2024-05-21,Senate,"Reported Favorably Without Amendment",7,0,0,0,7
1874253,1453149,2024-06-04,Senate,"Senate Third Reading: Passed Roll Call # 210",38,0,0,0,38
1874253,1457004,2024-06-12,House,"Reported With Recommendation Without Amendment",13,0,0,0,13
1874253,1457098,2024-06-13,House,"House Third Reading: Given Immediate Effect Roll Call # 178",109,0,0,0,109
1874326,1469946,2024-12-10,House,"House Third Reading: Given Immediate Effect Roll Call # 391",89,19,0,0,108
1874339,1469986,2024-12-10,House,"House Third Reading: Given Immediate Effect Roll Call # 392",89,19,0,0,108
1874504,1458149,2024-06-18,House,"Reported With Recommendation With Substitute H-1",14,0,0,0,14
1874504,1461395,2024-06-26,House,"House Third Reading: Given Immediate Effect Roll Call # 256",106,4,0,0,110
1874511,1454051,2024-06-05,House,"Reported With Recommendation With Substitute H-1",17,0,0,0,17
1874511,1467608,2024-09-25,House,"House Third Reading: Given Immediate Effect Roll Call # 318",103,6,0,0,109
1874545,1458319,2024-06-18,House,"Reported With Recommendation With Substitute H-1",14,0,0,0,14
1874545,1461354,2024-06-26,House,"House Third Reading: Given Immediate Effect Roll Call # 257",98,12,0,0,110
1874592,1458225,2024-06-18,House,"Reported With Recommendation Without Amendment",13,0,0,0,13
1874592,1461396,2024-06-26,House,"House Third Reading: Given Immediate Effect Roll Call # 253",107,3,0,0,110
1874592,1468873,2024-10-10,Senate,"Reported Favorably With Substitute S-1",10,0,0,0,10
1874592,1469222,2024-10-23,Senate,"Senate Third Reading: Passed Roll Call # 383",36,2,0,0,38
1874592,1469223,2024-11-12,House,"House Third Reading: Roll Call # 329",105,2,0,0,107
1874599,1458148,2024-06-18,House,"Reported With Recommendation With Substitute H-1",13,0,0,0,13
1874599,1461358,2024-06-26,House,"House Third Reading: Given Immediate Effect Roll Call # 254",106,4,0,0,110
1874599,1468634,2024-10-10,Senate,"Reported Favorably With Substitute S-2",10,0,0,0,10
1874599,1469217,2024-11-12,House,"House Third Reading: Roll Call # 330",104,3,0,0,107
1875218,1470177,2024-11-13,House,"Reported With Recommendation With Substitute H-2",9,0,0,0,9
1875218,1470178,2024-12-11,House,"House Third Reading: Given Immediate Effect Roll Call # 445",69,40,0,0,109
1875230,1453303,2024-06-04,House,"Reported With Recommendation Without Amendment",8,2,0,0,10
1875245,1449351,2024-05-23,House,"Reported With Recommendation With Substitute H-1",10,0,0,0,10
1875245,1461334,2024-06-26,House,"House Third Reading: Given Immediate Effect Roll Call # 258",104,6,0,0,110
1875367,1443100,2024-05-14,House,"Reported With Recommendation Without Amendment",6,0,0,0,6
1875367,1461319,2024-06-26,House,"House Third Reading: Given Immediate Effect Roll Call # 238",109,0,0,0,109
1875411,1443057,2024-05-14,House,"Reported With Recommendation Without Amendment",6,0,0,0,6
1875411,1461316,2024-06-26,House,"House Third Reading: Given Immediate Effect Roll Call # 240",109,0,0,0,109
1875429,1443065,2024-05-14,House,"Reported With Recommendation Without Amendment",6,0,0,0,6
1875429,1461397,2024-06-26,House,"House Third Reading: Given Immediate Effect Roll Call # 241",109,0,0,0,109
1875491,1443040,2024-05-14,House,"Reported With Recommendation Without Amendment",6,0,0,0,6
1875491,1461398,2024-06-26,House,"House Third Reading: Given Immediate Effect Roll Call # 239",109,0,0,0,109
1875588,1469598,2024-11-26,Senate,"Reported Favorably Without Amendment",4,2,0,0,6
1875617,1469513,2024-11-26,Senate,"Reported Favorably With Substitute S-1",4,2,0,0,6
1876725,1469767,2024-12-04,Senate,"Reported Favorably Without Amendment",5,2,0,0,7
1876725,1470444,2024-12-12,Senate,"Senate Third Reading: Passed Roll Call # 568",23,12,0,3,38
1876749,1468057,2024-10-02,Senate,"Reported Favorably With Substitute S-1",5,0,0,0,5
1876749,1468445,2024-10-08,Senate,"Senate Third Reading: Passed Roll Call # 370",30,6,0,2,38
1876756,1470598,2024-12-13,Senate,"Senate Third Reading: Passed Roll Call # 603",24,9,0,5,38
1876765,1469791,2024-12-04,Senate,"Reported Favorably Without Amendment",5,2,0,0,7
1876781,1469766,2024-12-04,Senate,"Reported Favorably With Substitute S-1",5,2,0,0,7
1876788,1469804,2024-12-04,Senate,"Reported Favorably Without Amendment",5,2,0,0,7
1876799,1470349,2024-12-04,House,"Reported With Recommendation Without Amendment",8,0,0,0,8
1876799,1470574,2024-12-13,House,"House Third Reading: Given Immediate Effect Roll Call # 492",56,0,0,0,56
1876851,1456135,2024-06-11,House,"Reported With Recommendation Without Amendment",13,0,0,0,13
1876851,1467610,2024-09-25,House,"House Third Reading: Given Immediate Effect Roll Call # 323",109,0,0,0,109
1876851,1469553,2024-11-26,Senate,"Reported Favorably Without Amendment",4,0,0,0,4
1876851,1469644,2024-12-04,Senate,"Senate Third Reading: Passed Roll Call # 425",36,0,0,2,38
1877287,1459867,2024-06-25,Senate,"Reported Favorably With Substitute S-1",8,0,0,0,8
1877287,1460905,2024-06-26,Senate,"Senate Third Reading: Passed Roll Call # 302",37,1,0,0,38
1877287,1468602,2024-06-26,Senate,"Senate Third Reading: Passed Roll Call # 301",37,1,0,0,38
1877287,1469589,2024-12-03,House,"Reported With Recommendation Without Amendment",10,0,0,0,10
1877297,1468712,2024-10-17,Senate,"Reported Favorably With Substitute S-2",10,0,0,0,10
1877318,1468460,2024-10-08,Senate,"Reported Favorably With Substitute S-1",5,0,0,0,5
1877318,1469145,2024-11-07,Senate,"Senate Third Reading: Passed Roll Call # 406",22,16,0,0,38
1877415,1456042,2024-06-11,House,"Reported With Recommendation Without Amendment",10,0,0,0,10
1877415,1458718,2024-06-20,House,"House Third Reading: Given Immediate Effect Roll Call # 185",106,3,0,0,109
1878148,1456990,2024-06-12,Senate,"Reported Favorably With Substitute S-1",9,0,0,0,9
1878148,1469155,2024-11-07,Senate,"Senate Third Reading: Passed Roll Call # 407",38,0,0,0,38
1878251,1456834,2024-06-12,House,"Reported With Recommendation With Substitute H-2",12,0,0,0,12
1878251,1463199,2024-06-27,House,"House Third Reading: Given Immediate Effect Roll Call # 280",81,27,0,0,108
1878251,1469058,2024-10-24,Senate,"Reported Favorably With Substitute S-3",5,2,0,0,7
1878255,1448435,2024-05-22,House,"Reported With Recommendation Without Amendment",8,2,0,0,10
1878255,1463203,2024-06-27,House,"House Third Reading: Given Immediate Effect Roll Call # 287",60,50,0,0,110
1878873,1453248,2024-06-04,House,"Reported With Recommendation Without Amendment",9,2,0,0,11
1878873,1463200,2024-06-27,House,"House Third Reading: Given Immediate Effect Roll Call # 260",69,39,0,0,108
1878873,1463201,2024-06-27,House,"House Third Reading: Given Immediate Effect Roll Call # 271",70,40,0,0,110
1878932,1458147,2024-06-18,House,"Reported With Recommendation Without Amendment",13,0,0,0,13
1879791,1469593,2024-12-03,House,"Reported With Recommendation Without Amendment",8,2,0,0,10
1879791,1470589,2024-12-13,House,"House Third Reading: Given Immediate Effect Roll Call # 523",56,0,0,0,56
1879813,1458723,2024-06-20,House,"Reported With Recommendation With Substitute H-2",6,0,0,0,6
1879813,1463264,2024-06-27,House,"House Third Reading: Given Immediate Effect Roll Call # 276",56,54,0,0,110
1879813,1469992,2024-12-10,Senate,"Reported Favorably Without Amendment",5,1,0,0,6
1879813,1470120,2024-12-11,Senate,"Senate Third Reading: Passed Roll Call # 497",20,16,0,2,38
1879886,1460901,2024-06-26,Senate,"Senate Third Reading: Passed Roll Call # 316",28,10,0,0,38
1879886,1469370,2024-11-13,House,"Reported With Recommendation Without Amendment",10,0,0,0,10
1879886,1469950,2024-12-10,House,"House Third Reading: Given Immediate Effect Roll Call # 386",58,49,0,0,107
1879890,1454514,2024-06-06,Senate,"Reported Favorably With Substitute S-1",10,0,0,0,10
1879890,1457465,2024-06-12,Senate,"Senate Third Reading: Passed Roll Call # 244",38,0,0,0,38
1879890,1467255,2024-06-20,House,"House Third Reading: Given Immediate Effect Roll Call # 210",109,0,0,0,109
1879904,1468053,2024-10-02,Senate,"Reported Favorably Without Amendment",6,0,0,0,6
1879904,1468396,2024-10-08,Senate,"Senate Third Reading: Passed Roll Call # 371",36,0,0,2,38
1879909,1461018,2024-06-26,Senate,"Senate Third Reading: Passed Roll Call # 315",28,10,0,0,38
1879909,1469308,2024-11-13,House,"Reported With Recommendation With Substitute H-1",9,0,0,0,9
1879909,1470071,2024-12-10,House,"House Third Reading: Given Immediate Effect Roll Call # 385",56,52,0,0,108
1879909,1470148,2024-12-11,Senate,"Senate Third Reading: Roll Call: Roll Call # 502",25,11,0,2,38
1879933,1449332,2024-05-23,House,"Reported With Recommendation With Substitute H-1",8,0,0,0,8
1879933,1456158,2024-06-11,House,"House Third Reading: Given Immediate Effect Roll Call # 152",109,0,0,0,109
1879933,1461107,2024-06-26,Senate,"Senate Third Reading: Given Immediate Effect Roll Call # 313",38,0,0,0,38
1880148,1470036,2024-12-04,House,"Reported With Recommendation With Substitute H-2",13,0,0,0,13
1880148,1470222,2024-12-11,House,"House Third Reading: Given Immediate Effect Roll Call # 414",97,12,0,0,109
1880159,1469705,2024-12-04,House,"Reported With Recommendation Without Amendment",13,0,0,0,13
1880159,1470286,2024-12-11,House,"House Third Reading: Given Immediate Effect Roll Call # 415",99,10,0,0,109
1880166,1470010,2024-12-04,House,"Reported With Recommendation Without Amendment",13,0,0,0,13
1880166,1470216,2024-12-11,House,"House Third Reading: Given Immediate Effect Roll Call # 416",105,4,0,0,109
1880177,1456612,2024-06-11,House,"House Third Reading: Given Immediate Effect Roll Call # 156",99,10,0,0,109
1880177,1469231,2024-10-17,Senate,"Reported Favorably Without Amendment",10,0,0,0,10
1880177,1470023,2024-12-10,Senate,"Senate Third Reading: Passed Roll Call # 471",37,0,0,1,38
1880823,1468700,2024-10-17,Senate,"Reported Favorably With Substitute S-1",10,0,0,0,10
1880826,1470754,2024-12-12,Senate,"Senate Third Reading: Passed Roll Call # 542",20,15,0,3,38
1880837,1470782,2024-12-12,Senate,"Reported Favorably With Substitute S-1",4,0,0,0,4
1880849,1469265,2024-11-13,Senate,"Reported Favorably Without Amendment",8,0,0,0,8
1880867,1456124,2024-06-11,House,"Reported With Recommendation With Substitute H-2",8,3,0,0,11
1880871,1456128,2024-06-11,House,"Reported With Recommendation Without Amendment",8,3,0,0,11
1880884,1456141,2024-06-11,House,"Reported With Recommendation Without Amendment",8,3,0,0,11
1880903,1470096,2024-12-10,House,"Reported With Recommendation With Substitute H-1",8,5,0,0,13
1881374,1460992,2024-06-26,Senate,"Senate Third Reading: Passed Roll Call # 317",20,18,0,0,38
1881374,1460993,2024-06-26,Senate,"Senate Third Reading: Passed Roll Call # 318",20,18,0,0,38
1881374,1469361,2024-11-14,House,"Reported With Recommendation Without Amendment",7,3,0,0,10
1881553,1468456,2024-10-09,Senate,"Reported Favorably With Substitute S-1",5,2,0,0,7
1881589,1469755,2024-11-12,House,"Reported With Recommendation Without Amendment",10,0,0,0,10
1881589,1471018,2024-12-19,Senate,"Senate Third Reading: Passed Roll Call # 634",38,0,0,0,38
1881597,1469259,2024-11-13,House,"Reported With Recommendation Without Amendment",14,0,0,0,14
1881597,1470991,2024-12-19,Senate,"Senate Third Reading: Passed Roll Call # 635",38,0,0,0,38
1881607,1470122,2024-12-10,House,"Reported With Recommendation With Substitute H-1",13,0,0,0,13
1881607,1470322,2024-12-12,House,"House Third Reading: Given Immediate Effect Roll Call # 479",91,18,0,0,109
1881618,1458122,2024-06-18,House,"Reported With Recommendation With Substitute H-1",8,0,0,0,8
1881618,1458713,2024-06-20,House,"House Third Reading: Given Immediate Effect Roll Call # 208",56,25,0,0,81
1881618,1467570,2024-09-25,Senate,"Senate Third Reading: Passed Roll Call # 344",20,18,0,0,38
1881686,1456790,2024-06-12,Senate,"Reported Favorably Without Amendment",5,0,0,0,5
1881686,1458636,2024-06-20,Senate,"Senate Third Reading: Passed Roll Call # 254",21,17,0,0,38
1881744,1470334,2024-12-12,House,"House Third Reading: Given Immediate Effect Roll Call # 464",56,53,0,0,109
1881797,1458124,2024-06-18,House,"Reported With Recommendation Without Amendment",10,0,0,0,10
1881797,1469975,2024-12-10,House,"House Third Reading: Given Immediate Effect Roll Call # 397",100,8,0,0,108
1881831,1469215,2024-11-12,House,"Reported With Recommendation Without Amendment",15,0,0,0,15
1881831,1469977,2024-12-10,House,"House Third Reading: Given Immediate Effect Roll Call # 410",105,3,0,0,108
1882088,1459799,2024-06-25,Senate,"Reported Favorably Without Amendment",8,0,0,0,8
1882088,1460896,2024-06-26,Senate,"Senate Third Reading: Passed Roll Call # 294",38,0,0,0,38
1882088,1470006,2024-12-10,House,"Reported With Recommendation Without Amendment",15,0,0,0,15
1882090,1459803,2024-06-25,Senate,"Reported Favorably Without Amendment",8,0,0,0,8
1882090,1460958,2024-06-26,Senate,"Senate Third Reading: Passed Roll Call # 293",38,0,0,0,38
1882090,1470015,2024-12-10,House,"Reported With Recommendation Without Amendment",14,0,0,0,14
1882098,1459878,2024-06-25,Senate,"Reported Favorably Without Amendment",8,0,0,0,8
1882098,1460885,2024-06-26,Senate,"Senate Third Reading: Passed Roll Call # 292",38,0,0,0,38
1882124,1460136,2024-06-25,House,"House Third Reading: Given Immediate Effect Roll Call # 211",56,52,0,0,108
1882124,1467605,2024-09-25,Senate,"Senate Third Reading: Defeated Roll Call # 348",19,18,1,0,38
1882124,1467606,2024-09-25,Senate,"Senate Third Reading: Passed Roll Call # 349",20,18,0,0,38
1882124,1467607,2024-09-25,House,"House Third Reading: Roll Call # 308",56,52,0,0,108
1882184,1458726,2024-06-20,Senate,"Senate Third Reading: Passed Roll Call # 270",20,17,1,0,38
1882184,1461411,2024-06-27,House,"House Third Reading: Given Immediate Effect Roll Call # 270",56,54,0,0,110
1882184,1467380,2024-09-17,Senate,"Senate Third Reading: Roll Call: Roll Call # 341",20,16,0,2,38
1882201,1469237,2024-10-31,Senate,"Reported Favorably With Substitute S-1",10,0,0,0,10
1882201,1469671,2024-12-04,Senate,"Senate Third Reading: Passed Roll Call # 431",36,0,0,2,38
1882204,1469248,2024-10-31,Senate,"Reported Favorably With Substitute S-1",10,0,0,0,10
1882204,1469662,2024-12-04,Senate,"Senate Third Reading: Passed Roll Call # 429",36,0,0,2,38
1882210,1469225,2024-10-31,Senate,"Reported Favorably With Substitute S-1",10,0,0,0,10
1882210,1469667,2024-12-04,Senate,"Senate Third Reading: Passed Roll Call # 430",36,0,0,2,38
1882225,1469226,2024-10-31,Senate,"Reported Favorably With Substitute S-1",10,0,0,0,10
1882225,1469647,2024-12-04,Senate,"Senate Third Reading: Passed Roll Call # 432",36,0,0,2,38
1882229,1469703,2024-12-04,Senate,"Reported Favorably Without Amendment",7,0,0,0,7
1882229,1469839,2024-12-05,Senate,"Senate Third Reading: Passed Roll Call # 455",36,0,0,2,38
1882282,1469220,2024-11-12,House,"Reported With Recommendation With Substitute H-2",6,0,0,0,6
1882376,1458722,2024-06-20,Senate,"Senate Third Reading: Passed Roll Call # 259",20,18,0,0,38
1882380,1458737,2024-06-20,Senate,"Senate Third Reading: Passed Roll Call # 265",21,17,0,0,38
1882380,1467580,2024-09-25,House,"Reported With Recommendation Without Amendment",17,10,0,0,27
1882380,1467581,2024-09-25,House,"House Third Reading: Given Immediate Effect Roll Call # 300",58,51,0,0,109
1882382,1468586,2024-10-03,Senate,"Reported Favorably Without Amendment",7,0,0,0,7
1882382,1468697,2024-10-16,Senate,"Senate Third Reading: Passed Roll Call # 376",38,0,0,0,38
1882384,1458752,2024-06-20,Senate,"Senate Third Reading: Passed Roll Call # 261",20,18,0,0,38
1882384,1467616,2024-09-25,House,"Reported With Recommendation With Substitute H-1",17,10,0,0,27
1882384,1467617,2024-09-25,House,"House Third Reading: Given Immediate Effect Roll Call # 305",56,53,0,0,109
1882384,1467639,2024-09-26,Senate,"Senate Third Reading: Roll Call: Roll Call # 365",20,17,0,1,38
1882386,1458750,2024-06-20,Senate,"Senate Third Reading: Passed Roll Call # 264",20,18,0,0,38
1882386,1467577,2024-09-25,House,"Reported With Recommendation Without Amendment",17,10,0,0,27
1882386,1467578,2024-09-25,House,"House Third Reading: Given Immediate Effect Roll Call # 301",58,51,0,0,109
1882389,1470391,2024-10-31,Senate,"Reported Favorably Without Amendment",8,3,0,0,11
1882391,1458731,2024-06-20,Senate,"Senate Third Reading: Passed Roll Call # 260",20,18,0,0,38
1882391,1467568,2024-09-25,House,"Reported With Recommendation Without Amendment",17,10,0,0,27
1882391,1467569,2024-09-25,House,"House Third Reading: Given Immediate Effect Roll Call # 304",56,53,0,0,109
1882394,1458763,2024-06-20,Senate,"Senate Third Reading: Passed Roll Call # 266",20,18,0,0,38
1882394,1467588,2024-09-25,House,"Reported With Recommendation Without Amendment",18,0,0,0,18
1882394,1467589,2024-09-25,House,"House Third Reading: Given Immediate Effect Roll Call # 312",58,51,0,0,109
1882398,1459875,2024-06-25,Senate,"Reported Favorably With Substitute S-1",8,0,0,0,8
1882398,1460888,2024-06-26,Senate,"Senate Third Reading: Passed Roll Call # 295",38,0,0,0,38
1882400,1468583,2024-10-03,Senate,"Reported Favorably With Substitute S-1",7,0,0,0,7
1882400,1468684,2024-10-16,Senate,"Senate Third Reading: Passed Roll Call # 373",25,13,0,0,38
1882401,1468585,2024-10-03,Senate,"Reported Favorably Without Amendment",7,0,0,0,7
1882401,1468696,2024-10-16,Senate,"Senate Third Reading: Passed Roll Call # 375",38,0,0,0,38
1882401,1470009,2024-12-10,House,"Reported With Recommendation Without Amendment",6,4,0,0,10
1882403,1468584,2024-10-03,Senate,"Reported Favorably Without Amendment",7,0,0,0,7
1882403,1468702,2024-10-16,Senate,"Senate Third Reading: Passed Roll Call # 374",38,0,0,0,38
1882403,1470100,2024-12-10,House,"Reported With Recommendation Without Amendment",6,4,0,0,10
1882409,1458662,2024-06-20,Senate,"Senate Third Reading: Passed Roll Call # 263",20,18,0,0,38
1882409,1458663,2024-06-20,Senate,"Senate Third Reading: Passed Roll Call # 263",20,18,0,0,38
1882409,1467584,2024-09-25,House,"Reported With Recommendation Without Amendment",17,12,0,0,29
1882409,1467585,2024-09-25,House,"House Third Reading: Given Immediate Effect Roll Call # 307",56,53,0,0,109
1882411,1458749,2024-06-20,Senate,"Senate Third Reading: Passed Roll Call # 258",20,18,0,0,38
1882411,1467586,2024-09-25,House,"Reported With Recommendation Without Amendment",17,10,0,0,27
1882411,1467587,2024-09-25,House,"House Third Reading: Given Immediate Effect Roll Call # 298",58,51,0,0,109
1882412,1458762,2024-06-20,Senate,"Senate Third Reading: Passed Roll Call # 262",20,18,0,0,38
1882412,1467582,2024-09-25,House,"Reported With Recommendation With Substitute H-1",17,2,0,0,19
1882412,1467583,2024-09-25,House,"House Third Reading: Given Immediate Effect Roll Call # 299",61,48,0,0,109
1882412,1468606,2024-09-26,Senate,"Senate Third Reading: Roll Call: Roll Call # 366",20,17,0,1,38
1882457,1458083,2024-06-18,House,"Reported With Recommendation Without Amendment",9,1,0,0,10
1882457,1463260,2024-06-27,House,"House Third Reading: Given Immediate Effect Roll Call # 267",56,54,0,0,110
1882457,1470652,2024-11-26,Senate,"Reported Favorably Without Amendment",6,1,0,0,7
1882475,1458084,2024-06-18,House,"Reported With Recommendation Without Amendment",9,1,0,0,10
1882475,1461766,2024-06-27,House,"House Third Reading: Given Immediate Effect Roll Call # 268",56,54,0,0,110
1882475,1470698,2024-11-26,Senate,"Reported Favorably Without Amendment",6,1,0,0,7
1882698,1461762,2024-06-27,House,"House Third Reading: Given Immediate Effect Roll Call # 296",58,52,0,0,110
1882698,1468807,2024-10-17,Senate,"Reported Favorably With Substitute S-1",9,2,0,0,11
1882698,1469914,2024-12-03,Senate,"Senate Third Reading: Passed Roll Call # 424",22,15,0,1,38
1882698,1469955,2024-12-10,House,"House Third Reading: Roll Call # 401",56,51,0,0,107
1882708,1469951,2024-11-14,House,"Reported With Recommendation Without Amendment",9,1,0,0,10
1882708,1469999,2024-12-10,House,"House Third Reading: Given Immediate Effect Roll Call # 406",56,52,0,0,108
1882968,1470268,2024-10-31,Senate,"Reported Favorably Without Amendment",7,0,0,0,7
1882968,1470269,2024-12-11,Senate,"Senate Third Reading: Passed Roll Call # 499",33,3,0,2,38
1882992,1461413,2024-06-26,House,"House Third Reading: Given Immediate Effect Roll Call # 224",56,54,0,0,110
1883255,1470154,2024-12-11,Senate,"Reported Favorably With Substitute S-1",10,4,0,0,14
1883314,1470029,2024-11-13,House,"Reported With Recommendation Without Amendment",12,0,0,0,12
1883314,1470109,2024-12-11,House,"House Third Reading: Given Immediate Effect Roll Call # 427",56,53,0,0,109
1883315,1470039,2024-11-13,House,"Reported With Recommendation Without Amendment",12,0,0,0,12
1883315,1470116,2024-12-11,House,"House Third Reading: Given Immediate Effect Roll Call # 425",56,53,0,0,109
1883316,1470001,2024-11-13,House,"Reported With Recommendation With Substitute H-2",12,0,0,0,12
1883316,1470129,2024-12-11,House,"House Third Reading: Given Immediate Effect Roll Call # 424",56,53,0,0,109
1883317,1470392,2024-12-11,House,"House Third Reading: Given Immediate Effect Roll Call # 435",56,53,0,0,109
1883318,1469278,2024-11-13,House,"Reported With Recommendation Without Amendment",12,0,0,0,12
1883318,1470118,2024-12-11,House,"House Third Reading: Given Immediate Effect Roll Call # 428",56,53,0,0,109
1883320,1470136,2024-11-13,House,"Reported With Recommendation Without Amendment",12,0,0,0,12
1883320,1470137,2024-12-11,House,"House Third Reading: Given Immediate Effect Roll Call # 423",61,48,0,0,109
1883321,1470030,2024-11-13,House,"Reported With Recommendation Without Amendment",12,0,0,0,12
1883321,1470112,2024-12-11,House,"House Third Reading: Given Immediate Effect Roll Call # 426",56,53,0,0,109
1883322,1470130,2024-12-11,House,"House Third Reading: Given Immediate Effect Roll Call # 436",56,53,0,0,109
1883323,1470164,2024-12-11,House,"House Third Reading: Given Immediate Effect Roll Call # 431",56,53,0,0,109
1883325,1470174,2024-12-11,House,"House Third Reading: Given Immediate Effect Roll Call # 433",56,53,0,0,109
1883326,1470021,2024-12-04,House,"Reported With Recommendation Without Amendment",13,0,0,0,13
1883326,1470230,2024-12-11,House,"House Third Reading: Given Immediate Effect Roll Call # 420",58,51,0,0,109
1883327,1470153,2024-12-11,House,"House Third Reading: Given Immediate Effect Roll Call # 432",59,50,0,0,109
1883329,1469921,2024-11-13,House,"Reported With Recommendation Without Amendment",9,0,0,0,9
1883329,1469995,2024-12-10,House,"House Third Reading: Given Immediate Effect Roll Call # 403",99,9,0,0,108
1883330,1470114,2024-12-11,House,"House Third Reading: Given Immediate Effect Roll Call # 430",58,51,0,0,109
1883331,1470108,2024-12-11,House,"House Third Reading: Given Immediate Effect Roll Call # 429",56,53,0,0,109
1883332,1470219,2024-12-11,House,"House Third Reading: Given Immediate Effect Roll Call # 434",56,53,0,0,109
1883333,1469909,2024-11-13,House,"Reported With Recommendation With Substitute H-1",9,0,0,0,9
1883333,1469988,2024-12-10,House,"House Third Reading: Given Immediate Effect Roll Call # 402",99,8,0,0,107
1883335,1470352,2024-12-03,House,"Reported With Recommendation Without Amendment",10,0,0,0,10
1883335,1470694,2024-12-13,House,"House Third Reading: Given Immediate Effect Roll Call # 490",56,0,0,0,56
1883338,1469263,2024-11-13,House,"Reported With Recommendation Without Amendment",12,0,0,0,12
1883340,1469267,2024-11-13,House,"Reported With Recommendation With Substitute H-1",12,0,0,0,12
1883340,1470155,2024-12-11,House,"House Third Reading: Given Immediate Effect Roll Call # 419",57,52,0,0,109
1883341,1470150,2024-11-13,House,"Reported With Recommendation With Substitute H-1",9,2,0,0,11
1883341,1470324,2024-12-12,House,"House Third Reading: Given Immediate Effect Roll Call # 452",56,53,0,0,109
1883342,1469333,2024-11-13,House,"Reported With Recommendation Without Amendment",12,0,0,0,12
1883342,1470156,2024-12-11,House,"House Third Reading: Given Immediate Effect Roll Call # 418",58,51,0,0,109
1883481,1470145,2024-12-11,House,"House Third Reading: Given Immediate Effect Roll Call # 437",56,53,0,0,109
1883491,1470781,2024-12-12,Senate,"Reported Favorably Without Amendment",4,0,0,0,4
1883493,1468704,2024-10-17,Senate,"Reported Favorably Without Amendment",3,1,0,0,4
1883493,1469149,2024-11-07,Senate,"Senate Third Reading: Passed Roll Call # 408",20,18,0,0,38
1883493,1469344,2024-11-14,House,"Reported With Recommendation Without Amendment",7,3,0,0,10
1883496,1468703,2024-10-17,Senate,"Reported Favorably With Substitute S-1",3,0,0,0,3
1883496,1469154,2024-11-07,Senate,"Senate Third Reading: Passed Roll Call # 410",20,18,0,0,38
1883502,1470192,2024-12-05,Senate,"Reported Favorably With Substitute S-1",5,2,0,0,7
1883504,1469543,2024-11-26,Senate,"Reported Favorably With Substitute S-1",4,2,0,0,6
1883504,1470785,2024-12-13,Senate,"Senate Third Reading: Passed Roll Call # 583",20,13,0,5,38
1883505,1469780,2024-11-26,Senate,"Reported Favorably With Substitute S-1",4,2,0,0,6
1883508,1469117,2024-10-17,Senate,"Reported Favorably With Substitute S-1",3,1,0,0,4
1883508,1469151,2024-11-07,Senate,"Senate Third Reading: Passed Roll Call # 409",20,18,0,0,38
1883508,1469360,2024-11-14,House,"Reported With Recommendation Without Amendment",7,3,0,0,10
1883515,1470228,2024-12-11,Senate,"Reported Favorably Without Amendment",5,2,0,0,7
1883515,1470552,2024-12-12,Senate,"Senate Third Reading: Passed Roll Call # 560",23,12,0,3,38
1883517,1469548,2024-11-26,Senate,"Reported Favorably With Substitute S-1",4,2,0,0,6
1883521,1470769,2024-12-12,Senate,"Reported Favorably Without Amendment",4,0,0,0,4
1883523,1470676,2024-12-13,Senate,"Senate Third Reading: Passed Roll Call # 579",33,0,0,5,38
1883526,1470473,2024-12-12,Senate,"Reported Favorably With Substitute S-2",4,0,0,0,4
1883526,1470474,2024-12-12,Senate,"Senate Third Reading: Passed Roll Call # 554",23,12,0,3,38
1883528,1470462,2024-12-12,Senate,"Reported Favorably Without Amendment",4,0,0,0,4
1883531,1469335,2024-11-14,Senate,"Reported Favorably With Substitute S-2",3,1,0,0,4
1883531,1469989,2024-12-10,House,"House Third Reading: Given Immediate Effect Roll Call # 380",56,53,0,0,109
1883534,1469820,2024-11-26,Senate,"Reported Favorably With Substitute S-1",4,2,0,0,6
1883536,1470276,2024-12-05,Senate,"Reported Favorably With Substitute S-1",5,2,0,0,7
1883537,1470265,2024-12-05,Senate,"Reported Favorably With Substitute S-1",5,2,0,0,7
1883544,1469916,2024-12-04,House,"Reported With Recommendation Without Amendment",8,1,0,0,9
1883544,1469990,2024-12-10,House,"House Third Reading: Given Immediate Effect Roll Call # 398",91,17,0,0,108
1883553,1470679,2024-12-10,House,"Reported With Recommendation With Substitute H-2",14,0,0,0,14
1883554,1470365,2024-12-10,House,"Reported With Recommendation With Substitute H-1",13,0,0,0,13
1883554,1470479,2024-12-13,House,"House Third Reading: Given Immediate Effect Roll Call # 486",56,0,0,0,56
1883558,1470069,2024-12-10,House,"Reported With Recommendation With Substitute H-1",13,0,0,0,13
1883558,1470493,2024-12-13,House,"House Third Reading: Given Immediate Effect Roll Call # 487",56,0,0,0,56
1883562,1470321,2024-12-12,House,"House Third Reading: Given Immediate Effect Roll Call # 468",56,53,0,0,109
1883571,1470360,2024-12-10,House,"Reported With Recommendation With Substitute H-1",13,0,0,0,13
1883571,1470503,2024-12-13,House,"House Third Reading: Given Immediate Effect Roll Call # 485",56,0,0,0,56
1883575,1469910,2024-12-04,House,"Reported With Recommendation Without Amendment",8,1,0,0,9
1883575,1470017,2024-12-10,House,"House Third Reading: Given Immediate Effect Roll Call # 399",89,19,0,0,108
1885173,1469905,2024-12-05,Senate,"Reported Favorably With Substitute S-3",9,0,0,0,9
1885173,1470095,2024-12-11,Senate,"Senate Third Reading: Passed Roll Call # 480",27,9,0,2,38
1885175,1469844,2024-12-05,Senate,"Reported Favorably With Substitute S-1",9,0,0,0,9
1885175,1470062,2024-12-11,Senate,"Senate Third Reading: Passed Roll Call # 481",27,9,0,2,38
1885180,1469784,2024-11-14,Senate,"Reported Favorably With Substitute S-2",3,1,0,0,4
1885180,1469964,2024-12-10,House,"House Third Reading: Given Immediate Effect Roll Call # 382",56,53,0,0,109
1885180,1471016,2024-12-19,Senate,"Senate Third Reading: Roll Call: Roll Call # 624",21,17,0,0,38
1885186,1470580,2024-12-13,Senate,"Senate Third Reading: Passed Roll Call # 589",23,10,0,5,38
1885188,1469757,2024-11-14,Senate,"Reported Favorably With Substitute S-1",3,1,0,0,4
1885188,1470065,2024-12-10,House,"House Third Reading: Given Immediate Effect Roll Call # 381",56,53,0,0,109
1885196,1470077,2024-12-10,House,"Reported With Recommendation With Substitute H-3",7,5,0,0,12
1885196,1470509,2024-12-13,House,"House Third Reading: Given Immediate Effect Roll Call # 527",56,0,0,0,56
1885207,1470362,2024-12-10,House,"Reported With Recommendation With Substitute H-2",7,5,0,0,12
1885207,1470561,2024-12-13,House,"House Third Reading: Given Immediate Effect Roll Call # 526",56,0,0,0,56
1885221,1470008,2024-12-10,House,"Reported With Recommendation With Substitute H-2",7,5,0,0,12
1885221,1470536,2024-12-13,House,"House Third Reading: Given Immediate Effect Roll Call # 525",56,0,0,0,56
1885805,1469221,2024-11-12,House,"Reported With Recommendation Without Amendment",15,0,0,0,15
1885805,1469350,2024-11-14,House,"House Third Reading: Given Immediate Effect Roll Call # 362",95,7,0,0,102
1885807,1469331,2024-11-12,House,"Reported With Recommendation Without Amendment",15,0,0,0,15
1885807,1469368,2024-11-14,House,"House Third Reading: Given Immediate Effect Roll Call # 361",95,7,0,0,102
1885810,1469348,2024-11-12,House,"Reported With Recommendation Without Amendment",15,0,0,0,15
1885810,1469349,2024-11-14,House,"House Third Reading: Given Immediate Effect Roll Call # 360",95,7,0,0,102
1885815,1469351,2024-11-12,House,"Reported With Recommendation Without Amendment",15,0,0,0,15
1885815,1469352,2024-11-14,House,"House Third Reading: Given Immediate Effect Roll Call # 363",96,6,0,0,102
1885853,1469112,2024-10-24,Senate,"Reported Favorably Without Amendment",10,0,0,0,10
1885853,1469139,2024-10-30,Senate,"Senate Third Reading: Passed Roll Call # 401",37,0,0,1,38
1885853,1469281,2024-11-13,House,"Reported With Recommendation Without Amendment",5,0,0,0,5
1885853,1469762,2024-12-04,House,"House Third Reading: Given Immediate Effect Roll Call # 372",104,1,0,0,105
1885855,1467472,2024-09-19,Senate,"Reported Favorably Without Amendment",4,0,0,0,4
1885855,1467611,2024-09-25,Senate,"Senate Third Reading: Passed Roll Call # 346",38,0,0,0,38
1885856,1468966,2024-10-24,Senate,"Reported Favorably With Substitute S-1",10,0,0,0,10
1885856,1469121,2024-10-30,Senate,"Senate Third Reading: Passed Roll Call # 399",37,0,0,1,38
1885856,1469678,2024-11-13,House,"Reported With Recommendation Without Amendment",5,0,0,0,5
1885856,1469679,2024-12-04,House,"House Third Reading: Given Immediate Effect Roll Call # 370",104,1,0,0,105
1885857,1468890,2024-10-17,Senate,"Reported Favorably Without Amendment",10,0,0,0,10
1885858,1469334,2024-11-14,Senate,"Reported Favorably With Substitute S-2",3,1,0,0,4
1885858,1469958,2024-12-10,House,"House Third Reading: Given Immediate Effect Roll Call # 383",56,53,0,0,109
1885859,1467473,2024-09-19,Senate,"Reported Favorably Without Amendment",4,0,0,0,4
1885859,1467563,2024-09-25,Senate,"Senate Third Reading: Passed Roll Call # 345",38,0,0,0,38
1885860,1468643,2024-10-10,Senate,"Reported Favorably Without Amendment",10,0,0,0,10
1885861,1469114,2024-10-24,Senate,"Reported Favorably Without Amendment",10,0,0,0,10
1885861,1469140,2024-10-30,Senate,"Senate Third Reading: Passed Roll Call # 400",37,0,0,1,38
1885861,1469654,2024-11-13,House,"Reported With Recommendation Without Amendment",5,0,0,0,5
1885861,1469736,2024-12-04,House,"House Third Reading: Given Immediate Effect Roll Call # 371",104,1,0,0,105
1886822,1469042,2024-10-24,Senate,"Reported Favorably Without Amendment",5,0,0,0,5
1886822,1470983,2024-12-12,Senate,"Senate Third Reading: Passed Roll Call # 566",35,0,0,3,38
1886850,1469915,2024-12-05,Senate,"Reported Favorably With Substitute S-1",9,0,0,0,9
1886850,1470110,2024-12-11,Senate,"Senate Third Reading: Passed Roll Call # 482",35,1,0,2,38
1886856,1470319,2024-12-12,House,"Reported With Recommendation With Substitute H-1",6,2,0,0,8
1886870,1467571,2024-09-25,House,"House Third Reading: Given Immediate Effect Roll Call # 321",96,13,0,0,109
1886870,1468948,2024-10-17,Senate,"Reported Favorably Without Amendment",10,0,0,0,10
1886870,1469960,2024-12-10,Senate,"Senate Third Reading: Passed Roll Call # 469",37,0,0,1,38
1886877,1467599,2024-09-25,House,"Reported With Recommendation Without Amendment",17,12,0,0,29
1886882,1469383,2024-11-12,House,"Reported With Recommendation With Substitute H-1",13,0,0,0,13
1887306,1470295,2024-11-13,Senate,"Reported Favorably Without Amendment",8,1,0,0,9
1887311,1468711,2024-10-17,Senate,"Reported Favorably Without Amendment",19,0,0,0,19
1887314,1468895,2024-10-17,Senate,"Reported Favorably Without Amendment",19,0,0,0,19
1887323,1468906,2024-10-17,Senate,"Reported Favorably Without Amendment",19,0,0,0,19
1887323,1469801,2024-11-13,House,"Reported With Recommendation Without Amendment",14,0,0,0,14
1887330,1470490,2024-12-13,House,"House Third Reading: Given Immediate Effect Roll Call # 515",56,0,0,0,56
1887333,1470289,2024-12-10,House,"Reported With Recommendation With Substitute H-2",11,0,0,0,11
1887333,1470363,2024-12-12,House,"House Third Reading: Given Immediate Effect Roll Call # 473",80,29,0,0,109
1887335,1470515,2024-12-13,House,"House Third Reading: Given Immediate Effect Roll Call # 514",56,0,0,0,56
1887337,1470351,2024-12-04,House,"Reported With Recommendation Without Amendment",8,4,0,0,12
1887337,1470548,2024-12-13,House,"House Third Reading: Given Immediate Effect Roll Call # 509",56,0,0,0,56
1887481,1469279,2024-10-17,Senate,"Reported Favorably Without Amendment",10,0,0,0,10
1887488,1469362,2024-11-13,Senate,"Reported Favorably Without Amendment",9,0,0,0,9
1887500,1469620,2024-11-13,Senate,"Reported Favorably Without Amendment",9,0,0,0,9
1887506,1469635,2024-11-13,Senate,"Reported Favorably Without Amendment",9,0,0,0,9
1887852,1470066,2024-12-03,House,"Reported With Recommendation With Substitute H-2",7,1,0,0,8
1887852,1470696,2024-12-11,House,"House Third Reading: Given Immediate Effect Roll Call # 417",56,53,0,0,109
1887959,1469213,2024-11-12,House,"Reported With Recommendation Without Amendment",15,0,0,0,15
1887959,1469339,2024-11-14,House,"House Third Reading: Given Immediate Effect Roll Call # 358",101,1,0,0,102
1887959,1470632,2024-12-11,Senate,"Reported Favorably Without Amendment",10,0,0,0,10
1887959,1471022,2024-12-19,Senate,"Senate Third Reading: Passed Roll Call # 638",33,5,0,0,38
1887960,1469587,2024-12-03,House,"Reported With Recommendation With Substitute H-2",6,0,0,0,6
1887960,1470147,2024-12-11,House,"House Third Reading: Given Immediate Effect Roll Call # 444",91,18,0,0,109
1887966,1470382,2024-12-10,House,"Reported With Recommendation Without Amendment",6,4,0,0,10
1887966,1470507,2024-12-13,House,"House Third Reading: Given Immediate Effect Roll Call # 533",56,0,0,0,56
1887973,1470350,2024-12-10,House,"Reported With Recommendation Without Amendment",8,3,0,0,11
1887973,1470519,2024-12-13,House,"House Third Reading: Given Immediate Effect Roll Call # 537",56,0,0,0,56
1887990,1469588,2024-12-03,House,"Reported With Recommendation With Substitute H-2",6,0,0,0,6
1887990,1470226,2024-12-11,House,"House Third Reading: Given Immediate Effect Roll Call # 443",90,19,0,0,109
1887996,1470011,2024-12-10,House,"Reported With Recommendation With Substitute H-1",6,4,0,0,10
1887996,1470533,2024-12-13,House,"House Third Reading: Given Immediate Effect Roll Call # 532",56,0,0,0,56
1887997,1469340,2024-11-12,House,"Reported With Recommendation Without Amendment",15,0,0,0,15
1887997,1469374,2024-11-14,House,"House Third Reading: Given Immediate Effect Roll Call # 359",101,1,0,0,102
1887997,1470293,2024-12-11,Senate,"Reported Favorably Without Amendment",10,0,0,0,10
1887997,1471011,2024-12-19,Senate,"Senate Third Reading: Passed Roll Call # 639",33,5,0,0,38
1888003,1469343,2024-11-14,House,"Reported With Recommendation Without Amendment",9,1,0,0,10
1888003,1469984,2024-12-10,House,"House Third Reading: Given Immediate Effect Roll Call # 405",57,51,0,0,108
1888013,1469341,2024-11-12,House,"Reported With Recommendation With Substitute H-1",15,0,0,0,15
1888013,1469359,2024-11-14,House,"House Third Reading: Given Immediate Effect Roll Call # 357",101,1,0,0,102
1888013,1470259,2024-12-11,Senate,"Reported Favorably Without Amendment",10,0,0,0,10
1888013,1471001,2024-12-19,Senate,"Senate Third Reading: Passed Roll Call # 637",33,2,3,0,38
1888026,1470393,2024-12-12,House,"House Third Reading: Given Immediate Effect Roll Call # 471",105,4,0,0,109
1888030,1469617,2024-12-03,House,"Reported With Recommendation With Substitute H-2",6,0,0,0,6
1888030,1470131,2024-12-11,House,"House Third Reading: Given Immediate Effect Roll Call # 442",91,18,0,0,109
1888037,1470544,2024-12-13,House,"House Third Reading: Given Immediate Effect Roll Call # 543",56,0,0,0,56
1888048,1470978,2024-12-11,House,"Reported With Recommendation Without Amendment",8,0,0,0,8
1888053,1469688,2024-12-04,House,"Reported With Recommendation Without Amendment",8,1,0,0,9
1888062,1469996,2024-11-12,House,"Reported With Recommendation Without Amendment",10,0,0,0,10
1888062,1469997,2024-12-10,House,"House Third Reading: Given Immediate Effect Roll Call # 407",98,10,0,0,108
1888065,1470101,2024-12-10,House,"Reported With Recommendation Without Amendment",6,4,0,0,10
1888065,1470491,2024-12-13,House,"House Third Reading: Given Immediate Effect Roll Call # 531",56,0,0,0,56
1888070,1470977,2024-12-11,House,"Reported With Recommendation With Substitute H-1",8,0,0,0,8
1888082,1470081,2024-12-03,House,"Reported With Recommendation With Substitute H-1",6,0,0,0,6
1888082,1470166,2024-12-11,House,"House Third Reading: Given Immediate Effect Roll Call # 441",90,19,0,0,109
1888098,1470380,2024-12-10,House,"Reported With Recommendation With Substitute H-2",6,4,0,0,10
1888098,1470485,2024-12-13,House,"House Third Reading: Given Immediate Effect Roll Call # 530",56,0,0,0,56
1888101,1470979,2024-12-11,House,"Reported With Recommendation Without Amendment",9,0,0,0,9
1888106,1469616,2024-12-03,House,"Reported With Recommendation With Substitute H-1",6,0,0,0,6
1888690,1469569,2024-11-13,Senate,"Reported Favorably With Substitute S-1",6,1,0,0,7
1888690,1469697,2024-12-04,Senate,"Senate Third Reading: Passed Roll Call # 434",22,14,0,2,38
1888691,1470757,2024-12-13,Senate,"Senate Third Reading: Passed Roll Call # 604",26,7,0,5,38
1888692,1469747,2024-11-26,Senate,"Reported Favorably With Substitute S-1",5,2,0,0,7
1889282,1469913,2024-11-12,House,"Reported With Recommendation Without Amendment",9,0,0,0,9
1889282,1469947,2024-12-10,House,"House Third Reading: Given Immediate Effect Roll Call # 408",100,8,0,0,108
1889303,1470634,2024-12-13,Senate,"Senate Third Reading: Passed Roll Call # 606",21,12,0,5,38
1889313,1469125,2024-10-31,Senate,"Reported Favorably Without Amendment",10,0,0,0,10
1889313,1469656,2024-12-04,Senate,"Senate Third Reading: Passed Roll Call # 427",36,0,0,2,38
1889559,1469691,2024-12-04,Senate,"Reported Favorably With Substitute S-2",6,2,0,0,8
1889560,1468963,2024-10-24,Senate,"Reported Favorably Without Amendment",10,0,0,0,10
1889560,1469134,2024-10-30,Senate,"Senate Third Reading: Passed Roll Call # 402",37,0,0,1,38
1889560,1469742,2024-11-13,House,"Reported With Recommendation Without Amendment",5,0,0,0,5
1889560,1469743,2024-12-04,House,"House Third Reading: Given Immediate Effect Roll Call # 373",103,2,0,0,105
1889563,1469690,2024-12-04,Senate,"Reported Favorably With Substitute S-1",6,2,0,0,8
1889566,1469815,2024-12-05,Senate,"Reported Favorably Without Amendment",10,0,0,0,10
1889566,1469816,2024-12-05,Senate,"Senate Third Reading: Passed Roll Call # 458",20,16,0,2,38
1889828,1470678,2024-12-13,Senate,"Senate Third Reading: Passed Roll Call # 599",31,2,0,5,38
1889832,1470681,2024-12-13,Senate,"Senate Third Reading: Passed Roll Call # 597",33,0,0,5,38
1889833,1470636,2024-12-13,Senate,"Senate Third Reading: Passed Roll Call # 598",29,4,0,5,38
1889834,1470160,2024-12-11,Senate,"Reported Favorably With Substitute S-1",10,4,0,0,14
1890050,1470330,2024-11-12,House,"Reported With Recommendation With Substitute H-1",6,1,0,0,7
1890050,1470331,2024-12-11,House,"House Third Reading: Given Immediate Effect Roll Call # 448",56,53,0,0,109
1890051,1469332,2024-11-13,Senate,"Reported Favorably Without Amendment",9,0,0,0,9
1890051,1469692,2024-12-04,Senate,"Senate Third Reading: Passed Roll Call # 438",32,4,0,2,38
1890052,1469901,2024-11-26,Senate,"Reported Favorably With Substitute S-1",5,1,0,0,6
1890052,1469974,2024-12-10,Senate,"Senate Third Reading: Passed Roll Call # 468",20,17,0,1,38
1890055,1470326,2024-11-12,House,"Reported With Recommendation Without Amendment",6,1,0,0,7
1890055,1470327,2024-12-11,House,"House Third Reading: Given Immediate Effect Roll Call # 449",56,53,0,0,109
1890058,1469219,2024-11-12,House,"Reported With Recommendation Without Amendment",6,1,0,0,7
1890058,1470157,2024-12-11,House,"House Third Reading: Given Immediate Effect Roll Call # 450",56,53,0,0,109
1890059,1470379,2024-12-12,House,"Reported With Recommendation Without Amendment",6,2,0,0,8
1890065,1469689,2024-12-04,Senate,"Reported Favorably With Substitute S-1",8,3,0,0,11
1890069,1470539,2024-12-13,House,"House Third Reading: Given Immediate Effect Roll Call # 511",56,0,0,0,56
1890083,1470141,2024-12-11,Senate,"Reported Favorably Without Amendment",10,0,0,0,10
1890083,1470459,2024-12-12,Senate,"Senate Third Reading: Passed Roll Call # 526",25,11,0,2,38
1890085,1469802,2024-12-04,Senate,"Reported Favorably With Substitute S-1",6,2,0,0,8
1890087,1470306,2024-12-11,House,"Reported With Recommendation With Substitute H-2",17,11,0,0,28
1890087,1470566,2024-12-13,House,"House Third Reading: Given Immediate Effect Roll Call # 506",56,0,0,0,56
1890091,1469195,2024-11-12,House,"Reported With Recommendation Without Amendment",6,1,0,0,7
1890091,1470194,2024-12-11,House,"House Third Reading: Given Immediate Effect Roll Call # 447",56,53,0,0,109
1890093,1469675,2024-12-04,Senate,"Reported Favorably Without Amendment",6,2,0,0,8
1890097,1470635,2024-12-13,Senate,"Senate Third Reading: Passed Roll Call # 590",23,10,0,5,38
1890098,1469796,2024-12-04,Senate,"Reported Favorably Without Amendment",6,2,0,0,8
1890099,1469262,2024-11-13,Senate,"Reported Favorably Without Amendment",9,0,0,0,9
1890099,1469626,2024-12-04,Senate,"Senate Third Reading: Passed Roll Call # 437",32,4,0,2,38
1890100,1470472,2024-12-13,House,"House Third Reading: Given Immediate Effect Roll Call # 512",56,0,0,0,56
1890185,1470510,2024-12-13,House,"House Third Reading: Given Immediate Effect Roll Call # 503",56,0,0,0,56
1890212,1469971,2024-11-13,House,"Reported With Recommendation Without Amendment",9,1,0,0,10
1890212,1470046,2024-12-10,House,"House Third Reading: Given Immediate Effect Roll Call # 387",58,51,0,0,109
1890215,1470353,2024-12-12,House,"Reported With Recommendation Without Amendment",7,2,0,0,9
1890215,1470545,2024-12-13,House,"House Third Reading: Given Immediate Effect Roll Call # 524",56,0,0,0,56
1890227,1470381,2024-12-12,House,"Reported With Recommendation Without Amendment",7,2,0,0,9
1891767,1470340,2024-12-12,House,"Reported With Recommendation Without Amendment",12,0,0,0,12
1891767,1470568,2024-12-13,House,"House Third Reading: Given Immediate Effect Roll Call # 507",56,0,0,0,56
1891776,1470210,2024-12-11,Senate,"Reported Favorably Without Amendment",6,0,0,0,6
1891781,1470089,2024-12-10,Senate,"Reported Favorably With Substitute S-1",5,1,0,0,6
1891781,1470090,2024-12-11,Senate,"Senate Third Reading: Passed Roll Call # 485",20,16,0,2,38
1891783,1470125,2024-12-11,Senate,"Reported Favorably With Substitute S-2",5,0,0,0,5
1891786,1470018,2024-12-10,Senate,"Reported Favorably With Substitute S-1",5,1,0,0,6
1891786,1470104,2024-12-11,Senate,"Senate Third Reading: Passed Roll Call # 484",20,16,0,2,38
1891788,1470660,2024-12-11,Senate,"Reported Favorably With Substitute S-2",6,0,0,0,6
1891789,1470630,2024-12-11,Senate,"Reported Favorably Without Amendment",5,1,0,0,6
1891791,1470504,2024-12-12,Senate,"Reported Favorably With Substitute S-1",4,0,0,0,4
1891791,1470505,2024-12-12,Senate,"Senate Third Reading: Passed Roll Call # 507",36,0,0,2,38
1891792,1470128,2024-12-11,Senate,"Reported Favorably With Substitute S-2",5,2,0,0,7
1891792,1470627,2024-12-13,Senate,"Senate Third Reading: Passed Roll Call # 621",21,12,0,5,38
1891798,1470025,2024-12-10,Senate,"Reported Favorably With Substitute S-2",5,1,0,0,6
1891798,1470106,2024-12-11,Senate,"Senate Third Reading: Passed Roll Call # 483",20,16,0,2,38
1891804,1470315,2024-12-11,Senate,"Reported Favorably Without Amendment",5,2,0,0,7
1891806,1470775,2024-12-13,Senate,"Senate Third Reading: Passed Roll Call # 588",20,13,0,5,38
1891807,1470298,2024-12-11,Senate,"Reported Favorably Without Amendment",5,1,0,0,6
1891810,1470312,2024-12-11,Senate,"Reported Favorably With Substitute S-1",7,0,0,0,7
1891810,1470621,2024-12-13,Senate,"Senate Third Reading: Passed Roll Call # 622",21,12,0,5,38
1891814,1470344,2024-12-11,Senate,"Reported Favorably With Substitute S-2",7,0,0,0,7
1891814,1470690,2024-12-13,Senate,"Senate Third Reading: Passed Roll Call # 620",21,12,0,5,38
1891896,1470699,2024-12-12,House,"House Third Reading: Given Immediate Effect Roll Call # 453",96,12,0,0,108
1891898,1470366,2024-12-04,House,"Reported With Recommendation Without Amendment",7,1,0,0,8
1891900,1470374,2024-12-12,House,"House Third Reading: Given Immediate Effect Roll Call # 458",96,13,0,0,109
1891903,1470682,2024-12-12,House,"House Third Reading: Given Immediate Effect Roll Call # 454",96,13,0,0,109
1891910,1470389,2024-12-12,House,"House Third Reading: Given Immediate Effect Roll Call # 455",96,13,0,0,109
1891916,1470658,2024-12-12,House,"House Third Reading: Given Immediate Effect Roll Call # 456",99,10,0,0,109
1891932,1470346,2024-12-04,House,"Reported With Recommendation Without Amendment",7,1,0,0,8
1891937,1470348,2024-12-04,House,"Reported With Recommendation Without Amendment",7,1,0,0,8
1891943,1469908,2024-11-26,House,"Reported With Recommendation Without Amendment",8,3,0,0,11
1891943,1469985,2024-12-10,House,"House Third Reading: Given Immediate Effect Roll Call # 393",56,52,0,0,108
1891954,1470342,2024-12-12,House,"House Third Reading: Given Immediate Effect Roll Call # 459",96,13,0,0,109
1891956,1470338,2024-12-04,House,"Reported With Recommendation Without Amendment",7,1,0,0,8
1892002,1470563,2024-12-12,Senate,"Reported Favorably With Substitute S-1",4,0,0,0,4
1892003,1470604,2024-12-13,Senate,"Senate Third Reading: Passed Roll Call # 618",20,13,0,5,38
1892006,1470648,2024-12-13,Senate,"Senate Third Reading: Passed Roll Call # 619",20,13,0,5,38
1892007,1470987,2024-12-18,Senate,"Reported Favorably With Substitute S-1",10,0,0,0,10
1892011,1470314,2024-12-11,Senate,"Reported Favorably With Substitute S-1",6,0,0,0,6
1892019,1470549,2024-12-12,Senate,"Reported Favorably With Substitute S-1",4,0,0,0,4
1892019,1470550,2024-12-12,Senate,"Senate Third Reading: Passed Roll Call # 510",35,1,0,2,38
1892022,1470238,2024-12-11,Senate,"Reported Favorably With Substitute S-1",6,0,0,0,6
1892026,1470310,2024-12-11,Senate,"Reported Favorably With Substitute S-2",9,5,0,0,14
1892027,1470163,2024-12-11,Senate,"Reported Favorably Without Amendment",8,5,0,0,13
1892042,1470520,2024-12-12,Senate,"Senate Third Reading: Passed Roll Call # 509",35,1,0,2,38
1892113,1470000,2024-12-10,House,"Reported With Recommendation Without Amendment",7,5,0,0,12
1892123,1470357,2024-12-11,House,"Reported With Recommendation Without Amendment",11,0,0,0,11
1892123,1470518,2024-12-13,House,"House Third Reading: Given Immediate Effect Roll Call # 540",56,0,0,0,56
1892128,1470373,2024-12-11,House,"Reported With Recommendation Without Amendment",8,0,0,0,8
1892128,1470492,2024-12-13,House,"House Third Reading: Given Immediate Effect Roll Call # 541",56,0,0,0,56
1892130,1470117,2024-12-10,House,"Reported With Recommendation With Substitute H-1",6,4,0,0,10
1892130,1470354,2024-12-12,House,"House Third Reading: Given Immediate Effect Roll Call # 481",56,53,0,0,109
1892133,1470143,2024-12-11,House,"Reported With Recommendation Without Amendment",8,0,0,0,8
1892133,1470495,2024-12-13,House,"House Third Reading: Given Immediate Effect Roll Call # 542",56,0,0,0,56
1892137,1470167,2024-12-10,House,"Reported With Recommendation Without Amendment",7,5,0,0,12
1892139,1470084,2024-12-10,House,"Reported With Recommendation With Substitute H-1",7,5,0,0,12
1892143,1470107,2024-12-10,House,"Reported With Recommendation With Substitute H-1",7,5,0,0,12
1892146,1470316,2024-12-11,House,"Reported With Recommendation Without Amendment",8,2,0,0,10
1892146,1470593,2024-12-13,House,"House Third Reading: Given Immediate Effect Roll Call # 539",56,0,0,0,56
1892151,1470355,2024-12-11,House,"Reported With Recommendation Without Amendment",9,0,0,0,9
1892151,1470583,2024-12-13,House,"House Third Reading: Given Immediate Effect Roll Call # 538",56,0,0,0,56
1892157,1470051,2024-12-10,House,"Reported With Recommendation Without Amendment",8,5,0,0,13
1892161,1470024,2024-12-10,House,"Reported With Recommendation Without Amendment",6,4,0,0,10
1892161,1470368,2024-12-12,House,"House Third Reading: Given Immediate Effect Roll Call # 480",56,53,0,0,109
1892164,1470244,2024-12-10,House,"Reported With Recommendation With Substitute H-1",6,4,0,0,10
1892164,1470358,2024-12-12,House,"House Third Reading: Given Immediate Effect Roll Call # 482",56,53,0,0,109
1892167,1470375,2024-12-11,House,"Reported With Recommendation With Substitute H-1",9,0,0,0,9
1893104,1470516,2024-12-12,Senate,"Senate Third Reading: Passed Roll Call # 513",20,16,0,2,38
1893119,1470149,2024-12-11,Senate,"Reported Favorably With Substitute S-1",5,2,0,0,7
1893119,1470623,2024-12-12,Senate,"Senate Third Reading: Passed Roll Call # 553",20,15,0,3,38
1893126,1470169,2024-12-11,Senate,"Reported Favorably With Substitute S-2",5,2,0,0,7
1893136,1470231,2024-12-11,Senate,"Reported Favorably Without Amendment",5,2,0,0,7
1893141,1470383,2024-12-04,House,"Reported With Recommendation Without Amendment",3,0,0,0,3
1893141,1470483,2024-12-13,House,"House Third Reading: Given Immediate Effect Roll Call # 508",56,0,0,0,56
1893147,1470345,2024-12-10,House,"Reported With Recommendation Without Amendment",6,2,0,0,8
1893147,1470522,2024-12-13,House,"House Third Reading: Given Immediate Effect Roll Call # 493",56,0,0,0,56
1893153,1469758,2024-12-04,House,"Reported With Recommendation Without Amendment",7,0,0,0,7
1893155,1470386,2024-12-12,House,"Reported With Recommendation Without Amendment",12,0,0,0,12
1893162,1470074,2024-12-04,House,"Reported With Recommendation Without Amendment",7,0,0,0,7
1893192,1470535,2024-12-13,House,"House Third Reading: Given Immediate Effect Roll Call # 536",56,0,0,0,56
1894330,1469843,2024-12-05,Senate,"Reported Favorably Without Amendment",13,5,0,0,18
1894330,1470102,2024-12-11,Senate,"Senate Third Reading: Passed Roll Call # 486",20,16,0,2,38
1894338,1470468,2024-12-12,Senate,"Reported Favorably Without Amendment",4,0,0,0,4
1894346,1470618,2024-12-13,Senate,"Senate Third Reading: Passed Roll Call # 587",21,12,0,5,38
1894354,1470086,2024-12-10,Senate,"Reported Favorably Without Amendment",5,1,0,0,6
1894354,1470511,2024-12-12,Senate,"Senate Third Reading: Passed Roll Call # 520",20,16,0,2,38
1894361,1470889,2024-12-12,Senate,"Reported Favorably With Substitute S-1",4,0,0,0,4
1894361,1470890,2024-12-12,Senate,"Senate Third Reading: Passed Roll Call # 549",20,15,0,3,38
1894370,1470248,2024-12-11,Senate,"Reported Favorably Without Amendment",6,0,0,0,6
1894370,1470895,2024-12-13,Senate,"Senate Third Reading: Passed Roll Call # 623",32,1,0,5,38
1894393,1470753,2024-12-12,Senate,"Reported Favorably With Substitute S-1",4,0,0,0,4
1894408,1470553,2024-12-12,Senate,"Reported Favorably With Substitute S-1",4,0,0,0,4
1894408,1470554,2024-12-12,Senate,"Senate Third Reading: Passed Roll Call # 547",20,15,0,3,38
1894516,1470638,2024-12-12,Senate,"Reported Favorably Without Amendment",4,0,0,0,4
1894516,1470639,2024-12-13,Senate,"Senate Third Reading: Passed Roll Call # 578",30,3,0,5,38
1894610,1470325,2024-12-12,House,"Reported With Recommendation Without Amendment",7,0,0,0,7
1894632,1470335,2024-12-12,House,"House Third Reading: Given Immediate Effect Roll Call # 469",76,33,0,0,109
1894637,1470333,2024-12-12,House,"Reported With Recommendation Without Amendment",7,0,0,0,7
1894637,1470496,2024-12-13,House,"House Third Reading: Passed Roll Call # 494",56,0,0,0,56
1894637,1470497,2024-12-13,House,"House Third Reading: Given Immediate Effect Roll Call # 495",56,0,0,0,56
1894708,1470523,2024-12-12,Senate,"Reported Favorably Without Amendment",4,0,0,0,4
1894712,1470585,2024-12-13,Senate,"Senate Third Reading: Passed Roll Call # 602",28,5,0,5,38
1894714,1470872,2024-12-13,Senate,"Senate Third Reading: Passed Roll Call # 596",24,9,0,5,38
1894718,1470466,2024-12-12,Senate,"Reported Favorably Without Amendment",4,0,0,0,4
1894718,1470605,2024-12-13,Senate,"Senate Third Reading: Passed Roll Call # 609",33,0,0,5,38
1894728,1470615,2024-12-13,Senate,"Senate Third Reading: Passed Roll Call # 595",24,9,0,5,38
1894750,1470498,2024-12-12,Senate,"Senate Third Reading: Passed Roll Call # 539",32,3,0,3,38
1894750,1470986,2024-12-18,Senate,"Reported Favorably Without Amendment",4,0,0,0,4
1894756,1470469,2024-12-12,Senate,"Reported Favorably With Substitute S-1",4,0,0,0,4
1894757,1470595,2024-12-13,Senate,"Senate Third Reading: Passed Roll Call # 593",24,9,0,5,38
1894767,1470063,2024-12-10,House,"Reported With Recommendation With Substitute H-1",9,4,0,0,13
1894770,1470617,2024-12-13,Senate,"Senate Third Reading: Passed Roll Call # 591",24,9,0,5,38
1894771,1470597,2024-12-13,Senate,"Senate Third Reading: Passed Roll Call # 592",24,9,0,5,38
1894776,1470878,2024-12-13,Senate,"Senate Third Reading: Passed Roll Call # 594",24,9,0,5,38
1894780,1470560,2024-12-13,House,"House Third Reading: Given Immediate Effect Roll Call # 491",56,0,0,0,56
