bill_id,roll_call_id,date,chamber,description,yea,nay,nv,absent,total
906212,567378,2017-01-11,House,"House Third Reading: Roll Call # 3",108,0,0,0,108
906246,567377,2017-01-11,House,"House Third Reading: Roll Call # 2",108,0,0,0,108
907655,597198,2017-03-02,House,"Reported With Recommendation With Substitute H-1",15,0,0,0,15
907655,597937,2017-03-02,House,"Reported With Recommendation With Substitute  H-1",15,0,0,0,15
907655,603607,2017-03-14,House,"House Third Reading: Given Immediate Effect Roll Call # 34",108,0,0,0,108
907655,661183,2017-06-08,Senate,"Reported Favorably Without Amendment",9,0,0,0,9
907655,664440,2017-06-15,Senate,"Senate Third Reading: Given Immediate Effect Roll Call # 269",38,0,0,0,38
907915,586463,2017-02-15,House,"Reported With Recommendation Without Amendment",7,4,0,0,11
907915,592433,2017-02-23,House,"House Third Reading: Defeated Roll Call # 5",52,55,0,0,107
910056,697403,2018-02-07,House,"Reported With Recommendation Without Amendment",12,1,0,0,13
910056,714836,2018-03-01,House,"House Third Reading: Given Immediate Effect Roll Call # 122",105,2,0,0,107
910056,753589,2018-05-15,Senate,"Reported Favorably Without Amendment",7,0,0,0,7
910056,762460,2018-06-12,Senate,"Senate Third Reading: Given Immediate Effect Roll Call # 491",36,0,0,1,37
910087,697375,2018-02-07,House,"Reported With Recommendation With Substitute  H-1",11,1,0,0,12
910087,714784,2018-03-01,House,"House Third Reading: Given Immediate Effect Roll Call # 121",105,2,0,0,107
910087,753603,2018-05-15,Senate,"Reported Favorably Without Amendment",7,0,0,0,7
910087,762467,2018-06-12,Senate,"Senate Third Reading: Given Immediate Effect Roll Call # 490",36,0,0,1,37
910087,764446,2018-06-12,House,"House Third Reading: Roll Call # 546",104,3,0,0,107
910122,725035,2018-03-15,House,"Reported With Recommendation For Referral To Committee On Law And Justice",9,0,0,0,9
916636,574977,2017-01-31,Senate,"Reported Favorably Without Amendment",5,0,0,0,5
916636,597470,2017-03-02,House,"Reported With Recommendation Without Amendment",6,3,0,0,9
917105,575967,2017-02-02,Senate,"Reported Favorably With Substitute 1",8,0,0,0,8
917105,579171,2017-02-02,Senate,"Reported Favorably With Substitute S-1",8,0,0,0,8
917105,581112,2017-02-09,Senate,"Senate Third Reading: Passed Roll Call # 22",34,3,0,1,38
917105,615118,2017-03-29,House,"Reported With Recommendation With Substitute  H-1",13,2,0,0,15
917105,635878,2017-04-27,House,"House Third Reading: Given Immediate Effect Roll Call # 81",100,9,0,0,109
917105,781420,2018-12-20,Senate,"Senate Third Reading: Roll Call # 1024",37,1,0,0,38
917118,678145,2017-10-18,House,"Reported With Recommendation For Referral To Committee On Communications And Technology",12,0,0,0,12
917155,574555,2017-01-31,Senate,"Reported Favorably Without Amendment",5,0,0,0,5
917155,576338,2017-02-02,Senate,"Senate Third Reading: Passed Roll Call # 12",35,0,0,3,38
917155,596823,2017-03-02,House,"Reported With Recommendation With Substitute H-1",9,0,0,0,9
917155,597536,2017-03-02,House,"Reported With Recommendation With Substitute  H-1",9,0,0,0,9
917155,599966,2017-03-08,House,"House Third Reading: Given Immediate Effect Roll Call # 21",103,4,0,0,107
917155,601154,2017-03-09,Senate,"Senate Third Reading: Roll Call # 57",35,0,0,3,38
917171,680983,2017-12-13,House,"Reported With Recommendation Without Amendment",3,0,0,0,3
917171,711676,2018-02-22,House,"House Third Reading: Given Immediate Effect Roll Call # 95",62,46,0,0,108
917171,727881,2018-03-22,Senate,"Reported Favorably Without Amendment",3,1,0,0,4
917183,571629,2017-01-25,Senate,"Reported Favorably Without Amendment",3,1,0,0,4
917183,584119,2017-02-14,Senate,"Senate Third Reading: Passed Roll Call # 27",36,1,0,1,38
917183,595186,2017-02-28,House,"Reported With Recommendation With Substitute H-1",10,0,0,0,10
917183,603618,2017-03-09,House,"House Third Reading: Given Immediate Effect Roll Call # 31",108,0,0,0,108
917183,603619,2017-03-14,Senate,"Senate Third Reading: Roll Call # 69",36,1,0,1,38
917195,574094,2017-01-31,Senate,"Reported Favorably With Substitute  S-1",5,0,0,0,5
917195,576083,2017-02-02,Senate,"Senate Third Reading: Passed Roll Call # 7",35,0,0,3,38
917195,596908,2017-03-02,House,"Reported With Recommendation With Substitute H-2",9,0,0,0,9
917195,597558,2017-03-02,House,"Reported With Recommendation With Substitute  H-2",9,0,0,0,9
917195,600030,2017-03-08,House,"House Third Reading: Given Immediate Effect Roll Call # 17",83,24,0,0,107
917195,601268,2017-03-09,Senate,"Senate Third Reading: Roll Call # 54",34,1,0,3,38
917206,586345,2017-02-15,House,"Reported With Recommendation Without Amendment",11,0,0,0,11
917206,592510,2017-02-23,House,"House Third Reading: Given Immediate Effect Roll Call # 4",107,0,0,0,107
917206,648995,2017-05-23,Senate,"Reported Favorably Without Amendment",9,0,0,0,9
917206,655168,2017-05-30,Senate,"Senate Third Reading: Given Immediate Effect Roll Call # 231",38,0,0,0,38
917219,574359,2017-01-31,Senate,"Reported Favorably Without Amendment",4,1,0,0,5
917219,576273,2017-02-02,Senate,"Senate Third Reading: Passed Roll Call # 15",34,1,0,3,38
917219,597008,2017-03-02,House,"Reported With Recommendation With Substitute H-1",9,0,0,0,9
917219,597708,2017-03-02,House,"Reported With Recommendation With Substitute  H-1",9,0,0,0,9
917219,600012,2017-03-08,House,"House Third Reading: Given Immediate Effect Roll Call # 24",101,6,0,0,107
917219,601159,2017-03-09,Senate,"Senate Third Reading: Roll Call # 60",34,1,0,3,38
917310,610956,2017-03-21,House,"Reported With Recommendation Without Amendment",12,1,0,0,13
917310,615564,2017-03-29,House,"House Third Reading: Given Immediate Effect Roll Call # 60",106,2,0,0,108
917324,574528,2017-01-31,Senate,"Reported Favorably Without Amendment",5,0,0,0,5
917324,576365,2017-02-02,Senate,"Senate Third Reading: Passed Roll Call # 14",35,0,0,3,38
917324,597205,2017-03-02,House,"Reported With Recommendation With Substitute H-1",9,0,0,0,9
917324,597986,2017-03-02,House,"Reported With Recommendation With Substitute  H-1",9,0,0,0,9
917324,600020,2017-03-08,House,"House Third Reading: Given Immediate Effect Roll Call # 23",103,4,0,0,107
917324,601284,2017-03-09,Senate,"Senate Third Reading: Roll Call # 59",35,0,0,3,38
917352,574551,2017-01-31,Senate,"Reported Favorably Without Amendment",5,0,0,0,5
917352,576296,2017-02-02,Senate,"Senate Third Reading: Passed Roll Call # 19",35,0,0,3,38
917352,596903,2017-03-02,House,"Reported With Recommendation With Substitute H-1",9,0,0,0,9
917352,597610,2017-03-02,House,"Reported With Recommendation With Substitute  H-1",9,0,0,0,9
917352,600032,2017-03-08,House,"House Third Reading: Given Immediate Effect Roll Call # 28",106,1,0,0,107
917352,601162,2017-03-09,Senate,"Senate Third Reading: Roll Call # 63",35,0,0,3,38
917365,645223,2017-05-16,Senate,"Reported Favorably Without Amendment",7,0,0,0,7
917388,590314,2017-02-21,House,"Reported With Recommendation Without Amendment",14,0,0,0,14
917388,595994,2017-03-01,House,"House Third Reading: Given Immediate Effect Roll Call # 6",108,0,0,0,108
917388,627329,2017-04-18,Senate,"Reported Favorably Without Amendment",4,0,0,0,4
917388,632307,2017-04-25,Senate,"Senate Third Reading: Given Immediate Effect Roll Call # 113",37,0,0,1,38
917403,579175,2017-02-07,Senate,"Reported Favorably Without Amendment",7,1,0,0,8
917403,581409,2017-02-09,Senate,"Senate Third Reading: Passed Roll Call # 24",24,13,0,1,38
917403,679990,2017-12-05,House,"Reported With Recommendation With Substitute H-4",11,3,0,0,14
917403,781312,2018-12-20,House,"House Third Reading: Given Immediate Effect Roll Call # 905",56,53,0,0,109
917403,781313,2018-12-20,Senate,"Senate Third Reading: Roll Call # 1011",24,14,0,0,38
917425,574179,2017-01-31,Senate,"Reported Favorably Without Amendment",5,0,0,0,5
917425,576090,2017-02-02,Senate,"Senate Third Reading: Passed Roll Call # 20",35,0,0,3,38
917425,597160,2017-03-02,House,"Reported With Recommendation Without Amendment",9,0,0,0,9
917425,600046,2017-03-08,House,"House Third Reading: Given Immediate Effect Roll Call # 29",106,1,0,0,107
917438,616221,2017-03-30,Senate,"Reported Favorably Without Amendment",4,1,0,0,5
917479,574532,2017-01-31,Senate,"Reported Favorably Without Amendment",5,0,0,0,5
917479,576364,2017-02-02,Senate,"Senate Third Reading: Passed Roll Call # 11",35,0,0,3,38
917479,596841,2017-03-02,House,"Reported With Recommendation With Substitute H-1",9,0,0,0,9
917479,597564,2017-03-02,House,"Reported With Recommendation With Substitute  H-1",9,0,0,0,9
917479,600011,2017-03-08,House,"House Third Reading: Given Immediate Effect Roll Call # 20",100,7,0,0,107
917479,601233,2017-03-09,Senate,"Senate Third Reading: Roll Call # 56",35,0,0,3,38
917491,574541,2017-01-31,Senate,"Reported Favorably Without Amendment",5,0,0,0,5
917491,576046,2017-02-02,Senate,"Senate Third Reading: Passed Roll Call # 17",35,0,0,3,38
917491,596831,2017-03-02,House,"Reported With Recommendation With Substitute H-2",9,0,0,0,9
917491,597549,2017-03-02,House,"Reported With Recommendation With Substitute  H-2",9,0,0,0,9
917491,599997,2017-03-08,House,"House Third Reading: Given Immediate Effect Roll Call # 26",107,0,0,0,107
917491,601126,2017-03-09,Senate,"Senate Third Reading: Roll Call # 61",34,1,0,3,38
917514,574033,2017-01-31,Senate,"Reported Favorably Without Amendment",5,0,0,0,5
917514,576067,2017-02-02,Senate,"Senate Third Reading: Passed Roll Call # 4",35,0,0,3,38
917514,597154,2017-03-02,House,"Reported With Recommendation With Substitute H-1",9,0,0,0,9
917514,598041,2017-03-02,House,"Reported With Recommendation With Substitute  H-1",9,0,0,0,9
917514,600103,2017-03-08,House,"House Third Reading: Given Immediate Effect Roll Call # 14",107,0,0,0,107
917514,601015,2017-03-09,Senate,"Senate Third Reading: Roll Call # 51",35,0,0,3,38
917539,659255,2017-06-06,House,"Reported With Recommendation With Substitute H-1",14,0,0,0,14
917539,660509,2017-06-06,House,"Reported With Recommendation With Substitute  H-1",14,0,0,0,14
917539,664479,2017-06-15,House,"House Third Reading: Given Immediate Effect Roll Call # 206",101,6,0,0,107
917539,679461,2017-11-28,Senate,"Reported Favorably Without Amendment",4,0,0,0,4
917539,680617,2017-12-12,Senate,"Senate Third Reading: Given Immediate Effect Roll Call # 513",38,0,0,0,38
917548,573912,2017-01-31,Senate,"Reported Favorably Without Amendment",5,0,0,0,5
917548,576526,2017-02-02,Senate,"Senate Third Reading: Passed Roll Call # 18",35,0,0,3,38
917548,596928,2017-03-02,House,"Reported With Recommendation With Substitute H-1",7,2,0,0,9
917548,597638,2017-03-02,House,"Reported With Recommendation With Substitute  H-1",7,2,0,0,9
917548,600276,2017-03-08,House,"House Third Reading: Given Immediate Effect Roll Call # 27",107,0,0,0,107
917548,601074,2017-03-09,Senate,"Senate Third Reading: Roll Call # 62",35,0,0,3,38
917607,574530,2017-01-31,Senate,"Reported Favorably Without Amendment",5,0,0,0,5
917607,576017,2017-02-02,Senate,"Senate Third Reading: Passed Roll Call # 1",35,0,0,3,38
917607,596811,2017-03-02,House,"Reported With Recommendation With Substitute H-1",9,0,0,0,9
917607,597635,2017-03-02,House,"Reported With Recommendation With Substitute  H-1",9,0,0,0,9
917607,600288,2017-03-08,House,"House Third Reading: Given Immediate Effect Roll Call # 11",107,0,0,0,107
917607,601102,2017-03-09,Senate,"Senate Third Reading: Roll Call # 48",34,0,1,3,38
917618,571630,2017-01-25,Senate,"Reported Favorably Without Amendment",4,0,0,0,4
917618,595922,2017-02-28,Senate,"Senate Third Reading: Passed Roll Call # 41",36,0,0,2,38
917618,615504,2017-03-28,House,"Reported With Recommendation With Substitute  H-1",9,1,0,0,10
917618,677802,2017-10-05,House,"House Third Reading: Given Immediate Effect Roll Call # 290",107,1,0,0,108
917618,677807,2017-10-10,Senate,"Senate Third Reading: Roll Call # 376",36,0,0,2,38
917641,574512,2017-01-31,Senate,"Reported Favorably Without Amendment",5,0,0,0,5
917641,576003,2017-02-02,Senate,"Senate Third Reading: Passed Roll Call # 5",35,0,0,3,38
917641,597192,2017-03-02,House,"Reported With Recommendation With Substitute H-1",6,3,0,0,9
917641,597522,2017-03-02,House,"Reported With Recommendation With Substitute  H-1",6,3,0,0,9
917641,600095,2017-03-08,House,"House Third Reading: Given Immediate Effect Roll Call # 15",73,34,0,0,107
917641,600934,2017-03-09,Senate,"Senate Third Reading: Roll Call # 52",28,7,0,3,38
917667,574731,2017-01-31,Senate,"Reported Favorably Without Amendment",5,0,0,0,5
917667,576095,2017-02-02,Senate,"Senate Third Reading: Passed Roll Call # 10",34,1,0,3,38
917667,597158,2017-03-02,House,"Reported With Recommendation With Substitute H-1",7,1,0,0,8
917667,598031,2017-03-02,House,"Reported With Recommendation With Substitute  H-1",7,1,0,0,8
917681,573970,2017-01-31,Senate,"Reported Favorably Without Amendment",5,0,0,0,5
917681,576443,2017-02-02,Senate,"Senate Third Reading: Passed Roll Call # 13",35,0,0,3,38
917681,596839,2017-03-02,House,"Reported With Recommendation With Substitute H-1",6,3,0,0,9
917681,597554,2017-03-02,House,"Reported With Recommendation With Substitute  H-1",6,3,0,0,9
917681,599989,2017-03-08,House,"House Third Reading: Given Immediate Effect Roll Call # 22",63,44,0,0,107
917681,601295,2017-03-09,Senate,"Senate Third Reading: Roll Call # 58",28,7,0,3,38
917716,603507,2017-03-14,Senate,"Reported Favorably Without Amendment",5,0,0,0,5
917716,605694,2017-03-16,Senate,"Senate Third Reading: Passed Roll Call # 74",37,0,0,1,38
917716,632707,2017-04-25,House,"Reported With Recommendation Without Amendment",13,1,0,0,14
917716,639187,2017-05-03,House,"House Third Reading: Given Immediate Effect Roll Call # 91",94,12,0,0,106
917756,573907,2017-01-31,Senate,"Reported Favorably Without Amendment",5,0,0,0,5
917756,575974,2017-02-02,Senate,"Senate Third Reading: Passed Roll Call # 9",35,0,0,3,38
917756,596822,2017-03-02,House,"Reported With Recommendation With Substitute H-1",6,1,0,0,7
917756,597541,2017-03-02,House,"Reported With Recommendation With Substitute  H-1",6,1,0,0,7
917756,600115,2017-03-08,House,"House Third Reading: Given Immediate Effect Roll Call # 19",99,8,0,0,107
917756,600954,2017-03-09,Senate,"Senate Third Reading: Roll Call # 55",35,0,0,3,38
917768,571237,2017-01-25,Senate,"Reported Favorably Without Amendment",3,0,0,0,3
917768,581218,2017-02-09,Senate,"Senate Third Reading: Passed Roll Call # 25",37,0,0,1,38
917785,573905,2017-01-31,Senate,"Reported Favorably Without Amendment",5,0,0,0,5
917785,575971,2017-02-02,Senate,"Senate Third Reading: Passed Roll Call # 6",35,0,0,3,38
917785,597159,2017-03-02,House,"Reported With Recommendation With Substitute H-1",9,0,0,0,9
917785,598039,2017-03-02,House,"Reported With Recommendation With Substitute  H-1",9,0,0,0,9
917785,600298,2017-03-08,House,"House Third Reading: Given Immediate Effect Roll Call # 16",107,0,0,0,107
917785,601318,2017-03-09,Senate,"Senate Third Reading: Roll Call # 53",35,0,0,3,38
917793,574068,2017-01-31,Senate,"Reported Favorably With Substitute  S-1",5,0,0,0,5
917793,576072,2017-02-02,Senate,"Senate Third Reading: Passed Roll Call # 8",35,0,0,3,38
917793,596877,2017-03-02,House,"Reported With Recommendation Without Amendment",9,0,0,0,9
917793,600083,2017-03-08,House,"House Third Reading: Given Immediate Effect Roll Call # 18",107,0,0,0,107
917833,677305,2017-09-26,Senate,"Reported Favorably With Substitute  S-2",4,0,0,0,4
917833,678053,2017-10-17,Senate,"Senate Third Reading: Passed Roll Call # 391",38,0,0,0,38
917874,574031,2017-01-31,Senate,"Reported Favorably Without Amendment",5,0,0,0,5
917874,575969,2017-02-02,Senate,"Senate Third Reading: Passed Roll Call # 3",35,0,0,3,38
917874,597167,2017-03-02,House,"Reported With Recommendation With Substitute H-1",9,0,0,0,9
917874,597561,2017-03-02,House,"Reported With Recommendation With Substitute  H-1",9,0,0,0,9
917874,600279,2017-03-08,House,"House Third Reading: Given Immediate Effect Roll Call # 13",107,0,0,0,107
917874,601254,2017-03-09,Senate,"Senate Third Reading: Roll Call # 50",35,0,0,3,38
917886,574082,2017-01-31,Senate,"Reported Favorably Without Amendment",5,0,0,0,5
917886,576077,2017-02-02,Senate,"Senate Third Reading: Passed Roll Call # 2",35,0,0,3,38
917886,597207,2017-03-02,House,"Reported With Recommendation With Substitute H-1",9,0,0,0,9
917886,597530,2017-03-02,House,"Reported With Recommendation With Substitute  H-1",9,0,0,0,9
917886,600307,2017-03-08,House,"House Third Reading: Given Immediate Effect Roll Call # 12",107,0,0,0,107
917886,601251,2017-03-09,Senate,"Senate Third Reading: Roll Call # 49",35,0,0,3,38
917899,576079,2017-02-02,Senate,"Reported Favorably With Substitute  S-1",3,1,0,0,4
917912,574228,2017-01-31,Senate,"Reported Favorably Without Amendment",4,0,0,0,4
917912,576118,2017-02-02,Senate,"Senate Third Reading: Passed Roll Call # 21",29,6,0,3,38
917912,597054,2017-03-02,House,"Reported With Recommendation Without Amendment",6,3,0,0,9
917912,600009,2017-03-08,House,"House Third Reading: Given Immediate Effect Roll Call # 30",65,42,0,0,107
917923,679402,2017-11-08,House,"Reported With Recommendation For Referral To Committee On Tax Policy",11,0,0,0,11
917948,576071,2017-02-02,Senate,"Reported Favorably Without Amendment",5,0,0,0,5
917948,589944,2017-02-21,Senate,"Senate Third Reading: Passed Roll Call # 34",34,1,0,3,38
917948,678885,2017-11-07,House,"Reported With Recommendation With Substitute  H-3",8,2,0,0,10
917948,681035,2017-12-13,House,"House Third Reading: Given Immediate Effect Roll Call # 484",66,44,0,0,110
917948,681036,2017-12-13,Senate,"Senate Third Reading: Roll Call # 566",37,0,0,1,38
917963,574328,2017-01-31,Senate,"Reported Favorably Without Amendment",5,0,0,0,5
917963,576284,2017-02-02,Senate,"Senate Third Reading: Passed Roll Call # 16",35,0,0,3,38
917963,597206,2017-03-02,House,"Reported With Recommendation Without Amendment",9,0,0,0,9
917963,600159,2017-03-08,House,"House Third Reading: Given Immediate Effect Roll Call # 25",104,3,0,0,107
917976,571622,2017-01-25,Senate,"Reported Favorably Without Amendment",3,0,0,0,3
917976,581039,2017-02-09,Senate,"Senate Third Reading: Passed Roll Call # 26",37,0,0,1,38
917976,599555,2017-03-07,House,"Reported With Recommendation Without Amendment",10,0,0,0,10
917976,628623,2017-04-19,House,"House Third Reading: Given Immediate Effect Roll Call # 69",107,0,0,0,107
917987,608529,2017-03-21,Senate,"Reported Favorably Without Amendment",9,0,0,0,9
917987,611241,2017-03-23,Senate,"Senate Third Reading: Passed Roll Call # 83",37,0,0,1,38
917987,651048,2017-05-18,House,"Reported With Recommendation Without Amendment",16,1,0,0,17
917987,659257,2017-05-31,House,"House Third Reading: Given Immediate Effect Roll Call # 160",107,0,0,0,107
917998,660453,2017-06-07,Senate,"Reported Favorably With Substitute  S-4",10,0,0,0,10
917998,667979,2017-06-22,Senate,"Senate Third Reading: Passed Roll Call # 295",36,1,0,1,38
917998,677601,2017-10-04,House,"Reported With Recommendation With Substitute  H-2",17,0,0,0,17
917998,680975,2017-12-13,House,"House Third Reading: Given Immediate Effect Roll Call # 478",104,6,0,0,110
917998,680976,2017-12-13,Senate,"Senate Third Reading: Roll Call # 561",36,1,0,1,38
918012,599376,2017-03-07,Senate,"Reported Favorably Without Amendment",5,0,0,0,5
918012,601218,2017-03-09,Senate,"Senate Third Reading: Passed Roll Call # 68",35,0,0,3,38
918012,603743,2017-03-14,House,"Reported With Recommendation Without Amendment",14,0,0,0,14
918012,605622,2017-03-16,House,"House Third Reading: Given Immediate Effect Roll Call # 49",108,0,0,0,108
929671,596321,2017-03-01,House,"Reported With Recommendation With Substitute H-1",11,0,0,0,11
929671,603551,2017-03-14,House,"House Third Reading: Given Immediate Effect Roll Call # 33",106,2,0,0,108
929671,615053,2017-03-29,Senate,"Reported Favorably Without Amendment",5,0,0,0,5
929671,628470,2017-04-19,Senate,"Senate Third Reading: Given Immediate Effect Roll Call # 106",36,0,0,2,38
929724,599484,2017-03-07,House,"Reported With Recommendation Without Amendment",10,1,0,0,11
929724,605444,2017-03-16,House,"House Third Reading: Given Immediate Effect Roll Call # 46",106,2,0,0,108
929724,616334,2017-03-30,Senate,"Reported Favorably With Substitute  S-1",5,0,0,0,5
929724,632135,2017-04-25,Senate,"Senate Third Reading: Given Immediate Effect Roll Call # 112",37,0,0,1,38
929724,636676,2017-05-02,House,"House Third Reading: Roll Call # 83",105,2,0,0,107
929787,604730,2017-03-15,House,"Reported With Recommendation With Substitute H-1",9,3,0,0,12
929787,615058,2017-03-28,House,"House Third Reading: Given Immediate Effect Roll Call # 57",76,31,0,0,107
929787,691331,2018-01-30,Senate,"Reported Favorably Without Amendment",4,0,0,0,4
929819,603644,2017-03-14,House,"Reported With Recommendation Without Amendment",8,0,0,0,8
929819,605538,2017-03-16,House,"House Third Reading: Given Immediate Effect Roll Call # 48",108,0,0,0,108
929850,599517,2017-03-07,House,"Reported With Recommendation Without Amendment",10,1,0,0,11
929850,605553,2017-03-16,House,"House Third Reading: Given Immediate Effect Roll Call # 45",107,1,0,0,108
929850,616266,2017-03-30,Senate,"Reported Favorably With Substitute  S-1",5,0,0,0,5
929850,632133,2017-04-25,Senate,"Senate Third Reading: Given Immediate Effect Roll Call # 111",37,0,0,1,38
929850,636807,2017-05-02,House,"House Third Reading: Roll Call # 82",105,2,0,0,107
929882,610574,2017-03-21,House,"Reported With Recommendation Without Amendment",11,1,0,0,12
929882,646203,2017-05-17,House,"House Third Reading: Given Immediate Effect Roll Call # 103",104,3,0,0,107
929882,661164,2017-06-08,Senate,"Reported Favorably Without Amendment",3,0,0,0,3
929882,679495,2017-11-29,Senate,"Senate Third Reading: Given Immediate Effect Roll Call # 464",38,0,0,0,38
929975,610446,2017-03-21,House,"Reported With Recommendation For Referral To Committee On Law And Justice",10,0,0,0,10
930067,677337,2017-09-27,House,"Reported With Recommendation With Substitute  H-1",16,0,0,0,16
930067,677619,2017-09-27,House,"Reported With Recommendation With Substitute H-1",16,0,0,0,16
930067,677817,2017-10-10,House,"House Third Reading: Given Immediate Effect Roll Call # 296",100,6,0,0,106
930067,780597,2018-12-12,Senate,"Reported Favorably With Substitute  S-1",4,0,0,0,4
930067,780695,2018-12-13,Senate,"Senate Third Reading: Given Immediate Effect Roll Call # 796",36,1,0,1,38
930067,781169,2018-12-19,House,"House Third Reading: Roll Call # 883",102,7,0,0,109
930097,677331,2017-09-27,House,"Reported With Recommendation Without Amendment",16,0,0,0,16
930097,677805,2017-10-10,House,"House Third Reading: Given Immediate Effect Roll Call # 295",100,6,0,0,106
930097,780496,2018-12-12,Senate,"Reported Favorably With Substitute  S-1",4,0,0,0,4
930097,780681,2018-12-13,Senate,"Senate Third Reading: Given Immediate Effect Roll Call # 795",36,1,0,1,38
930097,781204,2018-12-19,House,"House Third Reading: Roll Call # 882",103,6,0,0,109
930128,636182,2017-04-27,House,"Reported With Recommendation Without Amendment",9,5,0,0,14
930128,681050,2017-12-12,House,"House Third Reading: Given Immediate Effect Roll Call # 460",64,45,0,0,109
930128,760940,2018-06-06,Senate,"Reported Favorably With Substitute  S-1",4,0,0,0,4
930128,762401,2018-06-12,Senate,"Senate Third Reading: Given Immediate Effect Roll Call # 494",26,10,0,1,37
930128,764608,2018-06-12,House,"House Third Reading: Roll Call # 557",63,46,0,0,109
930128,764609,2018-06-12,Senate,"Senate Third Reading: Roll Call # 554",25,11,0,1,37
930219,615673,2017-03-29,House,"Reported With Recommendation With Substitute  H-2",13,2,0,0,15
930219,636293,2017-04-27,House,"House Third Reading: Given Immediate Effect Roll Call # 80",100,9,0,0,109
930219,645311,2017-05-16,Senate,"Reported Favorably Without Amendment",9,0,0,0,9
930219,781316,2018-12-20,Senate,"Senate Third Reading: Passed Roll Call # 1023",36,2,0,0,38
932274,711702,2018-02-22,House,"Reported With Recommendation With Substitute  H-5",15,0,0,0,15
932274,722541,2018-03-13,House,"House Third Reading: Given Immediate Effect Roll Call # 155",102,7,0,0,109
932274,760590,2018-06-06,Senate,"Reported Favorably Without Amendment",5,0,0,0,5
932449,610368,2017-03-22,House,"Reported With Recommendation With Substitute  H-2",9,0,0,0,9
932449,616410,2017-03-30,House,"House Third Reading: Given Immediate Effect Roll Call # 64",108,0,0,0,108
932449,655406,2017-05-25,Senate,"Reported Favorably Without Amendment",5,0,0,0,5
932449,662557,2017-06-13,Senate,"Senate Third Reading: Given Immediate Effect Roll Call # 248",36,0,0,2,38
934088,580477,2017-02-08,Senate,"Reported Favorably With Substitute  S-1",3,0,0,0,3
934088,585717,2017-02-15,Senate,"Senate Third Reading: Passed Roll Call # 33",36,0,0,2,38
934088,592476,2017-02-22,House,"Reported With Recommendation Without Amendment",9,0,0,0,9
934088,596961,2017-03-02,House,"House Third Reading: Given Immediate Effect Roll Call # 9",106,2,0,0,108
934088,599977,2017-03-08,House,"House Third Reading: Passed Roll Call # 10",107,0,0,0,107
934088,610872,2017-03-21,House,"House Third Reading: Passed Roll Call # 50",108,0,0,0,108
934088,610873,2017-03-22,Senate,"Senate Third Reading: Roll Call # 76",38,0,0,0,38
934256,722451,2018-03-13,House,"Reported With Recommendation With Substitute  H-4",8,0,0,0,8
934256,722452,2018-03-13,House,"Reported With Recommendation With Substitute H-4",8,0,0,0,8
934256,727211,2018-03-21,House,"House Third Reading: Given Immediate Effect Roll Call # 189",104,4,0,0,108
934256,753549,2018-05-15,Senate,"Reported Favorably Without Amendment",8,0,0,0,8
934256,757331,2018-05-29,Senate,"Senate Third Reading: Given Immediate Effect Roll Call # 365",36,0,0,1,37
934343,713516,2018-02-28,House,"Reported With Recommendation With Substitute  H-2",25,4,0,0,29
934343,719387,2018-03-07,House,"House Third Reading: Given Immediate Effect Roll Call # 135",95,13,0,0,108
934343,755135,2018-05-17,Senate,"Reported Favorably With Substitute  S-1",3,1,0,0,4
934411,713530,2018-02-28,House,"Reported With Recommendation With Substitute  H-2",24,4,0,0,28
934411,719046,2018-03-07,House,"House Third Reading: Given Immediate Effect Roll Call # 134",94,14,0,0,108
934411,754972,2018-05-17,Senate,"Reported Favorably With Substitute  S-1",3,2,0,0,5
934465,713540,2018-02-28,House,"Reported With Recommendation Without Amendment",24,4,0,0,28
934465,719412,2018-03-07,House,"House Third Reading: Given Immediate Effect Roll Call # 136",101,7,0,0,108
934465,755146,2018-05-17,Senate,"Reported Favorably With Substitute  S-1",5,0,0,0,5
934517,660361,2017-06-07,House,"Reported With Recommendation With Substitute  H-1",7,4,0,0,11
938568,584386,2017-02-14,Senate,"Reported Favorably With Substitute  S-1",5,0,0,0,5
938591,727133,2018-03-21,House,"Reported With Recommendation With Substitute  H-3",12,1,0,0,13
938591,737747,2018-03-21,House,"Reported With Recommendation With Substitute H-3",12,1,0,0,13
938591,742048,2018-04-18,House,"House Third Reading: Given Immediate Effect Roll Call # 231",76,33,0,0,109
938591,753559,2018-05-15,Senate,"Reported Favorably With Substitute  S-1",4,2,0,0,6
938591,761245,2018-06-07,Senate,"Senate Third Reading: Given Immediate Effect Roll Call # 414",27,9,0,1,37
938591,764527,2018-06-12,House,"House Third Reading: Roll Call # 535",81,28,0,0,109
938694,646699,2017-05-18,Senate,"Reported Favorably With Substitute  S-1",15,0,0,0,15
938694,649497,2017-05-24,Senate,"Senate Third Reading: Passed Roll Call # 224",38,0,0,0,38
938694,660356,2017-06-07,House,"Reported With Recommendation With Substitute  H-2",16,13,0,0,29
938694,664362,2017-06-15,House,"House Third Reading: Given Immediate Effect Roll Call # 208",104,3,0,0,107
938694,669441,2017-06-22,Senate,"Senate Third Reading: Roll Call # 311",37,0,0,1,38
938746,616206,2017-03-30,Senate,"Reported Favorably Without Amendment",6,0,0,0,6
938746,631312,2017-04-20,Senate,"Senate Third Reading: Passed Roll Call # 110",37,0,0,1,38
938774,603536,2017-03-14,House,"Reported With Recommendation With Substitute H-1",8,3,0,0,11
938774,692288,2018-01-31,House,"House Third Reading: Given Immediate Effect Roll Call # 36",86,23,0,0,109
938774,708949,2018-02-22,Senate,"Reported Favorably Without Amendment",5,0,0,0,5
938802,603883,2017-03-14,House,"Reported With Recommendation With Substitute H-2",9,3,0,0,12
938802,692229,2018-01-31,House,"House Third Reading: Given Immediate Effect Roll Call # 37",86,23,0,0,109
938802,709096,2018-02-22,Senate,"Reported Favorably Without Amendment",5,0,0,0,5
938880,779627,2018-12-04,House,"Reported With Recommendation Without Amendment",15,1,0,0,16
938880,779628,2018-12-04,House,"House Third Reading: Passed Roll Call # 668",95,13,0,0,108
938880,780587,2018-12-12,Senate,"Reported Favorably Without Amendment",9,0,0,0,9
938880,781287,2018-12-18,Senate,"Senate Third Reading: Given Immediate Effect Roll Call # 855",38,0,0,0,38
938907,605397,2017-03-16,Senate,"Reported Favorably With Substitute S-1",4,0,0,0,4
938907,676985,2017-09-20,Senate,"Senate Third Reading: Passed Roll Call # 341",35,0,0,3,38
938907,679433,2017-11-28,House,"Reported With Recommendation Without Amendment",12,0,0,0,12
938907,681039,2017-12-13,House,"House Third Reading: Given Immediate Effect Roll Call # 485",110,0,0,0,110
939007,610544,2017-03-21,House,"Reported With Recommendation With Substitute  H-1",10,0,0,0,10
939007,615220,2017-03-29,House,"House Third Reading: Given Immediate Effect Roll Call # 61",108,0,0,0,108
939007,635444,2017-04-27,Senate,"Reported Favorably With Substitute  S-1",5,0,0,0,5
939007,646633,2017-05-18,Senate,"Senate Third Reading: Given Immediate Effect Roll Call # 198",35,2,0,1,38
939007,651276,2017-05-23,House,"House Third Reading: Roll Call # 127",108,0,0,0,108
939030,580484,2017-02-08,Senate,"Reported Favorably With Substitute  S-1",5,0,0,0,5
939062,605544,2017-03-16,Senate,"Reported Favorably With Substitute  S-1",4,0,0,0,4
939062,676978,2017-09-20,Senate,"Senate Third Reading: Passed Roll Call # 342",35,0,0,3,38
939062,679416,2017-11-28,House,"Reported With Recommendation Without Amendment",12,0,0,0,12
939062,681058,2017-12-13,House,"House Third Reading: Given Immediate Effect Roll Call # 486",110,0,0,0,110
939141,779535,2018-12-04,House,"Reported With Recommendation With Substitute  H-2",15,1,0,0,16
939141,779536,2018-12-04,House,"House Third Reading: Passed Roll Call # 669",89,19,0,0,108
939141,780586,2018-12-12,Senate,"Reported Favorably Without Amendment",9,0,0,0,9
939141,781415,2018-12-18,Senate,"Senate Third Reading: Given Immediate Effect Roll Call # 856",38,0,0,0,38
939194,642076,2017-05-09,Senate,"Reported Favorably Without Amendment",5,0,0,0,5
939194,646733,2017-05-18,Senate,"Senate Third Reading: Passed Roll Call # 199",37,0,0,1,38
939352,779191,2018-11-28,House,"Reported With Recommendation With Substitute  H-1",8,1,0,0,9
939458,610531,2017-03-21,House,"Reported With Recommendation For Referral To Committee On Judiciary",11,0,0,0,11
939458,632230,2017-04-25,House,"Reported With Recommendation Without Amendment",10,0,0,0,10
939458,645987,2017-05-17,House,"House Third Reading: Roll Call # 100",107,0,0,0,107
939484,664486,2017-06-14,House,"Reported With Recommendation Without Amendment",13,0,0,0,13
939484,666618,2017-06-20,House,"House Third Reading: Given Immediate Effect Roll Call # 241",107,0,0,0,107
941271,592370,2017-02-22,House,"Reported With Recommendation Without Amendment",13,0,0,0,13
941271,597156,2017-03-02,House,"House Third Reading: Given Immediate Effect Roll Call # 8",108,0,0,0,108
941271,605477,2017-03-16,Senate,"Reported Favorably Without Amendment",7,0,0,0,7
941271,631371,2017-04-20,Senate,"Senate Third Reading: Given Immediate Effect Roll Call # 108",37,0,0,1,38
941315,678147,2017-10-18,House,"Reported With Recommendation For Referral To Committee On Communications And Technology",12,0,0,0,12
941366,611361,2017-03-23,Senate,"Reported Favorably Without Amendment",7,0,0,0,7
941423,605430,2017-03-16,Senate,"Reported Favorably With Substitute  S-1",7,0,0,0,7
941423,615306,2017-03-29,Senate,"Senate Third Reading: Passed Roll Call # 87",37,0,0,1,38
941423,664324,2017-06-15,House,"Reported With Recommendation Without Amendment",9,0,0,0,9
941423,666850,2017-06-20,House,"House Third Reading: Given Immediate Effect Roll Call # 248",88,19,0,0,107
941423,685876,2018-01-17,Senate,"Senate Third Reading: Veto Override Approved By 2/3 Vote Roll Call # 8",37,0,0,1,38
941423,687496,2018-01-17,House,"House Third Reading: Bill Passed By 2/3 Vote Notwithstanding Governors Veto Roll Call # 7",85,23,0,0,108
941449,605427,2017-03-16,Senate,"Reported Favorably With Substitute  S-1",7,0,0,0,7
941449,615480,2017-03-29,Senate,"Senate Third Reading: Passed Roll Call # 88",37,0,0,1,38
941449,664283,2017-06-15,House,"Reported With Recommendation Without Amendment",11,0,0,0,11
941449,666991,2017-06-20,House,"House Third Reading: Given Immediate Effect Roll Call # 249",88,19,0,0,107
941449,685878,2018-01-17,Senate,"Senate Third Reading: Veto Override Approved By 2/3 Vote Roll Call # 9",37,0,0,1,38
941449,687254,2018-01-17,House,"House Third Reading: Bill Passed By 2/3 Vote Notwithstanding Governors Veto Roll Call # 8",85,23,0,0,108
941585,611208,2017-03-23,Senate,"Reported Favorably Without Amendment",7,0,0,0,7
941669,585554,2017-02-15,Senate,"Reported Favorably Without Amendment",5,0,0,0,5
941669,596349,2017-02-28,Senate,"Senate Third Reading: Passed Roll Call # 42",29,7,0,2,38
941832,583983,2017-02-14,Senate,"Reported Favorably Without Amendment",5,0,0,0,5
941891,599494,2017-03-07,House,"Reported With Recommendation Without Amendment",10,0,0,0,10
941891,605424,2017-03-16,House,"House Third Reading: Given Immediate Effect Roll Call # 47",108,0,0,0,108
941891,616147,2017-03-30,Senate,"Reported Favorably Without Amendment",4,0,0,0,4
941891,628071,2017-04-19,Senate,"Senate Third Reading: Given Immediate Effect Roll Call # 107",36,0,0,2,38
943125,641968,2017-05-09,House,"Reported With Recommendation With Substitute  H-4",14,0,0,0,14
943125,651172,2017-05-18,House,"House Third Reading: Given Immediate Effect Roll Call # 126",105,2,0,0,107
943125,668190,2017-06-20,Senate,"Reported Favorably With Substitute  S-3",4,0,0,0,4
943125,669898,2017-06-28,Senate,"Senate Third Reading: Given Immediate Effect Roll Call # 322",36,0,0,2,38
943125,672473,2017-07-12,House,"House Third Reading: Roll Call # 258",98,8,0,0,106
943125,672474,2017-07-12,House,"House Third Reading: Roll Call # 259",97,9,0,0,106
943162,603581,2017-03-14,House,"Reported With Recommendation Without Amendment",8,0,0,0,8
943162,605507,2017-03-16,House,"House Third Reading: Given Immediate Effect Roll Call # 37",108,0,0,0,108
943203,603499,2017-03-14,House,"Reported With Recommendation Without Amendment",8,0,0,0,8
943203,605450,2017-03-16,House,"House Third Reading: Given Immediate Effect Roll Call # 36",108,0,0,0,108
943279,603748,2017-03-14,House,"Reported With Recommendation Without Amendment",8,0,0,0,8
943279,605475,2017-03-16,House,"House Third Reading: Given Immediate Effect Roll Call # 41",108,0,0,0,108
943400,603719,2017-03-14,House,"Reported With Recommendation Without Amendment",8,0,0,0,8
943400,605492,2017-03-16,House,"House Third Reading: Given Immediate Effect Roll Call # 40",108,0,0,0,108
943630,603770,2017-03-14,House,"Reported With Recommendation With Substitute H-3",8,0,0,0,8
943630,605490,2017-03-16,House,"House Third Reading: Given Immediate Effect Roll Call # 42",108,0,0,0,108
943829,749057,2018-05-01,House,"Reported With Recommendation With Substitute  H-5",8,1,0,0,9
943829,750148,2018-05-01,House,"Reported With Recommendation With Substitute H-5",8,1,0,0,9
943829,752864,2018-05-08,House,"House Third Reading: Given Immediate Effect Roll Call # 277",83,26,0,0,109
943869,603736,2017-03-14,House,"Reported With Recommendation Without Amendment",8,0,0,0,8
943869,605618,2017-03-16,House,"House Third Reading: Given Immediate Effect Roll Call # 39",108,0,0,0,108
944027,603560,2017-03-14,House,"Reported With Recommendation Without Amendment",8,0,0,0,8
944027,605501,2017-03-16,House,"House Third Reading: Given Immediate Effect Roll Call # 44",108,0,0,0,108
944104,603561,2017-03-14,House,"Reported With Recommendation Without Amendment",8,0,0,0,8
944104,605497,2017-03-16,House,"House Third Reading: Given Immediate Effect Roll Call # 35",108,0,0,0,108
944141,603728,2017-03-14,House,"Reported With Recommendation Without Amendment",8,0,0,0,8
944141,605433,2017-03-16,House,"House Third Reading: Given Immediate Effect Roll Call # 38",108,0,0,0,108
944177,603713,2017-03-14,House,"Reported With Recommendation Without Amendment",8,0,0,0,8
944177,605496,2017-03-16,House,"House Third Reading: Given Immediate Effect Roll Call # 43",108,0,0,0,108
944733,591675,2017-02-22,Senate,"Reported Favorably Without Amendment",4,0,0,0,4
944733,596762,2017-03-02,Senate,"Senate Third Reading: Passed Roll Call # 44",26,11,0,1,38
944733,615531,2017-03-29,House,"Reported With Recommendation With Substitute  H-1",7,4,0,0,11
944733,633859,2017-04-26,House,"House Third Reading: Given Immediate Effect Roll Call # 74",77,32,0,0,109
944733,634973,2017-04-27,Senate,"Senate Third Reading: Roll Call # 119",26,10,0,2,38
944769,639919,2017-05-04,Senate,"Reported Favorably Without Amendment",5,0,0,0,5
944769,645207,2017-05-16,Senate,"Senate Third Reading: Passed Roll Call # 185",35,2,0,1,38
944769,677800,2017-10-05,House,"Reported With Recommendation With Substitute  H-1",14,1,0,0,15
944769,678103,2017-10-17,House,"House Third Reading: Given Immediate Effect Roll Call # 314",89,18,0,0,107
944769,678144,2017-10-18,Senate,"Senate Third Reading: Roll Call # 405",35,2,0,1,38
944803,595998,2017-02-28,Senate,"Reported Favorably Without Amendment",4,0,0,0,4
944803,676292,2017-09-14,Senate,"Senate Third Reading: Passed Roll Call # 334",31,3,0,3,37
944803,778934,2018-11-27,House,"Reported With Recommendation With Substitute H-1",9,0,0,0,9
944803,780649,2018-12-13,House,"House Third Reading: Given Immediate Effect Roll Call # 839",92,17,0,0,109
944803,781388,2018-12-19,Senate,"Senate Third Reading: Roll Call # 922",28,10,0,0,38
944850,595923,2017-02-28,Senate,"Reported Favorably Without Amendment",4,0,0,0,4
944850,676350,2017-09-14,Senate,"Senate Third Reading: Passed Roll Call # 335",32,3,0,3,38
944850,778937,2018-11-27,House,"Reported With Recommendation Without Amendment",9,0,0,0,9
944850,780629,2018-12-13,House,"House Third Reading: Given Immediate Effect Roll Call # 840",99,10,0,0,109
945013,586648,2017-02-16,Senate,"Reported Favorably Without Amendment",5,0,0,0,5
945013,592241,2017-02-23,Senate,"Senate Third Reading: Passed Roll Call # 40",32,4,0,2,38
945013,679438,2017-11-28,House,"Reported With Recommendation With Substitute  H-1",12,1,0,0,13
947988,615177,2017-03-28,House,"Reported With Recommendation Without Amendment",15,0,0,0,15
947988,649528,2017-05-18,Senate,"Reported Favorably Without Amendment",5,0,0,0,5
948391,604541,2017-03-15,House,"Reported With Recommendation Without Amendment",12,0,0,0,12
948391,611513,2017-03-23,House,"House Third Reading: Given Immediate Effect Roll Call # 56",97,11,0,0,108
948391,636668,2017-05-02,Senate,"Reported Favorably Without Amendment",5,0,0,0,5
948391,645316,2017-05-16,Senate,"Senate Third Reading: Given Immediate Effect Roll Call # 183",37,0,0,1,38
948467,664462,2017-06-14,House,"Reported With Recommendation Without Amendment",16,0,0,0,16
948467,666571,2017-06-20,House,"House Third Reading: Given Immediate Effect Roll Call # 245",105,2,0,0,107
948467,677845,2017-10-11,Senate,"Reported Favorably Without Amendment",10,0,0,0,10
948467,678604,2017-10-31,Senate,"Senate Third Reading: Given Immediate Effect Roll Call # 431",35,0,0,3,38
948596,605448,2017-03-16,House,"Reported With Recommendation Without Amendment",9,5,0,0,14
948646,616583,2017-03-30,House,"Reported With Recommendation Without Amendment",10,5,0,0,15
948646,636150,2017-04-27,House,"House Third Reading: Given Immediate Effect Roll Call # 77",62,47,0,0,109
948646,677848,2017-10-11,Senate,"Reported Favorably Without Amendment",4,0,0,0,4
948646,678670,2017-11-01,Senate,"Senate Third Reading: Given Immediate Effect Roll Call # 436",25,9,0,4,38
948668,664519,2017-06-14,House,"Reported With Recommendation With Substitute  H-1",16,0,0,0,16
948668,666735,2017-06-20,House,"House Third Reading: Given Immediate Effect Roll Call # 244",106,1,0,0,107
948668,677846,2017-10-11,Senate,"Reported Favorably With Substitute  S-1",10,0,0,0,10
948668,678606,2017-10-31,Senate,"Senate Third Reading: Given Immediate Effect Roll Call # 430",35,0,0,3,38
948668,678649,2017-11-01,House,"House Third Reading: Roll Call # 337",107,1,0,0,108
948696,639195,2017-05-03,House,"Reported With Recommendation Without Amendment",15,0,0,0,15
948696,651059,2017-05-25,House,"House Third Reading: Given Immediate Effect Roll Call # 145",103,4,0,0,107
948696,664379,2017-06-15,Senate,"Reported Favorably Without Amendment",5,0,0,0,5
948696,664380,2017-06-15,Senate,"Senate Third Reading: Given Immediate Effect Roll Call # 262",37,1,0,0,38
948816,664475,2017-06-14,House,"Reported With Recommendation Without Amendment",16,0,0,0,16
948816,666868,2017-06-20,House,"House Third Reading: Given Immediate Effect Roll Call # 246",105,2,0,0,107
948816,677836,2017-10-11,Senate,"Reported Favorably Without Amendment",10,0,0,0,10
948816,678607,2017-10-31,Senate,"Senate Third Reading: Given Immediate Effect Roll Call # 432",35,0,0,3,38
949012,651018,2017-05-23,House,"Reported With Recommendation With Substitute  H-1",14,0,0,0,14
949012,659600,2017-06-06,House,"House Third Reading: Given Immediate Effect Roll Call # 173",108,0,0,0,108
949012,718276,2018-03-06,Senate,"Reported Favorably Without Amendment",4,0,0,0,4
949012,719299,2018-03-07,Senate,"Senate Third Reading: Given Immediate Effect Roll Call # 133",35,0,0,2,37
950243,603662,2017-03-14,Senate,"Reported Favorably With Substitute  S-1",5,0,0,0,5
950243,610288,2017-03-22,Senate,"Senate Third Reading: Passed Roll Call # 77",38,0,0,0,38
950243,678083,2017-10-17,House,"Reported With Recommendation Without Amendment",13,0,0,0,13
950243,678665,2017-11-01,House,"House Third Reading: Given Immediate Effect Roll Call # 354",108,0,0,0,108
950243,678872,2017-11-07,Senate,"Senate Third Reading: Roll Call # 442",35,0,0,3,38
950271,589757,2017-02-21,Senate,"Reported Favorably Without Amendment",7,0,0,0,7
950271,591369,2017-02-22,Senate,"Senate Third Reading: Passed Roll Call # 36",27,6,0,5,38
950271,633786,2017-04-26,House,"Reported With Recommendation With Substitute  H-1",10,3,0,0,13
950271,639359,2017-05-04,House,"House Third Reading: Given Immediate Effect Roll Call # 95",85,22,0,0,107
950271,641869,2017-05-09,Senate,"Senate Third Reading: Roll Call # 175",32,6,0,0,38
950300,592397,2017-02-23,Senate,"Reported Favorably Without Amendment",4,0,0,0,4
950300,596212,2017-03-01,Senate,"Senate Third Reading: Passed Roll Call # 43",37,0,0,1,38
950300,628872,2017-04-19,House,"Reported With Recommendation With Substitute H-1",5,0,0,0,5
950300,631332,2017-04-19,House,"Reported With Recommendation With Substitute  H-1",5,0,0,0,5
950300,637034,2017-05-02,House,"House Third Reading: Given Immediate Effect Roll Call # 86",106,1,0,0,107
950300,639991,2017-05-04,Senate,"Senate Third Reading: Roll Call # 157",37,0,0,1,38
950385,590377,2017-02-21,Senate,"Reported Favorably Without Amendment",7,0,0,0,7
950385,591359,2017-02-22,Senate,"Senate Third Reading: Passed Roll Call # 39",28,6,0,4,38
950385,634153,2017-04-26,House,"Reported With Recommendation Without Amendment",10,3,0,0,13
950385,639213,2017-05-04,House,"House Third Reading: Given Immediate Effect Roll Call # 98",85,22,0,0,107
950385,645209,2017-05-16,Senate,"Senate Third Reading: House Amendment(s) Concurred In Roll Call # 181",31,6,0,1,38
950416,589738,2017-02-21,Senate,"Reported Favorably Without Amendment",7,0,0,0,7
950416,591386,2017-02-22,Senate,"Senate Third Reading: Passed Roll Call # 37",28,6,0,4,38
950416,633805,2017-04-26,House,"Reported With Recommendation Without Amendment",10,3,0,0,13
950416,639415,2017-05-04,House,"House Third Reading: Given Immediate Effect Roll Call # 96",83,24,0,0,107
950416,645900,2017-05-16,Senate,"Senate Third Reading: House Amendment(s) Concurred In Roll Call # 179",31,6,0,1,38
950501,660659,2017-06-07,Senate,"Reported Favorably With Substitute  S-5",5,0,0,0,5
950501,668121,2017-06-22,Senate,"Senate Third Reading: Passed Roll Call # 291",37,0,0,1,38
950501,677607,2017-10-04,House,"Reported With Recommendation Without Amendment",11,0,0,0,11
950501,678637,2017-11-01,House,"House Third Reading: Given Immediate Effect Roll Call # 339",102,6,0,0,108
950593,592246,2017-02-23,Senate,"Reported Favorably Without Amendment",16,0,0,0,16
950593,596910,2017-03-02,Senate,"Senate Third Reading: Passed Roll Call # 47",37,0,0,1,38
950593,615623,2017-03-29,House,"Reported With Recommendation Without Amendment",29,0,0,0,29
950593,632571,2017-04-25,House,"House Third Reading: Given Immediate Effect Roll Call # 70",108,1,0,0,109
950651,603472,2017-03-14,Senate,"Reported Favorably With Substitute  S-1",4,0,0,0,4
950651,646849,2017-05-18,Senate,"Senate Third Reading: Passed Roll Call # 195",35,2,0,1,38
950680,589978,2017-02-21,Senate,"Reported Favorably Without Amendment",7,0,0,0,7
950680,591292,2017-02-22,Senate,"Senate Third Reading: Passed Roll Call # 35",27,6,0,5,38
950680,633675,2017-04-26,House,"Reported With Recommendation With Substitute  H-1",10,3,0,0,13
950680,638175,2017-04-26,House,"Reported With Recommendation With Substitute H-1",10,3,0,0,13
950680,639528,2017-05-04,House,"House Third Reading: Given Immediate Effect Roll Call # 94",85,22,0,0,107
950680,641870,2017-05-09,Senate,"Senate Third Reading: Roll Call # 174",32,6,0,0,38
950710,703983,2018-02-15,Senate,"Reported Favorably With Substitute  S-1",5,0,0,0,5
950710,762498,2018-06-12,Senate,"Senate Third Reading: Passed Roll Call # 514",32,4,0,1,37
950710,780469,2018-12-11,House,"Reported With Recommendation Without Amendment",10,1,0,0,11
950710,781048,2018-12-18,House,"House Third Reading: Given Immediate Effect Roll Call # 873",95,14,0,0,109
950741,603554,2017-03-14,Senate,"Reported Favorably Without Amendment",4,0,0,0,4
950741,646705,2017-05-18,Senate,"Senate Third Reading: Passed Roll Call # 197",35,2,0,1,38
950771,603470,2017-03-14,Senate,"Reported Favorably With Substitute  S-2",4,0,0,0,4
950771,646613,2017-05-18,Senate,"Senate Third Reading: Passed Roll Call # 194",28,9,0,1,38
950799,603481,2017-03-14,Senate,"Reported Favorably With Substitute  S-1",4,0,0,0,4
950799,646718,2017-05-18,Senate,"Senate Third Reading: Passed Roll Call # 196",35,2,0,1,38
950829,590401,2017-02-21,Senate,"Reported Favorably Without Amendment",7,0,0,0,7
950829,591458,2017-02-22,Senate,"Senate Third Reading: Passed Roll Call # 38",29,5,0,4,38
950829,633808,2017-04-26,House,"Reported With Recommendation Without Amendment",10,3,0,0,13
950829,639519,2017-05-04,House,"House Third Reading: Given Immediate Effect Roll Call # 97",83,24,0,0,107
950829,645299,2017-05-16,Senate,"Senate Third Reading: House Amendment(s) Concurred In Roll Call # 180",31,6,0,1,38
950853,606107,2017-02-16,Senate,"Reported Favorably Without Amendment",5,0,0,0,5
951251,611248,2017-03-23,House,"Reported With Recommendation Without Amendment",10,0,0,0,10
951366,611022,2017-03-21,House,"Reported With Recommendation With Substitute  H-1",9,0,0,0,9
951366,651060,2017-05-24,House,"House Third Reading: Given Immediate Effect Roll Call # 140",100,7,0,0,107
951366,677604,2017-10-04,Senate,"Reported Favorably With Substitute  S-1",5,0,0,0,5
951366,678064,2017-10-17,Senate,"Senate Third Reading: Given Immediate Effect Roll Call # 393",38,0,0,0,38
951366,678416,2017-10-24,House,"House Third Reading: Roll Call # 321",101,6,0,0,107
951429,664359,2017-06-14,House,"Reported With Recommendation With Substitute  H-1",16,0,0,0,16
951429,666556,2017-06-20,House,"House Third Reading: Given Immediate Effect Roll Call # 247",105,2,0,0,107
951429,677844,2017-10-11,Senate,"Reported Favorably Without Amendment",10,0,0,0,10
951429,678603,2017-10-31,Senate,"Senate Third Reading: Given Immediate Effect Roll Call # 433",35,0,0,3,38
951487,616455,2017-03-30,House,"Reported With Recommendation Without Amendment",6,3,0,0,9
951487,636185,2017-04-27,House,"House Third Reading: Given Immediate Effect Roll Call # 79",63,46,0,0,109
951487,662831,2017-06-13,Senate,"Reported Favorably Without Amendment",4,0,0,0,4
951487,669917,2017-06-28,Senate,"Senate Third Reading: Given Immediate Effect Roll Call # 314",26,9,0,3,38
951665,616459,2017-03-30,House,"Reported With Recommendation Without Amendment",6,3,0,0,9
951665,636106,2017-04-27,House,"House Third Reading: Given Immediate Effect Roll Call # 78",63,46,0,0,109
951665,662630,2017-06-13,Senate,"Reported Favorably Without Amendment",4,0,0,0,4
951665,669923,2017-06-28,Senate,"Senate Third Reading: Given Immediate Effect Roll Call # 313",26,9,0,3,38
951904,681087,2017-12-12,House,"Reported With Recommendation With Substitute  H-2",12,0,0,0,12
951904,685245,2018-01-11,House,"House Third Reading: Given Immediate Effect Roll Call # 3",106,0,0,0,106
951904,757919,2018-05-30,Senate,"Reported Favorably Without Amendment",4,0,0,0,4
951904,762483,2018-06-12,Senate,"Senate Third Reading: Given Immediate Effect Roll Call # 456",36,0,0,1,37
953687,592348,2017-02-22,House,"Reported With Recommendation With Substitute H-1",5,0,0,0,5
953998,648860,2017-05-23,Senate,"Reported Favorably Without Amendment",3,0,0,0,3
953998,649710,2017-05-24,Senate,"Senate Third Reading: Passed Roll Call # 226",32,6,0,0,38
953998,696968,2018-02-07,House,"Reported With Recommendation For Referral To Committee On Agriculture",13,1,0,0,14
954030,632162,2017-04-25,Senate,"Reported Favorably With Substitute  S-1",16,0,0,0,16
954030,639915,2017-05-04,Senate,"Senate Third Reading: Passed Roll Call # 170",35,2,0,1,38
954030,646212,2017-05-17,House,"House Third Reading: Passed Roll Call # 114",63,44,0,0,107
954030,649619,2017-05-24,Senate,"Senate Third Reading: Roll Call # 214",0,38,0,0,38
954058,637070,2017-05-02,Senate,"Reported Favorably With Substitute  S-1",15,0,0,0,15
954058,640003,2017-05-04,Senate,"Senate Third Reading: Passed Roll Call # 164",35,2,0,1,38
954058,640004,2017-05-04,Senate,"Senate Third Reading: Passed Roll Call # 167",33,4,0,1,38
954058,646083,2017-05-17,House,"House Third Reading: Passed Roll Call # 117",63,44,0,0,107
954058,649909,2017-05-24,Senate,"Senate Third Reading: Roll Call # 217",0,38,0,0,38
954120,636139,2017-04-27,House,"Reported With Recommendation With Substitute  H-1",4,2,0,0,6
954120,659421,2017-05-31,House,"House Third Reading: Given Immediate Effect Roll Call # 165",96,12,0,0,108
954183,632480,2017-04-25,Senate,"Reported Favorably With Substitute  S-1",17,0,0,0,17
954183,639949,2017-05-04,Senate,"Senate Third Reading: Passed Roll Call # 169",37,0,0,1,38
954183,646116,2017-05-17,House,"House Third Reading: Passed Roll Call # 113",63,44,0,0,107
954183,649603,2017-05-24,Senate,"Senate Third Reading: Roll Call # 213",0,38,0,0,38
954211,636947,2017-05-02,Senate,"Reported Favorably With Substitute  S-1",12,5,0,0,17
954211,639926,2017-05-04,Senate,"Senate Third Reading: Passed Roll Call # 163",22,15,0,1,38
954245,638740,2017-05-03,Senate,"Reported Favorably With Substitute  S-3",12,5,0,0,17
954245,638741,2017-05-03,Senate,"Senate Third Reading: Passed Roll Call # 156",25,13,0,0,38
954275,601111,2017-03-09,Senate,"Reported Favorably Without Amendment",4,0,0,0,4
954275,603457,2017-03-14,Senate,"Senate Third Reading: Passed Roll Call # 70",36,1,0,1,38
954275,646032,2017-05-17,House,"Reported With Recommendation Without Amendment",16,0,0,0,16
954275,655403,2017-05-30,House,"House Third Reading: Given Immediate Effect Roll Call # 157",108,0,0,0,108
954365,592501,2017-02-23,Senate,"Reported Favorably Without Amendment",5,0,0,0,5
954365,596850,2017-03-02,Senate,"Senate Third Reading: Passed Roll Call # 46",37,0,0,1,38
954365,736441,2018-04-10,House,"Reported With Recommendation For Referral To Committee On Families, Children, And Seniors",10,1,0,0,11
954397,611193,2017-03-23,Senate,"Reported Favorably Without Amendment",17,0,0,0,17
954397,627207,2017-04-18,Senate,"Senate Third Reading: Passed Roll Call # 103",36,0,0,2,38
954552,632182,2017-04-25,Senate,"Reported Favorably With Substitute  S-1",11,5,0,0,16
954552,637932,2017-05-03,Senate,"Senate Third Reading: Passed Roll Call # 133",27,11,0,0,38
954581,592019,2017-02-23,Senate,"Reported Favorably With Substitute  S-1",5,0,0,0,5
954647,677379,2017-09-28,Senate,"Reported Favorably Without Amendment",5,0,0,0,5
954647,755910,2018-05-23,Senate,"Senate Third Reading: Passed Roll Call # 336",37,0,0,0,37
954675,677376,2017-09-28,Senate,"Reported Favorably Without Amendment",5,0,0,0,5
954675,755828,2018-05-23,Senate,"Senate Third Reading: Passed Roll Call # 335",36,1,0,0,37
954705,758333,2018-05-29,House,"Reported With Recommendation With Substitute  H-3",13,1,0,0,14
954705,759600,2018-05-29,House,"Reported With Recommendation With Substitute H-3",13,1,0,0,14
954705,759815,2018-06-05,House,"House Third Reading: Given Immediate Effect Roll Call # 451",102,6,0,0,108
954705,762512,2018-06-12,Senate,"Reported Favorably Without Amendment",15,1,0,0,16
954705,762513,2018-06-12,Senate,"Senate Third Reading: Given Immediate Effect Roll Call # 499",36,0,0,1,37
954732,592022,2017-02-23,Senate,"Reported Favorably Without Amendment",4,1,0,0,5
954732,600993,2017-03-09,Senate,"Senate Third Reading: Passed Roll Call # 67",24,11,0,3,38
954732,615111,2017-03-29,House,"Reported With Recommendation Without Amendment",7,2,0,0,9
954732,632282,2017-04-25,House,"House Third Reading: Given Immediate Effect Roll Call # 72",74,35,0,0,109
954795,636945,2017-05-02,Senate,"Reported Favorably With Substitute  S-1",15,1,0,0,16
954795,639940,2017-05-04,Senate,"Senate Third Reading: Passed Roll Call # 159",35,2,0,1,38
954795,645982,2017-05-17,House,"House Third Reading: Passed Roll Call # 116",63,44,0,0,107
954795,649510,2017-05-24,Senate,"Senate Third Reading: Roll Call # 216",0,38,0,0,38
954825,636955,2017-05-02,Senate,"Reported Favorably With Substitute  S-1",10,6,0,0,16
954825,637987,2017-05-03,Senate,"Senate Third Reading: Passed Roll Call # 142",23,15,0,0,38
954825,781628,2018-12-21,House,"House Third Reading: Given Immediate Effect Roll Call # 1000",96,11,0,0,107
954825,781629,2018-12-21,Senate,"Senate Third Reading: Roll Call # 1045",38,0,0,0,38
954856,592043,2017-02-22,House,"Reported With Recommendation Without Amendment",11,0,0,0,11
954856,596181,2017-03-01,House,"House Third Reading: Given Immediate Effect Roll Call # 7",100,8,0,0,108
954856,662520,2017-06-13,Senate,"Reported Favorably Without Amendment",4,0,0,0,4
954856,667978,2017-06-22,Senate,"Senate Third Reading: Given Immediate Effect Roll Call # 307",36,1,0,1,38
954886,632085,2017-04-25,Senate,"Reported Favorably With Substitute  S-1",17,0,0,0,17
954886,639909,2017-05-04,Senate,"Senate Third Reading: Passed Roll Call # 168",37,0,0,1,38
954886,646154,2017-05-17,House,"House Third Reading: Passed Roll Call # 119",64,43,0,0,107
954886,649486,2017-05-24,Senate,"Senate Third Reading: Roll Call # 219",0,38,0,0,38
954918,632679,2017-04-25,Senate,"Reported Favorably With Substitute  S-1",17,0,0,0,17
954918,639989,2017-05-04,Senate,"Senate Third Reading: Passed Roll Call # 166",37,0,0,1,38
954918,645999,2017-05-17,House,"House Third Reading: Passed Roll Call # 118",63,44,0,0,107
954918,649585,2017-05-24,Senate,"Senate Third Reading: Roll Call # 218",0,38,0,0,38
954948,677312,2017-09-26,Senate,"Reported Favorably With Substitute  S-1",15,0,0,0,15
954948,677354,2017-09-27,Senate,"Senate Third Reading: Passed Roll Call # 350",35,2,0,1,38
954948,677799,2017-10-05,House,"Reported With Recommendation With Substitute  H-1",29,0,0,0,29
954948,677814,2017-10-10,House,"House Third Reading: Given Immediate Effect Roll Call # 297",105,1,0,0,106
954948,678151,2017-10-18,Senate,"Senate Third Reading: Roll Call # 404",36,1,0,1,38
954979,632497,2017-04-25,Senate,"Reported Favorably With Substitute  S-1",12,5,0,0,17
954979,637688,2017-05-03,Senate,"Senate Third Reading: Passed Roll Call # 131",38,0,0,0,38
954979,646191,2017-05-17,House,"House Third Reading: Passed Roll Call # 115",63,44,0,0,107
954979,649572,2017-05-24,Senate,"Senate Third Reading: Roll Call # 215",0,38,0,0,38
955009,592193,2017-02-23,Senate,"Reported Favorably With Substitute  S-1",5,0,0,0,5
955071,645383,2017-05-16,House,"Reported With Recommendation Without Amendment",13,0,0,0,13
955071,659544,2017-06-06,House,"House Third Reading: Given Immediate Effect Roll Call # 172",108,0,0,0,108
955071,699567,2018-02-06,Senate,"Reported Favorably Without Amendment",5,0,0,0,5
955071,707608,2018-02-21,Senate,"Senate Third Reading: Given Immediate Effect Roll Call # 103",36,0,0,2,38
955100,637049,2017-05-02,Senate,"Reported Favorably With Substitute  S-1",16,0,0,0,16
955100,639905,2017-05-04,Senate,"Senate Third Reading: Passed Roll Call # 165",37,0,0,1,38
955162,639917,2017-05-04,Senate,"Senate Third Reading: Passed Roll Call # 173",26,11,0,1,38
955162,646128,2017-05-17,House,"House Third Reading: Given Immediate Effect Roll Call # 112",63,44,0,0,107
955162,649530,2017-05-24,Senate,"Senate Third Reading: Roll Call # 212",0,38,0,0,38
955193,636894,2017-05-02,Senate,"Reported Favorably With Substitute  S-1",17,0,0,0,17
955193,640202,2017-05-04,Senate,"Senate Third Reading: Passed Roll Call # 161",32,5,0,1,38
955226,592546,2017-02-23,Senate,"Reported Favorably Without Amendment",5,0,0,0,5
955226,596795,2017-03-02,Senate,"Senate Third Reading: Passed Roll Call # 45",37,0,0,1,38
955226,737074,2018-04-10,House,"Reported With Recommendation For Referral To Committee On Families, Children, And Seniors",10,1,0,0,11
955255,632382,2017-04-25,House,"Reported With Recommendation Without Amendment",7,2,0,0,9
955288,636639,2017-05-02,Senate,"Reported Favorably With Substitute  S-1",16,0,0,0,16
955288,639916,2017-05-04,Senate,"Senate Third Reading: Passed Roll Call # 160",37,0,0,1,38
955317,632498,2017-04-25,Senate,"Reported Favorably With Substitute  S-1",17,0,0,0,17
955317,639903,2017-05-04,Senate,"Senate Third Reading: Passed Roll Call # 172",32,5,0,1,38
955317,646219,2017-05-17,House,"House Third Reading: Passed Roll Call # 120",63,44,0,0,107
955317,649501,2017-05-24,Senate,"Senate Third Reading: Roll Call # 220",0,38,0,0,38
955345,632698,2017-04-25,Senate,"Reported Favorably With Substitute  S-1",12,5,0,0,17
955345,637802,2017-05-03,Senate,"Senate Third Reading: Passed Roll Call # 136",26,12,0,0,38
957472,599245,2017-03-07,Senate,"Reported Favorably Without Amendment",8,0,0,0,8
957472,616779,2017-03-28,House,"Reported With Recommendation Without Amendment",18,0,0,0,18
960075,600995,2017-03-09,Senate,"Reported Favorably Without Amendment",4,0,0,0,4
960075,603823,2017-03-14,Senate,"Senate Third Reading: Passed Roll Call # 71",37,0,0,1,38
960075,646054,2017-05-17,House,"Reported With Recommendation Without Amendment",16,0,0,0,16
960075,659317,2017-05-31,House,"House Third Reading: Given Immediate Effect Roll Call # 166",108,0,0,0,108
960075,659318,2017-06-06,Senate,"Senate Third Reading: House Amendment(s) Concurred In Roll Call # 233",36,0,0,2,38
960190,611318,2017-03-23,Senate,"Reported Favorably With Substitute  S-2",4,1,0,0,5
960370,597140,2017-03-02,House,"Reported With Recommendation Without Amendment",7,2,0,0,9
960370,603530,2017-03-09,House,"House Third Reading: Given Immediate Effect Roll Call # 32",72,36,0,0,108
960370,641914,2017-05-09,Senate,"Reported Favorably Without Amendment",4,0,0,0,4
960370,679481,2017-11-29,Senate,"Senate Third Reading: Given Immediate Effect Roll Call # 463",35,3,0,0,38
960452,611821,2017-03-16,Senate,"Reported Favorably Without Amendment",4,0,0,0,4
960452,679564,2017-11-08,House,"Reported With Recommendation With Substitute  H-1",5,0,0,0,5
960472,702235,2018-02-13,House,"Reported With Recommendation With Substitute  H-1",14,0,0,0,14
960472,725843,2018-02-13,House,"Reported With Recommendation With Substitute H-1",14,0,0,0,14
960472,727076,2018-03-21,House,"House Third Reading: Given Immediate Effect Roll Call # 184",106,2,0,0,108
960472,762331,2018-06-12,Senate,"Reported Favorably Without Amendment",15,1,0,0,16
960472,762332,2018-06-12,Senate,"Senate Third Reading: Passed Roll Call # 500",36,0,0,1,37
960472,764798,2018-06-12,House,"House Third Reading: Roll Call # 547",107,2,0,0,109
960516,611379,2017-03-23,House,"Reported With Recommendation With Substitute H-3",4,2,0,0,6
960516,614416,2017-03-23,House,"Reported With Recommendation With Substitute  H-3",4,2,0,0,6
960516,650968,2017-05-18,House,"House Third Reading: Given Immediate Effect Roll Call # 121",57,50,0,0,107
960516,677804,2017-10-10,Senate,"Reported Favorably With Substitute  S-1",4,0,0,0,4
960516,780122,2018-12-05,Senate,"Senate Third Reading: Given Immediate Effect Roll Call # 681",24,13,1,0,38
960516,780412,2018-12-11,House,"House Third Reading: Roll Call # 778",57,51,0,0,108
960516,780517,2018-12-12,House,"House Third Reading: Roll Call # 820",57,52,0,0,109
960516,780685,2018-12-13,Senate,"Senate Third Reading: Roll Call # 831",23,14,0,1,38
960565,599500,2017-03-07,House,"Reported With Recommendation Without Amendment",9,0,0,0,9
960565,610786,2017-03-21,House,"House Third Reading: Given Immediate Effect Roll Call # 51",108,0,0,0,108
960565,628215,2017-04-19,Senate,"Reported Favorably Without Amendment",5,0,0,0,5
960565,634838,2017-04-27,Senate,"Senate Third Reading: Given Immediate Effect Roll Call # 124",36,0,0,2,38
960629,599503,2017-03-07,House,"Reported With Recommendation Without Amendment",9,0,0,0,9
960629,610568,2017-03-21,House,"House Third Reading: Given Immediate Effect Roll Call # 52",108,0,0,0,108
960629,628529,2017-04-19,Senate,"Reported Favorably Without Amendment",5,0,0,0,5
960629,634912,2017-04-27,Senate,"Senate Third Reading: Given Immediate Effect Roll Call # 125",36,0,0,2,38
960653,636738,2017-05-02,House,"Reported With Recommendation With Substitute  H-2",11,2,0,0,13
960653,678914,2017-11-07,House,"House Third Reading: Given Immediate Effect Roll Call # 377",83,24,0,0,107
960653,679925,2017-12-05,Senate,"Reported Favorably Without Amendment",8,0,0,0,8
960653,680770,2017-12-13,Senate,"Senate Third Reading: Given Immediate Effect Roll Call # 555",33,4,0,1,38
962391,639485,2017-05-03,House,"Reported With Recommendation With Substitute  H-3",18,10,0,0,28
962391,646043,2017-05-17,House,"House Third Reading: Passed Roll Call # 104",63,44,0,0,107
962391,648846,2017-05-23,Senate,"Senate Third Reading: Passed Roll Call # 204",28,10,0,0,38
962391,650882,2017-05-24,House,"House Third Reading: Roll Call # 131",0,107,0,0,107
962403,601290,2017-03-09,Senate,"Reported Favorably Without Amendment",4,0,0,0,4
962413,608671,2017-03-21,Senate,"Reported Favorably With Substitute  S-1",4,0,0,0,4
962413,614055,2017-03-28,Senate,"Senate Third Reading: Passed Roll Call # 85",37,0,0,1,38
962413,655409,2017-05-30,House,"Reported With Recommendation Without Amendment",14,0,0,0,14
962413,662655,2017-06-13,House,"House Third Reading: Given Immediate Effect Roll Call # 199",96,11,0,0,107
962423,614381,2017-03-28,Senate,"Reported Favorably Without Amendment",5,0,0,0,5
962423,627249,2017-04-18,Senate,"Senate Third Reading: Passed Roll Call # 104",36,0,0,2,38
962423,659655,2017-06-06,House,"Reported With Recommendation With Substitute H-1",9,5,0,0,14
962423,660748,2017-06-06,House,"Reported With Recommendation With Substitute  H-1",9,5,0,0,14
962423,666613,2017-06-20,House,"House Third Reading: Given Immediate Effect Roll Call # 234",68,39,0,0,107
962423,667959,2017-06-22,Senate,"Senate Third Reading: Roll Call # 282",37,0,0,1,38
962494,641877,2017-05-09,Senate,"Reported Favorably Without Amendment",5,0,0,0,5
962508,774974,2018-09-25,House,"Reported With Recommendation With Substitute H-2",13,1,0,0,14
962508,775325,2018-09-25,House,"Reported With Recommendation With Substitute  H-2",13,1,0,0,14
962508,775362,2018-10-03,House,"House Third Reading: Given Immediate Effect Roll Call # 602",71,36,0,0,107
962517,608591,2017-03-21,Senate,"Reported Favorably Without Amendment",9,0,0,0,9
962517,613927,2017-03-28,Senate,"Senate Third Reading: Passed Roll Call # 84",37,0,0,1,38
962517,636064,2017-04-27,House,"Reported With Recommendation Without Amendment",15,1,0,0,16
962517,646310,2017-05-17,House,"House Third Reading: Given Immediate Effect Roll Call # 101",103,4,0,0,107
962553,627282,2017-04-18,Senate,"Reported Favorably With Substitute  S-1",3,1,0,0,4
962553,634984,2017-04-27,Senate,"Senate Third Reading: Passed Roll Call # 123",25,11,0,2,38
962553,645472,2017-05-16,House,"Reported With Recommendation Without Amendment",9,4,0,0,13
962553,650894,2017-05-25,House,"House Third Reading: Given Immediate Effect Roll Call # 152",65,43,0,0,108
962563,660339,2017-06-07,Senate,"Reported Favorably With Substitute  S-1",7,0,0,0,7
962563,668216,2017-06-22,Senate,"Senate Third Reading: Passed Roll Call # 296",36,1,0,1,38
962563,677585,2017-10-04,House,"Reported With Recommendation With Substitute  H-2",16,1,0,0,17
962563,681168,2017-12-13,House,"House Third Reading: Given Immediate Effect Roll Call # 479",86,24,0,0,110
962563,681169,2017-12-13,Senate,"Senate Third Reading: Roll Call # 562",36,1,0,1,38
962574,632459,2017-04-25,House,"Reported With Recommendation Without Amendment",12,0,0,0,12
962574,639416,2017-05-03,House,"House Third Reading: Given Immediate Effect Roll Call # 89",106,0,0,0,106
962574,646863,2017-05-18,Senate,"Reported Favorably With Substitute  S-1",5,0,0,0,5
962574,654667,2017-05-30,Senate,"Senate Third Reading: Given Immediate Effect Roll Call # 227",38,0,0,0,38
962574,658948,2017-06-06,House,"House Third Reading: Roll Call # 170",108,0,0,0,108
962585,638718,2017-05-03,House,"Reported With Recommendation With Substitute  H-3",18,10,0,0,28
962585,646136,2017-05-17,House,"House Third Reading: Passed Roll Call # 108",63,44,0,0,107
962585,649118,2017-05-23,Senate,"Senate Third Reading: Passed Roll Call # 208",27,11,0,0,38
962585,651255,2017-05-24,House,"House Third Reading: Roll Call # 135",0,107,0,0,107
962619,639512,2017-05-03,House,"Reported With Recommendation With Substitute  H-2",18,10,0,0,28
962619,646025,2017-05-17,House,"House Third Reading: Passed Roll Call # 110",63,44,0,0,107
962619,648887,2017-05-23,Senate,"Senate Third Reading: Passed Roll Call # 210",27,11,0,0,38
962619,650947,2017-05-24,House,"House Third Reading: Roll Call # 137",0,107,0,0,107
962654,678439,2017-10-24,House,"Reported With Recommendation With Substitute  H-1",10,0,0,0,10
962654,678645,2017-11-01,House,"House Third Reading: Given Immediate Effect Roll Call # 356",107,1,0,0,108
962654,680082,2017-12-06,Senate,"Reported Favorably Without Amendment",5,0,0,0,5
962654,688456,2018-01-24,Senate,"Senate Third Reading: Given Immediate Effect Roll Call # 27",36,2,0,0,38
962664,615245,2017-03-28,House,"Reported With Recommendation With Substitute  H-4",9,5,0,0,14
962664,637001,2017-05-02,House,"House Third Reading: Given Immediate Effect Roll Call # 84",77,30,0,0,107
962664,654703,2017-05-30,Senate,"Reported Favorably Without Amendment",3,1,0,0,4
962664,662524,2017-06-13,Senate,"Senate Third Reading: Given Immediate Effect Roll Call # 249",30,6,0,2,38
962679,632430,2017-04-25,House,"Reported With Recommendation Without Amendment",12,0,0,0,12
962679,639405,2017-05-03,House,"House Third Reading: Given Immediate Effect Roll Call # 90",106,0,0,0,106
962679,646708,2017-05-18,Senate,"Reported Favorably With Substitute  S-1",5,0,0,0,5
962679,654838,2017-05-30,Senate,"Senate Third Reading: Given Immediate Effect Roll Call # 228",38,0,0,0,38
962679,659440,2017-06-06,House,"House Third Reading: Roll Call # 171",108,0,0,0,108
962688,638720,2017-05-03,House,"Reported With Recommendation With Substitute  H-3",18,10,0,0,28
962688,646106,2017-05-17,House,"House Third Reading: Passed Roll Call # 109",63,44,0,0,107
962688,648911,2017-05-23,Senate,"Senate Third Reading: Passed Roll Call # 209",27,11,0,0,38
962688,651034,2017-05-24,House,"House Third Reading: Roll Call # 136",0,107,0,0,107
962700,599469,2017-03-07,House,"Reported With Recommendation Without Amendment",12,0,0,0,12
962700,610540,2017-03-22,House,"House Third Reading: Given Immediate Effect Roll Call # 53",108,0,0,0,108
962700,639913,2017-05-04,Senate,"Reported Favorably Without Amendment",4,0,0,0,4
962700,645280,2017-05-16,Senate,"Senate Third Reading: Given Immediate Effect Roll Call # 186",37,0,0,1,38
962747,599491,2017-03-07,House,"Reported With Recommendation Without Amendment",8,1,0,0,9
962747,646090,2017-05-17,House,"House Third Reading: Given Immediate Effect Roll Call # 102",106,1,0,0,107
962747,659312,2017-06-06,Senate,"Reported Favorably Without Amendment",4,0,0,0,4
962747,661109,2017-06-08,Senate,"Senate Third Reading: Given Immediate Effect Roll Call # 245",37,0,0,1,38
962758,639489,2017-05-03,House,"Reported With Recommendation With Substitute  H-2",18,10,0,0,28
962758,646022,2017-05-17,House,"House Third Reading: Passed Roll Call # 107",63,44,0,0,107
962758,648934,2017-05-23,Senate,"Senate Third Reading: Passed Roll Call # 207",27,11,0,0,38
962758,651072,2017-05-24,House,"House Third Reading: Roll Call # 134",0,107,0,0,107
962780,638714,2017-05-03,House,"Reported With Recommendation With Substitute  H-2",18,10,0,0,28
962780,646072,2017-05-17,House,"House Third Reading: Passed Roll Call # 106",63,44,0,0,107
962780,648936,2017-05-23,Senate,"Senate Third Reading: Passed Roll Call # 206",27,11,0,0,38
962780,651062,2017-05-24,House,"House Third Reading: Roll Call # 133",0,107,0,0,107
962803,610503,2017-03-21,House,"Reported With Recommendation Without Amendment",12,0,0,0,12
962803,615535,2017-03-29,House,"House Third Reading: Given Immediate Effect Roll Call # 59",102,6,0,0,108
962803,639910,2017-05-04,Senate,"Reported Favorably Without Amendment",4,0,0,0,4
962803,668298,2017-06-22,Senate,"Senate Third Reading: Given Immediate Effect Roll Call # 289",37,0,0,1,38
962814,638721,2017-05-03,House,"Reported With Recommendation With Substitute  H-2",18,10,0,0,28
962814,646264,2017-05-17,House,"House Third Reading: Passed Roll Call # 111",63,44,0,0,107
962814,648912,2017-05-23,Senate,"Senate Third Reading: Passed Roll Call # 211",26,12,0,0,38
962814,650916,2017-05-24,House,"House Third Reading: Roll Call # 138",0,107,0,0,107
962837,660226,2017-06-07,Senate,"Reported Favorably With Substitute  S-1",7,0,0,0,7
962837,668188,2017-06-22,Senate,"Senate Third Reading: Passed Roll Call # 297",36,1,0,1,38
962837,677588,2017-10-04,House,"Reported With Recommendation With Substitute  H-2",16,1,0,0,17
962837,681166,2017-12-13,House,"House Third Reading: Given Immediate Effect Roll Call # 480",83,27,0,0,110
962837,681167,2017-12-13,Senate,"Senate Third Reading: Roll Call # 563",35,2,0,1,38
962891,638704,2017-05-03,House,"Reported With Recommendation With Substitute  H-2",18,10,0,0,28
962891,646298,2017-05-17,House,"House Third Reading: Passed Roll Call # 105",63,44,0,0,107
962891,648933,2017-05-23,Senate,"Senate Third Reading: Passed Roll Call # 205",27,11,0,0,38
962891,651043,2017-05-24,House,"House Third Reading: Roll Call # 132",0,107,0,0,107
968359,677381,2017-09-28,Senate,"Reported Favorably Without Amendment",5,0,0,0,5
968359,755818,2018-05-23,Senate,"Senate Third Reading: Passed Roll Call # 337",36,1,0,0,37
968587,760690,2018-06-06,Senate,"Reported Favorably With Substitute  S-1",4,0,0,0,4
968587,761098,2018-06-07,Senate,"Senate Third Reading: Passed Roll Call # 429",35,1,0,1,37
968587,764367,2018-06-12,House,"Reported With Recommendation Without Amendment",9,0,0,0,9
968587,764368,2018-06-12,House,"House Third Reading: Given Immediate Effect Roll Call # 490",90,19,0,0,109
968587,764369,2018-06-12,Senate,"Senate Third Reading: House Amendment(s) Concurred In Roll Call # 548",36,0,0,1,37
969108,605646,2017-03-16,House,"Reported With Recommendation Without Amendment",6,0,0,0,6
969108,615106,2017-03-28,House,"House Third Reading: Given Immediate Effect Roll Call # 58",107,0,0,0,107
969108,780080,2018-12-05,Senate,"Reported Favorably With Substitute S-1",5,0,0,0,5
969108,780081,2018-12-05,Senate,"Senate Third Reading: Given Immediate Effect Roll Call # 696",37,0,0,1,38
969108,780082,2018-12-06,House,"House Third Reading: Roll Call # 716",107,2,0,0,109
969971,662837,2017-06-13,Senate,"Reported Favorably With Substitute  S-2",4,0,0,0,4
970099,608545,2017-03-21,Senate,"Reported Favorably With Substitute  S-1",4,0,0,0,4
970099,635164,2017-04-27,Senate,"Senate Third Reading: Passed Roll Call # 120",33,3,0,2,38
970099,680019,2017-12-05,House,"Reported With Recommendation With Substitute H-2",12,2,0,0,14
970099,738383,2017-12-05,House,"Reported With Recommendation With Substitute  H-2",12,2,0,0,14
970099,764581,2018-06-12,House,"House Third Reading: Given Immediate Effect Roll Call # 525",80,29,0,0,109
970099,764582,2018-06-12,Senate,"Senate Third Reading: Roll Call # 552",35,1,0,1,37
970357,603475,2017-03-14,Senate,"Reported Favorably Without Amendment",5,0,0,0,5
970357,605439,2017-03-16,Senate,"Senate Third Reading: Passed Roll Call # 75",37,0,0,1,38
970357,636840,2017-05-02,House,"Reported With Recommendation Without Amendment",14,0,0,0,14
970357,650859,2017-05-18,House,"House Third Reading: Given Immediate Effect Roll Call # 122",107,0,0,0,107
971555,599373,2017-03-07,Senate,"Reported Favorably Without Amendment",8,0,0,0,8
971555,616783,2017-03-28,House,"Reported With Recommendation Without Amendment",18,0,0,0,18
972021,599168,2017-03-07,Senate,"Reported Favorably Without Amendment",8,0,0,0,8
972021,616780,2017-03-28,House,"Reported With Recommendation Without Amendment",18,0,0,0,18
972948,610374,2017-03-21,House,"Reported With Recommendation Without Amendment",9,0,0,0,9
972951,718936,2018-03-06,House,"Reported With Recommendation With Substitute  H-3",13,0,0,0,13
972951,725042,2018-03-06,House,"Reported With Recommendation With Substitute H-3",13,0,0,0,13
972951,727294,2018-03-21,House,"House Third Reading: Given Immediate Effect Roll Call # 185",98,10,0,0,108
972951,762682,2018-06-12,Senate,"Reported Favorably With Substitute  S-1",15,1,0,0,16
972951,762683,2018-06-12,Senate,"Senate Third Reading: Given Immediate Effect Roll Call # 501",35,1,0,1,37
972951,764409,2018-06-12,House,"House Third Reading: Roll Call # 548",99,10,0,0,109
973588,611182,2017-03-23,Senate,"Reported Favorably Without Amendment",6,3,0,0,9
973588,615374,2017-03-29,Senate,"Senate Third Reading: Passed Roll Call # 92",24,13,0,1,38
973680,616176,2017-03-30,Senate,"Reported Favorably With Substitute  S-1",5,0,0,0,5
973680,637010,2017-05-02,Senate,"Senate Third Reading: Passed Roll Call # 129",35,0,0,3,38
973680,664378,2017-06-15,House,"Reported With Recommendation With Substitute H-1",10,0,0,0,10
973680,668456,2017-06-15,House,"Reported With Recommendation With Substitute  H-1",10,0,0,0,10
973680,680220,2017-12-06,House,"House Third Reading: Given Immediate Effect Roll Call # 433",96,14,0,0,110
973680,680606,2017-12-12,Senate,"Senate Third Reading: Roll Call # 505",38,0,0,0,38
973771,644147,2017-05-10,Senate,"Reported Favorably Without Amendment",6,3,0,0,9
973861,605401,2017-03-16,Senate,"Reported Favorably With Substitute  S-1",6,0,0,0,6
973861,615436,2017-03-29,Senate,"Senate Third Reading: Passed Roll Call # 90",37,0,0,1,38
973958,605510,2017-03-16,Senate,"Reported Favorably Without Amendment",6,0,0,0,6
973958,615172,2017-03-29,Senate,"Senate Third Reading: Passed Roll Call # 91",37,0,0,1,38
974149,605526,2017-03-16,Senate,"Reported Favorably Without Amendment",6,0,0,0,6
974149,615399,2017-03-29,Senate,"Senate Third Reading: Passed Roll Call # 94",37,0,0,1,38
974247,616190,2017-03-30,Senate,"Reported Favorably With Substitute  S-1",5,0,0,0,5
974247,636822,2017-05-02,Senate,"Senate Third Reading: Passed Roll Call # 128",35,0,0,3,38
974247,664361,2017-06-15,House,"Reported With Recommendation With Substitute H-1",10,0,0,0,10
974247,668702,2017-06-15,House,"Reported With Recommendation With Substitute  H-1",10,0,0,0,10
974247,680215,2017-12-06,House,"House Third Reading: Given Immediate Effect Roll Call # 432",95,15,0,0,110
974247,680608,2017-12-12,Senate,"Senate Third Reading: Roll Call # 504",38,0,0,0,38
974432,616205,2017-03-30,Senate,"Reported Favorably With Substitute  S-1",5,0,0,0,5
974432,636751,2017-05-02,Senate,"Senate Third Reading: Passed Roll Call # 127",35,0,0,3,38
974432,664273,2017-06-15,House,"Reported With Recommendation With Substitute H-1",10,0,0,0,10
974432,668431,2017-06-15,House,"Reported With Recommendation With Substitute  H-1",10,0,0,0,10
974432,680302,2017-12-06,House,"House Third Reading: Given Immediate Effect Roll Call # 431",95,15,0,0,110
974432,680623,2017-12-12,Senate,"Senate Third Reading: Roll Call # 503",38,0,0,0,38
974531,605446,2017-03-16,Senate,"Reported Favorably With Substitute  S-1",6,0,0,0,6
974531,615392,2017-03-29,Senate,"Senate Third Reading: Passed Roll Call # 93",37,0,0,1,38
974627,616183,2017-03-30,Senate,"Reported Favorably With Substitute  S-1",5,0,0,0,5
974627,636679,2017-05-02,Senate,"Senate Third Reading: Passed Roll Call # 130",36,0,0,2,38
974627,664387,2017-06-15,House,"Reported With Recommendation Without Amendment",10,0,0,0,10
974627,680251,2017-12-06,House,"House Third Reading: Given Immediate Effect Roll Call # 434",95,15,0,0,110
974717,645403,2017-05-16,Senate,"Reported Favorably Without Amendment",7,0,0,0,7
974717,670048,2017-06-28,Senate,"Senate Third Reading: Passed Roll Call # 319",33,3,0,2,38
974812,605498,2017-03-16,Senate,"Reported Favorably With Substitute  S-1",6,0,0,0,6
974812,615268,2017-03-29,Senate,"Senate Third Reading: Passed Roll Call # 89",37,0,0,1,38
974905,605521,2017-03-16,Senate,"Reported Favorably Without Amendment",6,0,0,0,6
974905,615471,2017-03-29,Senate,"Senate Third Reading: Passed Roll Call # 95",37,0,0,1,38
977728,601043,2017-03-09,Senate,"Reported Favorably Without Amendment",3,1,0,0,4
977806,611181,2017-03-23,Senate,"Reported Favorably Without Amendment",7,0,0,0,7
977806,616140,2017-03-30,Senate,"Senate Third Reading: Passed Roll Call # 102",36,0,0,2,38
977806,697920,2018-02-08,House,"Reported With Recommendation With Substitute  H-1",11,0,0,0,11
977806,764540,2018-06-12,House,"House Third Reading: Given Immediate Effect Roll Call # 492",104,5,0,0,109
977806,764541,2018-06-12,Senate,"Senate Third Reading: Roll Call # 542",36,0,0,1,37
977845,611178,2017-03-23,Senate,"Reported Favorably Without Amendment",7,0,0,0,7
977845,616169,2017-03-30,Senate,"Senate Third Reading: Passed Roll Call # 101",36,0,0,2,38
977845,697915,2018-02-08,House,"Reported With Recommendation Without Amendment",11,0,0,0,11
977845,764673,2018-06-12,House,"House Third Reading: Given Immediate Effect Roll Call # 480",104,5,0,0,109
978004,601269,2017-03-09,Senate,"Reported Favorably Without Amendment",3,1,0,0,4
979240,605392,2017-03-16,Senate,"Reported Favorably Without Amendment",4,0,0,0,4
979240,610241,2017-03-22,Senate,"Senate Third Reading: Passed Roll Call # 78",35,3,0,0,38
979240,629098,2017-04-19,House,"Reported With Recommendation Without Amendment",16,0,0,0,16
979240,636648,2017-05-02,House,"House Third Reading: Given Immediate Effect Roll Call # 85",103,4,0,0,107
979240,639911,2017-05-04,Senate,"Senate Third Reading: House Amendment(s) Concurred In Roll Call # 158",35,2,0,1,38
979331,600943,2017-03-09,Senate,"Reported Favorably Without Amendment",7,1,0,0,8
979420,600930,2017-03-09,Senate,"Reported Favorably Without Amendment",7,1,0,0,8
979510,601545,2017-03-07,House,"Reported With Recommendation Without Amendment",12,1,0,0,13
979598,600975,2017-03-09,Senate,"Reported Favorably Without Amendment",7,1,0,0,8
979695,676013,2017-09-13,House,"Reported With Recommendation Without Amendment",6,4,0,0,10
979776,646052,2017-05-17,House,"Reported With Recommendation With Substitute H-1",12,0,0,0,12
979776,661359,2017-06-08,House,"House Third Reading: Given Immediate Effect Roll Call # 196",106,1,0,0,107
979776,677313,2017-09-26,Senate,"Reported Favorably With Substitute  S-1",7,0,0,0,7
979776,678139,2017-10-18,Senate,"Senate Third Reading: Given Immediate Effect Roll Call # 394",37,0,0,1,38
979776,678402,2017-10-24,House,"House Third Reading: Roll Call # 322",106,1,0,0,107
979776,678862,2017-11-07,Senate,"Senate Third Reading: Roll Call # 443",35,0,0,3,38
979986,610412,2017-03-21,House,"Reported With Recommendation With Substitute  H-1",10,0,0,0,10
979986,616581,2017-03-30,House,"House Third Reading: Given Immediate Effect Roll Call # 63",108,0,0,0,108
979986,640039,2017-05-04,Senate,"Reported Favorably Without Amendment",4,0,0,0,4
979986,645218,2017-05-16,Senate,"Senate Third Reading: Given Immediate Effect Roll Call # 187",35,2,0,1,38
980032,615680,2017-03-29,House,"Reported With Recommendation With Substitute  H-1",10,1,0,0,11
980032,634005,2017-04-26,House,"House Third Reading: Given Immediate Effect Roll Call # 73",104,5,0,0,109
980032,650752,2017-05-24,Senate,"Reported Favorably With Substitute  S-1",4,0,0,0,4
980032,659269,2017-06-06,Senate,"Senate Third Reading: Given Immediate Effect Roll Call # 235",35,1,0,2,38
980032,663075,2017-06-13,House,"House Third Reading: Roll Call # 197",101,6,0,0,107
980836,600138,2017-03-08,Senate,"Reported Favorably With Substitute  S-1",9,0,0,0,9
980836,601079,2017-03-09,Senate,"Senate Third Reading: Passed Roll Call # 64",35,0,0,3,38
980836,604493,2017-03-15,House,"Reported With Recommendation With Substitute H-1",16,0,0,0,16
980836,610448,2017-03-22,House,"House Third Reading: Given Immediate Effect Roll Call # 54",104,4,0,0,108
980836,611197,2017-03-23,Senate,"Senate Third Reading: Roll Call # 80",37,0,0,1,38
980875,601053,2017-03-09,Senate,"Reported Favorably Without Amendment",5,0,0,0,5
980875,605567,2017-03-16,Senate,"Senate Third Reading: Passed Roll Call # 72",37,0,0,1,38
980875,679997,2017-12-05,House,"Reported With Recommendation Without Amendment",9,0,0,0,9
980875,685246,2018-01-11,House,"House Third Reading: Given Immediate Effect Roll Call # 1",61,45,0,0,106
981033,654820,2017-05-30,Senate,"Reported Favorably Without Amendment",5,0,0,0,5
981033,762493,2018-06-12,Senate,"Senate Third Reading: Passed Roll Call # 531",36,0,0,1,37
981033,780563,2018-12-12,House,"Reported With Recommendation Without Amendment",14,0,0,0,14
981033,781301,2018-12-20,House,"House Third Reading: Given Immediate Effect Roll Call # 915",109,0,0,0,109
981053,779743,2018-12-04,Senate,"Reported Favorably Without Amendment",3,1,0,0,4
981116,635419,2017-04-27,Senate,"Reported Favorably With Substitute  S-1",5,0,0,0,5
981116,641996,2017-05-09,Senate,"Senate Third Reading: Passed Roll Call # 176",38,0,0,0,38
981186,666708,2017-06-20,House,"Reported With Recommendation With Substitute H-1",9,0,0,0,9
981186,668453,2017-06-20,House,"Reported With Recommendation With Substitute  H-1",9,0,0,0,9
981186,691762,2018-01-30,House,"Reported With Recommendation With Substitute  H-5",8,1,0,0,9
981186,707367,2018-02-21,House,"House Third Reading: Given Immediate Effect Roll Call # 88",91,18,0,0,109
981219,666431,2017-06-20,House,"Reported With Recommendation With Substitute H-1",7,2,0,0,9
981219,668420,2017-06-20,House,"Reported With Recommendation With Substitute  H-1",7,2,0,0,9
981219,691377,2018-01-30,House,"Reported With Recommendation With Substitute  H-6",8,1,0,0,9
981219,707711,2018-02-21,House,"House Third Reading: Given Immediate Effect Roll Call # 90",93,16,0,0,109
981253,645274,2017-05-16,House,"Reported With Recommendation With Substitute H-3",7,1,0,0,8
981253,649577,2017-05-16,House,"Reported With Recommendation With Substitute  H-3",7,1,0,0,8
981253,654781,2017-05-30,House,"House Third Reading: Passed Roll Call # 154",90,16,0,0,106
981253,654782,2017-05-30,House,"House Third Reading: Given Immediate Effect Roll Call # 155",91,16,0,0,107
981253,664382,2017-06-15,Senate,"Reported Favorably Without Amendment",4,1,0,0,5
981287,645595,2017-05-16,House,"Reported With Recommendation Without Amendment",7,1,0,0,8
981287,655300,2017-05-30,House,"House Third Reading: Given Immediate Effect Roll Call # 153",93,14,0,0,107
981287,664319,2017-06-15,Senate,"Reported Favorably Without Amendment",4,1,0,0,5
981324,645582,2017-05-16,House,"Reported With Recommendation Without Amendment",7,1,0,0,8
981324,654818,2017-05-30,House,"House Third Reading: Given Immediate Effect Roll Call # 156",90,17,0,0,107
981324,664469,2017-06-15,Senate,"Reported Favorably Without Amendment",4,1,0,0,5
981356,666428,2017-06-20,House,"Reported With Recommendation With Substitute H-1",7,2,0,0,9
981356,668433,2017-06-20,House,"Reported With Recommendation With Substitute  H-1",7,2,0,0,9
981356,691313,2018-01-30,House,"Reported With Recommendation With Substitute  H-6",8,1,0,0,9
981356,707591,2018-02-21,House,"House Third Reading: Given Immediate Effect Roll Call # 89",92,17,0,0,109
981427,641946,2017-05-09,House,"Reported With Recommendation Without Amendment",15,0,0,0,15
981427,650900,2017-05-18,House,"House Third Reading: Given Immediate Effect Roll Call # 125",106,1,0,0,107
981427,678082,2017-10-12,Senate,"Reported Favorably Without Amendment",5,0,0,0,5
981427,678148,2017-10-18,Senate,"Senate Third Reading: Given Immediate Effect Roll Call # 398",37,0,0,1,38
981463,605734,2017-03-16,House,"Reported With Recommendation With Substitute H-3",4,2,0,0,6
981536,615533,2017-03-28,House,"Reported With Recommendation With Substitute  H-3",14,0,0,0,14
981536,660644,2017-06-07,House,"House Third Reading: Given Immediate Effect Roll Call # 181",94,14,0,0,108
981536,668100,2017-06-20,Senate,"Reported Favorably Without Amendment",4,0,0,0,4
981536,669888,2017-06-28,Senate,"Senate Third Reading: Given Immediate Effect Roll Call # 316",33,2,0,3,38
985032,603797,2017-03-14,Senate,"Reported Favorably Without Amendment",5,0,0,0,5
985032,605432,2017-03-16,Senate,"Senate Third Reading: Passed Roll Call # 73",37,0,0,1,38
985226,605678,2017-03-16,Senate,"Reported Favorably With Substitute  S-1",5,0,0,0,5
985226,611381,2017-03-23,Senate,"Senate Third Reading: Passed Roll Call # 81",27,10,0,1,38
985226,660476,2017-06-07,House,"Reported With Recommendation With Substitute  H-1",9,0,0,0,9
985226,666786,2017-06-20,House,"House Third Reading: Given Immediate Effect Roll Call # 236",104,3,0,0,107
985226,667960,2017-06-22,Senate,"Senate Third Reading: Roll Call # 283",32,5,0,1,38
985325,610944,2017-03-21,House,"Reported With Recommendation Without Amendment",13,0,0,0,13
985325,664627,2017-06-13,Senate,"Reported Favorably Without Amendment",5,0,0,0,5
985450,664429,2017-06-14,House,"Reported With Recommendation Without Amendment",13,0,0,0,13
985450,679404,2017-11-09,House,"House Third Reading: Passed Roll Call # 391",106,1,0,0,107
985450,751424,2018-05-08,Senate,"Reported Favorably With Substitute  S-1",5,0,0,0,5
985450,781283,2018-12-18,Senate,"Senate Third Reading: Given Immediate Effect Roll Call # 842",38,0,0,0,38
985450,781534,2018-12-20,House,"House Third Reading: Roll Call # 947",107,1,0,0,108
985486,615598,2017-03-28,House,"Reported With Recommendation Without Amendment",6,3,0,0,9
985486,616536,2017-03-30,House,"House Third Reading: Given Immediate Effect Roll Call # 68",91,17,0,0,108
985504,615174,2017-03-28,House,"Reported With Recommendation With Substitute  H-1",6,3,0,0,9
985504,616272,2017-03-30,House,"House Third Reading: Given Immediate Effect Roll Call # 66",69,39,0,0,108
985522,636161,2017-04-27,House,"Reported With Recommendation With Substitute  H-1",18,9,0,0,27
985522,637028,2017-05-02,House,"House Third Reading: Given Immediate Effect Roll Call # 88",60,47,0,0,107
985522,663338,2017-06-14,Senate,"Senate Third Reading: Passed Roll Call # 250",26,11,0,1,38
985522,664288,2017-06-15,House,"House Third Reading: Roll Call # 207",0,107,0,0,107
985522,666624,2017-06-20,House,"House Third Reading: Conference Report Adopted Roll Call # 217",64,43,0,0,107
985522,668028,2017-06-22,Senate,"Senate Third Reading: Senate Adopted Conference Report With Immediate Effect Roll Call # 280",26,11,0,1,38
985540,616799,2017-03-30,House,"Reported With Recommendation With Substitute H-1",14,0,0,0,14
985540,633769,2017-04-26,House,"House Third Reading: Given Immediate Effect Roll Call # 75",106,2,0,0,108
985540,661173,2017-06-08,Senate,"Reported Favorably Without Amendment",10,0,0,0,10
985540,664525,2017-06-15,Senate,"Senate Third Reading: Given Immediate Effect Roll Call # 270",38,0,0,0,38
985540,666406,2017-06-20,House,"House Third Reading: Roll Call # 219",105,1,0,0,106
985558,660661,2017-06-07,House,"Reported With Recommendation With Substitute  H-1",6,2,0,0,8
985574,780418,2018-12-12,House,"Reported With Recommendation Without Amendment",8,0,0,0,8
985610,651116,2017-05-18,House,"Reported With Recommendation With Substitute H-3",14,1,0,0,15
985629,634101,2017-04-26,House,"Reported With Recommendation With Substitute H-1",17,10,0,0,27
985629,636920,2017-04-26,House,"Reported With Recommendation With Substitute  H-1",17,10,0,0,27
985629,636921,2017-05-02,House,"House Third Reading: Passed Roll Call # 87",60,47,0,0,107
985629,648927,2017-05-23,Senate,"Senate Third Reading: Passed Roll Call # 203",27,10,1,0,38
985629,651046,2017-05-24,House,"House Third Reading: Roll Call # 139",0,107,0,0,107
985629,666769,2017-06-20,House,"House Third Reading: Conference Report Adopted Roll Call # 218",72,35,0,0,107
985629,668136,2017-06-22,Senate,"Senate Third Reading: Senate Adopted Conference Report With Immediate Effect Roll Call # 281",23,14,0,1,38
985648,615579,2017-03-28,House,"Reported With Recommendation Without Amendment",6,3,0,0,9
985648,616529,2017-03-30,House,"House Third Reading: Given Immediate Effect Roll Call # 65",79,29,0,0,108
985683,707379,2018-02-21,House,"Reported With Recommendation With Substitute  H-1",29,0,0,0,29
985683,707380,2018-02-21,House,"House Third Reading: Given Immediate Effect Roll Call # 91",109,0,0,0,109
985683,714568,2018-03-01,Senate,"Reported Favorably With Substitute  S-1",4,0,0,0,4
985683,714569,2018-03-01,Senate,"Senate Third Reading: Given Immediate Effect Roll Call # 120",36,0,0,2,38
985683,714570,2018-03-01,House,"House Third Reading: Roll Call # 126",109,0,0,0,109
985699,610993,2017-03-22,House,"Reported With Recommendation With Substitute  H-1",29,0,0,0,29
985699,610994,2017-03-22,House,"House Third Reading: Given Immediate Effect Roll Call # 55",101,7,0,0,108
985699,615205,2017-03-29,Senate,"Reported Favorably With Substitute  S-1",5,0,0,0,5
985699,615206,2017-03-29,Senate,"Senate Third Reading: Given Immediate Effect Roll Call # 100",36,1,0,1,38
985699,616296,2017-03-30,House,"House Third Reading: Roll Call # 62",101,7,0,0,108
985699,633687,2017-04-26,Senate,"Senate Third Reading: Roll Call # 114",37,0,0,1,38
985699,634963,2017-04-27,Senate,"Senate Third Reading: Roll Call # 118",36,0,0,2,38
985699,635843,2017-04-27,House,"House Third Reading: Senate Amendment(s) To House Amendment(s) Concurred In Roll Call # 76",108,1,0,0,109
985737,660376,2017-06-07,House,"Reported With Recommendation Without Amendment",18,11,0,0,29
985737,661303,2017-06-08,House,"House Third Reading: Given Immediate Effect Roll Call # 195",63,44,0,0,107
985737,680724,2017-12-13,Senate,"Reported Favorably With Substitute S-3",5,0,0,0,5
985737,680725,2017-12-13,Senate,"Senate Third Reading: Given Immediate Effect Roll Call # 553",33,4,0,1,38
985737,681007,2017-12-13,House,"House Third Reading: Roll Call # 512",109,1,0,0,110
985755,615079,2017-03-28,House,"Reported With Recommendation With Substitute  H-2",5,4,0,0,9
985755,616185,2017-03-30,House,"House Third Reading: Given Immediate Effect Roll Call # 67",61,47,0,0,108
985787,615063,2017-03-29,House,"Reported With Recommendation Without Amendment",16,0,0,0,16
985787,632248,2017-04-25,House,"House Third Reading: Given Immediate Effect Roll Call # 71",109,0,0,0,109
985787,677310,2017-09-26,Senate,"Reported Favorably Without Amendment",5,0,0,0,5
985787,678149,2017-10-18,Senate,"Senate Third Reading: Given Immediate Effect Roll Call # 395",37,0,0,1,38
987016,605418,2017-03-16,Senate,"Reported Favorably Without Amendment",4,0,0,0,4
987016,676976,2017-09-20,Senate,"Senate Third Reading: Passed Roll Call # 343",35,0,0,3,38
987016,679431,2017-11-28,House,"Reported With Recommendation Without Amendment",12,0,0,0,12
987016,681104,2017-12-13,House,"House Third Reading: Given Immediate Effect Roll Call # 487",110,0,0,0,110
987136,646026,2017-05-17,House,"Reported With Recommendation With Substitute H-1",13,0,0,0,13
987136,660523,2017-06-07,House,"House Third Reading: Given Immediate Effect Roll Call # 179",108,0,0,0,108
987136,677316,2017-09-26,Senate,"Reported Favorably Without Amendment",4,0,0,0,4
987136,677351,2017-09-27,Senate,"Senate Third Reading: Given Immediate Effect Roll Call # 348",37,0,0,1,38
987209,655156,2017-05-30,House,"Reported With Recommendation Without Amendment",10,0,0,0,10
987209,679569,2017-11-29,House,"House Third Reading: Given Immediate Effect Roll Call # 405",92,15,0,0,107
987209,686993,2018-01-18,Senate,"Reported Favorably Without Amendment",5,0,0,0,5
987209,780738,2018-12-13,Senate,"Senate Third Reading: Given Immediate Effect Roll Call # 814",33,4,0,1,38
987508,646250,2017-05-17,House,"Reported With Recommendation With Substitute H-1",13,0,0,0,13
987508,660330,2017-06-07,House,"House Third Reading: Given Immediate Effect Roll Call # 180",108,0,0,0,108
987508,677315,2017-09-26,Senate,"Reported Favorably Without Amendment",4,0,0,0,4
987508,677350,2017-09-27,Senate,"Senate Third Reading: Given Immediate Effect Roll Call # 349",37,0,0,1,38
987579,655563,2017-05-30,House,"Reported With Recommendation Without Amendment",8,0,0,0,8
987579,679559,2017-11-29,House,"House Third Reading: Given Immediate Effect Roll Call # 406",90,17,0,0,107
987579,686990,2018-01-18,Senate,"Reported Favorably Without Amendment",5,0,0,0,5
987579,780730,2018-12-13,Senate,"Senate Third Reading: Given Immediate Effect Roll Call # 815",33,4,0,1,38
987579,781514,2018-12-19,Senate,"Senate Third Reading: Passed Roll Call # 911",34,4,0,0,38
987579,781563,2018-12-20,House,"House Third Reading: Roll Call # 969",92,15,0,0,107
987649,660359,2017-06-07,House,"Reported With Recommendation With Substitute  H-1",7,4,0,0,11
988166,605404,2017-03-16,Senate,"Reported Favorably With Substitute  S-1",4,0,0,0,4
988166,611281,2017-03-23,Senate,"Senate Third Reading: Passed Roll Call # 82",37,0,0,1,38
988166,660329,2017-06-07,House,"Reported With Recommendation Without Amendment",9,0,0,0,9
988166,677551,2017-10-03,House,"House Third Reading: Given Immediate Effect Roll Call # 287",105,2,0,0,107
988200,692512,2018-01-31,Senate,"Reported Favorably With Substitute  S-2",4,0,0,0,4
988200,701065,2018-02-13,Senate,"Senate Third Reading: Passed Roll Call # 66",36,0,0,2,38
988200,755398,2018-05-22,House,"Reported With Recommendation Without Amendment",9,1,0,0,10
988200,764385,2018-06-12,House,"House Third Reading: Given Immediate Effect Roll Call # 522",103,6,0,0,109
992062,615125,2017-03-29,Senate,"Reported Favorably Without Amendment",7,0,0,0,7
992062,645416,2017-05-16,Senate,"Senate Third Reading: Passed Roll Call # 182",32,5,0,1,38
992062,678484,2017-10-25,House,"Reported With Recommendation Without Amendment",7,2,0,0,9
992062,678870,2017-11-07,House,"House Third Reading: Given Immediate Effect Roll Call # 379",72,35,0,0,107
992114,633816,2017-04-26,House,"Reported With Recommendation Without Amendment",7,2,0,0,9
992235,615269,2017-03-29,House,"Reported With Recommendation With Substitute  H-1",8,5,0,0,13
992235,651086,2017-05-25,House,"House Third Reading: Given Immediate Effect Roll Call # 143",71,37,0,0,108
992235,677680,2017-10-05,Senate,"Reported Favorably Without Amendment",6,0,0,0,6
992235,775058,2018-09-26,Senate,"Senate Third Reading: Given Immediate Effect Roll Call # 561",36,0,0,1,37
992240,663082,2017-06-13,House,"Reported With Recommendation With Substitute  H-1",10,1,0,0,11
992240,666540,2017-06-20,House,"House Third Reading: Given Immediate Effect Roll Call # 240",93,14,0,0,107
992240,676032,2017-09-13,Senate,"Reported Favorably Without Amendment",5,0,0,0,5
992240,679646,2017-11-30,Senate,"Senate Third Reading: Given Immediate Effect Roll Call # 469",38,0,0,0,38
992275,615485,2017-03-29,House,"Reported With Recommendation With Substitute  H-1",8,5,0,0,13
992275,651022,2017-05-25,House,"House Third Reading: Given Immediate Effect Roll Call # 144",70,38,0,0,108
992275,677672,2017-10-05,Senate,"Reported Favorably Without Amendment",6,0,0,0,6
992275,775066,2018-09-26,Senate,"Senate Third Reading: Given Immediate Effect Roll Call # 562",36,0,0,1,37
992566,616524,2017-03-30,Senate,"Reported Favorably Without Amendment",5,0,0,0,5
992566,631416,2017-04-20,Senate,"Senate Third Reading: Passed Roll Call # 109",36,1,0,1,38
992566,651023,2017-05-23,House,"Reported With Recommendation Without Amendment",9,1,0,0,10
992566,666569,2017-06-20,House,"House Third Reading: Given Immediate Effect Roll Call # 238",106,1,0,0,107
992566,668160,2017-06-22,Senate,"Senate Third Reading: House Amendment(s) Concurred In Roll Call # 284",36,1,0,1,38
992577,613945,2017-03-28,Senate,"Reported Favorably Without Amendment",5,0,0,0,5
992577,615087,2017-03-29,Senate,"Senate Third Reading: Passed Roll Call # 98",33,4,0,1,38
992577,666718,2017-06-20,House,"Reported With Recommendation Without Amendment",9,3,0,0,12
992577,672510,2017-07-12,House,"House Third Reading: Given Immediate Effect Roll Call # 262",71,35,0,0,106
992577,672511,2017-07-12,Senate,"Senate Third Reading: House Amendment(s) Concurred In Roll Call # 325",30,4,0,4,38
992604,614069,2017-03-28,Senate,"Reported Favorably Without Amendment",5,0,0,0,5
992604,615066,2017-03-29,Senate,"Senate Third Reading: Passed Roll Call # 97",32,5,0,1,38
992604,666809,2017-06-20,House,"Reported With Recommendation Without Amendment",9,3,0,0,12
992604,672508,2017-07-12,House,"House Third Reading: Given Immediate Effect Roll Call # 261",71,35,0,0,106
992604,672509,2017-07-12,Senate,"Senate Third Reading: House Amendment(s) Concurred In Roll Call # 324",29,5,0,4,38
992643,632097,2017-04-25,Senate,"Reported Favorably With Substitute  S-1",4,0,0,0,4
992643,634971,2017-04-27,Senate,"Senate Third Reading: Passed Roll Call # 126",36,0,0,2,38
992643,654870,2017-05-30,House,"Reported With Recommendation Without Amendment",14,0,0,0,14
992643,662785,2017-06-13,House,"House Third Reading: Given Immediate Effect Roll Call # 200",107,0,0,0,107
992668,613995,2017-03-28,Senate,"Reported Favorably With Substitute  S-1",5,0,0,0,5
992668,615064,2017-03-29,Senate,"Senate Third Reading: Passed Roll Call # 96",32,5,0,1,38
992668,666478,2017-06-20,House,"Reported With Recommendation With Amendment(s)",9,3,0,0,12
992668,672513,2017-07-12,House,"House Third Reading: Given Immediate Effect Roll Call # 260",71,35,0,0,106
992668,672514,2017-07-12,Senate,"Senate Third Reading: House Amendment(s) Concurred In Roll Call # 323",29,5,0,4,38
992745,707559,2018-02-21,House,"Reported With Recommendation With Substitute  H-1",7,2,0,0,9
992745,723680,2018-02-21,House,"Reported With Recommendation With Substitute H-1",7,2,0,0,9
992745,727533,2018-03-21,House,"House Third Reading: Given Immediate Effect Roll Call # 176",81,27,0,0,108
992745,727534,2018-03-21,House,"House Third Reading: Passed Roll Call # 180",85,23,0,0,108
992745,758331,2018-05-30,Senate,"Reported Favorably With Substitute  S-2",4,0,0,0,4
992745,760944,2018-06-06,Senate,"Senate Third Reading: Given Immediate Effect Roll Call # 402",31,6,0,0,37
992745,764689,2018-06-12,House,"House Third Reading: Roll Call # 533",82,27,0,0,109
993397,643145,2017-05-10,Senate,"Reported Favorably With Substitute  S-1",4,1,0,0,5
993397,648867,2017-05-23,Senate,"Senate Third Reading: Passed Roll Call # 202",25,13,0,0,38
993397,661440,2017-06-08,House,"Reported With Recommendation Without Amendment",10,5,0,0,15
993397,666755,2017-06-20,House,"House Third Reading: Given Immediate Effect Roll Call # 230",60,47,0,0,107
993456,614005,2017-03-28,Senate,"Reported Favorably Without Amendment",5,0,0,0,5
993456,628461,2017-04-19,Senate,"Senate Third Reading: Passed Roll Call # 105",36,0,0,2,38
993456,659654,2017-06-06,House,"Reported With Recommendation With Substitute H-3",12,1,0,0,13
993456,660743,2017-06-06,House,"Reported With Recommendation With Substitute  H-3",12,1,0,0,13
993456,666839,2017-06-20,House,"House Third Reading: Given Immediate Effect Roll Call # 235",105,2,0,0,107
993456,668025,2017-06-22,Senate,"Senate Third Reading: Roll Call # 285",37,0,0,1,38
995771,720289,2018-03-08,Senate,"Reported Favorably With Substitute  S-3",5,0,0,0,5
995771,762477,2018-06-12,Senate,"Senate Third Reading: Passed Roll Call # 526",36,0,0,1,37
995783,704000,2018-02-15,Senate,"Reported Favorably Without Amendment",5,0,0,0,5
995783,780146,2018-12-06,Senate,"Senate Third Reading: Passed Roll Call # 733",36,0,0,2,38
995823,646734,2017-05-18,Senate,"Reported Favorably Without Amendment",7,0,0,0,7
995823,649515,2017-05-24,Senate,"Senate Third Reading: Passed Roll Call # 222",37,0,1,0,38
995852,645991,2017-05-16,Senate,"Reported Favorably Without Amendment",15,1,0,0,16
995852,661051,2017-06-08,Senate,"Senate Third Reading: Passed Roll Call # 242",36,0,0,2,38
995852,666804,2017-06-20,House,"Reported With Recommendation Without Amendment",28,0,0,0,28
995852,666805,2017-06-20,House,"House Third Reading: Given Immediate Effect Roll Call # 252",107,0,0,0,107
995885,703998,2018-02-15,Senate,"Reported Favorably With Substitute  S-1",5,0,0,0,5
995885,780091,2018-12-06,Senate,"Senate Third Reading: Passed Roll Call # 735",36,0,0,2,38
995900,635445,2017-04-27,Senate,"Reported Favorably Without Amendment",9,0,0,0,9
995900,642081,2017-05-09,Senate,"Senate Third Reading: Passed Roll Call # 178",38,0,0,0,38
995900,676034,2017-09-13,House,"Reported With Recommendation Without Amendment",15,0,0,0,15
995900,677859,2017-10-11,House,"House Third Reading: Given Immediate Effect Roll Call # 303",107,1,0,0,108
995913,677318,2017-09-26,Senate,"Reported Favorably With Substitute  S-1",15,0,0,0,15
995913,677346,2017-09-27,Senate,"Senate Third Reading: Passed Roll Call # 351",36,1,0,1,38
995913,677792,2017-10-05,House,"Reported With Recommendation With Substitute  H-1",29,0,0,0,29
995913,677809,2017-10-10,House,"House Third Reading: Given Immediate Effect Roll Call # 298",104,2,0,0,106
995913,678198,2017-10-19,Senate,"Senate Third Reading: Roll Call # 406",37,0,0,1,38
995913,678638,2017-10-31,House,"House Third Reading: Roll Call # 335",105,2,0,0,107
995929,635418,2017-04-27,Senate,"Reported Favorably Without Amendment",9,0,0,0,9
995929,641909,2017-05-09,Senate,"Senate Third Reading: Passed Roll Call # 177",38,0,0,0,38
995929,676010,2017-09-13,House,"Reported With Recommendation With Substitute H-1",15,0,0,0,15
995929,677863,2017-10-11,House,"House Third Reading: Given Immediate Effect Roll Call # 302",107,1,0,0,108
995929,678077,2017-10-17,Senate,"Senate Third Reading: Roll Call # 388",38,0,0,0,38
995942,645464,2017-05-16,Senate,"Reported Favorably With Substitute  S-1",15,0,0,0,15
995972,645384,2017-05-16,Senate,"Reported Favorably Without Amendment",16,0,0,0,16
995972,661144,2017-06-08,Senate,"Senate Third Reading: Passed Roll Call # 241",36,0,0,2,38
995983,703891,2018-02-15,Senate,"Reported Favorably Without Amendment",5,0,0,0,5
995983,780077,2018-12-06,Senate,"Senate Third Reading: Passed Roll Call # 734",36,0,0,2,38
996234,680037,2017-12-05,House,"Reported With Recommendation With Substitute H-2",13,0,0,0,13
996234,680555,2017-12-05,House,"Reported With Recommendation With Substitute  H-2",13,0,0,0,13
996234,681151,2017-12-12,House,"House Third Reading: Given Immediate Effect Roll Call # 469",109,0,0,0,109
996258,679995,2017-12-05,House,"Reported With Recommendation With Substitute H-1",13,0,0,0,13
996258,680545,2017-12-05,House,"Reported With Recommendation With Substitute  H-1",13,0,0,0,13
996258,681172,2017-12-12,House,"House Third Reading: Given Immediate Effect Roll Call # 470",109,0,0,0,109
996373,639912,2017-05-04,Senate,"Reported Favorably With Substitute  S-1",5,0,0,0,5
996373,661133,2017-06-08,Senate,"Senate Third Reading: Passed Roll Call # 240",36,0,0,2,38
996373,666821,2017-06-20,House,"Reported With Recommendation Without Amendment",28,0,0,0,28
996373,666822,2017-06-20,House,"House Third Reading: Given Immediate Effect Roll Call # 251",107,0,0,0,107
996578,660390,2017-06-07,House,"Reported With Recommendation With Substitute  H-1",9,2,0,0,11
996578,666578,2017-06-20,House,"House Third Reading: Passed Roll Call # 228",94,12,0,0,106
996578,677304,2017-09-26,Senate,"Reported Favorably Without Amendment",7,0,0,0,7
996578,678059,2017-10-17,Senate,"Senate Third Reading: Given Immediate Effect Roll Call # 392",37,0,1,0,38
996988,660260,2017-06-07,Senate,"Reported Favorably With Substitute  S-2",10,0,0,0,10
996988,668002,2017-06-22,Senate,"Senate Third Reading: Passed Roll Call # 298",37,0,0,1,38
996988,677590,2017-10-04,House,"Reported With Recommendation With Substitute  H-2",17,0,0,0,17
996988,681056,2017-12-13,House,"House Third Reading: Given Immediate Effect Roll Call # 481",102,8,0,0,110
996988,681057,2017-12-13,Senate,"Senate Third Reading: Roll Call # 564",37,0,0,1,38
997005,615055,2017-03-29,Senate,"Reported Favorably With Substitute  S-1",4,1,0,0,5
997010,677880,2017-09-26,Senate,"Reported Favorably Without Amendment",5,0,0,0,5
997017,717949,2018-03-06,Senate,"Reported Favorably With Substitute  S-2",4,0,0,0,4
997040,660257,2017-06-07,Senate,"Reported Favorably With Substitute  S-1",9,0,0,0,9
997040,667998,2017-06-22,Senate,"Senate Third Reading: Passed Roll Call # 300",36,1,0,1,38
997040,677594,2017-10-04,House,"Reported With Recommendation Without Amendment",16,1,0,0,17
997040,681065,2017-12-13,House,"House Third Reading: Given Immediate Effect Roll Call # 483",97,13,0,0,110
997040,681066,2017-12-13,Senate,"Senate Third Reading: House Amendment(s) Concurred In Roll Call # 565",36,1,0,1,38
997052,660418,2017-06-07,Senate,"Reported Favorably With Substitute  S-1",9,0,0,0,9
997052,668114,2017-06-22,Senate,"Senate Third Reading: Passed Roll Call # 299",37,0,0,1,38
997052,677621,2017-10-04,House,"Reported With Recommendation Without Amendment",17,0,0,0,17
997052,680998,2017-12-13,House,"House Third Reading: Given Immediate Effect Roll Call # 482",104,6,0,0,110
997065,657165,2017-05-23,Senate,"Reported Favorably Without Amendment",3,0,0,0,3
997101,651093,2017-05-24,House,"Reported With Recommendation With Substitute  H-2",16,0,0,0,16
997101,680185,2017-12-06,House,"House Third Reading: Given Immediate Effect Roll Call # 440",99,11,0,0,110
997121,677546,2017-10-03,House,"Reported With Recommendation With Substitute  H-1",6,4,0,0,10
997121,702663,2018-02-14,House,"House Third Reading: Given Immediate Effect Roll Call # 62",101,8,0,0,109
997121,740951,2018-04-18,Senate,"Reported Favorably Without Amendment",5,0,0,0,5
997121,745380,2018-04-26,Senate,"Senate Third Reading: Given Immediate Effect Roll Call # 236",35,0,0,2,37
997158,650950,2017-05-24,House,"Reported With Recommendation With Substitute  H-1",16,0,0,0,16
997158,662702,2017-06-13,House,"House Third Reading: Given Immediate Effect Roll Call # 201",105,2,0,0,107
997158,678669,2017-11-01,Senate,"Reported Favorably Without Amendment",10,0,0,0,10
997158,680742,2017-12-13,Senate,"Senate Third Reading: Given Immediate Effect Roll Call # 531",38,0,0,0,38
997182,651000,2017-05-24,House,"Reported With Recommendation With Substitute  H-1",16,0,0,0,16
997182,662895,2017-06-13,House,"House Third Reading: Given Immediate Effect Roll Call # 202",91,16,0,0,107
997197,650945,2017-05-24,House,"Reported With Recommendation Without Amendment",16,0,0,0,16
997197,662585,2017-06-13,House,"House Third Reading: Given Immediate Effect Roll Call # 203",102,5,0,0,107
997197,680720,2017-12-13,Senate,"Reported Favorably With Substitute S-1",5,0,0,0,5
997197,680721,2017-12-13,Senate,"Senate Third Reading: Given Immediate Effect Roll Call # 532",37,1,0,0,38
997197,681017,2017-12-13,House,"House Third Reading: Roll Call # 506",105,5,0,0,110
997231,650933,2017-05-24,House,"Reported With Recommendation With Substitute  H-1",16,0,0,0,16
997231,662644,2017-06-13,House,"House Third Reading: Given Immediate Effect Roll Call # 204",102,5,0,0,107
997231,680731,2017-12-13,Senate,"Reported Favorably With Substitute S-1",5,0,0,0,5
997231,680732,2017-12-13,Senate,"Senate Third Reading: Given Immediate Effect Roll Call # 533",37,1,0,0,38
997231,681084,2017-12-13,House,"House Third Reading: Roll Call # 507",105,5,0,0,110
997250,651047,2017-05-24,House,"Reported With Recommendation With Substitute  H-1",16,0,0,0,16
997250,662590,2017-06-13,House,"House Third Reading: Given Immediate Effect Roll Call # 205",81,26,0,0,107
997250,677847,2017-10-11,Senate,"Reported Favorably With Substitute  S-2",10,0,0,0,10
997250,680728,2017-12-13,Senate,"Senate Third Reading: Given Immediate Effect Roll Call # 522",37,1,0,0,38
997250,681015,2017-12-13,House,"House Third Reading: Roll Call # 508",89,21,0,0,110
997264,677608,2017-10-04,House,"Reported With Recommendation Without Amendment",16,0,0,0,16
997264,678534,2017-10-25,House,"House Third Reading: Given Immediate Effect Roll Call # 326",105,1,0,0,106
997264,689036,2018-01-25,Senate,"Reported Favorably Without Amendment",7,0,0,0,7
997264,698720,2018-02-06,Senate,"Senate Third Reading: Given Immediate Effect Roll Call # 65",34,3,0,0,37
999765,635421,2017-04-27,Senate,"Reported Favorably With Substitute S-1",4,0,0,0,4
999784,755078,2018-05-17,Senate,"Reported Favorably Without Amendment",9,0,0,0,9
999784,757329,2018-05-29,Senate,"Senate Third Reading: Passed Roll Call # 369",36,0,0,1,37
999804,635263,2017-04-25,House,"Reported With Recommendation Without Amendment",13,0,0,0,13
999823,628560,2017-04-19,Senate,"Reported Favorably Without Amendment",5,0,0,0,5
999823,633787,2017-04-26,Senate,"Senate Third Reading: Passed Roll Call # 115",38,0,0,0,38
999823,662835,2017-06-13,House,"Reported With Recommendation With Substitute  H-1",10,1,0,0,11
999823,679575,2017-11-30,House,"House Third Reading: Given Immediate Effect Roll Call # 415",91,17,0,0,108
999823,680155,2017-12-06,Senate,"Senate Third Reading: Roll Call # 479",36,0,1,1,38
999861,635420,2017-04-27,Senate,"Reported Favorably Without Amendment",5,0,0,0,5
999878,661174,2017-06-08,Senate,"Reported Favorably Without Amendment",5,0,0,0,5
999878,664417,2017-06-15,Senate,"Senate Third Reading: Passed Roll Call # 268",38,0,0,0,38
999878,678099,2017-10-17,House,"Reported With Recommendation Without Amendment",15,0,0,0,15
999878,678650,2017-11-01,House,"House Third Reading: Given Immediate Effect Roll Call # 340",105,3,0,0,108
999908,646067,2017-05-17,House,"Reported With Recommendation With Substitute H-2",12,1,0,0,13
999908,666983,2017-06-20,House,"House Third Reading: Given Immediate Effect Roll Call # 226",82,25,0,0,107
999908,780243,2018-12-06,Senate,"Reported Favorably With Substitute  S-2",5,2,0,0,7
999908,780603,2018-12-12,Senate,"Senate Third Reading: Given Immediate Effect Roll Call # 762",37,1,0,0,38
999908,781053,2018-12-18,House,"House Third Reading: Roll Call # 877",67,42,0,0,109
999914,635883,2017-04-27,House,"Reported With Recommendation With Substitute  H-1",11,2,0,0,13
999914,639193,2017-05-03,House,"House Third Reading: Given Immediate Effect Roll Call # 92",64,42,0,0,106
999914,779339,2018-11-28,Senate,"Reported Favorably With Substitute S-3",4,1,0,0,5
999914,780353,2018-12-11,Senate,"Senate Third Reading: Given Immediate Effect Roll Call # 749",26,11,0,1,38
999914,780590,2018-12-13,House,"House Third Reading: Roll Call # 846",64,45,0,0,109
999943,639258,2017-05-03,House,"Reported With Recommendation With Substitute  H-1",11,0,0,0,11
999953,680038,2017-12-05,House,"Reported With Recommendation With Substitute  H-1",8,0,0,0,8
999953,686312,2018-01-17,House,"House Third Reading: Given Immediate Effect Roll Call # 10",107,1,0,0,108
999953,708802,2018-02-22,Senate,"Reported Favorably With Substitute  S-1",5,0,0,0,5
999953,713441,2018-02-28,Senate,"Senate Third Reading: Given Immediate Effect Roll Call # 117",37,0,0,1,38
999953,714538,2018-03-01,House,"House Third Reading: Roll Call # 117",108,1,0,0,109
999996,655058,2017-05-30,House,"Reported With Recommendation With Substitute  H-2",6,4,0,0,10
999996,660375,2017-06-07,House,"House Third Reading: Given Immediate Effect Roll Call # 184",60,48,0,0,108
1000006,633666,2017-04-26,House,"Reported With Recommendation Without Amendment",9,0,0,0,9
1000006,645486,2017-05-16,House,"House Third Reading: Given Immediate Effect Roll Call # 99",104,0,0,0,104
1000006,649506,2017-05-24,Senate,"Reported Favorably Without Amendment",4,0,0,0,4
1000006,654980,2017-05-30,Senate,"Senate Third Reading: Given Immediate Effect Roll Call # 232",38,0,0,0,38
1000006,677843,2017-10-11,House,"House Third Reading: Senate Amendment(s) Concurred In Roll Call # 299",108,0,0,0,108
1000019,654754,2017-05-30,House,"Reported With Recommendation With Substitute  H-1",6,4,0,0,10
1000019,660290,2017-06-07,House,"House Third Reading: Given Immediate Effect Roll Call # 183",59,49,0,0,108
1000029,648982,2017-05-23,Senate,"Reported Favorably With Substitute S-1",5,0,0,0,5
1000050,655002,2017-05-30,House,"Reported With Recommendation With Substitute  H-1",6,4,0,0,10
1000050,660275,2017-06-07,House,"House Third Reading: Given Immediate Effect Roll Call # 185",59,49,0,0,108
1000061,660690,2017-06-07,House,"Reported With Recommendation Without Amendment",10,3,0,0,13
1000061,678658,2017-11-01,House,"House Third Reading: Given Immediate Effect Roll Call # 338",95,13,0,0,108
1000061,679635,2017-11-30,Senate,"Reported Favorably Without Amendment",6,0,0,0,6
1000061,680730,2017-12-13,Senate,"Senate Third Reading: Given Immediate Effect Roll Call # 545",34,4,0,0,38
1000073,655077,2017-05-30,House,"Reported With Recommendation With Substitute  H-1",6,4,0,0,10
1000073,660278,2017-06-07,House,"House Third Reading: Given Immediate Effect Roll Call # 186",61,47,0,0,108
1000092,637146,2017-05-02,House,"Reported With Recommendation With Substitute  H-1",10,0,0,0,10
1000092,651164,2017-05-23,House,"House Third Reading: Given Immediate Effect Roll Call # 129",108,0,0,0,108
1000092,658910,2017-06-06,Senate,"Reported Favorably Without Amendment",4,0,0,0,4
1000092,668247,2017-06-22,Senate,"Senate Third Reading: Given Immediate Effect Roll Call # 290",37,0,0,1,38
1000112,635850,2017-04-27,House,"Reported With Recommendation Without Amendment",14,0,0,0,14
1000112,639283,2017-05-03,House,"House Third Reading: Given Immediate Effect Roll Call # 93",102,4,0,0,106
1000112,740996,2018-04-18,Senate,"Reported Favorably With Substitute  S-1",4,0,0,0,4
1000112,745316,2018-04-25,Senate,"Senate Third Reading: Given Immediate Effect Roll Call # 230",37,0,0,0,37
1000112,745317,2018-04-26,House,"House Third Reading: Roll Call # 252",106,3,0,0,109
1000372,630887,2017-04-20,Senate,"Reported Favorably With Substitute  S-1",5,0,0,0,5
1000372,633702,2017-04-26,Senate,"Senate Third Reading: Passed Roll Call # 116",38,0,0,0,38
1000575,646700,2017-05-18,Senate,"Reported Favorably With Substitute  S-1",12,2,0,0,14
1000575,649782,2017-05-24,Senate,"Senate Third Reading: Passed Roll Call # 225",24,14,0,0,38
1000617,628435,2017-04-19,Senate,"Reported Favorably Without Amendment",10,0,0,0,10
1000617,668142,2017-06-22,Senate,"Senate Third Reading: Passed Roll Call # 293",36,0,1,1,38
1000617,668143,2017-06-22,Senate,"Senate Third Reading: Passed Roll Call # 294",37,0,0,1,38
1000617,677861,2017-10-11,House,"Reported With Recommendation With Substitute  H-1",17,0,0,0,17
1000617,678706,2017-11-02,House,"House Third Reading: Given Immediate Effect Roll Call # 360",106,2,0,0,108
1000617,679110,2017-11-09,Senate,"Senate Third Reading: Roll Call # 459",36,0,0,2,38
1000928,639292,2017-05-04,House,"Reported With Recommendation Without Amendment",4,2,0,0,6
1000928,650936,2017-05-24,House,"House Third Reading: Given Immediate Effect Roll Call # 141",61,46,0,0,107
1000952,639299,2017-05-04,House,"Reported With Recommendation Without Amendment",4,2,0,0,6
1000952,650888,2017-05-24,House,"House Third Reading: Given Immediate Effect Roll Call # 142",67,40,0,0,107
1000952,780227,2018-12-05,Senate,"Reported Favorably Without Amendment",4,1,0,0,5
1001307,655378,2017-05-25,Senate,"Reported Favorably With Substitute  S-1",9,0,0,0,9
1001307,661065,2017-06-08,Senate,"Senate Third Reading: Passed Roll Call # 244",37,0,0,1,38
1001307,679412,2017-11-08,House,"Reported With Recommendation Without Amendment",14,2,0,0,16
1001307,749065,2018-05-01,House,"House Third Reading: Given Immediate Effect Roll Call # 258",89,20,0,0,109
1001330,659053,2017-06-06,House,"Reported With Recommendation With Substitute H-1",14,1,0,0,15
1001350,642006,2017-05-09,Senate,"Reported Favorably Without Amendment",4,0,0,0,4
1001350,648946,2017-05-23,Senate,"Senate Third Reading: Passed Roll Call # 201",27,11,0,0,38
1001350,678557,2017-10-26,House,"Reported With Recommendation With Substitute  H-1",9,0,0,0,9
1001350,741831,2018-04-18,House,"House Third Reading: Given Immediate Effect Roll Call # 230",93,16,0,0,109
1001350,741832,2018-04-19,Senate,"Senate Third Reading: Roll Call # 214",27,10,0,0,37
1001446,650898,2017-05-24,House,"Reported With Recommendation Without Amendment",11,0,0,0,11
1001446,659612,2017-06-06,House,"House Third Reading: Given Immediate Effect Roll Call # 178",108,0,0,0,108
1001446,677012,2017-09-20,Senate,"Reported Favorably Without Amendment",4,0,0,0,4
1001446,678117,2017-10-17,Senate,"Senate Third Reading: Given Immediate Effect Roll Call # 390",38,0,0,0,38
1001487,676759,2017-09-19,House,"Reported With Recommendation Without Amendment",7,2,0,0,9
1001487,677353,2017-09-27,House,"House Third Reading: Given Immediate Effect Roll Call # 282",82,26,0,0,108
1001510,655122,2017-05-30,House,"Reported With Recommendation With Substitute  H-1",7,4,0,0,11
1001510,677343,2017-09-26,House,"House Third Reading: Given Immediate Effect Roll Call # 280",64,43,0,0,107
1001537,664430,2017-06-14,House,"Reported With Recommendation With Amendment(s)",10,1,0,0,11
1001537,667004,2017-06-20,House,"House Third Reading: Given Immediate Effect Roll Call # 243",82,25,0,0,107
1001537,753920,2018-05-16,Senate,"Reported Favorably Without Amendment",3,1,0,0,4
1001537,761269,2018-06-07,Senate,"Senate Third Reading: Given Immediate Effect Roll Call # 415",26,10,0,1,37
1001537,764516,2018-06-12,House,"House Third Reading: Roll Call # 536",80,29,0,0,109
1001567,678395,2017-10-24,House,"Reported With Recommendation Without Amendment",9,1,0,0,10
1001567,678626,2017-11-01,House,"House Third Reading: Given Immediate Effect Roll Call # 357",102,6,0,0,108
1001567,683942,2017-12-28,Senate,"Reported Favorably Without Amendment",4,0,0,0,4
1001567,689000,2018-01-25,Senate,"Senate Third Reading: Given Immediate Effect Roll Call # 29",37,0,0,1,38
1001581,686294,2018-01-17,House,"Reported With Recommendation With Substitute  H-3",14,0,0,0,14
1001581,691222,2018-01-25,House,"House Third Reading: Given Immediate Effect Roll Call # 28",105,1,0,0,106
1001581,692066,2018-01-31,Senate,"Reported Favorably Without Amendment",10,0,0,0,10
1001581,703905,2018-02-15,Senate,"Senate Third Reading: Given Immediate Effect Roll Call # 93",34,0,0,4,38
1001594,651169,2017-05-18,House,"Reported With Recommendation Without Amendment",11,0,0,0,11
1001628,678434,2017-10-24,House,"Reported With Recommendation Without Amendment",9,1,0,0,10
1001628,678635,2017-11-01,House,"House Third Reading: Given Immediate Effect Roll Call # 358",101,7,0,0,108
1001628,683955,2017-12-28,Senate,"Reported Favorably With Substitute  S-1",4,0,0,0,4
1001628,689216,2018-01-25,Senate,"Senate Third Reading: Given Immediate Effect Roll Call # 30",37,1,0,0,38
1001628,691133,2018-01-30,House,"House Third Reading: Roll Call # 33",101,7,0,0,108
1006595,643173,2017-05-10,Senate,"Reported Favorably Without Amendment",4,0,0,0,4
1006898,639918,2017-05-04,Senate,"Reported Favorably With Substitute  S-1",4,1,0,0,5
1006898,678209,2017-10-19,Senate,"Senate Third Reading: Passed Roll Call # 409",25,12,0,1,38
1006898,755307,2018-05-16,House,"Reported With Recommendation With Substitute  H-1",8,1,0,0,9
1006898,764464,2018-06-12,House,"House Third Reading: Given Immediate Effect Roll Call # 508",67,42,0,0,109
1006898,764465,2018-06-12,Senate,"Senate Third Reading: Roll Call # 538",24,12,0,1,37
1006925,639904,2017-05-04,Senate,"Reported Favorably With Substitute  S-1",4,1,0,0,5
1006925,678205,2017-10-19,Senate,"Senate Third Reading: Passed Roll Call # 408",25,12,0,1,38
1006925,755271,2018-05-16,House,"Reported With Recommendation With Substitute  H-5",7,2,0,0,9
1006925,764473,2018-06-12,House,"House Third Reading: Given Immediate Effect Roll Call # 507",66,43,0,0,109
1006925,764474,2018-06-12,Senate,"Senate Third Reading: Roll Call # 537",24,12,0,1,37
1006937,654978,2017-05-30,House,"Reported With Recommendation Without Amendment",9,0,0,0,9
1006950,678622,2017-10-31,House,"Reported With Recommendation With Substitute  H-2",10,1,0,0,11
1006950,698031,2018-02-08,House,"House Third Reading: Given Immediate Effect Roll Call # 53",100,9,0,0,109
1006950,714607,2018-03-01,Senate,"Reported Favorably Without Amendment",4,0,0,0,4
1006952,755229,2018-05-16,House,"Reported With Recommendation With Substitute  H-5",7,2,0,0,9
1006952,756056,2018-05-23,House,"House Third Reading: Given Immediate Effect Roll Call # 372",67,42,0,0,109
1006952,761460,2018-06-04,Senate,"Reported Favorably Without Amendment",3,1,0,0,4
1006952,762620,2018-06-12,Senate,"Senate Third Reading: Given Immediate Effect Roll Call # 493",24,12,0,1,37
1006954,697397,2018-02-06,House,"Reported With Recommendation With Substitute  H-1",12,1,0,0,13
1006954,758357,2018-05-30,House,"House Third Reading: Given Immediate Effect Roll Call # 432",101,6,0,0,107
1006954,774837,2018-09-25,Senate,"Reported Favorably With Substitute  S-1",5,0,0,0,5
1006965,707991,2018-02-20,House,"Reported With Recommendation Without Amendment",14,0,0,0,14
1006973,666875,2017-06-20,House,"Reported With Recommendation With Substitute H-6",10,6,0,0,16
1006973,668430,2017-06-20,House,"Reported With Recommendation With Substitute  H-6",10,6,0,0,16
1006978,666878,2017-06-20,House,"Reported With Recommendation With Substitute H-6",10,6,0,0,16
1006978,668499,2017-06-20,House,"Reported With Recommendation With Substitute  H-6",10,6,0,0,16
1006985,678561,2017-10-26,House,"Reported With Recommendation Without Amendment",8,6,0,0,14
1007015,678623,2017-10-31,House,"Reported With Recommendation With Substitute  H-2",9,1,0,0,10
1007015,698047,2018-02-08,House,"House Third Reading: Given Immediate Effect Roll Call # 54",100,9,0,0,109
1007015,715388,2018-03-01,Senate,"Reported Favorably Without Amendment",4,0,0,0,4
1007023,654751,2017-05-30,House,"Reported With Recommendation With Substitute  H-2",13,0,0,0,13
1007023,660507,2017-06-07,House,"House Third Reading: Given Immediate Effect Roll Call # 182",103,5,0,0,108
1007023,678102,2017-10-17,Senate,"Reported Favorably Without Amendment",4,0,0,0,4
1007023,781541,2018-12-21,Senate,"Senate Third Reading: Passed Roll Call # 1038",34,4,0,0,38
1007205,780067,2018-12-05,Senate,"Reported Favorably With Substitute  S-1",5,0,0,0,5
1007205,780068,2018-12-06,Senate,"Senate Third Reading: Passed Roll Call # 709",25,11,0,2,38
1007205,780522,2018-12-12,House,"Reported With Recommendation Without Amendment",10,2,0,0,12
1007205,781058,2018-12-18,House,"House Third Reading: Given Immediate Effect Roll Call # 879",65,44,0,0,109
1007347,676780,2017-09-19,House,"Reported With Recommendation Without Amendment",6,3,0,0,9
1007347,679410,2017-11-09,House,"House Third Reading: Given Immediate Effect Roll Call # 392",63,44,0,0,107
1007347,703866,2018-02-15,Senate,"Reported Favorably Without Amendment",3,2,0,0,5
1008205,655338,2017-05-25,Senate,"Reported Favorably Without Amendment",4,1,0,0,5
1008205,661140,2017-06-08,Senate,"Senate Third Reading: Passed Roll Call # 243",29,8,0,1,38
1008205,678633,2017-11-01,House,"Reported With Recommendation With Substitute  H-2",6,3,0,0,9
1008205,679554,2017-11-30,House,"House Third Reading: Given Immediate Effect Roll Call # 421",69,39,0,0,108
1008205,693563,2018-02-01,Senate,"Senate Third Reading: Roll Call # 53",30,8,0,0,38
1008246,661393,2017-06-08,House,"Reported With Recommendation With Substitute  H-1",11,0,0,0,11
1008246,666581,2017-06-20,House,"House Third Reading: Given Immediate Effect Roll Call # 232",107,0,0,0,107
1008246,755005,2018-05-17,Senate,"Reported Favorably With Substitute S-1",3,0,0,0,3
1008246,781418,2018-12-18,Senate,"Senate Third Reading: Given Immediate Effect Roll Call # 895",38,0,0,0,38
1008246,781532,2018-12-20,House,"House Third Reading: Roll Call # 948",108,0,0,0,108
1008251,678904,2017-11-07,House,"Reported With Recommendation Without Amendment",10,0,0,0,10
1008251,679582,2017-11-29,House,"House Third Reading: Given Immediate Effect Roll Call # 410",107,0,0,0,107
1008251,686973,2018-01-18,Senate,"Reported Favorably Without Amendment",5,0,0,0,5
1008251,698730,2018-02-06,Senate,"Senate Third Reading: Given Immediate Effect Roll Call # 62",36,0,0,2,38
1008285,646039,2017-05-17,House,"Reported With Recommendation Without Amendment",13,0,0,0,13
1008285,651309,2017-05-25,House,"House Third Reading: Given Immediate Effect Roll Call # 150",107,0,0,0,107
1008285,651310,2017-05-25,House,"House Third Reading: Passed Roll Call # 151",108,0,0,0,108
1008285,679630,2017-11-30,Senate,"Reported Favorably Without Amendment",6,0,0,0,6
1008285,680790,2017-12-13,Senate,"Senate Third Reading: Given Immediate Effect Roll Call # 546",38,0,0,0,38
1008290,780568,2018-12-11,House,"Reported With Recommendation With Substitute  H-3",9,4,0,0,13
1008290,780569,2018-12-12,House,"House Third Reading: Given Immediate Effect Roll Call # 827",65,44,0,0,109
1008290,781326,2018-12-20,Senate,"Senate Third Reading: Passed Roll Call # 998",38,0,0,0,38
1008315,661400,2017-06-08,House,"Reported With Recommendation Without Amendment",11,0,0,0,11
1008315,666430,2017-06-20,House,"House Third Reading: Given Immediate Effect Roll Call # 233",107,0,0,0,107
1008315,755006,2018-05-17,Senate,"Reported Favorably Without Amendment",4,0,0,0,4
1008315,781427,2018-12-18,Senate,"Senate Third Reading: Given Immediate Effect Roll Call # 896",38,0,0,0,38
1008343,651063,2017-05-23,House,"Reported With Recommendation With Substitute  H-1",10,0,0,0,10
1008343,663049,2017-06-13,House,"House Third Reading: Given Immediate Effect Roll Call # 198",104,3,0,0,107
1008343,676819,2017-09-19,Senate,"Reported Favorably With Substitute  S-1",8,0,0,0,8
1008343,677808,2017-10-10,Senate,"Senate Third Reading: Given Immediate Effect Roll Call # 377",36,0,0,2,38
1008343,678044,2017-10-17,House,"House Third Reading: Roll Call # 312",104,3,0,0,107
1008361,678861,2017-11-07,House,"Reported With Recommendation Without Amendment",10,0,0,0,10
1008361,679563,2017-11-29,House,"House Third Reading: Given Immediate Effect Roll Call # 409",107,0,0,0,107
1008361,686957,2018-01-18,Senate,"Reported Favorably With Substitute  S-1",5,0,0,0,5
1008361,699122,2018-02-06,Senate,"Senate Third Reading: Given Immediate Effect Roll Call # 61",36,0,0,2,38
1008361,702169,2018-02-13,House,"House Third Reading: Roll Call # 57",108,0,0,0,108
1008367,727151,2018-03-21,House,"Reported With Recommendation With Substitute  H-2",13,0,0,0,13
1008367,737526,2018-04-11,House,"House Third Reading: Given Immediate Effect Roll Call # 214",109,0,0,0,109
1008367,753710,2018-05-15,Senate,"Reported Favorably Without Amendment",6,0,0,0,6
1008367,781512,2018-12-20,Senate,"Senate Third Reading: Passed Roll Call # 1008",38,0,0,0,38
1008367,781599,2018-12-21,House,"House Third Reading: Roll Call # 986",107,0,0,0,107
1008382,692058,2018-01-31,House,"Reported With Recommendation With Substitute  H-1",16,0,0,0,16
1008382,697021,2018-02-07,House,"House Third Reading: Given Immediate Effect Roll Call # 52",107,1,0,0,108
1008408,702510,2018-02-14,House,"Reported With Recommendation Without Amendment",10,1,0,0,11
1008630,677367,2017-09-28,Senate,"Reported Favorably With Substitute  S-1",5,0,0,0,5
1008630,755821,2018-05-23,Senate,"Senate Third Reading: Passed Roll Call # 338",37,0,0,0,37
1008630,758203,2018-05-29,House,"Reported With Recommendation With Substitute  H-1",14,0,0,0,14
1008630,760185,2018-06-05,House,"House Third Reading: Given Immediate Effect Roll Call # 452",107,1,0,0,108
1008630,762333,2018-06-12,Senate,"Senate Third Reading: Roll Call # 535",36,0,0,1,37
1008674,760598,2018-06-06,Senate,"Reported Favorably With Substitute  S-1",9,0,0,0,9
1008674,762325,2018-06-12,Senate,"Senate Third Reading: Passed Roll Call # 519",33,3,0,1,37
1008674,780490,2018-12-12,House,"Reported With Recommendation Without Amendment",17,0,0,0,17
1008674,781527,2018-12-20,House,"House Third Reading: Given Immediate Effect Roll Call # 946",97,11,0,0,108
1008674,781528,2018-12-20,Senate,"Senate Third Reading: Roll Call # 1029",36,2,0,0,38
1008699,641842,2017-05-09,Senate,"Reported Favorably With Substitute  S-1",5,0,0,0,5
1008699,648914,2017-05-23,Senate,"Senate Third Reading: Passed Roll Call # 200",38,0,0,0,38
1008699,666539,2017-06-20,House,"Reported With Recommendation Without Amendment",13,0,0,0,13
1008699,672481,2017-07-12,House,"House Third Reading: Given Immediate Effect Roll Call # 264",106,0,0,0,106
1008722,639936,2017-05-04,Senate,"Reported Favorably With Substitute  S-1",5,0,0,0,5
1008722,645585,2017-05-16,Senate,"Senate Third Reading: Passed Roll Call # 184",37,0,0,1,38
1008722,654970,2017-05-30,House,"Reported With Recommendation Without Amendment",10,0,0,0,10
1008722,666748,2017-06-20,House,"House Third Reading: Given Immediate Effect Roll Call # 239",107,0,0,0,107
1008722,668088,2017-06-22,Senate,"Senate Third Reading: House Amendment(s) Concurred In Roll Call # 286",37,0,0,1,38
1008752,678379,2017-10-24,House,"Reported With Recommendation With Substitute  H-1",14,0,0,0,14
1008752,678905,2017-11-07,House,"House Third Reading: Given Immediate Effect Roll Call # 376",107,0,0,0,107
1008752,706240,2018-02-20,Senate,"Reported Favorably Without Amendment",5,0,0,0,5
1008752,713868,2018-02-28,Senate,"Senate Third Reading: Given Immediate Effect Roll Call # 115",37,0,0,1,38
1008764,678678,2017-11-01,House,"Reported With Recommendation With Substitute  H-1",5,0,0,0,5
1008764,679436,2017-11-08,House,"House Third Reading: Given Immediate Effect Roll Call # 390",107,0,0,0,107
1008764,680393,2017-12-07,Senate,"Reported Favorably Without Amendment",3,0,0,0,3
1008764,686946,2018-01-18,Senate,"Senate Third Reading: Given Immediate Effect Roll Call # 14",37,0,0,1,38
1008771,678057,2017-10-17,House,"Reported With Recommendation Without Amendment",9,1,0,0,10
1008771,680311,2017-12-06,House,"House Third Reading: Given Immediate Effect Roll Call # 437",109,1,0,0,110
1008771,688255,2018-01-24,Senate,"Reported Favorably Without Amendment",5,0,0,0,5
1008771,703957,2018-02-15,Senate,"Senate Third Reading: Given Immediate Effect Roll Call # 92",34,0,0,4,38
1008771,707633,2018-02-21,Senate,"Senate Third Reading: Passed Roll Call # 102",36,0,0,2,38
1008771,711841,2018-02-22,House,"House Third Reading: Senate Amendment(s) Concurred In Roll Call # 94",108,0,0,0,108
1008777,678098,2017-10-17,House,"Reported With Recommendation Without Amendment",9,1,0,0,10
1008777,680304,2017-12-06,House,"House Third Reading: Given Immediate Effect Roll Call # 435",109,1,0,0,110
1008777,688650,2018-01-24,Senate,"Reported Favorably Without Amendment",5,0,0,0,5
1008777,703988,2018-02-15,Senate,"Senate Third Reading: Given Immediate Effect Roll Call # 90",34,0,0,4,38
1008777,707844,2018-02-21,Senate,"Senate Third Reading: Passed Roll Call # 100",36,0,0,2,38
1008777,711936,2018-02-22,House,"House Third Reading: Senate Amendment(s) Concurred In Roll Call # 92",108,0,0,0,108
1008800,651256,2017-05-24,House,"Reported With Recommendation With Substitute  H-1",9,0,0,0,9
1008800,659045,2017-05-31,House,"House Third Reading: Given Immediate Effect Roll Call # 158",107,0,0,0,107
1008800,660367,2017-06-07,Senate,"Reported Favorably Without Amendment",5,0,0,0,5
1008800,661135,2017-06-08,Senate,"Senate Third Reading: Given Immediate Effect Roll Call # 246",37,0,0,1,38
1008822,678107,2017-10-17,House,"Reported With Recommendation Without Amendment",9,1,0,0,10
1008822,680303,2017-12-06,House,"House Third Reading: Given Immediate Effect Roll Call # 436",109,1,0,0,110
1008822,688444,2018-01-24,Senate,"Reported Favorably Without Amendment",5,0,0,0,5
1008822,703970,2018-02-15,Senate,"Senate Third Reading: Given Immediate Effect Roll Call # 91",34,0,0,4,38
1008822,707625,2018-02-21,Senate,"Senate Third Reading: Passed Roll Call # 101",36,0,0,2,38
1008822,711803,2018-02-22,House,"House Third Reading: Senate Amendment(s) Concurred In Roll Call # 93",108,0,0,0,108
1009004,650769,2017-05-24,Senate,"Reported Favorably With Substitute  S-1",4,0,0,0,4
1009004,659380,2017-06-06,Senate,"Senate Third Reading: Passed Roll Call # 234",36,0,0,2,38
1009004,677856,2017-10-11,House,"Reported With Recommendation Without Amendment",11,0,0,0,11
1009004,679574,2017-11-29,House,"House Third Reading: Given Immediate Effect Roll Call # 407",107,0,0,0,107
1009015,641865,2017-05-09,Senate,"Reported Favorably With Substitute  S-1",4,0,0,0,4
1009015,676324,2017-09-14,Senate,"Senate Third Reading: Passed Roll Call # 337",23,12,0,3,38
1009015,676825,2017-09-19,House,"Reported With Recommendation Without Amendment",5,3,0,0,8
1009015,676826,2017-09-19,House,"House Third Reading: Given Immediate Effect Roll Call # 271",62,45,0,0,107
1009028,643042,2017-05-10,Senate,"Reported Favorably Without Amendment",4,0,0,0,4
1009035,639906,2017-05-04,Senate,"Reported Favorably Without Amendment",5,0,0,0,5
1009035,645985,2017-05-17,Senate,"Senate Third Reading: Passed Roll Call # 190",37,0,0,1,38
1009035,659572,2017-06-06,House,"Reported With Recommendation Without Amendment",10,1,0,0,11
1009035,664280,2017-06-15,House,"House Third Reading: Given Immediate Effect Roll Call # 213",103,4,0,0,107
1009041,639902,2017-05-04,Senate,"Reported Favorably With Substitute  S-1",5,0,0,0,5
1009041,645986,2017-05-17,Senate,"Senate Third Reading: Passed Roll Call # 189",37,0,0,1,38
1009041,659571,2017-06-06,House,"Reported With Recommendation Without Amendment",10,0,0,0,10
1009041,664467,2017-06-15,House,"House Third Reading: Given Immediate Effect Roll Call # 212",105,2,0,0,107
1009041,668106,2017-06-22,Senate,"Senate Third Reading: Roll Call # 287",37,0,0,1,38
1009053,641838,2017-05-09,Senate,"Reported Favorably Without Amendment",4,0,0,0,4
1009053,676387,2017-09-14,Senate,"Senate Third Reading: Passed Roll Call # 338",23,12,0,3,38
1009053,676808,2017-09-19,House,"Reported With Recommendation Without Amendment",5,3,0,0,8
1009053,676809,2017-09-19,House,"House Third Reading: Given Immediate Effect Roll Call # 272",62,45,0,0,107
1009072,657155,2017-05-31,Senate,"Reported Favorably With Substitute  S-2",5,0,0,0,5
1009072,660252,2017-06-07,Senate,"Senate Third Reading: Passed Roll Call # 238",37,0,0,1,38
1009072,755488,2018-05-22,House,"Reported With Recommendation With Substitute  H-2",9,0,0,0,9
1009072,764627,2018-06-12,House,"House Third Reading: Given Immediate Effect Roll Call # 486",98,11,0,0,109
1009072,764628,2018-06-12,Senate,"Senate Third Reading: Roll Call # 544",36,0,0,1,37
1009081,657049,2017-05-31,Senate,"Reported Favorably With Substitute  S-2",5,0,0,0,5
1009081,660618,2017-06-07,Senate,"Senate Third Reading: Passed Roll Call # 237",37,0,0,1,38
1009081,764467,2018-06-12,House,"Reported With Recommendation Without Amendment",9,0,0,0,9
1009081,764468,2018-06-12,House,"House Third Reading: Given Immediate Effect Roll Call # 491",96,13,0,0,109
1009096,642201,2017-05-09,House,"Reported With Recommendation With Substitute  H-3",9,0,0,0,9
1009096,651247,2017-05-18,House,"House Third Reading: Given Immediate Effect Roll Call # 124",106,1,0,0,107
1009096,678695,2017-11-02,Senate,"Reported Favorably With Substitute  S-1",5,0,0,0,5
1009096,714929,2018-03-01,Senate,"Senate Third Reading: Given Immediate Effect Roll Call # 122",36,0,0,2,38
1009096,719602,2018-03-06,House,"House Third Reading: Roll Call # 128",107,1,0,0,108
1009100,676027,2017-09-13,House,"Reported With Recommendation With Substitute H-2",12,4,0,0,16
1009100,677862,2017-10-11,House,"House Third Reading: Given Immediate Effect Roll Call # 300",76,32,0,0,108
1009106,650996,2017-05-24,House,"Reported With Recommendation Without Amendment",29,0,0,0,29
1009106,659122,2017-05-31,House,"House Third Reading: Given Immediate Effect Roll Call # 162",107,0,0,0,107
1009106,664325,2017-06-15,Senate,"Reported Favorably Without Amendment",17,0,0,0,17
1009106,667999,2017-06-22,Senate,"Senate Third Reading: Given Immediate Effect Roll Call # 310",37,0,0,1,38
1009138,641913,2017-05-09,House,"Reported With Recommendation With Substitute  H-4",9,0,0,0,9
1009138,651186,2017-05-18,House,"House Third Reading: Given Immediate Effect Roll Call # 123",106,1,0,0,107
1009138,678713,2017-11-02,Senate,"Reported Favorably With Substitute  S-1",5,0,0,0,5
1009138,714845,2018-03-01,Senate,"Senate Third Reading: Given Immediate Effect Roll Call # 121",36,0,0,2,38
1009138,719637,2018-03-06,House,"House Third Reading: Roll Call # 127",107,1,0,0,108
1009163,662732,2017-06-13,House,"Reported With Recommendation With Substitute  H-2",12,0,0,0,12
1009163,675740,2017-09-12,House,"House Third Reading: Given Immediate Effect Roll Call # 268",106,1,0,0,107
1009163,677857,2017-10-11,Senate,"Reported Favorably Without Amendment",5,0,0,0,5
1009163,678207,2017-10-19,Senate,"Senate Third Reading: Given Immediate Effect Roll Call # 418",37,0,0,1,38
1009163,678445,2017-10-24,House,"House Third Reading: Roll Call # 324",107,0,0,0,107
1009170,651252,2017-05-24,House,"Reported With Recommendation With Substitute  H-1",29,0,0,0,29
1009170,659288,2017-05-31,House,"House Third Reading: Given Immediate Effect Roll Call # 161",107,0,0,0,107
1009170,664327,2017-06-15,Senate,"Reported Favorably Without Amendment",17,0,0,0,17
1009170,668029,2017-06-22,Senate,"Senate Third Reading: Given Immediate Effect Roll Call # 309",37,0,0,1,38
1009201,662775,2017-06-13,House,"Reported With Recommendation With Substitute  H-2",12,0,0,0,12
1009201,675732,2017-09-12,House,"House Third Reading: Given Immediate Effect Roll Call # 267",106,1,0,0,107
1009201,677838,2017-10-11,Senate,"Reported Favorably Without Amendment",5,0,0,0,5
1009201,678190,2017-10-19,Senate,"Senate Third Reading: Given Immediate Effect Roll Call # 417",37,0,0,1,38
1009201,678417,2017-10-24,House,"House Third Reading: Roll Call # 323",107,0,0,0,107
1010021,655027,2017-05-25,Senate,"Reported Favorably Without Amendment",9,0,0,0,9
1010021,664463,2017-06-15,Senate,"Senate Third Reading: Passed Roll Call # 266",38,0,0,0,38
1010021,676011,2017-09-13,House,"Reported With Recommendation Without Amendment",15,0,0,0,15
1010021,677166,2017-09-20,House,"House Third Reading: Given Immediate Effect Roll Call # 276",107,0,0,0,107
1010037,660249,2017-06-07,Senate,"Reported Favorably Without Amendment",10,0,0,0,10
1010037,663354,2017-06-14,Senate,"Senate Third Reading: Passed Roll Call # 251",37,0,0,1,38
1010037,676028,2017-09-13,House,"Reported With Recommendation Without Amendment",16,0,0,0,16
1010037,677797,2017-10-05,House,"House Third Reading: Given Immediate Effect Roll Call # 291",104,4,0,0,108
1010039,662717,2017-06-13,Senate,"Reported Favorably With Substitute  S-1",4,0,0,0,4
1010039,663347,2017-06-14,Senate,"Senate Third Reading: Passed Roll Call # 253",33,4,0,1,38
1010051,645210,2017-05-16,Senate,"Reported Favorably With Substitute  S-1",7,0,0,0,7
1010051,645211,2017-05-16,Senate,"Senate Third Reading: Passed Roll Call # 188",37,0,0,1,38
1010051,646021,2017-05-17,House,"Reported With Recommendation Without Amendment",12,0,0,0,12
1010051,651002,2017-05-24,House,"House Third Reading: Given Immediate Effect Roll Call # 130",100,7,0,0,107
1010055,646625,2017-05-18,Senate,"Reported Favorably With Substitute  S-1",9,0,0,0,9
1010055,664449,2017-06-15,Senate,"Senate Third Reading: Passed Roll Call # 265",38,0,0,0,38
1010055,676012,2017-09-13,House,"Reported With Recommendation With Substitute H-1",14,1,0,0,15
1010055,677170,2017-09-20,House,"House Third Reading: Given Immediate Effect Roll Call # 275",106,1,0,0,107
1010055,677341,2017-09-27,Senate,"Senate Third Reading: Roll Call # 346",37,0,0,1,38
1010055,677535,2017-10-03,House,"House Third Reading: Roll Call # 286",107,0,0,0,107
1010065,661181,2017-06-08,Senate,"Reported Favorably Without Amendment",4,1,0,0,5
1010065,677671,2017-10-05,Senate,"Senate Third Reading: Passed Roll Call # 361",27,9,0,2,38
1010065,711710,2018-02-27,House,"Reported With Recommendation Without Amendment",10,4,0,0,14
1010065,719075,2018-03-07,House,"House Third Reading: Given Immediate Effect Roll Call # 140",62,46,0,0,108
1010100,654764,2017-05-25,Senate,"Reported Favorably With Substitute  S-1",9,0,0,0,9
1010100,664474,2017-06-15,Senate,"Senate Third Reading: Passed Roll Call # 267",38,0,0,0,38
1010100,676025,2017-09-13,House,"Reported With Recommendation Without Amendment",15,0,0,0,15
1010100,677171,2017-09-20,House,"House Third Reading: Given Immediate Effect Roll Call # 277",106,1,0,0,107
1010353,646074,2017-05-17,House,"Reported With Recommendation Without Amendment",16,0,0,0,16
1010353,650904,2017-05-25,House,"House Third Reading: Given Immediate Effect Roll Call # 148",108,0,0,0,108
1010353,661078,2017-06-08,Senate,"Reported Favorably Without Amendment",9,0,0,0,9
1010353,668039,2017-06-22,Senate,"Senate Third Reading: Given Immediate Effect Roll Call # 305",37,0,0,1,38
1010355,651020,2017-05-24,House,"Reported With Recommendation Without Amendment",10,0,0,0,10
1010355,659691,2017-06-06,House,"House Third Reading: Given Immediate Effect Roll Call # 175",107,1,0,0,108
1010355,713555,2018-02-28,Senate,"Reported Favorably With Substitute  S-1",5,0,0,0,5
1010355,727935,2018-03-22,Senate,"Senate Third Reading: Given Immediate Effect Roll Call # 183",34,0,0,3,37
1010355,742089,2018-04-12,House,"House Third Reading: Roll Call # 219",97,11,0,0,108
1010356,677542,2017-10-03,House,"Reported With Recommendation Without Amendment",13,0,0,0,13
1010356,677889,2017-10-12,House,"House Third Reading: Given Immediate Effect Roll Call # 311",107,0,0,0,107
1010356,753664,2018-05-15,Senate,"Reported Favorably With Substitute  S-2",5,0,0,0,5
1010356,755646,2018-05-22,Senate,"Senate Third Reading: Given Immediate Effect Roll Call # 325",36,0,0,1,37
1010356,758204,2018-05-29,House,"House Third Reading: Roll Call # 418",108,0,0,0,108
1010362,651025,2017-05-24,House,"Reported With Recommendation Without Amendment",10,0,0,0,10
1010362,659406,2017-06-06,House,"House Third Reading: Given Immediate Effect Roll Call # 174",107,1,0,0,108
1010362,713570,2018-02-28,Senate,"Reported Favorably With Substitute  S-2",5,0,0,0,5
1010362,727961,2018-03-22,Senate,"Senate Third Reading: Given Immediate Effect Roll Call # 182",34,0,0,3,37
1010362,737566,2018-04-11,House,"House Third Reading: Roll Call # 217",87,22,0,0,109
1010362,738392,2018-04-12,Senate,"Senate Third Reading: Roll Call # 195",35,0,0,2,37
1010367,651231,2017-05-23,House,"Reported With Recommendation With Substitute  H-2",7,2,0,0,9
1010367,659040,2017-05-31,House,"House Third Reading: Given Immediate Effect Roll Call # 169",98,10,0,0,108
1010367,661145,2017-06-08,Senate,"Reported Favorably Without Amendment",3,0,0,0,3
1010367,668224,2017-06-22,Senate,"Senate Third Reading: Given Immediate Effect Roll Call # 292",37,0,0,1,38
1010368,646058,2017-05-17,House,"Reported With Recommendation Without Amendment",14,2,0,0,16
1010368,650919,2017-05-25,House,"House Third Reading: Given Immediate Effect Roll Call # 146",99,8,0,0,107
1010368,661182,2017-06-08,Senate,"Reported Favorably Without Amendment",9,0,0,0,9
1010368,668067,2017-06-22,Senate,"Senate Third Reading: Given Immediate Effect Roll Call # 303",36,1,0,1,38
1010369,677168,2017-09-20,House,"Reported With Recommendation With Substitute  H-2",11,0,0,0,11
1010369,677869,2017-10-11,House,"House Third Reading: Given Immediate Effect Roll Call # 307",100,8,0,0,108
1010369,780222,2018-12-05,Senate,"Reported Favorably With Substitute  S-2",4,0,0,0,4
1010374,646098,2017-05-17,House,"Reported With Recommendation With Substitute  H-1",14,2,0,0,16
1010374,651246,2017-05-25,House,"House Third Reading: Given Immediate Effect Roll Call # 147",99,8,0,0,107
1010374,661157,2017-06-08,Senate,"Reported Favorably Without Amendment",9,0,0,0,9
1010374,668057,2017-06-22,Senate,"Senate Third Reading: Given Immediate Effect Roll Call # 304",36,1,0,1,38
1010375,651163,2017-05-24,House,"Reported With Recommendation Without Amendment",10,0,0,0,10
1010375,659698,2017-06-06,House,"House Third Reading: Given Immediate Effect Roll Call # 176",107,1,0,0,108
1010375,713529,2018-02-28,Senate,"Reported Favorably With Substitute  S-1",5,0,0,0,5
1010375,727904,2018-03-22,Senate,"Senate Third Reading: Given Immediate Effect Roll Call # 184",34,0,0,3,37
1010375,741846,2018-04-12,House,"House Third Reading: Roll Call # 220",91,17,0,0,108
1010377,651239,2017-05-24,House,"Reported With Recommendation Without Amendment",10,0,0,0,10
1010377,659627,2017-06-06,House,"House Third Reading: Given Immediate Effect Roll Call # 177",107,1,0,0,108
1010377,713536,2018-02-28,Senate,"Reported Favorably With Substitute  S-2",5,0,0,0,5
1010377,727878,2018-03-22,Senate,"Senate Third Reading: Given Immediate Effect Roll Call # 185",34,0,0,3,37
1010377,737912,2018-04-11,House,"House Third Reading: Roll Call # 218",86,23,0,0,109
1010377,738372,2018-04-12,Senate,"Senate Third Reading: Roll Call # 196",35,0,0,2,37
1010378,646078,2017-05-17,House,"Reported With Recommendation Without Amendment",16,0,0,0,16
1010378,651045,2017-05-25,House,"House Third Reading: Given Immediate Effect Roll Call # 149",108,0,0,0,108
1010378,661129,2017-06-08,Senate,"Reported Favorably Without Amendment",9,0,0,0,9
1010378,668238,2017-06-22,Senate,"Senate Third Reading: Given Immediate Effect Roll Call # 306",37,0,0,1,38
1010384,666033,2017-06-14,House,"Reported With Recommendation With Substitute  H-3",13,0,0,0,13
1010613,660469,2017-06-07,Senate,"Reported Favorably With Substitute  S-1",10,0,0,0,10
1010613,668299,2017-06-22,Senate,"Senate Third Reading: Passed Roll Call # 301",37,0,0,1,38
1010613,677339,2017-09-27,House,"Reported With Recommendation Without Amendment",16,0,0,0,16
1010613,678247,2017-10-19,House,"House Third Reading: Given Immediate Effect Roll Call # 320",88,19,0,0,107
1010625,679111,2017-11-09,Senate,"Reported Favorably With Substitute  S-1",7,0,0,0,7
1010625,680775,2017-12-13,Senate,"Senate Third Reading: Passed Roll Call # 539",37,1,0,0,38
1010625,779200,2018-11-28,House,"Reported With Recommendation With Substitute  H-1",12,1,0,0,13
1010625,781019,2018-12-18,House,"House Third Reading: Given Immediate Effect Roll Call # 876",91,18,0,0,109
1010625,781500,2018-12-19,Senate,"Senate Third Reading: Roll Call # 920",38,0,0,0,38
1010638,651161,2017-05-24,House,"Reported With Recommendation Without Amendment",9,0,0,0,9
1010638,658926,2017-05-31,House,"House Third Reading: Given Immediate Effect Roll Call # 159",103,4,0,0,107
1010638,676017,2017-09-13,Senate,"Reported Favorably Without Amendment",8,0,0,0,8
1010638,677605,2017-10-04,Senate,"Senate Third Reading: Given Immediate Effect Roll Call # 355",36,0,0,2,38
1010650,679097,2017-11-09,Senate,"Reported Favorably Without Amendment",7,0,0,0,7
1010650,680766,2017-12-13,Senate,"Senate Third Reading: Passed Roll Call # 538",37,1,0,0,38
1010650,779236,2018-11-28,House,"Reported With Recommendation With Substitute  H-1",11,0,0,0,11
1010650,781046,2018-12-18,House,"House Third Reading: Given Immediate Effect Roll Call # 875",98,11,0,0,109
1010650,781417,2018-12-19,Senate,"Senate Third Reading: Roll Call # 919",38,0,0,0,38
1010735,654879,2017-05-25,Senate,"Reported Favorably Without Amendment",4,1,0,0,5
1010735,679005,2017-11-08,Senate,"Senate Third Reading: Passed Roll Call # 445",26,11,0,1,38
1010795,646622,2017-05-18,Senate,"Reported Favorably Without Amendment",5,0,0,0,5
1010795,649496,2017-05-24,Senate,"Senate Third Reading: Passed Roll Call # 221",36,2,0,0,38
1010889,658929,2017-05-31,House,"Reported With Recommendation With Substitute  H-2",10,0,0,0,10
1010889,666840,2017-06-20,House,"House Third Reading: Given Immediate Effect Roll Call # 231",64,43,0,0,107
1010908,677564,2017-10-03,House,"Reported With Recommendation With Substitute  H-1",9,1,0,0,10
1010908,692712,2018-01-31,House,"House Third Reading: Given Immediate Effect Roll Call # 39",94,15,0,0,109
1010908,720713,2018-03-08,Senate,"Reported Favorably Without Amendment",5,0,0,0,5
1010927,677563,2017-10-03,House,"Reported With Recommendation With Substitute  H-2",9,1,0,0,10
1010927,692053,2018-01-31,House,"House Third Reading: Given Immediate Effect Roll Call # 40",93,16,0,0,109
1010927,720699,2018-03-08,Senate,"Reported Favorably Without Amendment",5,0,0,0,5
1010968,664313,2017-06-14,House,"Reported With Recommendation With Substitute  H-1",5,3,0,0,8
1010968,666439,2017-06-20,House,"House Third Reading: Given Immediate Effect Roll Call # 250",61,46,0,0,107
1010968,677303,2017-09-26,Senate,"Reported Favorably Without Amendment",5,0,0,0,5
1010968,677811,2017-10-10,Senate,"Senate Third Reading: Given Immediate Effect Roll Call # 378",26,10,0,2,38
1010975,677560,2017-10-03,House,"Reported With Recommendation With Substitute  H-1",9,1,0,0,10
1010975,692305,2018-01-31,House,"House Third Reading: Given Immediate Effect Roll Call # 38",93,16,0,0,109
1010975,692306,2018-01-31,House,"House Third Reading: Passed Roll Call # 41",94,15,0,0,109
1010975,720714,2018-03-08,Senate,"Reported Favorably Without Amendment",5,0,0,0,5
1012110,643401,2017-05-10,Senate,"Reported Favorably Without Amendment",4,0,0,0,4
1012110,646077,2017-05-17,Senate,"Senate Third Reading: Passed Roll Call # 192",37,0,0,1,38
1012110,659316,2017-06-06,House,"Reported With Recommendation Without Amendment",10,1,0,0,11
1012110,664348,2017-06-15,House,"House Third Reading: Given Immediate Effect Roll Call # 215",103,4,0,0,107
1012165,642933,2017-05-10,Senate,"Reported Favorably With Substitute  S-2",4,0,0,0,4
1012165,646121,2017-05-17,Senate,"Senate Third Reading: Passed Roll Call # 191",37,0,0,1,38
1012165,659055,2017-06-06,House,"Reported With Recommendation Without Amendment",12,0,0,0,12
1012165,664338,2017-06-15,House,"House Third Reading: Given Immediate Effect Roll Call # 214",105,2,0,0,107
1012165,668182,2017-06-22,Senate,"Senate Third Reading: Roll Call # 288",37,0,0,1,38
1012540,646817,2017-05-18,Senate,"Reported Favorably Without Amendment",9,0,0,0,9
1012540,655401,2017-05-30,Senate,"Senate Third Reading: Passed Roll Call # 229",38,0,0,0,38
1012540,677347,2017-09-27,House,"Reported With Recommendation Without Amendment",16,0,0,0,16
1012540,677868,2017-10-11,House,"House Third Reading: Given Immediate Effect Roll Call # 304",107,1,0,0,108
1012559,677009,2017-09-20,Senate,"Reported Favorably With Substitute  S-1",4,0,0,0,4
1012559,677531,2017-10-03,Senate,"Senate Third Reading: Passed Roll Call # 353",36,0,1,1,38
1012559,680208,2017-12-06,House,"Reported With Recommendation Without Amendment",12,0,0,0,12
1012559,681060,2017-12-13,House,"House Third Reading: Given Immediate Effect Roll Call # 502",110,0,0,0,110
1012578,646835,2017-05-18,Senate,"Reported Favorably Without Amendment",8,0,0,0,8
1012578,655342,2017-05-30,Senate,"Senate Third Reading: Passed Roll Call # 230",38,0,0,0,38
1012578,677332,2017-09-27,House,"Reported With Recommendation Without Amendment",15,0,0,0,15
1012578,678486,2017-10-25,House,"House Third Reading: Given Immediate Effect Roll Call # 325",106,0,0,0,106
1012660,655121,2017-05-30,Senate,"Reported Favorably Without Amendment",5,0,0,0,5
1012660,780165,2018-12-05,Senate,"Senate Third Reading: Passed Roll Call # 698",32,5,0,1,38
1012660,780528,2018-12-12,House,"Reported With Recommendation With Substitute  H-2",12,2,0,0,14
1013008,651016,2017-05-24,House,"Reported With Recommendation Without Amendment",26,3,0,0,29
1013008,659026,2017-05-31,House,"House Third Reading: Given Immediate Effect Roll Call # 163",102,5,0,0,107
1013008,756888,2018-05-24,Senate,"Reported Favorably Without Amendment",16,0,0,0,16
1013008,762403,2018-06-12,Senate,"Senate Third Reading: Given Immediate Effect Roll Call # 437",35,1,0,1,37
1013040,651320,2017-05-17,House,"Reported With Recommendation With Substitute  H-1",9,0,0,0,9
1013040,651321,2017-05-23,House,"House Third Reading: Given Immediate Effect Roll Call # 128",65,43,0,0,108
1013040,662514,2017-06-13,Senate,"Reported Favorably Without Amendment",4,0,0,0,4
1013040,781353,2018-12-20,Senate,"Senate Third Reading: Given Immediate Effect Roll Call # 1022",35,3,0,0,38
1013040,781589,2018-12-21,House,"House Third Reading: Roll Call # 987",75,32,0,0,107
1013074,660400,2017-06-07,House,"Reported With Recommendation Without Amendment",10,6,0,0,16
1013074,666721,2017-06-20,House,"House Third Reading: Given Immediate Effect Roll Call # 229",62,45,0,0,107
1013074,781409,2018-12-18,Senate,"Senate Third Reading: Given Immediate Effect Roll Call # 898",26,12,0,0,38
1013104,779189,2018-11-28,House,"Reported With Recommendation With Substitute  H-1",9,2,0,0,11
1013172,774935,2018-09-26,House,"Reported With Recommendation Without Amendment",21,4,0,0,25
1013172,777165,2018-10-03,House,"House Third Reading: Passed Roll Call # 603",72,35,0,0,107
1013172,780166,2018-12-06,Senate,"Reported Favorably Without Amendment",11,3,0,0,14
1013172,781489,2018-12-19,Senate,"Senate Third Reading: Given Immediate Effect Roll Call # 936",26,12,0,0,38
1013172,781547,2018-12-20,House,"House Third Reading: Roll Call # 949",73,35,0,0,108
1013228,650940,2017-05-24,House,"Reported With Recommendation With Substitute  H-1",26,3,0,0,29
1013228,658918,2017-05-31,House,"House Third Reading: Given Immediate Effect Roll Call # 164",104,4,0,0,108
1013228,756882,2018-05-24,Senate,"Reported Favorably Without Amendment",16,0,0,0,16
1013228,762406,2018-06-12,Senate,"Senate Third Reading: Given Immediate Effect Roll Call # 438",35,1,0,1,37
1013260,677335,2017-09-26,House,"Reported With Recommendation Without Amendment",10,1,0,0,11
1013260,678245,2017-10-19,House,"House Third Reading: Given Immediate Effect Roll Call # 315",104,3,0,0,107
1013260,680084,2017-12-06,Senate,"Reported Favorably Without Amendment",5,0,0,0,5
1013260,711654,2018-02-27,Senate,"Senate Third Reading: Defeated Roll Call # 112",16,19,1,2,38
1013992,646723,2017-05-18,Senate,"Reported Favorably Without Amendment",7,0,0,0,7
1013992,649553,2017-05-24,Senate,"Senate Third Reading: Passed Roll Call # 223",38,0,0,0,38
1013992,660570,2017-06-07,House,"Reported With Recommendation Without Amendment",13,0,0,0,13
1013992,666703,2017-06-20,House,"House Third Reading: Given Immediate Effect Roll Call # 237",105,2,0,0,107
1014002,664337,2017-06-15,Senate,"Reported Favorably With Substitute  S-2",8,0,0,0,8
1014002,668112,2017-06-22,Senate,"Senate Third Reading: Passed Roll Call # 308",37,0,0,1,38
1014002,677831,2017-10-11,House,"Reported With Recommendation With Substitute  H-1",16,0,0,0,16
1014002,678248,2017-10-19,House,"House Third Reading: Given Immediate Effect Roll Call # 316",103,4,0,0,107
1014002,678605,2017-10-31,Senate,"Senate Third Reading: Roll Call # 428",35,0,0,3,38
1014164,651014,2017-05-24,House,"Reported With Recommendation Without Amendment",21,0,0,0,21
1014164,659557,2017-05-31,House,"House Third Reading: Given Immediate Effect Roll Call # 168",103,5,0,0,108
1014164,664523,2017-06-15,Senate,"Reported Favorably With Substitute  S-1",5,0,0,0,5
1014164,664524,2017-06-15,Senate,"Senate Third Reading: Given Immediate Effect Roll Call # 264",38,0,0,0,38
1014164,666933,2017-06-20,House,"House Third Reading: Roll Call # 227",103,4,0,0,107
1014219,651257,2017-05-24,House,"Reported With Recommendation Without Amendment",21,0,0,0,21
1014219,659505,2017-05-31,House,"House Third Reading: Given Immediate Effect Roll Call # 167",85,23,0,0,108
1014219,664322,2017-06-15,Senate,"Reported Favorably Without Amendment",5,0,0,0,5
1014219,664323,2017-06-15,Senate,"Senate Third Reading: Given Immediate Effect Roll Call # 263",38,0,0,0,38
1014413,676344,2017-09-14,Senate,"Reported Favorably Without Amendment",5,0,0,0,5
1014413,678196,2017-10-19,Senate,"Senate Third Reading: Passed Roll Call # 410",37,0,0,1,38
1014413,679419,2017-11-08,House,"Reported With Recommendation Without Amendment",16,0,0,0,16
1014413,679573,2017-11-29,House,"House Third Reading: Given Immediate Effect Roll Call # 413",94,13,0,0,107
1014424,655000,2017-05-25,Senate,"Reported Favorably With Substitute  S-1",5,0,0,0,5
1014424,659119,2017-06-06,Senate,"Senate Third Reading: Passed Roll Call # 236",36,0,0,2,38
1014424,666815,2017-06-20,House,"Reported With Recommendation Without Amendment",9,0,0,0,9
1014424,666816,2017-06-20,House,"House Third Reading: Given Immediate Effect Roll Call # 257",107,0,0,0,107
1014438,648866,2017-05-23,Senate,"Reported Favorably With Substitute  S-1",5,0,0,0,5
1014448,658917,2017-06-06,Senate,"Reported Favorably With Substitute  S-2",4,0,0,0,4
1014448,660547,2017-06-07,Senate,"Senate Third Reading: Passed Roll Call # 239",37,0,0,1,38
1014448,677812,2017-10-10,House,"Reported With Recommendation Without Amendment",10,0,0,0,10
1014448,678866,2017-11-07,House,"House Third Reading: Given Immediate Effect Roll Call # 378",107,0,0,0,107
1014458,661102,2017-06-08,Senate,"Reported Favorably Without Amendment",5,1,0,0,6
1014472,651012,2017-05-25,House,"Reported With Recommendation With Substitute  H-2",9,6,0,0,15
1014493,651042,2017-05-25,House,"Reported With Recommendation With Substitute  H-2",10,5,0,0,15
1014502,660494,2017-06-07,House,"Reported With Recommendation With Substitute  H-2",7,4,0,0,11
1014502,677334,2017-09-27,House,"House Third Reading: Given Immediate Effect Roll Call # 281",69,39,0,0,108
1014506,779689,2018-12-04,House,"Reported With Recommendation With Substitute  H-1",9,2,0,0,11
1014506,779959,2018-12-06,House,"House Third Reading: Given Immediate Effect Roll Call # 765",88,21,0,0,109
1014506,780515,2018-12-12,Senate,"Reported Favorably Without Amendment",5,0,0,0,5
1014506,780741,2018-12-13,Senate,"Senate Third Reading: Given Immediate Effect Roll Call # 798",30,7,0,1,38
1014535,651050,2017-05-25,House,"Reported With Recommendation With Substitute  H-1",17,0,0,0,17
1014544,697871,2018-02-08,House,"Reported With Recommendation Without Amendment",15,0,0,0,15
1014544,712475,2018-02-27,House,"House Third Reading: Given Immediate Effect Roll Call # 104",108,0,0,0,108
1014544,753984,2018-05-16,Senate,"Reported Favorably Without Amendment",4,0,0,0,4
1014544,760150,2018-06-05,Senate,"Senate Third Reading: Given Immediate Effect Roll Call # 389",36,0,0,1,37
1014546,651049,2017-05-25,House,"Reported With Recommendation Without Amendment",17,0,0,0,17
1014729,661154,2017-06-08,Senate,"Reported Favorably Without Amendment",7,0,0,0,7
1014729,668139,2017-06-22,Senate,"Senate Third Reading: Passed Roll Call # 302",29,8,0,1,38
1014738,654783,2017-05-30,House,"Reported With Recommendation Without Amendment",9,0,0,0,9
1014777,679945,2017-12-05,Senate,"Reported Favorably With Substitute  S-1",8,0,0,0,8
1014777,680765,2017-12-13,Senate,"Senate Third Reading: Passed Roll Call # 550",38,0,0,0,38
1014777,692698,2018-01-31,House,"Reported With Recommendation With Substitute  H-1",11,0,0,0,11
1014777,702178,2018-02-13,House,"House Third Reading: Given Immediate Effect Roll Call # 60",106,2,0,0,108
1014777,703022,2018-02-14,Senate,"Senate Third Reading: Roll Call # 69",36,0,0,2,38
1014805,679629,2017-11-30,Senate,"Reported Favorably With Substitute  S-1",4,1,0,0,5
1014805,680779,2017-12-13,Senate,"Senate Third Reading: Passed Roll Call # 548",25,13,0,0,38
1014805,703169,2018-02-14,House,"Reported With Recommendation With Amendment(s)",7,0,0,0,7
1014833,664270,2017-06-14,House,"Reported With Recommendation Without Amendment",13,0,0,0,13
1014833,666686,2017-06-20,House,"House Third Reading: Given Immediate Effect Roll Call # 242",107,0,0,0,107
1014833,740156,2018-04-17,Senate,"Reported Favorably With Substitute  S-1",4,0,0,0,4
1014833,741509,2018-04-19,Senate,"Senate Third Reading: Given Immediate Effect Roll Call # 216",37,0,0,0,37
1014833,745259,2018-04-24,House,"House Third Reading: Roll Call # 237",106,0,0,0,106
1015569,659488,2017-06-06,House,"Reported With Recommendation Without Amendment",10,0,0,0,10
1015576,661091,2017-06-08,Senate,"Reported Favorably Without Amendment",4,0,0,0,4
1015576,661092,2017-06-08,Senate,"Senate Third Reading: Passed Roll Call # 247",37,0,0,1,38
1015576,666810,2017-06-20,House,"Reported With Recommendation Without Amendment",27,0,0,0,27
1015576,666811,2017-06-20,House,"House Third Reading: Given Immediate Effect Roll Call # 253",107,0,0,0,107
1015591,774831,2018-09-25,Senate,"Reported Favorably With Substitute  S-5",4,1,0,0,5
1015591,779710,2018-12-04,Senate,"Senate Third Reading: Defeated Roll Call # 657",17,19,0,2,38
1015591,780208,2018-12-06,Senate,"Senate Third Reading: Passed Roll Call # 743",21,15,0,2,38
1015594,679454,2017-11-28,Senate,"Reported Favorably With Substitute  S-2",8,0,0,0,8
1015594,680127,2017-12-06,Senate,"Senate Third Reading: Passed Roll Call # 486",30,6,0,2,38
1015594,691340,2018-01-30,House,"Reported With Recommendation With Substitute  H-1",9,1,0,0,10
1015594,702718,2018-02-14,House,"House Third Reading: Given Immediate Effect Roll Call # 61",99,10,0,0,109
1015594,702719,2018-02-14,House,"House Third Reading: Passed Roll Call # 72",98,11,0,0,109
1015594,711653,2018-02-27,Senate,"Senate Third Reading: Roll Call # 111",35,1,0,2,38
1015630,664371,2017-06-15,Senate,"Reported Favorably With Substitute  S-1",5,0,0,0,5
1015630,664372,2017-06-15,Senate,"Senate Third Reading: Given Immediate Effect Roll Call # 261",21,17,0,0,38
1015630,666597,2017-06-20,House,"House Third Reading: Given Immediate Effect Roll Call # 216",55,51,0,0,106
1015644,664330,2017-06-14,House,"Reported With Recommendation With Substitute  H-1",9,5,0,0,14
1015644,664331,2017-06-15,House,"House Third Reading: Given Immediate Effect Roll Call # 211",55,52,0,0,107
1015654,659333,2017-06-06,House,"Reported With Recommendation Without Amendment",12,0,0,0,12
1015654,661285,2017-06-08,House,"House Third Reading: Given Immediate Effect Roll Call # 190",105,2,0,0,107
1015654,664328,2017-06-15,Senate,"Reported Favorably With Substitute  S-1",5,0,0,0,5
1015654,664329,2017-06-15,Senate,"Senate Third Reading: Given Immediate Effect Roll Call # 274",38,0,0,0,38
1015654,666549,2017-06-20,House,"House Third Reading: Roll Call # 222",105,2,0,0,107
1015660,664496,2017-06-14,House,"Reported With Recommendation With Substitute  H-4",13,0,0,0,13
1015660,672532,2017-07-12,House,"House Third Reading: Passed Roll Call # 263",100,6,0,0,106
1015660,680645,2017-12-12,Senate,"Reported Favorably With Substitute  S-2",4,0,0,0,4
1015660,688548,2018-01-24,Senate,"Senate Third Reading: Given Immediate Effect Roll Call # 28",32,6,0,0,38
1015660,691644,2018-01-30,House,"House Third Reading: Roll Call # 30",96,12,0,0,108
1015660,692387,2018-01-31,Senate,"Senate Third Reading: Roll Call # 44",30,7,0,1,38
1015680,659167,2017-06-06,House,"Reported With Recommendation With Substitute H-1",12,0,0,0,12
1015680,660383,2017-06-06,House,"Reported With Recommendation With Substitute  H-1",12,0,0,0,12
1015680,661388,2017-06-08,House,"House Third Reading: Given Immediate Effect Roll Call # 191",107,0,0,0,107
1015680,664427,2017-06-15,Senate,"Reported Favorably With Substitute  S-1",5,0,0,0,5
1015680,664428,2017-06-15,Senate,"Senate Third Reading: Given Immediate Effect Roll Call # 275",38,0,0,0,38
1015680,666870,2017-06-20,House,"House Third Reading: Roll Call # 223",107,0,0,0,107
1015696,659297,2017-06-06,House,"Reported With Recommendation Without Amendment",11,0,0,0,11
1015696,661286,2017-06-08,House,"House Third Reading: Given Immediate Effect Roll Call # 187",105,2,0,0,107
1015696,664310,2017-06-15,Senate,"Senate Third Reading: Given Immediate Effect Roll Call # 271",38,0,0,0,38
1015696,666448,2017-06-20,House,"House Third Reading: Roll Call # 220",105,2,0,0,107
1015706,780506,2018-12-12,House,"Reported With Recommendation Without Amendment",8,0,0,0,8
1015706,780507,2018-12-12,House,"House Third Reading: Given Immediate Effect Roll Call # 822",100,9,0,0,109
1015710,659329,2017-06-06,House,"Reported With Recommendation Without Amendment",12,0,0,0,12
1015710,661415,2017-06-08,House,"House Third Reading: Given Immediate Effect Roll Call # 188",105,2,0,0,107
1015710,664368,2017-06-15,Senate,"Senate Third Reading: Given Immediate Effect Roll Call # 272",38,0,0,0,38
1015710,666725,2017-06-20,House,"House Third Reading: Roll Call # 221",105,2,0,0,107
1015716,702410,2018-02-14,House,"Reported With Recommendation With Substitute  H-2",13,0,0,0,13
1015716,722497,2018-03-13,House,"House Third Reading: Given Immediate Effect Roll Call # 154",96,13,0,0,109
1015716,753576,2018-05-15,Senate,"Reported Favorably With Substitute  S-1",4,2,0,0,6
1015716,755922,2018-05-23,Senate,"Senate Third Reading: Given Immediate Effect Roll Call # 343",30,7,0,0,37
1015716,757951,2018-05-29,House,"House Third Reading: Roll Call # 419",95,13,0,0,108
1015720,659052,2017-06-06,House,"Reported With Recommendation Without Amendment",10,1,0,0,11
1015720,661384,2017-06-08,House,"House Third Reading: Given Immediate Effect Roll Call # 189",105,2,0,0,107
1015720,664384,2017-06-15,Senate,"Senate Third Reading: Given Immediate Effect Roll Call # 273",38,0,0,0,38
1015725,659138,2017-06-06,House,"Reported With Recommendation Without Amendment",12,0,0,0,12
1015725,661324,2017-06-08,House,"House Third Reading: Given Immediate Effect Roll Call # 192",107,0,0,0,107
1015725,664354,2017-06-15,Senate,"Reported Favorably Without Amendment",5,0,0,0,5
1015725,664355,2017-06-15,Senate,"Senate Third Reading: Given Immediate Effect Roll Call # 276",38,0,0,0,38
1015730,707558,2018-02-20,House,"Reported With Recommendation Without Amendment",11,0,0,0,11
1015730,714847,2018-03-01,House,"House Third Reading: Given Immediate Effect Roll Call # 124",109,0,0,0,109
1015730,723300,2018-03-14,Senate,"Reported Favorably Without Amendment",5,0,0,0,5
1015730,727953,2018-03-22,Senate,"Senate Third Reading: Given Immediate Effect Roll Call # 178",34,0,0,3,37
1015885,654792,2017-05-30,House,"Reported With Recommendation Without Amendment",9,0,0,0,9
1015905,779319,2018-11-28,House,"Reported With Recommendation With Substitute  H-1",9,2,0,0,11
1015917,679686,2017-11-30,Senate,"Reported Favorably Without Amendment",6,0,0,0,6
1015917,680727,2017-12-13,Senate,"Senate Third Reading: Passed Roll Call # 543",37,1,0,0,38
1015919,659164,2017-06-06,House,"Reported With Recommendation With Substitute H-1",11,0,0,0,11
1015919,660433,2017-06-06,House,"Reported With Recommendation With Substitute  H-1",11,0,0,0,11
1015919,664518,2017-06-15,House,"House Third Reading: Given Immediate Effect Roll Call # 209",97,10,0,0,107
1015919,676812,2017-09-19,Senate,"Reported Favorably Without Amendment",8,0,0,0,8
1015919,677603,2017-10-04,Senate,"Senate Third Reading: Given Immediate Effect Roll Call # 356",36,0,0,2,38
1015929,655206,2017-05-30,Senate,"Reported Favorably Without Amendment",5,0,0,0,5
1015929,675092,2017-09-06,Senate,"Senate Third Reading: Passed Roll Call # 326",38,0,0,0,38
1015929,778933,2018-11-27,House,"Reported With Recommendation With Substitute  H-1",12,0,0,0,12
1015929,781372,2018-12-21,House,"House Third Reading: Given Immediate Effect Roll Call # 974",107,0,0,0,107
1015929,781631,2018-12-21,Senate,"Senate Third Reading: Roll Call # 1054",37,0,0,1,38
1015940,659151,2017-06-06,House,"Reported With Recommendation With Substitute H-1",11,0,0,0,11
1015940,660432,2017-06-06,House,"Reported With Recommendation With Substitute  H-1",11,0,0,0,11
1015940,664458,2017-06-15,House,"House Third Reading: Given Immediate Effect Roll Call # 210",98,9,0,0,107
1015940,676810,2017-09-19,Senate,"Reported Favorably Without Amendment",8,0,0,0,8
1015940,677627,2017-10-04,Senate,"Senate Third Reading: Given Immediate Effect Roll Call # 357",36,0,0,2,38
1015947,664410,2017-06-15,Senate,"Reported Favorably Without Amendment",5,0,0,0,5
1015947,669924,2017-06-28,Senate,"Senate Third Reading: Passed Roll Call # 315",35,0,0,3,38
1015947,677592,2017-10-04,House,"Reported With Recommendation With Amendment(s)",7,0,0,0,7
1015947,677841,2017-10-11,House,"House Third Reading: Given Immediate Effect Roll Call # 308",107,1,0,0,108
1015947,678038,2017-10-17,Senate,"Senate Third Reading: House Amendment(s) Concurred In Roll Call # 389",38,0,0,0,38
1016261,779307,2018-11-28,House,"Reported With Recommendation With Substitute  H-1",9,2,0,0,11
1016285,779196,2018-11-28,House,"Reported With Recommendation With Substitute  H-1",9,2,0,0,11
1016311,659570,2017-06-06,House,"Reported With Recommendation With Substitute H-1",12,0,0,0,12
1016311,660708,2017-06-06,House,"Reported With Recommendation With Substitute  H-1",12,0,0,0,12
1016311,661483,2017-06-08,House,"House Third Reading: Given Immediate Effect Roll Call # 193",107,0,0,0,107
1016311,664365,2017-06-15,Senate,"Reported Favorably With Substitute  S-1",5,0,0,0,5
1016311,664366,2017-06-15,Senate,"Senate Third Reading: Given Immediate Effect Roll Call # 277",38,0,0,0,38
1016311,666454,2017-06-20,House,"House Third Reading: Roll Call # 224",107,0,0,0,107
1017080,779212,2018-11-28,House,"Reported With Recommendation Without Amendment",9,2,0,0,11
1017082,779207,2018-11-28,House,"Reported With Recommendation With Substitute  H-1",9,2,0,0,11
1017083,661096,2017-06-08,Senate,"Reported Favorably Without Amendment",4,0,0,0,4
1017088,675305,2017-09-07,House,"Reported With Recommendation With Substitute H-1",15,0,0,0,15
1017088,676009,2017-09-13,House,"House Third Reading: Given Immediate Effect Roll Call # 269",104,3,0,0,107
1017088,679488,2017-11-29,Senate,"Reported Favorably With Substitute  S-1",5,0,0,0,5
1017088,699631,2018-02-06,Senate,"Senate Third Reading: Given Immediate Effect Roll Call # 58",36,0,0,2,38
1017088,702246,2018-02-13,House,"House Third Reading: Roll Call # 58",105,3,0,0,108
1017091,697500,2018-02-07,House,"Reported With Recommendation With Substitute H-3",8,1,0,0,9
1017091,711972,2018-02-27,House,"House Third Reading: Given Immediate Effect Roll Call # 101",96,12,0,0,108
1017091,723092,2018-03-14,Senate,"Reported Favorably Without Amendment",5,0,0,0,5
1017094,664296,2017-06-15,Senate,"Reported Favorably Without Amendment",5,0,0,0,5
1017094,664297,2017-06-15,Senate,"Senate Third Reading: Given Immediate Effect Roll Call # 279",38,0,0,0,38
1017094,666451,2017-06-20,House,"Reported With Recommendation Without Amendment",10,1,0,0,11
1017094,666452,2017-06-20,House,"House Third Reading: Given Immediate Effect Roll Call # 255",105,2,0,0,107
1017097,664407,2017-06-14,House,"Reported With Recommendation With Substitute  H-2",15,0,0,0,15
1017097,713193,2018-02-28,House,"House Third Reading: Given Immediate Effect Roll Call # 105",107,2,0,0,109
1017097,745509,2018-04-26,Senate,"Reported Favorably With Substitute  S-1",8,0,0,0,8
1017097,748176,2018-05-02,Senate,"Senate Third Reading: Given Immediate Effect Roll Call # 245",37,0,0,0,37
1017097,749215,2018-05-03,House,"House Third Reading: Roll Call # 265",104,3,0,0,107
1017098,681165,2017-12-13,House,"Reported With Recommendation With Substitute  H-1",3,0,0,0,3
1017098,753979,2017-12-13,House,"Reported With Recommendation With Substitute H-1",3,0,0,0,3
1017098,755215,2018-05-17,House,"House Third Reading: Given Immediate Effect Roll Call # 337",107,1,0,0,108
1017098,774297,2018-09-05,Senate,"Reported Favorably Without Amendment",3,0,0,0,3
1017098,774298,2018-09-05,Senate,"Senate Third Reading: Given Immediate Effect Roll Call # 559",35,0,0,2,37
1017098,774333,2018-09-05,Senate,"Senate Third Reading: Given Immediate Effect Roll Call # 558",35,0,0,2,37
1017104,678567,2017-10-26,House,"Reported With Recommendation With Substitute  H-1",9,0,0,0,9
1017104,679586,2017-11-29,House,"House Third Reading: Given Immediate Effect Roll Call # 404",104,3,0,0,107
1017107,662515,2017-06-13,Senate,"Reported Favorably Without Amendment",4,0,0,0,4
1017107,669874,2017-06-28,Senate,"Senate Third Reading: Passed Roll Call # 320",35,1,0,2,38
1017107,678043,2017-10-17,House,"Reported With Recommendation Without Amendment",15,0,0,0,15
1017107,678652,2017-10-31,House,"House Third Reading: Given Immediate Effect Roll Call # 336",101,5,0,0,106
1017112,697179,2018-02-07,House,"Reported With Recommendation With Substitute  H-2",8,1,0,0,9
1017112,712223,2018-02-27,House,"House Third Reading: Given Immediate Effect Roll Call # 102",96,12,0,0,108
1017112,723408,2018-03-14,Senate,"Reported Favorably Without Amendment",5,0,0,0,5
1017117,664408,2017-06-15,Senate,"Reported Favorably Without Amendment",4,1,0,0,5
1017117,675102,2017-09-06,Senate,"Senate Third Reading: Passed Roll Call # 328",26,12,0,0,38
1017117,680299,2017-12-06,House,"Reported With Recommendation Without Amendment",6,3,0,0,9
1017117,686329,2018-01-18,House,"House Third Reading: Given Immediate Effect Roll Call # 15",59,48,0,0,107
1017117,687842,2018-01-23,Senate,"Senate Third Reading: House Amendment(s) Concurred In As Amended Roll Call # 17",23,14,0,1,38
1017119,779228,2018-11-28,House,"Reported With Recommendation With Substitute  H-1",9,2,0,0,11
1017122,661075,2017-06-08,Senate,"Reported Favorably Without Amendment",4,0,0,0,4
1017123,664284,2017-06-14,House,"Reported With Recommendation Without Amendment",15,0,0,0,15
1017123,713772,2018-02-28,House,"House Third Reading: Given Immediate Effect Roll Call # 106",107,2,0,0,109
1017123,775105,2018-09-26,Senate,"Reported Favorably With Substitute  S-1",7,0,0,0,7
1017123,775106,2018-09-26,Senate,"Senate Third Reading: Given Immediate Effect Roll Call # 567",35,1,0,1,37
1017123,775311,2018-10-02,House,"House Third Reading: Roll Call # 584",101,4,0,0,105
1017132,779209,2018-11-28,House,"Reported With Recommendation Without Amendment",9,2,0,0,11
1017136,707670,2018-02-15,House,"Reported With Recommendation Without Amendment",4,2,0,0,6
1017141,779229,2018-11-28,House,"Reported With Recommendation With Substitute  H-2",9,2,0,0,11
1017225,666446,2017-06-20,House,"Reported With Recommendation With Substitute H-2",6,3,0,0,9
1017225,668422,2017-06-20,House,"Reported With Recommendation With Substitute  H-2",6,3,0,0,9
1017232,662551,2017-06-13,Senate,"Reported Favorably Without Amendment",5,0,0,0,5
1017232,679643,2017-11-30,Senate,"Senate Third Reading: Passed Roll Call # 467",37,0,0,1,38
1017232,697107,2018-02-07,House,"Reported With Recommendation With Substitute  H-1",9,0,0,0,9
1017232,702417,2018-02-07,House,"Reported With Recommendation With Substitute H-1",9,0,0,0,9
1017232,707447,2018-02-20,House,"House Third Reading: Given Immediate Effect Roll Call # 85",107,1,0,0,108
1017232,707448,2018-02-21,Senate,"Senate Third Reading: Roll Call # 99",35,0,0,3,38
1017240,779210,2018-11-28,House,"Reported With Recommendation With Substitute  H-1",9,2,0,0,11
1017246,662600,2017-06-13,Senate,"Reported Favorably With Substitute  S-1",5,0,0,0,5
1017246,679699,2017-11-30,Senate,"Senate Third Reading: Passed Roll Call # 466",37,0,0,1,38
1017246,697113,2018-02-07,House,"Reported With Recommendation With Substitute  H-1",9,0,0,0,9
1017246,707430,2018-02-20,House,"House Third Reading: Given Immediate Effect Roll Call # 83",102,6,0,0,108
1017246,707431,2018-02-20,House,"House Third Reading: Passed Roll Call # 86",104,4,0,0,108
1017246,707432,2018-02-21,Senate,"Senate Third Reading: Roll Call # 97",34,0,1,3,38
1017247,662863,2017-06-13,Senate,"Reported Favorably Without Amendment",5,0,0,0,5
1017247,679644,2017-11-30,Senate,"Senate Third Reading: Passed Roll Call # 468",38,0,0,0,38
1017247,697007,2018-02-07,House,"Reported With Recommendation With Substitute  H-1",9,0,0,0,9
1017247,707510,2018-02-20,House,"House Third Reading: Given Immediate Effect Roll Call # 84",103,5,0,0,108
1017247,707511,2018-02-21,Senate,"Senate Third Reading: Roll Call # 98",35,0,0,3,38
1017253,659489,2017-06-06,House,"Reported With Recommendation Without Amendment",9,0,0,0,9
1017257,659089,2017-06-06,House,"Reported With Recommendation Without Amendment",11,0,0,0,11
1017257,661396,2017-06-08,House,"House Third Reading: Given Immediate Effect Roll Call # 194",107,0,0,0,107
1017257,664293,2017-06-15,Senate,"Reported Favorably With Substitute  S-1",5,0,0,0,5
1017257,664294,2017-06-15,Senate,"Senate Third Reading: Given Immediate Effect Roll Call # 278",38,0,0,0,38
1017257,666758,2017-06-20,House,"House Third Reading: Roll Call # 225",107,0,0,0,107
1017260,661158,2017-06-08,Senate,"Reported Favorably Without Amendment",4,0,0,0,4
1017260,762507,2018-06-12,Senate,"Senate Third Reading: Passed Roll Call # 513",36,0,0,1,37
1017260,779218,2018-11-28,House,"Reported With Recommendation Without Amendment",11,0,0,0,11
1017260,781288,2018-12-20,House,"House Third Reading: Given Immediate Effect Roll Call # 916",105,4,0,0,109
1018080,722367,2018-03-13,Senate,"Reported Favorably Without Amendment",5,0,0,0,5
1018080,723699,2018-03-15,Senate,"Senate Third Reading: Passed Roll Call # 164",35,1,0,1,37
1018080,742361,2018-04-12,House,"Reported With Recommendation Without Amendment",9,0,0,0,9
1018080,775396,2018-10-03,House,"House Third Reading: Given Immediate Effect Roll Call # 598",107,0,0,0,107
1018089,722376,2018-03-13,Senate,"Reported Favorably Without Amendment",5,0,0,0,5
1018089,723703,2018-03-15,Senate,"Senate Third Reading: Passed Roll Call # 163",35,1,0,1,37
1018089,742050,2018-04-12,House,"Reported With Recommendation With Substitute  H-1",9,0,0,0,9
1018089,775343,2018-10-03,House,"House Third Reading: Given Immediate Effect Roll Call # 597",107,0,0,0,107
1018089,778853,2018-11-08,Senate,"Senate Third Reading: Roll Call # 586",33,1,0,3,37
1018101,722339,2018-03-13,Senate,"Reported Favorably Without Amendment",5,0,0,0,5
1018101,723764,2018-03-15,Senate,"Senate Third Reading: Passed Roll Call # 165",35,1,0,1,37
1018101,741923,2018-04-12,House,"Reported With Recommendation Without Amendment",9,0,0,0,9
1018101,775369,2018-10-03,House,"House Third Reading: Given Immediate Effect Roll Call # 599",107,0,0,0,107
1018130,722518,2018-03-13,Senate,"Reported Favorably Without Amendment",5,0,0,0,5
1018130,723704,2018-03-15,Senate,"Senate Third Reading: Passed Roll Call # 167",35,1,0,1,37
1018130,742364,2018-04-12,House,"Reported With Recommendation Without Amendment",9,0,0,0,9
1018130,775372,2018-10-03,House,"House Third Reading: Given Immediate Effect Roll Call # 601",107,0,0,0,107
1018137,661179,2017-06-08,Senate,"Reported Favorably Without Amendment",3,0,0,0,3
1018137,663292,2017-06-14,Senate,"Senate Third Reading: Passed Roll Call # 252",37,0,0,1,38
1018137,666407,2017-06-20,House,"Reported With Recommendation Without Amendment",11,0,0,0,11
1018137,666408,2017-06-20,House,"House Third Reading: Given Immediate Effect Roll Call # 254",104,3,0,0,107
1018142,722327,2018-03-13,Senate,"Reported Favorably Without Amendment",5,0,0,0,5
1018142,723769,2018-03-15,Senate,"Senate Third Reading: Passed Roll Call # 166",35,1,0,1,37
1018142,742374,2018-04-12,House,"Reported With Recommendation Without Amendment",9,0,0,0,9
1018142,775403,2018-10-03,House,"House Third Reading: Given Immediate Effect Roll Call # 600",107,0,0,0,107
1018201,678655,2017-10-31,House,"Reported With Recommendation Without Amendment",14,0,0,0,14
1018201,698082,2018-02-08,House,"House Third Reading: Given Immediate Effect Roll Call # 55",109,0,0,0,109
1018201,761147,2018-06-07,Senate,"Reported Favorably Without Amendment",4,0,0,0,4
1018201,762447,2018-06-12,Senate,"Senate Third Reading: Given Immediate Effect Roll Call # 497",36,0,0,1,37
1018207,696976,2018-02-06,House,"Reported With Recommendation With Substitute  H-3",13,0,0,0,13
1018207,711912,2018-02-27,House,"House Third Reading: Given Immediate Effect Roll Call # 97",108,0,0,0,108
1018218,679429,2017-11-28,House,"Reported With Recommendation Without Amendment",13,0,0,0,13
1018218,680223,2017-12-06,House,"House Third Reading: Given Immediate Effect Roll Call # 427",110,0,0,0,110
1018218,778980,2018-11-27,Senate,"Reported Favorably Without Amendment",4,0,0,0,4
1018218,780338,2018-12-11,Senate,"Senate Third Reading: Given Immediate Effect Roll Call # 747",37,0,0,1,38
1018223,755152,2018-05-17,House,"Reported With Recommendation With Substitute  H-3",9,0,0,0,9
1018223,778249,2018-05-17,House,"Reported With Recommendation With Substitute H-3",9,0,0,0,9
1018223,778250,2018-11-08,House,"House Third Reading: Given Immediate Effect Roll Call # 627",108,0,0,0,108
1018223,780132,2018-12-06,Senate,"Reported Favorably Without Amendment",5,0,0,0,5
1018223,781474,2018-12-20,Senate,"Senate Third Reading: Passed Roll Call # 1001",38,0,0,0,38
1018266,779149,2018-11-28,House,"Reported With Recommendation With Substitute  H-1",9,2,0,0,11
1018322,664275,2017-06-15,Senate,"Reported Favorably Without Amendment",4,0,0,0,4
1018322,675718,2017-09-12,Senate,"Senate Third Reading: Passed Roll Call # 330",37,0,0,1,38
1018322,678106,2017-10-17,House,"Reported With Recommendation Without Amendment",10,1,0,0,11
1018322,678562,2017-10-26,House,"House Third Reading: Given Immediate Effect Roll Call # 331",99,7,0,0,106
1018326,668197,2017-06-20,Senate,"Reported Favorably With Substitute  S-1",5,0,0,0,5
1018326,670042,2017-06-28,Senate,"Senate Third Reading: Passed Roll Call # 321",36,0,0,2,38
1018326,778958,2018-11-27,House,"Reported With Recommendation Without Amendment",12,0,0,0,12
1018326,780493,2018-12-12,House,"House Third Reading: Given Immediate Effect Roll Call # 793",109,0,0,0,109
1018336,664311,2017-06-15,Senate,"Reported Favorably Without Amendment",4,0,0,0,4
1018336,675739,2017-09-12,Senate,"Senate Third Reading: Passed Roll Call # 332",37,0,0,1,38
1018336,678113,2017-10-17,House,"Reported With Recommendation Without Amendment",10,1,0,0,11
1018336,678563,2017-10-26,House,"House Third Reading: Given Immediate Effect Roll Call # 333",100,6,0,0,106
1018341,680475,2017-12-07,Senate,"Reported Favorably Without Amendment",9,0,0,0,9
1018341,685998,2018-01-17,Senate,"Senate Third Reading: Passed Roll Call # 12",37,0,0,1,38
1018341,745176,2018-04-25,House,"Reported With Recommendation With Substitute  H-1",14,1,0,0,15
1018341,748407,2018-04-25,House,"Reported With Recommendation With Substitute H-1",14,1,0,0,15
1018341,752825,2018-05-08,House,"House Third Reading: Given Immediate Effect Roll Call # 268",107,2,0,0,109
1018341,752826,2018-05-10,Senate,"Senate Third Reading: Roll Call # 280",35,0,0,2,37
1018346,664268,2017-06-15,Senate,"Reported Favorably Without Amendment",4,0,0,0,4
1018346,675731,2017-09-12,Senate,"Senate Third Reading: Passed Roll Call # 329",37,0,0,1,38
1018346,678054,2017-10-17,House,"Reported With Recommendation With Substitute  H-1",10,1,0,0,11
1018346,678558,2017-10-26,House,"House Third Reading: Given Immediate Effect Roll Call # 330",97,9,0,0,106
1018346,678624,2017-11-01,Senate,"Senate Third Reading: Roll Call # 435",34,0,0,4,38
1018350,680442,2017-12-07,Senate,"Reported Favorably With Substitute  S-1",9,0,0,0,9
1018350,685915,2018-01-17,Senate,"Senate Third Reading: Passed Roll Call # 11",37,0,0,1,38
1018355,664453,2017-06-15,Senate,"Reported Favorably Without Amendment",5,0,0,0,5
1018355,675738,2017-09-12,Senate,"Senate Third Reading: Passed Roll Call # 331",37,0,0,1,38
1018355,678109,2017-10-17,House,"Reported With Recommendation Without Amendment",10,1,0,0,11
1018355,678559,2017-10-26,House,"House Third Reading: Given Immediate Effect Roll Call # 332",100,6,0,0,106
1018396,678041,2017-10-17,Senate,"Reported Favorably Without Amendment",4,0,0,0,4
1018439,666554,2017-06-20,House,"Reported With Recommendation With Substitute H-1",8,2,0,0,10
1018439,668429,2017-06-20,House,"Reported With Recommendation With Substitute  H-1",8,2,0,0,10
1018439,676338,2017-09-14,House,"House Third Reading: Given Immediate Effect Roll Call # 270",89,16,0,0,105
1018439,677583,2017-10-04,Senate,"Reported Favorably Without Amendment",4,0,0,0,4
1018439,679627,2017-11-30,Senate,"Senate Third Reading: Given Immediate Effect Roll Call # 470",38,0,0,0,38
1018642,678217,2017-10-19,Senate,"Reported Favorably Without Amendment",5,0,0,0,5
1018642,678662,2017-11-01,Senate,"Senate Third Reading: Passed Roll Call # 437",34,0,0,4,38
1018642,679984,2017-12-05,House,"Reported With Recommendation Without Amendment",14,0,0,0,14
1018642,718926,2018-03-07,House,"House Third Reading: Given Immediate Effect Roll Call # 139",108,0,0,0,108
1018783,761104,2018-06-07,House,"Reported With Recommendation With Substitute  H-1",9,0,0,0,9
1018783,774984,2018-09-26,House,"House Third Reading: Given Immediate Effect Roll Call # 580",107,0,0,0,107
1018783,780145,2018-12-06,Senate,"Reported Favorably With Substitute  S-1",5,0,0,0,5
1018783,781430,2018-12-20,Senate,"Senate Third Reading: Given Immediate Effect Roll Call # 1002",38,0,0,0,38
1018783,781545,2018-12-21,House,"House Third Reading: Roll Call # 1009",107,0,0,0,107
1018790,779215,2018-11-28,House,"Reported With Recommendation With Substitute  H-1",9,2,0,0,11
1018820,677387,2017-09-28,House,"Reported With Recommendation With Substitute  H-3",10,4,0,0,14
1018820,678065,2017-10-17,House,"House Third Reading: Given Immediate Effect Roll Call # 313",64,43,0,0,107
1018820,679478,2017-11-29,Senate,"Reported Favorably Without Amendment",5,0,0,0,5
1018820,688443,2018-01-23,Senate,"Senate Third Reading: Given Immediate Effect Roll Call # 21",30,7,0,1,38
1019214,664307,2017-06-15,Senate,"Reported Favorably Without Amendment",5,0,0,0,5
1019278,755074,2018-05-17,House,"Reported With Recommendation With Substitute  H-1",8,1,0,0,9
1019278,757228,2018-05-17,House,"Reported With Recommendation With Substitute H-1",8,1,0,0,9
1019278,757930,2018-05-30,House,"House Third Reading: Given Immediate Effect Roll Call # 444",94,13,0,0,107
1019278,780105,2018-12-06,Senate,"Reported Favorably With Substitute  S-1",5,0,0,0,5
1019278,781433,2018-12-20,Senate,"Senate Third Reading: Given Immediate Effect Roll Call # 1000",38,0,0,0,38
1019278,781542,2018-12-21,House,"House Third Reading: Roll Call # 1011",99,8,0,0,107
1019281,779193,2018-11-28,House,"Reported With Recommendation With Substitute  H-2",9,2,0,0,11
1019286,779216,2018-11-28,House,"Reported With Recommendation With Substitute  H-3",9,2,0,0,11
1019290,755198,2018-05-17,House,"Reported With Recommendation With Substitute  H-1",8,1,0,0,9
1019290,756866,2018-05-17,House,"Reported With Recommendation With Substitute H-1",8,1,0,0,9
1019290,758053,2018-05-30,House,"House Third Reading: Given Immediate Effect Roll Call # 442",97,10,0,0,107
1019299,755190,2018-05-17,House,"Reported With Recommendation With Substitute  H-1",8,1,0,0,9
1019299,756934,2018-05-17,House,"Reported With Recommendation With Substitute H-1",8,1,0,0,9
1019299,757877,2018-05-30,House,"House Third Reading: Given Immediate Effect Roll Call # 445",91,16,0,0,107
1019306,755130,2018-05-17,House,"Reported With Recommendation With Substitute  H-1",8,1,0,0,9
1019306,757252,2018-05-17,House,"Reported With Recommendation With Substitute H-1",8,1,0,0,9
1019306,757953,2018-05-30,House,"House Third Reading: Given Immediate Effect Roll Call # 446",90,17,0,0,107
1019310,678048,2017-10-17,House,"Reported With Recommendation With Substitute  H-1",7,4,0,0,11
1019310,678565,2017-10-26,House,"House Third Reading: Given Immediate Effect Roll Call # 329",63,43,0,0,106
1019310,679923,2017-12-05,Senate,"Reported Favorably With Substitute  S-1",4,0,0,0,4
1019314,755200,2018-05-17,House,"Reported With Recommendation With Substitute  H-1",8,1,0,0,9
1019314,756874,2018-05-17,House,"Reported With Recommendation With Substitute H-1",8,1,0,0,9
1019314,758102,2018-05-30,House,"House Third Reading: Given Immediate Effect Roll Call # 443",92,15,0,0,107
1019314,780115,2018-12-06,Senate,"Reported Favorably With Substitute  S-1",5,0,0,0,5
1019314,781334,2018-12-20,Senate,"Senate Third Reading: Given Immediate Effect Roll Call # 999",38,0,0,0,38
1019314,781611,2018-12-21,House,"House Third Reading: Roll Call # 1010",95,12,0,0,107
1019319,678454,2017-10-24,House,"Reported With Recommendation Without Amendment",12,0,0,0,12
1019319,678709,2017-11-02,House,"House Third Reading: Given Immediate Effect Roll Call # 362",108,0,0,0,108
1019319,679625,2017-11-30,Senate,"Reported Favorably Without Amendment",5,0,0,0,5
1019319,692417,2018-01-31,Senate,"Senate Third Reading: Given Immediate Effect Roll Call # 47",37,0,0,1,38
1019319,697262,2018-02-06,House,"House Third Reading: Roll Call # 46",108,0,0,0,108
1019422,699577,2018-02-06,Senate,"Reported Favorably Without Amendment",7,0,0,0,7
1019422,701627,2018-02-13,Senate,"Senate Third Reading: Passed Roll Call # 68",36,0,0,2,38
1019422,755367,2018-05-15,House,"Reported With Recommendation Without Amendment",14,0,0,0,14
1019422,764364,2018-06-12,House,"House Third Reading: Given Immediate Effect Roll Call # 476",109,0,0,0,109
1019433,677849,2017-10-11,Senate,"Reported Favorably Without Amendment",3,0,0,0,3
1019436,677567,2017-10-03,House,"Reported With Recommendation Without Amendment",10,0,0,0,10
1019436,677839,2017-10-11,House,"House Third Reading: Given Immediate Effect Roll Call # 306",108,0,0,0,108
1019436,678222,2017-10-19,Senate,"Reported Favorably Without Amendment",4,0,0,0,4
1019436,678701,2017-11-02,Senate,"Senate Third Reading: Given Immediate Effect Roll Call # 440",35,0,0,3,38
1019438,670081,2017-06-28,Senate,"Reported Favorably With Substitute  S-1",5,0,0,0,5
1019438,670082,2017-06-28,Senate,"Senate Third Reading: Passed Roll Call # 317",34,1,0,3,38
1019438,677599,2017-10-04,House,"Reported With Recommendation Without Amendment",17,0,0,0,17
1019438,677874,2017-10-11,House,"House Third Reading: Given Immediate Effect Roll Call # 301",105,3,0,0,108
1019444,678208,2017-10-19,Senate,"Reported Favorably Without Amendment",7,0,0,0,7
1019459,678215,2017-10-19,Senate,"Reported Favorably Without Amendment",7,0,0,0,7
1019464,666560,2017-06-20,House,"Reported With Recommendation Without Amendment",5,0,0,0,5
1019464,666561,2017-06-20,House,"House Third Reading: Given Immediate Effect Roll Call # 256",107,0,0,0,107
1019464,669903,2017-06-28,Senate,"Senate Third Reading: Given Immediate Effect Roll Call # 312",26,9,1,2,38
1019466,757909,2018-05-30,Senate,"Reported Favorably With Substitute  S-1",5,0,0,0,5
1019466,762509,2018-06-12,Senate,"Senate Third Reading: Passed Roll Call # 525",36,0,0,1,37
1019466,779252,2018-11-28,House,"Reported With Recommendation Without Amendment",11,0,0,0,11
1019466,781307,2018-12-20,House,"House Third Reading: Passed Roll Call # 920",109,0,0,0,109
1019594,677386,2017-09-28,Senate,"Reported Favorably Without Amendment",3,2,0,0,5
1019618,750139,2018-05-03,Senate,"Reported Favorably With Substitute  S-2",6,0,0,0,6
1019618,755654,2018-05-22,Senate,"Senate Third Reading: Passed Roll Call # 324",36,0,0,1,37
1019618,774930,2018-09-26,House,"Reported With Recommendation With Substitute H-1",8,0,0,0,8
1019618,775262,2018-09-26,House,"Reported With Recommendation With Substitute  H-1",8,0,0,0,8
1019618,779182,2018-11-28,House,"House Third Reading: Given Immediate Effect Roll Call # 643",105,4,0,0,109
1019618,779340,2018-11-29,Senate,"Senate Third Reading: Roll Call # 619",38,0,0,0,38
1019654,678042,2017-10-17,House,"Reported With Recommendation With Substitute  H-1",10,0,0,0,10
1019654,678482,2017-10-25,House,"House Third Reading: Given Immediate Effect Roll Call # 328",106,0,0,0,106
1019654,679636,2017-11-30,Senate,"Reported Favorably Without Amendment",4,0,0,0,4
1019654,745388,2018-04-26,Senate,"Senate Third Reading: Given Immediate Effect Roll Call # 232",35,0,0,2,37
1020094,678045,2017-10-17,House,"Reported With Recommendation With Substitute  H-2",10,2,0,0,12
1020222,685815,2018-01-16,House,"Reported With Recommendation With Substitute  H-1",11,0,0,0,11
1020222,691500,2018-01-25,House,"House Third Reading: Passed Roll Call # 25",105,1,0,0,106
1020222,780535,2018-12-12,Senate,"Reported Favorably Without Amendment",4,0,0,0,4
1020222,780732,2018-12-13,Senate,"Senate Third Reading: Given Immediate Effect Roll Call # 793",37,0,0,1,38
1020229,780435,2018-12-13,House,"House Third Reading: Given Immediate Effect Roll Call # 830",106,3,0,0,109
1020235,676388,2017-09-14,House,"Reported With Recommendation Without Amendment",5,0,0,0,5
1020235,677377,2017-09-28,House,"House Third Reading: Given Immediate Effect Roll Call # 285",101,6,0,0,107
1020235,678085,2017-10-12,Senate,"Reported Favorably Without Amendment",5,0,0,0,5
1020235,678210,2017-10-19,Senate,"Senate Third Reading: Given Immediate Effect Roll Call # 416",37,0,0,1,38
1020238,685710,2018-01-16,House,"Reported With Recommendation With Substitute  H-1",11,0,0,0,11
1020238,691131,2018-01-25,House,"House Third Reading: Given Immediate Effect Roll Call # 24",106,0,0,0,106
1020238,780619,2018-12-12,Senate,"Reported Favorably Without Amendment",4,0,0,0,4
1020238,780679,2018-12-13,Senate,"Senate Third Reading: Given Immediate Effect Roll Call # 792",37,0,0,1,38
1020238,781174,2018-12-19,House,"House Third Reading: Roll Call # 884",109,0,0,0,109
1020241,779223,2018-11-28,House,"Reported With Recommendation With Substitute  H-1",9,2,0,0,11
1020243,780440,2018-12-13,House,"House Third Reading: Given Immediate Effect Roll Call # 829",105,4,0,0,109
1020244,678266,2017-10-19,House,"Reported With Recommendation With Substitute  H-3",15,0,0,0,15
1020244,678566,2017-10-26,House,"House Third Reading: Given Immediate Effect Roll Call # 334",101,5,0,0,106
1020247,678390,2017-10-24,House,"Reported With Recommendation With Substitute  H-1",14,0,0,0,14
1020247,678720,2017-11-02,House,"House Third Reading: Given Immediate Effect Roll Call # 361",106,2,0,0,108
1020247,680667,2017-12-12,Senate,"Reported Favorably Without Amendment",4,0,0,0,4
1020247,680736,2017-12-13,Senate,"Senate Third Reading: Given Immediate Effect Roll Call # 557",37,0,0,1,38
1020247,683996,2017-12-13,House,"House Third Reading: Roll Call # 511",108,2,0,0,110
1020252,678634,2017-11-01,House,"Reported With Recommendation With Substitute  H-2",9,0,0,0,9
1020252,679396,2017-11-09,House,"House Third Reading: Given Immediate Effect Roll Call # 400",96,11,0,0,107
1020252,689033,2018-01-25,Senate,"Reported Favorably Without Amendment",5,0,0,0,5
1020252,693095,2018-02-01,Senate,"Senate Third Reading: Given Immediate Effect Roll Call # 55",38,0,0,0,38
1020254,676390,2017-09-14,House,"Reported With Recommendation With Substitute  H-3",5,0,0,0,5
1020254,677385,2017-09-28,House,"House Third Reading: Given Immediate Effect Roll Call # 284",107,0,0,0,107
1020254,678061,2017-10-12,Senate,"Reported Favorably Without Amendment",5,0,0,0,5
1020254,678211,2017-10-19,Senate,"Senate Third Reading: Given Immediate Effect Roll Call # 415",37,0,0,1,38
1020256,677789,2017-10-05,House,"Reported With Recommendation Without Amendment",11,0,0,0,11
1020256,677840,2017-10-11,House,"House Third Reading: Given Immediate Effect Roll Call # 310",108,0,0,0,108
1020256,679924,2017-12-05,Senate,"Reported Favorably Without Amendment",5,0,0,0,5
1020256,680075,2017-12-06,Senate,"Senate Third Reading: Given Immediate Effect Roll Call # 487",36,0,0,2,38
1020258,676389,2017-09-14,House,"Reported With Recommendation With Substitute  H-2",5,0,0,0,5
1020258,677384,2017-09-28,House,"House Third Reading: Given Immediate Effect Roll Call # 283",107,0,0,0,107
1020258,678116,2017-10-12,Senate,"Reported Favorably Without Amendment",5,0,0,0,5
1020258,678195,2017-10-19,Senate,"Senate Third Reading: Given Immediate Effect Roll Call # 414",37,0,0,1,38
1020315,678415,2017-10-24,Senate,"Reported Favorably Without Amendment",5,0,0,0,5
1020315,679623,2017-11-30,Senate,"Senate Third Reading: Passed Roll Call # 473",38,0,0,0,38
1020315,681116,2017-12-12,House,"Reported With Recommendation Without Amendment",12,0,0,0,12
1020315,681117,2017-12-13,House,"House Third Reading: Given Immediate Effect Roll Call # 496",102,8,0,0,110
1020318,679631,2017-11-30,Senate,"Reported Favorably Without Amendment",6,0,0,0,6
1020318,680716,2017-12-13,Senate,"Senate Third Reading: Passed Roll Call # 544",36,2,0,0,38
1020318,760579,2018-06-06,House,"Reported With Recommendation With Substitute  H-2",8,2,0,0,10
1020322,679919,2017-12-05,Senate,"Reported Favorably With Substitute  S-2",5,0,0,0,5
1020322,680114,2017-12-06,Senate,"Senate Third Reading: Passed Roll Call # 488",36,0,0,2,38
1020322,755390,2018-05-22,House,"Reported With Recommendation With Substitute  H-2",13,0,0,0,13
1020322,774938,2018-09-26,House,"House Third Reading: Given Immediate Effect Roll Call # 579",107,0,0,0,107
1020322,778850,2018-11-08,Senate,"Senate Third Reading: Roll Call # 587",34,0,0,3,37
1020329,678392,2017-10-24,Senate,"Reported Favorably Without Amendment",5,0,0,0,5
1020329,679463,2017-11-29,Senate,"Senate Third Reading: Passed Roll Call # 465",26,12,0,0,38
1020329,681162,2017-12-12,House,"Reported With Recommendation With Substitute  H-1",12,0,0,0,12
1020329,681163,2017-12-13,House,"House Third Reading: Given Immediate Effect Roll Call # 495",74,36,0,0,110
1020329,681164,2017-12-13,Senate,"Senate Third Reading: Roll Call # 569",29,8,0,1,38
1020332,670043,2017-06-28,Senate,"Reported Favorably With Substitute  S-1",5,0,0,0,5
1020332,670044,2017-06-28,Senate,"Senate Third Reading: Passed Roll Call # 318",36,0,0,2,38
1020332,672521,2017-07-12,House,"House Third Reading: Given Immediate Effect Roll Call # 265",106,0,0,0,106
1020344,677311,2017-09-26,Senate,"Reported Favorably Without Amendment",4,0,0,0,4
1020344,677340,2017-09-27,Senate,"Senate Third Reading: Passed Roll Call # 347",37,0,0,1,38
1020542,706524,2018-02-20,Senate,"Reported Favorably With Substitute  S-1",5,0,0,0,5
1020542,709090,2018-02-22,Senate,"Senate Third Reading: Passed Roll Call # 108",37,0,0,1,38
1020542,779175,2018-11-29,House,"Reported With Recommendation Without Amendment",7,1,0,0,8
1020542,780627,2018-12-13,House,"House Third Reading: Given Immediate Effect Roll Call # 836",63,46,0,0,109
1020543,680659,2017-12-12,Senate,"Reported Favorably With Substitute  S-1",4,0,0,0,4
1020543,680772,2017-12-13,Senate,"Senate Third Reading: Passed Roll Call # 560",37,0,0,1,38
1020543,685601,2018-01-16,House,"Reported With Recommendation Without Amendment",14,0,0,0,14
1020543,694495,2018-02-01,House,"House Third Reading: Given Immediate Effect Roll Call # 45",109,0,0,0,109
1020543,699711,2018-02-06,Senate,"Senate Third Reading: House Amendment(s) Concurred In Roll Call # 57",36,0,0,2,38
1020548,678069,2017-10-12,Senate,"Reported Favorably Without Amendment",5,0,0,0,5
1020548,678216,2017-10-19,Senate,"Senate Third Reading: Passed Roll Call # 411",36,1,0,1,38
1020548,679432,2017-11-28,House,"Reported With Recommendation Without Amendment",14,0,0,0,14
1020548,681026,2017-12-13,House,"House Third Reading: Given Immediate Effect Roll Call # 497",108,2,0,0,110
1020550,678060,2017-10-12,Senate,"Reported Favorably Without Amendment",5,0,0,0,5
1020550,678214,2017-10-19,Senate,"Senate Third Reading: Passed Roll Call # 413",36,1,0,1,38
1020550,679435,2017-11-28,House,"Reported With Recommendation Without Amendment",14,0,0,0,14
1020550,681157,2017-12-13,House,"House Third Reading: Given Immediate Effect Roll Call # 499",107,3,0,0,110
1020559,706061,2018-02-20,Senate,"Reported Favorably With Substitute  S-2",5,0,0,0,5
1020559,709283,2018-02-22,Senate,"Senate Third Reading: Passed Roll Call # 107",37,0,0,1,38
1020559,779176,2018-11-29,House,"Reported With Recommendation Without Amendment",7,1,0,0,8
1020559,780533,2018-12-13,House,"House Third Reading: Given Immediate Effect Roll Call # 835",63,46,0,0,109
1020562,678052,2017-10-12,Senate,"Reported Favorably With Substitute  S-1",8,0,0,0,8
1020562,678141,2017-10-18,Senate,"Senate Third Reading: Passed Roll Call # 399",36,1,0,1,38
1020562,761154,2018-06-07,House,"Reported With Recommendation For Referral To Committee On Health Policy",11,4,0,0,15
1020565,678078,2017-10-12,Senate,"Reported Favorably Without Amendment",5,0,0,0,5
1020565,678191,2017-10-19,Senate,"Senate Third Reading: Passed Roll Call # 412",36,1,0,1,38
1020565,679434,2017-11-28,House,"Reported With Recommendation Without Amendment",14,0,0,0,14
1020565,681154,2017-12-13,House,"House Third Reading: Given Immediate Effect Roll Call # 498",107,3,0,0,110
1021119,677760,2017-10-05,Senate,"Reported Favorably With Substitute  S-1",6,2,0,0,8
1021119,680323,2017-12-06,Senate,"Senate Third Reading: Passed Roll Call # 480",27,9,0,2,38
1021135,757915,2018-05-30,Senate,"Reported Favorably With Substitute  S-1",5,0,0,0,5
1021142,757902,2018-05-30,Senate,"Reported Favorably Without Amendment",5,0,0,0,5
1022032,679098,2017-11-09,Senate,"Reported Favorably With Substitute  S-1",7,0,0,0,7
1022032,680733,2017-12-13,Senate,"Senate Third Reading: Passed Roll Call # 541",37,1,0,0,38
1022032,749071,2018-05-02,House,"Reported With Recommendation With Substitute  H-1",11,2,0,0,13
1022032,779240,2018-11-29,House,"House Third Reading: Given Immediate Effect Roll Call # 655",89,20,0,0,109
1022032,779651,2018-12-04,Senate,"Senate Third Reading: Roll Call # 656",36,0,0,2,38
1022037,679099,2017-11-09,Senate,"Reported Favorably Without Amendment",7,0,0,0,7
1022037,680722,2017-12-13,Senate,"Senate Third Reading: Passed Roll Call # 540",37,1,0,0,38
1022037,749026,2018-05-02,House,"Reported With Recommendation Without Amendment",11,1,0,0,12
1022037,779164,2018-11-29,House,"House Third Reading: Given Immediate Effect Roll Call # 654",90,19,0,0,109
1022037,779646,2018-12-04,Senate,"Senate Third Reading: Roll Call # 655",35,0,2,1,38
1022041,677822,2017-10-10,Senate,"Reported Favorably Without Amendment",5,0,0,0,5
1022041,678051,2017-10-12,Senate,"Senate Third Reading: Passed Roll Call # 387",35,0,0,3,38
1022041,678461,2017-10-24,House,"Reported With Recommendation Without Amendment",14,0,0,0,14
1022041,679413,2017-11-09,House,"House Third Reading: Given Immediate Effect Roll Call # 393",107,0,0,0,107
1022054,676029,2017-09-13,Senate,"Reported Favorably Without Amendment",5,0,0,0,5
1022054,676813,2017-09-19,Senate,"Senate Third Reading: Passed Roll Call # 340",37,0,0,1,38
1022059,751479,2018-05-08,Senate,"Reported Favorably With Substitute  S-1",5,0,0,0,5
1022059,758336,2018-05-30,Senate,"Senate Third Reading: Passed Roll Call # 384",32,0,0,5,37
1022075,678457,2017-10-24,House,"Reported With Recommendation Without Amendment",14,0,0,0,14
1022075,678700,2017-11-02,House,"House Third Reading: Given Immediate Effect Roll Call # 364",108,0,0,0,108
1022075,706204,2018-02-20,Senate,"Reported Favorably Without Amendment",5,0,0,0,5
1022075,714876,2018-03-01,Senate,"Senate Third Reading: Given Immediate Effect Roll Call # 123",36,0,0,2,38
1022077,755211,2018-05-17,House,"Reported With Recommendation With Substitute  H-1",8,1,0,0,9
1022077,757223,2018-05-17,House,"Reported With Recommendation With Substitute H-1",8,1,0,0,9
1022077,759875,2018-06-05,House,"House Third Reading: Given Immediate Effect Roll Call # 447",90,18,0,0,108
1022090,677352,2017-09-26,House,"Reported With Recommendation With Substitute  H-2",10,0,0,0,10
1022090,677798,2017-10-05,House,"House Third Reading: Given Immediate Effect Roll Call # 288",108,0,0,0,108
1022090,679659,2017-11-30,Senate,"Reported Favorably With Substitute  S-1",5,0,0,0,5
1022090,687625,2018-01-23,Senate,"Senate Third Reading: Given Immediate Effect Roll Call # 22",37,0,0,1,38
1022090,691163,2018-01-30,House,"House Third Reading: Roll Call # 31",108,0,0,0,108
1022090,692047,2018-01-31,Senate,"Senate Third Reading: Roll Call # 45",37,0,0,1,38
1022092,697378,2018-02-06,House,"Reported With Recommendation Without Amendment",13,0,0,0,13
1022092,708961,2018-02-06,House,"Reported With Recommendation With Substitute  H-1",13,0,0,0,13
1022092,714636,2018-03-01,House,"House Third Reading: Given Immediate Effect Roll Call # 120",108,1,0,0,109
1022101,677336,2017-09-27,House,"Reported With Recommendation Without Amendment",12,0,0,0,12
1022101,677801,2017-10-05,House,"House Third Reading: Given Immediate Effect Roll Call # 293",108,0,0,0,108
1022101,713556,2018-02-28,Senate,"Reported Favorably Without Amendment",5,0,0,0,5
1022101,720459,2018-03-08,Senate,"Senate Third Reading: Given Immediate Effect Roll Call # 142",36,0,0,1,37
1022103,678463,2017-10-24,House,"Reported With Recommendation With Substitute  H-1",13,0,0,0,13
1022103,678715,2017-11-02,House,"House Third Reading: Given Immediate Effect Roll Call # 363",108,0,0,0,108
1022103,778932,2018-11-27,Senate,"Reported Favorably Without Amendment",4,0,0,0,4
1022103,780347,2018-12-11,Senate,"Senate Third Reading: Given Immediate Effect Roll Call # 748",37,0,0,1,38
1022105,725808,2018-03-20,House,"Reported With Recommendation Without Amendment",14,0,0,0,14
1022105,745194,2018-04-25,House,"House Third Reading: Given Immediate Effect Roll Call # 248",109,0,0,0,109
1022105,758001,2018-05-30,Senate,"Reported Favorably Without Amendment",4,0,0,0,4
1022105,762487,2018-06-12,Senate,"Senate Third Reading: Given Immediate Effect Roll Call # 457",36,0,0,1,37
1022105,764731,2018-06-12,House,"House Third Reading: Roll Call # 538",109,0,0,0,109
1022107,677333,2017-09-27,House,"Reported With Recommendation With Substitute  H-1",11,0,0,0,11
1022107,677791,2017-10-05,House,"House Third Reading: Given Immediate Effect Roll Call # 292",108,0,0,0,108
1022107,713537,2018-02-28,Senate,"Reported Favorably With Substitute  S-1",5,0,0,0,5
1022107,720404,2018-03-08,Senate,"Senate Third Reading: Given Immediate Effect Roll Call # 141",35,1,0,1,37
1022107,722656,2018-03-13,House,"House Third Reading: Roll Call # 153",101,8,0,0,109
1022109,754994,2018-05-17,House,"Reported With Recommendation With Substitute  H-1",8,1,0,0,9
1022109,757237,2018-05-17,House,"Reported With Recommendation With Substitute H-1",8,1,0,0,9
1022109,759989,2018-06-05,House,"House Third Reading: Given Immediate Effect Roll Call # 448",91,17,0,0,108
1022120,678636,2017-11-01,House,"Reported With Recommendation Without Amendment",14,1,0,0,15
1022120,679403,2017-11-09,House,"House Third Reading: Given Immediate Effect Roll Call # 401",104,3,0,0,107
1022120,689174,2018-01-25,Senate,"Reported Favorably With Substitute  S-1",7,0,0,0,7
1022120,692894,2018-02-01,Senate,"Senate Third Reading: Given Immediate Effect Roll Call # 56",38,0,0,0,38
1022120,697532,2018-02-06,House,"House Third Reading: Roll Call # 48",105,3,0,0,108
1022127,779670,2018-12-04,House,"Reported With Recommendation Without Amendment",3,0,0,0,3
1022127,780176,2018-12-06,House,"House Third Reading: Passed Roll Call # 768",102,7,0,0,109
1022128,779202,2018-11-28,House,"Reported With Recommendation With Substitute  H-1",9,2,0,0,11
1022130,677342,2017-09-26,House,"Reported With Recommendation With Substitute  H-1",10,0,0,0,10
1022130,677788,2017-10-05,House,"House Third Reading: Given Immediate Effect Roll Call # 289",108,0,0,0,108
1022130,679681,2017-11-30,Senate,"Reported Favorably With Substitute  S-1",5,0,0,0,5
1022130,688022,2018-01-23,Senate,"Senate Third Reading: Given Immediate Effect Roll Call # 23",37,0,0,1,38
1022130,691494,2018-01-30,House,"House Third Reading: Roll Call # 32",108,0,0,0,108
1022139,677338,2017-09-27,House,"Reported With Recommendation With Substitute  H-1",11,0,0,0,11
1022139,677879,2017-10-11,House,"House Third Reading: Given Immediate Effect Roll Call # 305",107,1,0,0,108
1022139,683953,2017-12-28,Senate,"Reported Favorably Without Amendment",9,0,0,0,9
1022139,685853,2018-01-17,Senate,"Senate Third Reading: Given Immediate Effect Roll Call # 13",37,0,0,1,38
1024814,678681,2017-10-31,House,"Reported With Recommendation With Substitute  H-1",14,0,0,0,14
1024827,679437,2017-11-28,House,"Reported With Recommendation Without Amendment",14,0,0,0,14
1024827,719117,2018-03-07,House,"House Third Reading: Given Immediate Effect Roll Call # 137",107,1,0,0,108
1024827,774877,2018-09-25,Senate,"Reported Favorably With Substitute  S-1",5,0,0,0,5
1024827,775046,2018-09-26,Senate,"Senate Third Reading: Given Immediate Effect Roll Call # 577",35,1,0,1,37
1024827,775287,2018-10-02,House,"House Third Reading: Roll Call # 585",106,0,0,0,106
1024831,711743,2018-02-22,House,"Reported With Recommendation With Substitute  H-3",8,1,0,0,9
1024831,736849,2018-02-22,House,"Reported With Recommendation With Substitute H-3",8,1,0,0,9
1024831,741874,2018-04-12,House,"House Third Reading: Given Immediate Effect Roll Call # 227",105,3,0,0,108
1024838,675284,2017-09-06,House,"Reported With Recommendation With Substitute H-1",8,1,0,0,9
1024838,675285,2017-09-06,House,"House Third Reading: Given Immediate Effect Roll Call # 266",92,13,0,0,105
1024838,675733,2017-09-12,Senate,"Reported Favorably Without Amendment",5,0,0,0,5
1024838,676014,2017-09-13,Senate,"Senate Third Reading: Given Immediate Effect Roll Call # 333",37,0,0,1,38
1024847,718931,2018-03-06,House,"Reported With Recommendation With Substitute  H-2",15,0,0,0,15
1024847,725931,2018-03-06,House,"Reported With Recommendation With Substitute H-2",15,0,0,0,15
1024847,727929,2018-03-22,House,"House Third Reading: Given Immediate Effect Roll Call # 200",107,2,0,0,109
1024847,747483,2018-05-01,Senate,"Reported Favorably Without Amendment",7,0,0,0,7
1024847,762690,2018-06-12,Senate,"Senate Third Reading: Given Immediate Effect Roll Call # 489",36,0,0,1,37
1024848,676838,2017-09-19,House,"Reported With Recommendation With Substitute  H-2",14,0,0,0,14
1024848,677169,2017-09-20,House,"House Third Reading: Given Immediate Effect Roll Call # 278",102,5,0,0,107
1024848,706068,2018-02-20,Senate,"Reported Favorably Without Amendment",5,0,0,0,5
1024848,717947,2018-03-06,Senate,"Senate Third Reading: Given Immediate Effect Roll Call # 127",36,0,0,1,37
1025478,678225,2017-10-19,Senate,"Reported Favorably With Substitute  S-1",3,1,0,0,4
1025478,678938,2017-11-08,Senate,"Senate Third Reading: Passed Roll Call # 446",26,11,0,1,38
1025480,679956,2017-12-05,Senate,"Reported Favorably With Substitute  S-1",5,0,0,0,5
1025480,680087,2017-12-06,Senate,"Senate Third Reading: Passed Roll Call # 489",36,0,0,2,38
1025480,722542,2018-03-13,House,"Reported With Recommendation Without Amendment",13,1,0,0,14
1025480,737571,2018-04-11,House,"House Third Reading: Given Immediate Effect Roll Call # 215",99,10,0,0,109
1025489,676703,2017-09-14,Senate,"Reported Favorably Without Amendment",4,1,0,0,5
1025496,677821,2017-10-10,Senate,"Reported Favorably With Substitute  S-1",15,0,0,0,15
1025496,677877,2017-10-11,Senate,"Senate Third Reading: Passed Roll Call # 385",37,0,0,1,38
1025496,686291,2018-01-18,House,"Reported With Recommendation With Substitute  H-1",11,0,0,0,11
1025496,691525,2018-01-30,House,"House Third Reading: Given Immediate Effect Roll Call # 35",108,0,0,0,108
1025496,692059,2018-01-31,Senate,"Senate Third Reading: Roll Call # 42",37,0,0,1,38
1025498,677361,2017-09-28,Senate,"Reported Favorably With Substitute  S-1",3,1,0,0,4
1025500,676035,2017-09-13,Senate,"Reported Favorably With Substitute S-1",5,0,0,0,5
1025500,677320,2017-09-26,Senate,"Senate Third Reading: Passed Roll Call # 345",36,2,0,0,38
1025500,677806,2017-10-10,House,"Reported With Recommendation Without Amendment",10,0,0,0,10
1025500,679961,2017-12-05,House,"House Third Reading: Given Immediate Effect Roll Call # 422",107,1,0,0,108
1025510,677163,2017-09-20,House,"Reported With Recommendation Without Amendment",29,0,0,0,29
1025510,677164,2017-09-20,House,"House Third Reading: Roll Call # 273",106,0,0,0,106
1025510,677165,2017-09-20,House,"House Third Reading: Roll Call # 274",107,0,0,0,107
1025510,678227,2017-10-10,Senate,"Reported Favorably Without Amendment",15,0,0,0,15
1025517,677813,2017-10-10,Senate,"Reported Favorably With Substitute  S-1",15,0,0,0,15
1025517,677860,2017-10-11,Senate,"Senate Third Reading: Passed Roll Call # 384",37,0,0,1,38
1025517,686321,2018-01-18,House,"Reported With Recommendation Without Amendment",11,0,0,0,11
1025517,691214,2018-01-30,House,"House Third Reading: Given Immediate Effect Roll Call # 34",108,0,0,0,108
1025525,677380,2017-09-28,Senate,"Reported Favorably Without Amendment",4,1,0,0,5
1025525,678717,2017-11-02,Senate,"Senate Third Reading: Passed Roll Call # 439",33,2,0,3,38
1025525,679959,2017-12-05,House,"Reported With Recommendation With Substitute H-1",7,2,0,0,9
1025525,685244,2018-01-11,House,"House Third Reading: Given Immediate Effect Roll Call # 2",63,43,0,0,106
1025525,685671,2018-01-16,Senate,"Senate Third Reading: Roll Call # 1",32,2,0,4,38
1025526,680161,2017-12-06,Senate,"Reported Favorably Without Amendment",3,1,0,0,4
1025526,685855,2018-01-17,Senate,"Senate Third Reading: Passed Roll Call # 10",30,7,0,1,38
1025526,702556,2018-02-14,House,"Reported With Recommendation Without Amendment",11,0,0,0,11
1025526,713993,2018-02-28,House,"House Third Reading: Given Immediate Effect Roll Call # 108",104,5,0,0,109
1025530,677317,2017-09-26,Senate,"Reported Favorably With Substitute  S-2",9,0,0,0,9
1025530,677530,2017-10-03,Senate,"Senate Third Reading: Passed Roll Call # 354",37,0,0,1,38
1025530,678664,2017-10-31,House,"Reported With Recommendation Without Amendment",14,0,0,0,14
1025530,679619,2017-11-08,House,"House Third Reading: Given Immediate Effect Roll Call # 389",107,0,0,0,107
1025567,677037,2017-09-20,Senate,"Reported Favorably Without Amendment",6,3,0,0,9
1025567,677867,2017-10-11,Senate,"Senate Third Reading: Passed Roll Call # 379",21,15,0,2,38
1025567,780071,2018-12-05,House,"Reported With Recommendation With Substitute  H-2",13,3,0,0,16
1025567,781113,2018-12-18,House,"House Third Reading: Given Immediate Effect Roll Call # 872",68,41,0,0,109
1025567,781508,2018-12-19,Senate,"Senate Third Reading: Roll Call # 917",23,15,0,0,38
1025576,677388,2017-09-28,Senate,"Reported Favorably With Substitute  S-3",4,1,0,0,5
1025576,678142,2017-10-18,Senate,"Senate Third Reading: Passed Roll Call # 397",25,12,0,1,38
1025576,760539,2018-06-06,House,"Reported With Recommendation With Substitute  H-1",8,0,0,0,8
1025576,764573,2018-06-12,House,"House Third Reading: Given Immediate Effect Roll Call # 523",66,42,0,0,108
1025576,764574,2018-06-12,Senate,"Senate Third Reading: Roll Call # 550",24,12,0,1,37
1025815,677004,2017-09-20,Senate,"Reported Favorably With Substitute S-2",4,1,0,0,5
1025815,679928,2017-12-05,Senate,"Senate Third Reading: Passed Roll Call # 478",22,15,0,1,38
1025815,698280,2018-02-08,House,"Reported With Recommendation With Substitute  H-1",10,5,0,0,15
1025816,677006,2017-09-20,Senate,"Reported Favorably Without Amendment",4,1,0,0,5
1025817,677001,2017-09-20,Senate,"Reported Favorably Without Amendment",4,1,0,0,5
1025817,679948,2017-12-05,Senate,"Senate Third Reading: Passed Roll Call # 477",23,14,0,1,38
1025817,698252,2018-02-08,House,"Reported With Recommendation Without Amendment",10,5,0,0,15
1025818,678429,2017-10-24,Senate,"Reported Favorably With Substitute  S-1",5,0,0,0,5
1025818,678696,2017-11-02,Senate,"Senate Third Reading: Passed Roll Call # 441",35,0,0,3,38
1025818,685680,2018-01-16,House,"Reported With Recommendation Without Amendment",14,0,0,0,14
1025818,692580,2018-01-31,House,"House Third Reading: Given Immediate Effect Roll Call # 42",109,0,0,0,109
1025819,677008,2017-09-20,Senate,"Reported Favorably With Substitute  S-1",4,1,0,0,5
1025819,679941,2017-12-05,Senate,"Senate Third Reading: Passed Roll Call # 476",23,14,0,1,38
1025819,697893,2018-02-08,House,"Reported With Recommendation With Substitute  H-1",10,5,0,0,15
1025821,677355,2017-09-26,House,"Reported With Recommendation Without Amendment",13,0,0,0,13
1025821,678234,2017-10-17,Senate,"Reported Favorably Without Amendment",4,0,0,0,4
1025823,676283,2017-09-14,Senate,"Reported Favorably Without Amendment",12,1,0,0,13
1025823,677046,2017-09-20,Senate,"Senate Third Reading: Passed Roll Call # 344",27,8,0,3,38
1025823,677866,2017-10-11,House,"Reported With Recommendation Without Amendment",18,6,0,0,24
1025823,707743,2018-02-21,House,"House Third Reading: Given Immediate Effect Roll Call # 87",56,53,0,0,109
1025823,750103,2018-05-03,Senate,"Senate Third Reading: Roll Call # 277",26,10,0,1,37
1025823,755022,2018-05-15,House,"House Third Reading: Senate Amendment(s) Concurred In Roll Call # 280",56,51,0,0,107
1025824,677000,2017-09-20,Senate,"Reported Favorably With Substitute  S-1",4,1,0,0,5
1025824,679999,2017-12-05,Senate,"Senate Third Reading: Passed Roll Call # 474",23,14,0,1,38
1025824,697948,2018-02-08,House,"Reported With Recommendation Without Amendment",10,5,0,0,15
1025825,677002,2017-09-20,Senate,"Reported Favorably With Substitute  S-1",4,1,0,0,5
1025825,679944,2017-12-05,Senate,"Senate Third Reading: Passed Roll Call # 475",23,14,0,1,38
1025825,698253,2018-02-08,House,"Reported With Recommendation Without Amendment",10,5,0,0,15
1025840,681083,2017-12-13,House,"Reported With Recommendation With Substitute  H-3",12,3,0,0,15
1025840,764519,2018-06-12,House,"House Third Reading: Given Immediate Effect Roll Call # 551",68,40,0,0,108
1025840,781442,2018-12-20,Senate,"Senate Third Reading: Passed Roll Call # 1018",33,5,0,0,38
1025840,781630,2018-12-21,House,"House Third Reading: Roll Call # 988",71,35,0,0,106
1025844,725954,2018-03-20,House,"Reported With Recommendation Without Amendment",15,0,0,0,15
1025844,745071,2018-04-26,House,"House Third Reading: Given Immediate Effect Roll Call # 254",109,0,0,0,109
1025847,679550,2017-11-29,House,"Reported With Recommendation With Substitute  H-2",12,1,0,0,13
1025847,680286,2017-12-06,House,"House Third Reading: Given Immediate Effect Roll Call # 439",109,1,0,0,110
1025847,703992,2018-02-15,Senate,"Reported Favorably Without Amendment",7,0,0,0,7
1025847,740461,2018-04-17,Senate,"Senate Third Reading: Given Immediate Effect Roll Call # 203",37,0,0,0,37
1025859,725959,2018-03-20,House,"Reported With Recommendation Without Amendment",15,0,0,0,15
1025859,745179,2018-04-26,House,"House Third Reading: Given Immediate Effect Roll Call # 255",109,0,0,0,109
1025877,678902,2017-11-07,House,"Reported With Recommendation With Substitute  H-2",14,0,0,0,14
1025877,679400,2017-11-09,House,"House Third Reading: Passed Roll Call # 403",107,0,0,0,107
1025877,679996,2017-12-05,Senate,"Reported Favorably Without Amendment",5,0,0,0,5
1025877,680625,2017-12-12,Senate,"Senate Third Reading: Given Immediate Effect Roll Call # 517",38,0,0,0,38
1025889,678491,2017-10-25,House,"Reported With Recommendation With Substitute H-2",9,0,0,0,9
1025889,679417,2017-11-09,House,"House Third Reading: Given Immediate Effect Roll Call # 394",105,2,0,0,107
1025889,755518,2018-05-22,Senate,"Reported Favorably With Substitute  S-2",4,0,0,0,4
1025889,762465,2018-06-12,Senate,"Senate Third Reading: Given Immediate Effect Roll Call # 455",36,0,0,1,37
1025889,764568,2018-06-12,House,"House Third Reading: Roll Call # 539",107,2,0,0,109
1025904,676015,2017-09-13,House,"Reported With Recommendation Without Amendment",12,4,0,0,16
1025908,678412,2017-10-24,House,"Reported With Recommendation Without Amendment",14,0,0,0,14
1025908,694540,2018-02-01,House,"House Third Reading: Given Immediate Effect Roll Call # 44",109,0,0,0,109
1025908,722353,2018-03-13,Senate,"Reported Favorably With Substitute  S-1",4,0,0,0,4
1025908,726134,2018-03-20,Senate,"Senate Third Reading: Given Immediate Effect Roll Call # 170",37,0,0,0,37
1025908,727466,2018-03-21,House,"House Third Reading: Roll Call # 175",107,1,0,0,108
1025928,681055,2017-12-13,House,"Reported With Recommendation Without Amendment",12,3,0,0,15
1025928,764648,2018-06-12,House,"House Third Reading: Given Immediate Effect Roll Call # 553",73,36,0,0,109
1025928,781473,2018-12-20,Senate,"Senate Third Reading: Passed Roll Call # 1020",35,3,0,0,38
1025928,781674,2018-12-21,House,"House Third Reading: Roll Call # 990",71,35,0,0,106
1025931,681095,2017-12-13,House,"Reported With Recommendation Without Amendment",12,3,0,0,15
1025931,764452,2018-06-12,House,"House Third Reading: Given Immediate Effect Roll Call # 552",68,40,0,0,108
1025931,781331,2018-12-20,Senate,"Senate Third Reading: Passed Roll Call # 1019",34,4,0,0,38
1025931,781668,2018-12-21,House,"House Third Reading: Roll Call # 989",72,34,0,0,106
1025972,677366,2017-09-28,Senate,"Reported Favorably Without Amendment",5,0,0,0,5
1025972,677767,2017-10-05,Senate,"Senate Third Reading: Passed Roll Call # 371",37,0,0,1,38
1025972,678523,2017-10-25,House,"Reported With Recommendation Without Amendment",5,0,0,0,5
1025972,678660,2017-11-01,House,"House Third Reading: Given Immediate Effect Roll Call # 349",108,0,0,0,108
1025973,677383,2017-09-28,Senate,"Reported Favorably Without Amendment",5,0,0,0,5
1025973,677759,2017-10-05,Senate,"Senate Third Reading: Passed Roll Call # 375",37,0,0,1,38
1025973,678506,2017-10-25,House,"Reported With Recommendation Without Amendment",5,0,0,0,5
1025973,678661,2017-11-01,House,"House Third Reading: Given Immediate Effect Roll Call # 353",108,0,0,0,108
1025974,677360,2017-09-28,Senate,"Reported Favorably Without Amendment",5,0,0,0,5
1025974,677670,2017-10-05,Senate,"Senate Third Reading: Passed Roll Call # 364",36,0,0,2,38
1025974,678504,2017-10-25,House,"Reported With Recommendation With Substitute H-1",5,0,0,0,5
1025974,678657,2017-11-01,House,"House Third Reading: Given Immediate Effect Roll Call # 342",108,0,0,0,108
1025974,678971,2017-11-08,Senate,"Senate Third Reading: Roll Call # 444",37,0,0,1,38
1025975,677314,2017-09-26,Senate,"Reported Favorably Without Amendment",7,0,0,0,7
1025975,677584,2017-10-04,Senate,"Senate Third Reading: Passed Roll Call # 358",36,0,0,2,38
1025975,678532,2017-10-25,House,"Reported With Recommendation With Substitute H-1",12,1,0,0,13
1025975,681173,2017-12-12,House,"House Third Reading: Given Immediate Effect Roll Call # 458",98,11,0,0,109
1025975,681174,2017-12-13,Senate,"Senate Third Reading: Roll Call # 519",37,0,1,0,38
1025975,681175,2017-12-13,Senate,"Senate Third Reading: Passed Roll Call # 520",38,0,0,0,38
1025976,677364,2017-09-28,Senate,"Reported Favorably Without Amendment",5,0,0,0,5
1025976,677684,2017-10-05,Senate,"Senate Third Reading: Passed Roll Call # 373",37,0,0,1,38
1025976,678517,2017-10-25,House,"Reported With Recommendation Without Amendment",5,0,0,0,5
1025976,678659,2017-11-01,House,"House Third Reading: Given Immediate Effect Roll Call # 351",108,0,0,0,108
1025977,677373,2017-09-28,Senate,"Reported Favorably Without Amendment",5,0,0,0,5
1025977,677692,2017-10-05,Senate,"Senate Third Reading: Passed Roll Call # 363",36,0,0,2,38
1025977,678519,2017-10-25,House,"Reported With Recommendation Without Amendment",5,0,0,0,5
1025977,678663,2017-11-01,House,"House Third Reading: Given Immediate Effect Roll Call # 341",108,0,0,0,108
1025978,677371,2017-09-28,Senate,"Reported Favorably Without Amendment",5,0,0,0,5
1025978,677681,2017-10-05,Senate,"Senate Third Reading: Passed Roll Call # 368",37,0,0,1,38
1025978,678480,2017-10-25,House,"Reported With Recommendation Without Amendment",5,0,0,0,5
1025978,678632,2017-11-01,House,"House Third Reading: Given Immediate Effect Roll Call # 346",108,0,0,0,108
1025979,677372,2017-09-28,Senate,"Reported Favorably Without Amendment",5,0,0,0,5
1025979,677691,2017-10-05,Senate,"Senate Third Reading: Passed Roll Call # 367",36,0,0,2,38
1025979,678507,2017-10-25,House,"Reported With Recommendation Without Amendment",5,0,0,0,5
1025979,678672,2017-11-01,House,"House Third Reading: Given Immediate Effect Roll Call # 345",108,0,0,0,108
1025981,677382,2017-09-28,Senate,"Reported Favorably Without Amendment",5,0,0,0,5
1025981,677770,2017-10-05,Senate,"Senate Third Reading: Passed Roll Call # 365",36,0,0,2,38
1025981,678520,2017-10-25,House,"Reported With Recommendation Without Amendment",5,0,0,0,5
1025981,678675,2017-11-01,House,"House Third Reading: Given Immediate Effect Roll Call # 343",108,0,0,0,108
1025985,677378,2017-09-28,Senate,"Reported Favorably Without Amendment",5,0,0,0,5
1025985,677757,2017-10-05,Senate,"Senate Third Reading: Passed Roll Call # 370",37,0,0,1,38
1025985,678525,2017-10-25,House,"Reported With Recommendation Without Amendment",5,0,0,0,5
1025985,678680,2017-11-01,House,"House Third Reading: Given Immediate Effect Roll Call # 348",108,0,0,0,108
1025986,677362,2017-09-28,Senate,"Reported Favorably Without Amendment",5,0,0,0,5
1025986,677693,2017-10-05,Senate,"Senate Third Reading: Passed Roll Call # 374",37,0,0,1,38
1025986,678505,2017-10-25,House,"Reported With Recommendation Without Amendment",5,0,0,0,5
1025986,678671,2017-11-01,House,"House Third Reading: Given Immediate Effect Roll Call # 352",108,0,0,0,108
1025988,677374,2017-09-28,Senate,"Reported Favorably Without Amendment",5,0,0,0,5
1025988,677673,2017-10-05,Senate,"Senate Third Reading: Passed Roll Call # 362",35,1,0,2,38
1025988,678514,2017-10-25,House,"Reported With Recommendation Without Amendment",5,0,0,0,5
1025988,679584,2017-11-30,House,"House Third Reading: Given Immediate Effect Roll Call # 419",105,3,0,0,108
1025989,677370,2017-09-28,Senate,"Reported Favorably With Substitute  S-1",5,0,0,0,5
1025989,677754,2017-10-05,Senate,"Senate Third Reading: Passed Roll Call # 369",37,0,0,1,38
1025989,678518,2017-10-25,House,"Reported With Recommendation Without Amendment",5,0,0,0,5
1025989,678677,2017-11-01,House,"House Third Reading: Given Immediate Effect Roll Call # 347",108,0,0,0,108
1025990,677363,2017-09-28,Senate,"Reported Favorably With Substitute  S-1",5,0,0,0,5
1025990,677682,2017-10-05,Senate,"Senate Third Reading: Passed Roll Call # 372",37,0,0,1,38
1025990,678524,2017-10-25,House,"Reported With Recommendation Without Amendment",5,0,0,0,5
1025990,678679,2017-11-01,House,"House Third Reading: Given Immediate Effect Roll Call # 350",108,0,0,0,108
1025992,677319,2017-09-26,Senate,"Reported Favorably Without Amendment",7,0,0,0,7
1025992,677598,2017-10-04,Senate,"Senate Third Reading: Passed Roll Call # 359",36,0,0,2,38
1025992,678522,2017-10-25,House,"Reported With Recommendation With Substitute H-1",12,1,0,0,13
1025992,680989,2017-12-12,House,"House Third Reading: Given Immediate Effect Roll Call # 459",98,11,0,0,109
1025992,680990,2017-12-13,Senate,"Senate Third Reading: Roll Call # 521",38,0,0,0,38
1025993,679987,2017-12-05,Senate,"Reported Favorably Without Amendment",5,0,0,0,5
1025993,680773,2017-12-13,Senate,"Senate Third Reading: Passed Roll Call # 549",38,0,0,0,38
1025994,677375,2017-09-28,Senate,"Reported Favorably Without Amendment",5,0,0,0,5
1025994,677678,2017-10-05,Senate,"Senate Third Reading: Passed Roll Call # 366",36,0,0,2,38
1025994,678516,2017-10-25,House,"Reported With Recommendation Without Amendment",5,0,0,0,5
1025994,678674,2017-11-01,House,"House Third Reading: Given Immediate Effect Roll Call # 344",108,0,0,0,108
1026001,677623,2017-10-04,House,"Reported With Recommendation Without Amendment",12,0,0,0,12
1026001,679560,2017-11-30,House,"House Third Reading: Given Immediate Effect Roll Call # 416",106,2,0,0,108
1026001,685869,2018-01-17,Senate,"Reported Favorably Without Amendment",6,0,0,0,6
1026001,699366,2018-02-06,Senate,"Senate Third Reading: Given Immediate Effect Roll Call # 59",36,0,0,2,38
1026005,676791,2017-09-19,House,"Reported With Recommendation With Substitute  H-1",9,0,0,0,9
1026005,677172,2017-09-20,House,"House Third Reading: Given Immediate Effect Roll Call # 279",101,6,0,0,107
1026005,677344,2017-09-27,Senate,"Reported Favorably Without Amendment",5,0,0,0,5
1026005,677345,2017-09-27,Senate,"Senate Third Reading: Given Immediate Effect Roll Call # 352",37,0,0,1,38
1026006,677864,2017-10-11,House,"Reported With Recommendation Without Amendment",12,0,0,0,12
1026006,678259,2017-10-19,House,"House Third Reading: Given Immediate Effect Roll Call # 319",107,0,0,0,107
1026006,680734,2017-12-13,Senate,"Reported Favorably Without Amendment",5,0,0,0,5
1026006,685702,2018-01-16,Senate,"Senate Third Reading: Given Immediate Effect Roll Call # 4",34,0,0,4,38
1026013,679415,2017-11-08,House,"Reported With Recommendation Without Amendment",25,2,0,0,27
1026013,680184,2017-12-06,House,"House Third Reading: Given Immediate Effect Roll Call # 438",94,16,0,0,110
1026013,686948,2018-01-18,Senate,"Reported Favorably Without Amendment",4,0,0,0,4
1026021,678639,2017-10-31,House,"Reported With Recommendation With Substitute  H-4",14,0,0,0,14
1026021,679401,2017-11-09,House,"House Third Reading: Given Immediate Effect Roll Call # 399",68,39,0,0,107
1026021,740075,2018-04-17,Senate,"Reported Favorably Without Amendment",4,0,0,0,4
1026021,741477,2018-04-19,Senate,"Senate Third Reading: Given Immediate Effect Roll Call # 217",35,2,0,0,37
1026021,745015,2018-04-24,House,"House Third Reading: Roll Call # 238",67,40,0,0,107
1026069,677755,2017-10-05,Senate,"Reported Favorably Without Amendment",7,0,0,0,7
1026069,677837,2017-10-11,Senate,"Senate Third Reading: Passed Roll Call # 382",37,0,0,1,38
1026069,679591,2017-11-29,House,"Reported With Recommendation Without Amendment",13,0,0,0,13
1026069,680238,2017-12-07,House,"House Third Reading: Given Immediate Effect Roll Call # 443",110,0,0,0,110
1026072,677669,2017-10-05,Senate,"Reported Favorably Without Amendment",7,0,0,0,7
1026072,677855,2017-10-11,Senate,"Senate Third Reading: Passed Roll Call # 383",37,0,0,1,38
1026072,679590,2017-11-29,House,"Reported With Recommendation Without Amendment",13,0,0,0,13
1026072,680307,2017-12-07,House,"House Third Reading: Given Immediate Effect Roll Call # 444",110,0,0,0,110
1026073,677842,2017-10-11,Senate,"Reported Favorably With Substitute  S-3",4,0,0,0,4
1026073,678146,2017-10-18,Senate,"Senate Third Reading: Passed Roll Call # 403",23,14,0,1,38
1026073,678727,2017-11-02,House,"Reported With Recommendation With Substitute  H-1",9,6,0,0,15
1026073,686323,2018-01-18,House,"House Third Reading: Given Immediate Effect Roll Call # 16",55,52,0,0,107
1026073,687901,2018-01-23,Senate,"Senate Third Reading: Roll Call # 18",23,14,0,1,38
1026074,677679,2017-10-05,Senate,"Reported Favorably Without Amendment",7,0,0,0,7
1026074,677878,2017-10-11,Senate,"Senate Third Reading: Passed Roll Call # 380",37,0,0,1,38
1026074,679549,2017-11-29,House,"Reported With Recommendation With Substitute  H-1",13,0,0,0,13
1026074,680310,2017-12-07,House,"House Third Reading: Given Immediate Effect Roll Call # 441",110,0,0,0,110
1026074,680627,2017-12-12,Senate,"Senate Third Reading: Roll Call # 506",38,0,0,0,38
1026076,677761,2017-10-05,Senate,"Reported Favorably Without Amendment",7,0,0,0,7
1026076,677870,2017-10-11,Senate,"Senate Third Reading: Passed Roll Call # 381",37,0,0,1,38
1026076,679588,2017-11-29,House,"Reported With Recommendation Without Amendment",13,0,0,0,13
1026076,680237,2017-12-07,House,"House Third Reading: Given Immediate Effect Roll Call # 442",110,0,0,0,110
1026082,779225,2018-11-28,House,"Reported With Recommendation With Substitute  H-1",9,2,0,0,11
1026099,678396,2017-10-24,House,"Reported With Recommendation Without Amendment",14,0,0,0,14
1026099,678673,2017-11-01,House,"House Third Reading: Given Immediate Effect Roll Call # 355",108,0,0,0,108
1026099,680675,2017-12-12,Senate,"Reported Favorably With Substitute  S-1",4,0,0,0,4
1026099,692525,2018-01-31,Senate,"Senate Third Reading: Given Immediate Effect Roll Call # 49",37,0,0,1,38
1026099,697191,2018-02-06,House,"House Third Reading: Roll Call # 47",108,0,0,0,108
1026104,677865,2017-10-11,House,"Reported With Recommendation With Substitute  H-2",9,0,0,0,9
1026104,678244,2017-10-19,House,"House Third Reading: Given Immediate Effect Roll Call # 317",104,3,0,0,107
1026104,680396,2017-12-07,Senate,"Reported Favorably Without Amendment",4,0,0,0,4
1026104,686923,2018-01-18,Senate,"Senate Third Reading: Given Immediate Effect Roll Call # 15",34,3,0,1,38
1026332,677348,2017-09-27,House,"Reported With Recommendation Without Amendment",9,0,0,0,9
1026332,741769,2018-04-18,Senate,"Reported Favorably Without Amendment",5,0,0,0,5
1026334,745313,2018-04-26,Senate,"Reported Favorably With Substitute  S-2",8,0,0,0,8
1026334,779336,2018-11-29,Senate,"Senate Third Reading: Passed Roll Call # 621",38,0,0,0,38
1026334,780601,2018-12-12,House,"Reported With Recommendation With Substitute  H-1",12,0,0,0,12
1026337,678419,2017-10-24,Senate,"Reported Favorably Without Amendment",5,0,0,0,5
1026337,688543,2018-01-24,Senate,"Senate Third Reading: Passed Roll Call # 25",38,0,0,0,38
1026344,678413,2017-10-24,Senate,"Reported Favorably Without Amendment",5,0,0,0,5
1026344,679622,2017-11-30,Senate,"Senate Third Reading: Passed Roll Call # 471",38,0,0,0,38
1026344,680984,2017-12-12,House,"Reported With Recommendation Without Amendment",12,0,0,0,12
1026344,680985,2017-12-13,House,"House Third Reading: Given Immediate Effect Roll Call # 501",89,21,0,0,110
1026361,702304,2018-02-14,House,"Reported With Recommendation With Substitute  H-1",13,0,0,0,13
1026361,749127,2018-05-02,House,"House Third Reading: Given Immediate Effect Roll Call # 263",107,2,0,0,109
1026361,781393,2018-12-20,Senate,"Senate Third Reading: Given Immediate Effect Roll Call # 979",26,12,0,0,38
1026361,781394,2018-12-21,House,"House Third Reading: Roll Call # 984",56,51,0,0,107
1026365,677919,2017-10-12,Senate,"Reported Favorably With Substitute S1",5,0,0,0,5
1026377,697152,2018-02-06,House,"Reported With Recommendation Without Amendment",11,1,0,0,12
1026377,742118,2018-04-12,House,"House Third Reading: Given Immediate Effect Roll Call # 226",108,0,0,0,108
1026381,780448,2018-12-12,House,"Reported With Recommendation With Substitute  H-2",10,1,0,0,11
1026387,780634,2018-12-12,House,"Reported With Recommendation With Substitute  H-2",10,1,0,0,11
1026403,755385,2018-05-22,House,"Reported With Recommendation With Substitute  H-2",14,0,0,0,14
1026403,759849,2018-06-05,House,"House Third Reading: Given Immediate Effect Roll Call # 450",108,0,0,0,108
1026403,779654,2018-12-04,Senate,"Reported Favorably With Substitute  S-2",5,0,0,0,5
1026403,781350,2018-12-20,Senate,"Senate Third Reading: Passed Roll Call # 1010",32,5,1,0,38
1026403,781621,2018-12-21,House,"House Third Reading: Roll Call # 1012",90,17,0,0,107
1026405,677606,2017-10-04,House,"Reported With Recommendation With Substitute  H-2",10,1,0,0,11
1026405,677854,2017-10-11,House,"House Third Reading: Given Immediate Effect Roll Call # 309",102,6,0,0,108
1026405,679118,2017-11-09,Senate,"Reported Favorably Without Amendment",7,0,0,0,7
1026405,680715,2017-12-13,Senate,"Senate Third Reading: Given Immediate Effect Roll Call # 542",38,0,0,0,38
1026406,678112,2017-10-17,House,"Reported With Recommendation Without Amendment",11,0,0,0,11
1026406,678488,2017-10-25,House,"House Third Reading: Given Immediate Effect Roll Call # 327",101,5,0,0,106
1026406,711897,2018-02-27,Senate,"Reported Favorably Without Amendment",5,0,0,0,5
1026406,714763,2018-03-01,Senate,"Senate Third Reading: Given Immediate Effect Roll Call # 124",36,0,0,2,38
1026406,719043,2018-03-06,House,"House Third Reading: Roll Call # 129",104,4,0,0,108
1026491,677834,2017-10-11,House,"Reported With Recommendation Without Amendment",5,4,0,0,9
1026494,678944,2017-11-08,Senate,"Reported Favorably Without Amendment",3,2,0,0,5
1026494,678945,2017-11-08,Senate,"Senate Third Reading: Passed Roll Call # 457",25,12,0,1,38
1026497,677365,2017-09-28,Senate,"Reported Favorably Without Amendment",4,1,0,0,5
1026497,677589,2017-10-04,Senate,"Senate Third Reading: Passed Roll Call # 360",31,5,0,2,38
1026500,677368,2017-09-28,Senate,"Reported Favorably Without Amendment",5,0,0,0,5
1026508,678985,2017-11-08,Senate,"Reported Favorably With Substitute  S-1",3,2,0,0,5
1026508,678986,2017-11-08,Senate,"Senate Third Reading: Passed Roll Call # 456",25,12,0,1,38
1026518,680668,2017-12-12,Senate,"Reported Favorably Without Amendment",4,0,0,0,4
1026518,680789,2017-12-13,Senate,"Senate Third Reading: Passed Roll Call # 556",37,0,0,1,38
1026518,697423,2018-02-06,House,"Reported With Recommendation Without Amendment",12,1,0,0,13
1026518,711694,2018-02-27,House,"House Third Reading: Given Immediate Effect Roll Call # 98",105,3,0,0,108
1026521,677369,2017-09-28,Senate,"Reported Favorably Without Amendment",5,0,0,0,5
1026524,678947,2017-11-08,Senate,"Reported Favorably With Substitute  S-1",3,2,0,0,5
1026524,678948,2017-11-08,Senate,"Senate Third Reading: Passed Roll Call # 455",25,12,0,1,38
1026533,774928,2018-09-25,House,"Reported With Recommendation Without Amendment",11,1,0,0,12
1026533,777205,2018-10-04,House,"House Third Reading: Given Immediate Effect Roll Call # 619",106,0,0,0,106
1026533,779355,2018-11-29,Senate,"Reported Favorably Without Amendment",4,0,0,0,4
1026533,780717,2018-12-13,Senate,"Senate Third Reading: Given Immediate Effect Roll Call # 773",37,0,1,0,38
1026539,677593,2017-10-04,House,"Reported With Recommendation Without Amendment",9,0,0,0,9
1026539,677790,2017-10-05,House,"House Third Reading: Given Immediate Effect Roll Call # 294",101,7,0,0,108
1026539,678095,2017-10-12,Senate,"Senate Third Reading: Given Immediate Effect Roll Call # 386",30,5,0,3,38
1027020,678560,2017-10-26,House,"Reported With Recommendation With Substitute  H-3",9,5,0,0,14
1027020,678729,2017-11-02,House,"House Third Reading: Defeated Roll Call # 375",45,63,0,0,108
1027029,678564,2017-10-26,House,"Reported With Recommendation Without Amendment",9,0,0,0,9
1027029,678656,2017-11-01,House,"House Third Reading: Given Immediate Effect Roll Call # 359",98,10,0,0,108
1027029,711895,2018-02-27,Senate,"Reported Favorably Without Amendment",4,1,0,0,5
1027029,740886,2018-04-18,Senate,"Senate Third Reading: Given Immediate Effect Roll Call # 206",27,8,0,2,37
1027031,696959,2018-02-06,House,"Reported With Recommendation Without Amendment",8,1,0,0,9
1027031,711940,2018-02-27,House,"House Third Reading: Given Immediate Effect Roll Call # 100",92,16,0,0,108
1027031,738314,2018-04-12,Senate,"Reported Favorably Without Amendment",5,0,0,0,5
1027031,747320,2018-05-01,Senate,"Senate Third Reading: Given Immediate Effect Roll Call # 242",32,4,0,1,37
1027040,680982,2017-12-13,House,"Reported With Recommendation With Substitute  H-2",9,0,0,0,9
1027040,686302,2018-01-17,House,"House Third Reading: Given Immediate Effect Roll Call # 12",98,10,0,0,108
1027040,727813,2018-03-22,Senate,"Reported Favorably Without Amendment",5,0,0,0,5
1027040,738348,2018-04-12,Senate,"Senate Third Reading: Given Immediate Effect Roll Call # 191",32,2,1,2,37
1027045,681205,2017-12-13,House,"Reported With Recommendation Without Amendment",9,0,0,0,9
1027045,686407,2018-01-17,House,"House Third Reading: Given Immediate Effect Roll Call # 13",98,10,0,0,108
1027045,727817,2018-03-22,Senate,"Reported Favorably Without Amendment",5,0,0,0,5
1027045,738369,2018-04-12,Senate,"Senate Third Reading: Given Immediate Effect Roll Call # 192",33,2,0,2,37
1027099,677683,2017-10-05,Senate,"Reported Favorably Without Amendment",7,0,0,0,7
1027099,680723,2017-12-13,Senate,"Senate Third Reading: Passed Roll Call # 536",38,0,0,0,38
1027099,713465,2018-02-28,House,"Reported With Recommendation Without Amendment",10,0,0,0,10
1027099,722622,2018-03-13,House,"House Third Reading: Given Immediate Effect Roll Call # 160",106,3,0,0,109
1027103,677677,2017-10-05,Senate,"Reported Favorably Without Amendment",7,0,0,0,7
1027103,680714,2017-12-13,Senate,"Senate Third Reading: Passed Roll Call # 537",38,0,0,0,38
1027103,713424,2018-02-28,House,"Reported With Recommendation Without Amendment",10,0,0,0,10
1027103,722659,2018-03-13,House,"House Third Reading: Given Immediate Effect Roll Call # 161",106,3,0,0,109
1027118,677762,2017-10-05,Senate,"Reported Favorably Without Amendment",7,0,0,0,7
1027118,680738,2017-12-13,Senate,"Senate Third Reading: Passed Roll Call # 534",38,0,0,0,38
1027118,713391,2018-02-28,House,"Reported With Recommendation Without Amendment",10,0,0,0,10
1027118,722660,2018-03-13,House,"House Third Reading: Given Immediate Effect Roll Call # 158",106,3,0,0,109
1027127,677756,2017-10-05,Senate,"Reported Favorably Without Amendment",7,0,0,0,7
1027127,680750,2017-12-13,Senate,"Senate Third Reading: Passed Roll Call # 535",38,0,0,0,38
1027127,713346,2018-02-28,House,"Reported With Recommendation Without Amendment",10,0,0,0,10
1027127,722604,2018-03-13,House,"House Third Reading: Given Immediate Effect Roll Call # 159",106,3,0,0,109
1027133,680658,2017-12-12,Senate,"Reported Favorably With Substitute  S-1",4,0,0,0,4
1027133,686983,2018-01-18,Senate,"Senate Third Reading: Passed Roll Call # 16",37,0,0,1,38
1027133,711848,2018-02-27,House,"Reported With Recommendation Without Amendment",14,0,0,0,14
1027133,722380,2018-03-13,House,"House Third Reading: Given Immediate Effect Roll Call # 157",106,3,0,0,109
1027133,723468,2018-03-14,Senate,"Senate Third Reading: House Amendment(s) Concurred In Roll Call # 144",35,0,0,2,37
1027137,712089,2018-02-27,House,"Reported With Recommendation With Substitute  H-2",10,1,0,0,11
1027137,726543,2018-02-27,House,"Reported With Recommendation With Substitute H-2",10,1,0,0,11
1027137,727922,2018-03-22,House,"House Third Reading: Given Immediate Effect Roll Call # 191",91,17,0,0,108
1027137,757869,2018-05-30,Senate,"Reported Favorably Without Amendment",5,0,0,0,5
1027137,780692,2018-12-13,Senate,"Senate Third Reading: Given Immediate Effect Roll Call # 816",35,2,0,1,38
1027141,678509,2017-10-25,House,"Reported With Recommendation With Substitute H-2",9,0,0,0,9
1027141,679414,2017-11-09,House,"House Third Reading: Given Immediate Effect Roll Call # 395",105,2,0,0,107
1027142,779537,2018-12-04,House,"Reported With Recommendation Without Amendment",9,1,0,0,10
1027142,780004,2018-12-06,House,"House Third Reading: Given Immediate Effect Roll Call # 766",90,19,0,0,109
1027142,780539,2018-12-12,Senate,"Reported Favorably Without Amendment",5,0,0,0,5
1027142,780751,2018-12-13,Senate,"Senate Third Reading: Given Immediate Effect Roll Call # 799",28,9,0,1,38
1027166,711835,2018-02-27,House,"Reported With Recommendation With Substitute  H-1",10,1,0,0,11
1027166,726390,2018-02-27,House,"Reported With Recommendation With Substitute H-1",10,1,0,0,11
1027166,727955,2018-03-22,House,"House Third Reading: Given Immediate Effect Roll Call # 193",92,17,0,0,109
1027166,757905,2018-05-30,Senate,"Reported Favorably With Substitute  S-1",5,0,0,0,5
1027166,780694,2018-12-13,Senate,"Senate Third Reading: Given Immediate Effect Roll Call # 817",35,2,0,1,38
1027166,781197,2018-12-19,House,"House Third Reading: Roll Call # 899",92,17,0,0,109
1027167,688432,2018-01-24,House,"Reported With Recommendation With Substitute  H-2",11,0,0,0,11
1027167,697274,2018-02-07,House,"House Third Reading: Given Immediate Effect Roll Call # 51",105,2,0,0,107
1027167,780489,2018-12-12,Senate,"Reported Favorably With Substitute  S-2",7,0,0,0,7
1027256,678708,2017-11-02,Senate,"Reported Favorably With Substitute  S-2",4,0,0,0,4
1027256,679125,2017-11-09,Senate,"Senate Third Reading: Passed Roll Call # 461",36,0,0,2,38
1027256,680300,2017-12-06,House,"Reported With Recommendation Without Amendment",5,0,0,0,5
1027256,714751,2018-03-01,House,"House Third Reading: Given Immediate Effect Roll Call # 119",109,0,0,0,109
1027258,749306,2018-05-03,House,"Reported With Recommendation Without Amendment",11,0,0,0,11
1027262,745391,2018-04-26,Senate,"Reported Favorably With Substitute  S-1",5,0,0,0,5
1027262,745392,2018-04-26,Senate,"Senate Third Reading: Passed Roll Call # 239",35,0,0,2,37
1027262,781626,2018-12-21,House,"House Third Reading: Given Immediate Effect Roll Call # 1003",84,23,0,0,107
1027262,781627,2018-12-21,Senate,"Senate Third Reading: Roll Call # 1044",34,4,0,0,38
1027268,678240,2017-10-19,House,"Reported With Recommendation With Substitute  H-1",9,0,0,0,9
1027268,678712,2017-11-02,House,"House Third Reading: Given Immediate Effect Roll Call # 368",108,0,0,0,108
1027268,693285,2018-02-01,Senate,"Reported Favorably Without Amendment",5,0,0,0,5
1027271,677586,2017-10-04,House,"Reported With Recommendation Without Amendment",12,0,0,0,12
1027271,679553,2017-11-30,House,"House Third Reading: Given Immediate Effect Roll Call # 417",106,2,0,0,108
1027271,686035,2018-01-17,Senate,"Reported Favorably Without Amendment",6,0,0,0,6
1027271,699662,2018-02-06,Senate,"Senate Third Reading: Given Immediate Effect Roll Call # 60",36,2,0,0,38
1027272,678271,2017-10-19,House,"Reported With Recommendation Without Amendment",9,0,0,0,9
1027272,678718,2017-11-02,House,"House Third Reading: Given Immediate Effect Roll Call # 369",104,4,0,0,108
1027272,693054,2018-02-01,Senate,"Reported Favorably Without Amendment",5,0,0,0,5
1027272,703015,2018-02-14,Senate,"Senate Third Reading: Given Immediate Effect Roll Call # 82",36,0,0,2,38
1027272,703016,2018-02-14,House,"House Third Reading: Roll Call # 75",109,0,0,0,109
1027278,678241,2017-10-19,House,"Reported With Recommendation With Substitute  H-1",9,0,0,0,9
1027278,678711,2017-11-02,House,"House Third Reading: Given Immediate Effect Roll Call # 370",108,0,0,0,108
1027278,692895,2018-02-01,Senate,"Reported Favorably Without Amendment",5,0,0,0,5
1027278,702559,2018-02-14,Senate,"Senate Third Reading: Given Immediate Effect Roll Call # 83",36,0,0,2,38
1027279,678253,2017-10-19,House,"Reported With Recommendation With Substitute  H-1",9,0,0,0,9
1027279,678721,2017-11-02,House,"House Third Reading: Given Immediate Effect Roll Call # 371",108,0,0,0,108
1027279,692904,2018-02-01,Senate,"Reported Favorably Without Amendment",5,0,0,0,5
1027280,678263,2017-10-19,House,"Reported With Recommendation With Substitute  H-1",9,0,0,0,9
1027280,678733,2017-11-02,House,"House Third Reading: Given Immediate Effect Roll Call # 367",107,1,0,0,108
1027280,693025,2018-02-01,Senate,"Reported Favorably Without Amendment",5,0,0,0,5
1027280,702526,2018-02-14,Senate,"Senate Third Reading: Given Immediate Effect Roll Call # 81",36,0,0,2,38
1027280,702527,2018-02-14,House,"House Third Reading: Roll Call # 74",109,0,0,0,109
1027282,677871,2017-10-11,House,"Reported With Recommendation With Substitute  H-1",12,0,0,0,12
1027282,678261,2017-10-19,House,"House Third Reading: Given Immediate Effect Roll Call # 318",104,3,0,0,107
1027282,699789,2018-02-06,Senate,"Reported Favorably Without Amendment",5,0,0,0,5
1027282,707453,2018-02-21,Senate,"Senate Third Reading: Given Immediate Effect Roll Call # 104",36,0,0,2,38
1027284,678243,2017-10-19,House,"Reported With Recommendation With Substitute  H-2",9,0,0,0,9
1027284,678730,2017-11-02,House,"House Third Reading: Given Immediate Effect Roll Call # 372",107,1,0,0,108
1027284,692893,2018-02-01,Senate,"Reported Favorably With Substitute  S-1",5,0,0,0,5
1027284,702257,2018-02-14,Senate,"Senate Third Reading: Given Immediate Effect Roll Call # 84",36,0,0,2,38
1027284,702259,2018-02-14,House,"House Third Reading: Roll Call # 77",109,0,0,0,109
1027285,678276,2017-10-19,House,"Reported With Recommendation With Substitute  H-1",9,0,0,0,9
1027285,678732,2017-11-02,House,"House Third Reading: Given Immediate Effect Roll Call # 366",103,5,0,0,108
1027285,692937,2018-02-01,Senate,"Reported Favorably Without Amendment",5,0,0,0,5
1027285,703259,2018-02-14,Senate,"Senate Third Reading: Given Immediate Effect Roll Call # 80",36,0,0,2,38
1027285,703260,2018-02-14,House,"House Third Reading: Roll Call # 73",109,0,0,0,109
1027534,686404,2018-01-17,House,"Reported With Recommendation Without Amendment",11,0,0,0,11
1027534,702265,2018-02-14,House,"House Third Reading: Given Immediate Effect Roll Call # 64",109,0,0,0,109
1027534,757983,2018-05-30,Senate,"Reported Favorably Without Amendment",5,0,0,0,5
1027534,761091,2018-06-07,Senate,"Senate Third Reading: Given Immediate Effect Roll Call # 423",36,0,0,1,37
1027534,761304,2018-06-07,Senate,"Senate Third Reading: Given Immediate Effect Roll Call # 424",36,0,0,1,37
1027543,678646,2017-11-01,Senate,"Reported Favorably With Substitute  S-2",3,0,0,0,3
1027543,679123,2017-11-09,Senate,"Senate Third Reading: Passed Roll Call # 460",35,1,0,2,38
1027573,678076,2017-10-17,Senate,"Reported Favorably Without Amendment",3,0,0,0,3
1027573,678609,2017-10-31,Senate,"Senate Third Reading: Passed Roll Call # 434",35,0,0,3,38
1027573,680011,2017-12-05,House,"Reported With Recommendation Without Amendment",14,0,0,0,14
1027654,678121,2017-10-12,Senate,"Reported Favorably Without Amendment",5,0,0,0,5
1027654,678197,2017-10-19,Senate,"Senate Third Reading: Passed Roll Call # 419",37,0,0,1,38
1027654,692054,2018-01-31,House,"Reported With Recommendation With Substitute  H-1",9,0,0,0,9
1027659,678090,2017-10-12,Senate,"Reported Favorably Without Amendment",5,0,0,0,5
1027659,678201,2017-10-19,Senate,"Senate Third Reading: Passed Roll Call # 421",37,0,0,1,38
1027659,692182,2018-01-31,House,"Reported With Recommendation With Substitute  H-1",9,0,0,0,9
1027660,678073,2017-10-12,Senate,"Reported Favorably Without Amendment",5,0,0,0,5
1027660,678199,2017-10-19,Senate,"Senate Third Reading: Passed Roll Call # 425",37,0,0,1,38
1027660,692170,2018-01-31,House,"Reported With Recommendation With Substitute  H-1",9,0,0,0,9
1027662,678070,2017-10-12,Senate,"Reported Favorably Without Amendment",5,0,0,0,5
1027662,678204,2017-10-19,Senate,"Senate Third Reading: Passed Roll Call # 423",37,0,0,1,38
1027662,692191,2018-01-31,House,"Reported With Recommendation Without Amendment",9,0,0,0,9
1027662,702166,2018-02-14,House,"House Third Reading: Given Immediate Effect Roll Call # 68",109,0,0,0,109
1027664,678071,2017-10-12,Senate,"Reported Favorably Without Amendment",5,0,0,0,5
1027664,678218,2017-10-19,Senate,"Senate Third Reading: Passed Roll Call # 422",37,0,0,1,38
1027664,692168,2018-01-31,House,"Reported With Recommendation With Substitute  H-1",9,0,0,0,9
1027666,680476,2017-12-07,Senate,"Reported Favorably Without Amendment",6,3,0,0,9
1027669,678079,2017-10-12,Senate,"Reported Favorably Without Amendment",5,0,0,0,5
1027669,678200,2017-10-19,Senate,"Senate Third Reading: Passed Roll Call # 424",37,0,0,1,38
1027669,692190,2018-01-31,House,"Reported With Recommendation Without Amendment",9,0,0,0,9
1027671,678067,2017-10-12,Senate,"Reported Favorably With Substitute  S-1",5,0,0,0,5
1027671,678202,2017-10-19,Senate,"Senate Third Reading: Passed Roll Call # 420",37,0,0,1,38
1027671,692169,2018-01-31,House,"Reported With Recommendation With Substitute  H-1",9,0,0,0,9
1027673,678206,2017-10-19,Senate,"Reported Favorably With Substitute  S-1",4,0,0,0,4
1027688,679492,2017-11-29,Senate,"Reported Favorably Without Amendment",4,0,0,0,4
1027688,698637,2018-02-08,House,"Reported With Recommendation Without Amendment",10,5,0,0,15
1027750,678876,2017-11-07,Senate,"Reported Favorably With Substitute  S-1",4,0,0,0,4
1027750,679649,2017-11-30,Senate,"Senate Third Reading: Passed Roll Call # 472",38,0,0,0,38
1027750,691758,2018-01-25,House,"Reported With Recommendation Without Amendment",11,0,0,0,11
1027750,697070,2018-02-07,House,"House Third Reading: Given Immediate Effect Roll Call # 50",105,3,0,0,108
1027979,679628,2017-11-30,Senate,"Reported Favorably Without Amendment",6,0,0,0,6
1027979,680191,2017-12-06,Senate,"Senate Third Reading: Passed Roll Call # 483",36,0,0,2,38
1027979,713481,2018-02-28,House,"Reported With Recommendation Without Amendment",11,1,0,0,12
1027979,727316,2018-03-21,House,"House Third Reading: Given Immediate Effect Roll Call # 177",91,17,0,0,108
1027985,678084,2017-10-12,Senate,"Reported Favorably Without Amendment",5,0,0,0,5
1027985,678219,2017-10-19,Senate,"Senate Third Reading: Passed Roll Call # 426",37,0,0,1,38
1027985,692483,2018-01-31,House,"Reported With Recommendation With Substitute  H-1",9,0,0,0,9
1027988,679929,2017-12-05,Senate,"Reported Favorably Without Amendment",5,0,0,0,5
1027988,688411,2018-01-24,Senate,"Senate Third Reading: Passed Roll Call # 26",38,0,0,0,38
1027988,740404,2018-04-17,House,"Reported With Recommendation Without Amendment",14,0,0,0,14
1027988,744987,2018-04-25,House,"House Third Reading: Given Immediate Effect Roll Call # 250",109,0,0,0,109
1027992,753928,2018-05-16,Senate,"Reported Favorably With Substitute  S-1",4,0,0,0,4
1027992,755752,2018-05-23,Senate,"Senate Third Reading: Passed Roll Call # 345",37,0,0,0,37
1027992,758220,2018-05-29,House,"Reported With Recommendation With Substitute  H-1",14,0,0,0,14
1027992,764589,2018-06-12,House,"House Third Reading: Given Immediate Effect Roll Call # 475",109,0,0,0,109
1027992,764590,2018-06-12,Senate,"Senate Third Reading: Roll Call # 541",36,0,0,1,37
1028003,679994,2017-12-05,Senate,"Reported Favorably Without Amendment",8,0,0,0,8
1028003,680740,2017-12-13,Senate,"Senate Third Reading: Passed Roll Call # 554",37,0,0,1,38
1028014,678272,2017-10-19,House,"Reported With Recommendation With Substitute  H-1",9,0,0,0,9
1028014,678707,2017-11-02,House,"House Third Reading: Given Immediate Effect Roll Call # 373",108,0,0,0,108
1028014,693085,2018-02-01,Senate,"Reported Favorably Without Amendment",5,0,0,0,5
1028014,702722,2018-02-14,Senate,"Senate Third Reading: Given Immediate Effect Roll Call # 85",36,0,0,2,38
1028014,702723,2018-02-14,House,"House Third Reading: Roll Call # 76",109,0,0,0,109
1028023,678723,2017-11-02,House,"Reported With Recommendation With Substitute  H-2",14,0,0,0,14
1028023,679047,2017-11-02,House,"Reported With Recommendation With Substitute H-2",14,0,0,0,14
1028023,679585,2017-11-29,House,"House Third Reading: Passed Roll Call # 408",93,14,0,0,107
1028026,686271,2018-01-17,House,"Reported With Recommendation Without Amendment",11,0,0,0,11
1028026,702217,2018-02-14,House,"House Third Reading: Given Immediate Effect Roll Call # 65",109,0,0,0,109
1028026,757900,2018-05-30,Senate,"Reported Favorably Without Amendment",5,0,0,0,5
1028026,761095,2018-06-07,Senate,"Senate Third Reading: Given Immediate Effect Roll Call # 425",36,0,0,1,37
1028031,678291,2017-10-19,Senate,"Reported Favorably Without Amendment",4,1,0,0,5
1028035,678115,2017-10-17,House,"Reported With Recommendation For Referral To Committee On Law And Justice",10,0,0,0,10
1028043,678254,2017-10-19,House,"Reported With Recommendation With Substitute  H-1",9,0,0,0,9
1028043,678724,2017-11-02,House,"House Third Reading: Given Immediate Effect Roll Call # 374",108,0,0,0,108
1028043,693291,2018-02-01,Senate,"Reported Favorably Without Amendment",5,0,0,0,5
1028048,678080,2017-10-12,Senate,"Reported Favorably Without Amendment",5,0,0,0,5
1028048,678192,2017-10-19,Senate,"Senate Third Reading: Passed Roll Call # 427",37,0,0,1,38
1028048,692500,2018-01-31,House,"Reported With Recommendation With Substitute  H-1",9,0,0,0,9
1028048,702293,2018-02-14,House,"House Third Reading: Given Immediate Effect Roll Call # 69",109,0,0,0,109
1028048,702294,2018-02-14,Senate,"Senate Third Reading: Roll Call # 86",36,0,0,2,38
1028112,757487,2018-05-29,Senate,"Reported Favorably Without Amendment",3,1,0,0,4
1028115,757379,2018-05-29,Senate,"Reported Favorably With Substitute  S-1",3,1,0,0,4
1028125,681034,2017-12-13,House,"Reported With Recommendation With Substitute  H-1",11,0,0,0,11
1028125,702174,2018-02-14,House,"House Third Reading: Given Immediate Effect Roll Call # 63",109,0,0,0,109
1028125,757941,2018-05-30,Senate,"Reported Favorably With Substitute  S-2",5,0,0,0,5
1028125,761113,2018-06-07,Senate,"Senate Third Reading: Given Immediate Effect Roll Call # 426",36,0,0,1,37
1028125,774292,2018-09-05,House,"House Third Reading: Roll Call # 561",105,1,0,0,106
1028129,678666,2017-11-01,House,"Reported With Recommendation With Substitute  H-1",13,0,0,0,13
1028129,681078,2017-12-12,House,"House Third Reading: Given Immediate Effect Roll Call # 461",108,1,0,0,109
1028129,756856,2018-05-24,Senate,"Reported Favorably With Substitute  S-1",7,0,0,0,7
1028129,761205,2018-06-07,Senate,"Senate Third Reading: Given Immediate Effect Roll Call # 422",36,0,0,1,37
1028129,764717,2018-06-12,House,"House Third Reading: Roll Call # 537",108,1,0,0,109
1028139,719307,2018-03-06,House,"Reported With Recommendation Without Amendment",13,0,0,0,13
1028139,727998,2018-03-22,House,"House Third Reading: Given Immediate Effect Roll Call # 202",88,21,0,0,109
1028139,774839,2018-09-25,Senate,"Reported Favorably Without Amendment",5,0,0,0,5
1028139,781438,2018-12-20,Senate,"Senate Third Reading: Passed Roll Call # 960",38,0,0,0,38
1028149,692055,2018-01-31,House,"Reported With Recommendation With Substitute  H-1",16,0,0,0,16
1028149,741324,2018-01-31,House,"Reported With Recommendation With Substitute H-1",16,0,0,0,16
1028149,745185,2018-04-24,House,"House Third Reading: Given Immediate Effect Roll Call # 239",104,3,0,0,107
1028242,679639,2017-11-30,Senate,"Reported Favorably With Substitute  S-2",9,0,0,0,9
1028242,680076,2017-12-06,Senate,"Senate Third Reading: Passed Roll Call # 484",36,0,0,2,38
1028242,681170,2017-12-12,House,"Reported With Recommendation Without Amendment",13,0,0,0,13
1028242,681171,2017-12-13,House,"House Third Reading: Given Immediate Effect Roll Call # 493",107,3,0,0,110
1028259,678203,2017-10-19,Senate,"Reported Favorably With Substitute  S-1",4,0,0,0,4
1028259,678653,2017-11-01,Senate,"Senate Third Reading: Passed Roll Call # 438",34,0,0,4,38
1028259,680044,2017-12-05,House,"Reported With Recommendation With Substitute H-1",9,0,0,0,9
1028259,681137,2017-12-13,House,"House Third Reading: Given Immediate Effect Roll Call # 491",110,0,0,0,110
1028259,681138,2017-12-13,Senate,"Senate Third Reading: Roll Call # 567",37,0,0,1,38
1028271,679978,2017-12-05,House,"Reported With Recommendation Without Amendment",6,3,0,0,9
1028271,680512,2017-12-05,House,"Reported With Recommendation With Substitute H-3",6,3,0,0,9
1028271,685132,2017-12-05,House,"Reported With Recommendation With Substitute  H-3",6,3,0,0,9
1028271,779221,2018-11-29,House,"House Third Reading: Given Immediate Effect Roll Call # 652",84,25,0,0,109
1028271,780729,2018-12-13,Senate,"Reported Favorably With Substitute  S-2",7,0,0,0,7
1028271,781488,2018-12-19,Senate,"Senate Third Reading: Given Immediate Effect Roll Call # 927",38,0,0,0,38
1028271,781600,2018-12-20,House,"House Third Reading: Roll Call # 971",84,23,0,0,107
1028277,680986,2017-12-12,House,"Reported With Recommendation Without Amendment",12,0,0,0,12
1028277,685300,2018-01-11,House,"House Third Reading: Given Immediate Effect Roll Call # 4",106,0,0,0,106
1028277,706612,2018-02-20,Senate,"Reported Favorably Without Amendment",5,0,0,0,5
1028277,713983,2018-02-28,Senate,"Senate Third Reading: Given Immediate Effect Roll Call # 116",37,0,0,1,38
1028277,714529,2018-03-01,House,"House Third Reading: Roll Call # 118",109,0,0,0,109
1028279,697395,2018-02-07,House,"Reported With Recommendation With Substitute  H-2",12,0,0,0,12
1028279,707577,2018-02-15,House,"House Third Reading: Given Immediate Effect Roll Call # 81",109,0,0,0,109
1028279,727999,2018-03-22,Senate,"Reported Favorably Without Amendment",7,0,0,0,7
1028279,737657,2018-04-11,Senate,"Senate Third Reading: Given Immediate Effect Roll Call # 188",37,0,0,0,37
1028280,686265,2018-01-17,House,"Reported With Recommendation Without Amendment",11,0,0,0,11
1028280,702164,2018-02-14,House,"House Third Reading: Given Immediate Effect Roll Call # 66",109,0,0,0,109
1028280,757992,2018-05-30,Senate,"Reported Favorably Without Amendment",5,0,0,0,5
1028280,761096,2018-06-07,Senate,"Senate Third Reading: Given Immediate Effect Roll Call # 427",36,0,0,1,37
1028282,678640,2017-11-01,House,"Reported With Recommendation With Substitute  H-3",9,0,0,0,9
1028282,679418,2017-11-09,House,"House Third Reading: Given Immediate Effect Roll Call # 402",106,1,0,0,107
1028289,680249,2017-12-06,House,"Reported With Recommendation Without Amendment",9,0,0,0,9
1028289,680995,2017-12-12,House,"House Third Reading: Given Immediate Effect Roll Call # 471",107,2,0,0,109
1028289,713603,2018-02-28,Senate,"Reported Favorably Without Amendment",7,0,0,0,7
1028289,720497,2018-03-08,Senate,"Senate Third Reading: Given Immediate Effect Roll Call # 140",35,1,0,1,37
1028295,678644,2017-10-31,House,"Reported With Recommendation With Amendment(s)",9,3,0,0,12
1028295,678714,2017-11-02,House,"House Third Reading: Given Immediate Effect Roll Call # 365",66,42,0,0,108
1028295,679093,2017-11-09,Senate,"Reported Favorably Without Amendment",4,1,0,0,5
1028295,679094,2017-11-09,Senate,"Senate Third Reading: Given Immediate Effect Roll Call # 462",25,11,0,2,38
1028295,762564,2018-06-12,Senate,"Senate Third Reading: Passed Roll Call # 549",26,10,0,1,37
1028295,764494,2018-06-12,House,"House Third Reading: Roll Call # 558",56,52,0,0,108
1028298,678533,2017-10-25,House,"Reported With Recommendation With Substitute H-1",9,0,0,0,9
1028298,678864,2017-11-07,House,"House Third Reading: Given Immediate Effect Roll Call # 380",106,1,0,0,107
1028298,751546,2018-05-09,Senate,"Reported Favorably With Substitute  S-3",5,0,0,0,5
1028298,754194,2018-05-16,Senate,"Senate Third Reading: Given Immediate Effect Roll Call # 301",37,0,0,0,37
1028298,755440,2018-05-22,House,"House Third Reading: Roll Call # 346",108,0,0,0,108
1028301,679420,2017-11-08,House,"Reported With Recommendation With Substitute  H-2",5,0,0,0,5
1028301,691458,2018-01-25,House,"House Third Reading: Given Immediate Effect Roll Call # 23",104,2,0,0,106
1028301,722335,2018-03-13,Senate,"Reported Favorably Without Amendment",4,0,0,0,4
1028301,747332,2018-05-01,Senate,"Senate Third Reading: Given Immediate Effect Roll Call # 241",36,0,0,1,37
1028304,679950,2017-12-05,House,"Reported With Recommendation With Substitute H-2",7,2,0,0,9
1028304,713282,2018-02-28,House,"House Third Reading: Given Immediate Effect Roll Call # 114",68,41,0,0,109
1028304,722624,2018-03-13,Senate,"Reported Favorably Without Amendment",10,0,0,0,10
1028304,727816,2018-03-21,Senate,"Senate Third Reading: Given Immediate Effect Roll Call # 173",29,5,0,3,37
1028526,678647,2017-11-01,Senate,"Reported Favorably Without Amendment",10,0,0,0,10
1028526,678960,2017-11-08,Senate,"Senate Third Reading: Passed Roll Call # 458",37,0,0,1,38
1028526,686380,2018-01-17,House,"Reported With Recommendation With Substitute  H-3",12,3,0,0,15
1028526,691191,2018-01-25,House,"House Third Reading: Given Immediate Effect Roll Call # 29",93,13,0,0,106
1028526,692935,2018-01-31,Senate,"Senate Third Reading: Roll Call # 43",37,0,0,1,38
1028530,678568,2017-10-26,House,"Reported With Recommendation With Substitute  H-1",15,0,0,0,15
1028530,679411,2017-11-09,House,"House Third Reading: Given Immediate Effect Roll Call # 398",107,0,0,0,107
1028530,680695,2017-12-12,Senate,"Reported Favorably Without Amendment",4,0,0,0,4
1028530,680729,2017-12-13,Senate,"Senate Third Reading: Given Immediate Effect Roll Call # 558",37,0,0,1,38
1028539,678651,2017-10-31,House,"Reported With Recommendation With Substitute  H-1",10,0,0,0,10
1028539,679935,2017-12-05,House,"House Third Reading: Given Immediate Effect Roll Call # 423",98,10,0,0,108
1028539,780456,2018-12-11,Senate,"Reported Favorably With Substitute  S-1",5,0,0,0,5
1028539,780726,2018-12-13,Senate,"Senate Third Reading: Given Immediate Effect Roll Call # 802",37,0,0,1,38
1028539,781183,2018-12-19,House,"House Third Reading: Roll Call # 885",107,2,0,0,109
1028552,678668,2017-10-31,House,"Reported With Recommendation With Substitute  H-1",10,0,0,0,10
1028552,679993,2017-12-05,House,"House Third Reading: Given Immediate Effect Roll Call # 424",99,9,0,0,108
1028552,780643,2018-12-11,Senate,"Reported Favorably Without Amendment",5,0,0,0,5
1028552,780731,2018-12-13,Senate,"Senate Third Reading: Given Immediate Effect Roll Call # 803",37,0,0,1,38
1028561,678654,2017-10-31,House,"Reported With Recommendation With Substitute  H-1",10,0,0,0,10
1028561,679933,2017-12-05,House,"House Third Reading: Given Immediate Effect Roll Call # 425",99,9,0,0,108
1028561,780449,2018-12-11,Senate,"Reported Favorably Without Amendment",5,0,0,0,5
1028561,780716,2018-12-13,Senate,"Senate Third Reading: Given Immediate Effect Roll Call # 804",37,0,0,1,38
1028564,686406,2018-01-17,House,"Reported With Recommendation Without Amendment",11,0,0,0,11
1028564,702532,2018-02-14,House,"House Third Reading: Given Immediate Effect Roll Call # 67",108,1,0,0,109
1028564,758329,2018-05-30,Senate,"Reported Favorably Without Amendment",5,0,0,0,5
1028564,761101,2018-06-07,Senate,"Senate Third Reading: Given Immediate Effect Roll Call # 428",36,0,0,1,37
1028568,680018,2017-12-05,House,"Reported With Recommendation Without Amendment",14,0,0,0,14
1028568,681191,2017-12-13,House,"House Third Reading: Given Immediate Effect Roll Call # 490",110,0,0,0,110
1028568,717958,2018-03-06,Senate,"Reported Favorably Without Amendment",4,0,0,0,4
1028568,722945,2018-03-14,Senate,"Senate Third Reading: Given Immediate Effect Roll Call # 146",35,0,0,2,37
1028629,678913,2017-11-07,House,"Reported With Recommendation Without Amendment",9,1,0,0,10
1028629,679589,2017-11-29,House,"House Third Reading: Given Immediate Effect Roll Call # 411",104,3,0,0,107
1028629,686915,2018-01-18,Senate,"Reported Favorably Without Amendment",5,0,0,0,5
1028629,698651,2018-02-06,Senate,"Senate Third Reading: Given Immediate Effect Roll Call # 63",36,0,0,2,38
1028666,681047,2017-12-13,House,"Reported With Recommendation With Substitute  H-2",6,3,0,0,9
1028680,678912,2017-11-07,House,"Reported With Recommendation Without Amendment",9,1,0,0,10
1028680,679587,2017-11-29,House,"House Third Reading: Given Immediate Effect Roll Call # 412",104,3,0,0,107
1028680,687015,2018-01-18,Senate,"Reported Favorably Without Amendment",5,0,0,0,5
1028680,698881,2018-02-06,Senate,"Senate Third Reading: Given Immediate Effect Roll Call # 64",34,2,0,2,38
1028706,680135,2017-12-06,Senate,"Reported Favorably With Substitute  S-1",7,0,0,0,7
1028706,762680,2018-06-12,Senate,"Senate Third Reading: Passed Roll Call # 527",34,2,0,1,37
1028836,681155,2017-12-12,House,"Reported With Recommendation With Substitute  H-1",5,1,0,0,6
1028836,681156,2017-12-13,House,"House Third Reading: Given Immediate Effect Roll Call # 509",61,49,0,0,110
1028838,713417,2018-02-28,House,"Reported With Recommendation With Substitute  H-1",17,0,0,0,17
1028838,726298,2018-02-28,House,"Reported With Recommendation With Substitute H-1",17,0,0,0,17
1028838,727850,2018-03-22,House,"House Third Reading: Given Immediate Effect Roll Call # 195",108,1,0,0,109
1028838,780616,2018-12-12,Senate,"Reported Favorably Without Amendment",9,0,0,0,9
1028838,781513,2018-12-21,Senate,"Senate Third Reading: Given Immediate Effect Roll Call # 1032",38,0,0,0,38
1028838,781612,2018-12-21,House,"House Third Reading: Roll Call # 1035",104,1,0,0,105
1028840,713894,2018-02-28,House,"Reported With Recommendation With Substitute  H-1",17,0,0,0,17
1028840,726415,2018-02-28,House,"Reported With Recommendation With Substitute H-1",17,0,0,0,17
1028840,727884,2018-03-22,House,"House Third Reading: Given Immediate Effect Roll Call # 194",108,1,0,0,109
1028840,780602,2018-12-12,Senate,"Reported Favorably Without Amendment",9,0,0,0,9
1028840,781602,2018-12-21,Senate,"Senate Third Reading: Given Immediate Effect Roll Call # 1031",36,0,0,2,38
1028846,680971,2017-12-12,House,"Reported With Recommendation With Substitute  H-1",7,0,0,0,7
1028846,681184,2017-12-13,House,"House Third Reading: Given Immediate Effect Roll Call # 503",97,13,0,0,110
1028846,762366,2018-06-12,Senate,"Reported Favorably With Substitute S-1",15,1,0,0,16
1028846,762367,2018-06-12,Senate,"Senate Third Reading: Given Immediate Effect Roll Call # 446",36,0,0,1,37
1028846,764355,2018-06-12,House,"House Third Reading: Roll Call # 517",98,11,0,0,109
1028850,680221,2017-12-06,House,"Reported With Recommendation Without Amendment",5,0,0,0,5
1028850,691726,2018-01-25,House,"House Third Reading: Given Immediate Effect Roll Call # 19",106,0,0,0,106
1028850,709052,2018-02-22,Senate,"Reported Favorably Without Amendment",5,0,0,0,5
1028850,718333,2018-03-06,Senate,"Senate Third Reading: Given Immediate Effect Roll Call # 129",36,0,0,1,37
1028852,722587,2018-03-13,Senate,"Reported Favorably With Substitute  S-2",9,1,0,0,10
1028852,723753,2018-03-15,Senate,"Senate Third Reading: Passed Roll Call # 161",33,3,0,1,37
1028852,777206,2018-10-04,House,"Reported With Recommendation Without Amendment",15,4,0,0,19
1028852,779264,2018-11-28,House,"House Third Reading: Given Immediate Effect Roll Call # 647",74,35,0,0,109
1028854,749004,2018-05-02,House,"Reported With Recommendation With Substitute  H-4",12,1,0,0,13
1028854,764487,2018-06-12,House,"House Third Reading: Given Immediate Effect Roll Call # 531",106,3,0,0,109
1028854,775104,2018-09-26,Senate,"Reported Favorably Without Amendment",7,0,0,0,7
1028854,781399,2018-12-19,Senate,"Senate Third Reading: Given Immediate Effect Roll Call # 934",38,0,0,0,38
1028858,680235,2017-12-06,House,"Reported With Recommendation Without Amendment",5,0,0,0,5
1028858,691251,2018-01-25,House,"House Third Reading: Given Immediate Effect Roll Call # 18",106,0,0,0,106
1028858,708755,2018-02-22,Senate,"Reported Favorably Without Amendment",5,0,0,0,5
1028858,718101,2018-03-06,Senate,"Senate Third Reading: Given Immediate Effect Roll Call # 128",36,0,0,1,37
1028861,681121,2017-12-12,House,"Reported With Recommendation With Substitute  H-1",6,1,0,0,7
1028861,681122,2017-12-13,House,"House Third Reading: Given Immediate Effect Roll Call # 504",61,49,0,0,110
1028861,762643,2018-06-12,Senate,"Reported Favorably With Substitute  S-1",15,1,0,0,16
1028861,762644,2018-06-12,Senate,"Senate Third Reading: Given Immediate Effect Roll Call # 447",25,11,0,1,37
1028861,764499,2018-06-12,House,"House Third Reading: Roll Call # 520",62,47,0,0,109
1028863,680973,2017-12-12,House,"Reported With Recommendation Without Amendment",6,1,0,0,7
1028863,681192,2017-12-13,House,"House Third Reading: Given Immediate Effect Roll Call # 505",74,36,0,0,110
1028863,762371,2018-06-12,Senate,"Reported Favorably Without Amendment",15,1,0,0,16
1028863,762372,2018-06-12,Senate,"Senate Third Reading: Given Immediate Effect Roll Call # 448",25,11,0,1,37
1028863,764424,2018-06-12,Senate,"Senate Third Reading: Passed Roll Call # 504",25,11,0,1,37
1028863,764425,2018-06-12,House,"House Third Reading: Roll Call # 549",72,37,0,0,109
1028868,681040,2017-12-12,House,"Reported With Recommendation With Substitute  H-4",6,0,0,0,6
1028868,681041,2017-12-13,House,"House Third Reading: Given Immediate Effect Roll Call # 510",105,5,0,0,110
1028868,762535,2018-06-12,Senate,"Reported Favorably With Substitute  S-1",15,1,0,0,16
1028868,762536,2018-06-12,Senate,"Senate Third Reading: Given Immediate Effect Roll Call # 449",30,6,0,1,37
1028868,764408,2018-06-12,House,"House Third Reading: Roll Call # 542",104,5,0,0,109
1028879,678731,2017-11-02,Senate,"Reported Favorably Without Amendment",4,0,0,0,4
1028880,678464,2017-10-24,House,"Reported With Recommendation Without Amendment",9,2,0,0,11
1028880,679580,2017-11-30,House,"House Third Reading: Given Immediate Effect Roll Call # 418",95,13,0,0,108
1028880,683940,2017-12-28,Senate,"Reported Favorably With Substitute  S-1",3,0,0,0,3
1028880,685661,2018-01-16,Senate,"Senate Third Reading: Given Immediate Effect Roll Call # 5",27,7,0,4,38
1028880,686278,2018-01-17,House,"House Third Reading: Roll Call # 9",95,13,0,0,108
1029071,678716,2017-11-02,House,"Reported With Recommendation Without Amendment",6,0,0,0,6
1029071,679409,2017-11-08,House,"House Third Reading: Given Immediate Effect Roll Call # 385",107,0,0,0,107
1029071,679915,2017-12-05,Senate,"Reported Favorably Without Amendment",5,0,0,0,5
1029071,680741,2017-12-13,Senate,"Senate Third Reading: Given Immediate Effect Roll Call # 527",38,0,0,0,38
1029082,678503,2017-10-25,House,"Reported With Recommendation Without Amendment",12,1,0,0,13
1029082,679398,2017-11-09,House,"House Third Reading: Given Immediate Effect Roll Call # 397",95,12,0,0,107
1029082,679624,2017-11-30,Senate,"Reported Favorably Without Amendment",6,0,0,0,6
1029082,680689,2017-12-12,Senate,"Senate Third Reading: Given Immediate Effect Roll Call # 515",38,0,0,0,38
1029097,678726,2017-11-02,House,"Reported With Recommendation Without Amendment",6,0,0,0,6
1029097,679426,2017-11-08,House,"House Third Reading: Given Immediate Effect Roll Call # 386",107,0,0,0,107
1029097,679942,2017-12-05,Senate,"Reported Favorably Without Amendment",5,0,0,0,5
1029097,680748,2017-12-13,Senate,"Senate Third Reading: Given Immediate Effect Roll Call # 528",38,0,0,0,38
1029104,678508,2017-10-25,House,"Reported With Recommendation Without Amendment",12,1,0,0,13
1029104,679405,2017-11-09,House,"House Third Reading: Given Immediate Effect Roll Call # 396",95,12,0,0,107
1029104,679626,2017-11-30,Senate,"Reported Favorably Without Amendment",6,0,0,0,6
1029104,680674,2017-12-12,Senate,"Senate Third Reading: Given Immediate Effect Roll Call # 514",38,0,0,0,38
1029107,678722,2017-11-02,House,"Reported With Recommendation Without Amendment",6,0,0,0,6
1029107,679427,2017-11-08,House,"House Third Reading: Given Immediate Effect Roll Call # 387",107,0,0,0,107
1029107,679957,2017-12-05,Senate,"Reported Favorably Without Amendment",5,0,0,0,5
1029107,680726,2017-12-13,Senate,"Senate Third Reading: Given Immediate Effect Roll Call # 529",38,0,0,0,38
1029114,678725,2017-11-02,House,"Reported With Recommendation Without Amendment",6,0,0,0,6
1029114,679424,2017-11-08,House,"House Third Reading: Given Immediate Effect Roll Call # 384",107,0,0,0,107
1029114,679949,2017-12-05,Senate,"Reported Favorably Without Amendment",5,0,0,0,5
1029114,680739,2017-12-13,Senate,"Senate Third Reading: Given Immediate Effect Roll Call # 526",38,0,0,0,38
1029118,678697,2017-11-02,House,"Reported With Recommendation With Substitute  H-1",6,0,0,0,6
1029118,679430,2017-11-08,House,"House Third Reading: Given Immediate Effect Roll Call # 381",107,0,0,0,107
1029118,679953,2017-12-05,Senate,"Reported Favorably Without Amendment",5,0,0,0,5
1029118,680743,2017-12-13,Senate,"Senate Third Reading: Given Immediate Effect Roll Call # 523",38,0,0,0,38
1029125,678710,2017-11-02,House,"Reported With Recommendation With Substitute  H-1",6,0,0,0,6
1029125,679423,2017-11-08,House,"House Third Reading: Given Immediate Effect Roll Call # 388",107,0,0,0,107
1029125,679998,2017-12-05,Senate,"Reported Favorably Without Amendment",5,0,0,0,5
1029125,680712,2017-12-13,Senate,"Senate Third Reading: Given Immediate Effect Roll Call # 530",38,0,0,0,38
1029136,678719,2017-11-02,House,"Reported With Recommendation With Substitute  H-1",6,0,0,0,6
1029136,679425,2017-11-08,House,"House Third Reading: Given Immediate Effect Roll Call # 382",107,0,0,0,107
1029136,680005,2017-12-05,Senate,"Reported Favorably Without Amendment",5,0,0,0,5
1029136,680717,2017-12-13,Senate,"Senate Third Reading: Given Immediate Effect Roll Call # 524",38,0,0,0,38
1029140,678728,2017-11-02,House,"Reported With Recommendation Without Amendment",6,0,0,0,6
1029140,679428,2017-11-08,House,"House Third Reading: Given Immediate Effect Roll Call # 383",107,0,0,0,107
1029140,679955,2017-12-05,Senate,"Reported Favorably Without Amendment",5,0,0,0,5
1029140,680753,2017-12-13,Senate,"Senate Third Reading: Given Immediate Effect Roll Call # 525",38,0,0,0,38
1029261,679422,2017-11-08,House,"Reported With Recommendation With Substitute  H-1",16,0,0,0,16
1029261,680225,2017-12-06,House,"House Third Reading: Given Immediate Effect Roll Call # 426",109,1,0,0,110
1029261,692886,2018-02-01,Senate,"Reported Favorably Without Amendment",9,0,0,0,9
1029261,700975,2018-02-13,Senate,"Senate Third Reading: Given Immediate Effect Roll Call # 67",36,0,0,2,38
1029268,741997,2018-04-12,House,"Reported With Recommendation With Substitute  H-3",9,0,0,0,9
1029268,743276,2018-04-12,House,"Reported With Recommendation With Substitute H-3",9,0,0,0,9
1029268,745197,2018-04-25,House,"House Third Reading: Given Immediate Effect Roll Call # 251",109,0,0,0,109
1029268,774832,2018-09-25,Senate,"Reported Favorably With Substitute  S-1",4,0,0,0,4
1029268,775076,2018-09-26,Senate,"Senate Third Reading: Given Immediate Effect Roll Call # 578",36,0,0,1,37
1029268,775280,2018-10-02,House,"House Third Reading: Roll Call # 586",102,4,0,0,106
1029285,707395,2018-02-21,House,"Reported With Recommendation With Substitute  H-4",6,3,0,0,9
1029285,722877,2018-02-21,House,"Reported With Recommendation With Substitute H-4",6,3,0,0,9
1029285,724878,2018-03-15,House,"House Third Reading: Given Immediate Effect Roll Call # 167",59,47,0,0,106
1029630,679917,2017-12-05,Senate,"Reported Favorably Without Amendment",5,0,0,0,5
1029630,685655,2018-01-16,Senate,"Senate Third Reading: Passed Roll Call # 2",34,0,0,4,38
1029630,740403,2018-04-17,House,"Reported With Recommendation Without Amendment",14,0,0,0,14
1029630,764491,2018-06-12,House,"House Third Reading: Given Immediate Effect Roll Call # 478",109,0,0,0,109
1029636,779270,2018-11-29,Senate,"Reported Favorably With Substitute  S-1",7,0,0,0,7
1029636,780178,2018-12-04,Senate,"Senate Third Reading: Passed Roll Call # 668",28,8,0,2,38
1029644,679695,2017-11-30,Senate,"Reported Favorably With Substitute  S-1",9,0,0,0,9
1029644,680086,2017-12-06,Senate,"Senate Third Reading: Passed Roll Call # 482",36,0,0,2,38
1029644,707491,2018-02-15,House,"Reported With Recommendation With Substitute  H-1",16,0,0,0,16
1029644,714803,2018-03-01,House,"House Third Reading: Given Immediate Effect Roll Call # 123",108,1,0,0,109
1029644,718131,2018-03-06,Senate,"Senate Third Reading: Roll Call # 126",36,0,0,1,37
1029688,755196,2018-05-17,House,"Reported With Recommendation Without Amendment",9,0,0,0,9
1029688,757887,2018-05-30,House,"House Third Reading: Given Immediate Effect Roll Call # 440",107,0,0,0,107
1029688,779755,2018-12-04,Senate,"Reported Favorably Without Amendment",5,0,0,0,5
1029688,780350,2018-12-11,Senate,"Senate Third Reading: Given Immediate Effect Roll Call # 750",37,0,0,1,38
1029691,681061,2017-12-13,House,"Reported With Recommendation With Substitute  H-1",9,0,0,0,9
1029691,686358,2018-01-18,House,"House Third Reading: Given Immediate Effect Roll Call # 14",107,0,0,0,107
1029691,709017,2018-02-22,Senate,"Reported Favorably Without Amendment",5,0,0,0,5
1029691,718916,2018-03-07,Senate,"Senate Third Reading: Given Immediate Effect Roll Call # 131",35,0,0,2,37
1029692,678676,2017-11-01,House,"Reported With Recommendation Without Amendment",9,0,0,0,9
1029692,679556,2017-11-30,House,"House Third Reading: Given Immediate Effect Roll Call # 420",84,24,0,0,108
1029692,689023,2018-01-25,Senate,"Reported Favorably With Substitute  S-1",4,1,0,0,5
1029692,692945,2018-02-01,Senate,"Senate Third Reading: Given Immediate Effect Roll Call # 54",31,7,0,0,38
1029692,696936,2018-02-06,House,"House Third Reading: Roll Call # 49",85,23,0,0,108
1029700,702582,2018-02-14,House,"Reported With Recommendation Without Amendment",16,0,0,0,16
1029700,712099,2018-02-22,House,"House Third Reading: Given Immediate Effect Roll Call # 96",108,0,0,0,108
1029700,720724,2018-03-08,Senate,"Reported Favorably Without Amendment",9,0,0,0,9
1029700,736452,2018-04-10,Senate,"Senate Third Reading: Given Immediate Effect Roll Call # 186",33,0,0,4,37
1029775,687663,2018-01-23,Senate,"Reported Favorably With Substitute  S-1",4,0,0,0,4
1029775,713926,2018-02-28,Senate,"Senate Third Reading: Passed Roll Call # 114",37,0,0,1,38
1029793,691277,2018-01-30,House,"Reported With Recommendation With Substitute  H-2",12,0,0,0,12
1029838,780610,2018-12-12,House,"Reported With Recommendation Without Amendment",7,0,0,0,7
1029838,780611,2018-12-12,House,"House Third Reading: Given Immediate Effect Roll Call # 823",104,5,0,0,109
1029846,712264,2018-02-22,House,"Reported With Recommendation Without Amendment",6,0,0,0,6
1029846,719647,2018-03-07,House,"House Third Reading: Given Immediate Effect Roll Call # 142",108,0,0,0,108
1029846,740919,2018-04-18,Senate,"Reported Favorably Without Amendment",3,0,0,0,3
1029846,745389,2018-04-25,Senate,"Senate Third Reading: Given Immediate Effect Roll Call # 231",37,0,0,0,37
1029848,780599,2018-12-12,House,"Reported With Recommendation Without Amendment",7,1,0,0,8
1029848,780600,2018-12-12,House,"House Third Reading: Given Immediate Effect Roll Call # 825",98,11,0,0,109
1029855,780607,2018-12-12,House,"Reported With Recommendation Without Amendment",8,0,0,0,8
1029855,780608,2018-12-12,House,"House Third Reading: Given Immediate Effect Roll Call # 824",104,5,0,0,109
1029874,780593,2018-12-12,House,"Reported With Recommendation Without Amendment",8,0,0,0,8
1029877,780614,2018-12-12,House,"Reported With Recommendation Without Amendment",7,0,0,0,7
1029922,703951,2018-02-15,Senate,"Reported Favorably Without Amendment",7,0,0,0,7
1029922,707485,2018-02-21,Senate,"Senate Third Reading: Passed Roll Call # 106",36,0,0,2,38
1029922,749272,2018-05-02,House,"Reported With Recommendation With Substitute  H-1",11,1,0,0,12
1029922,751873,2018-05-02,House,"Reported With Recommendation With Substitute H-1",11,1,0,0,12
1029922,754981,2018-05-15,House,"House Third Reading: Given Immediate Effect Roll Call # 287",104,4,0,0,108
1029922,754982,2018-05-16,Senate,"Senate Third Reading: Roll Call # 303",37,0,0,0,37
1029929,679963,2017-12-05,Senate,"Reported Favorably Without Amendment",5,0,0,0,5
1029929,680691,2017-12-12,Senate,"Senate Third Reading: Passed Roll Call # 516",38,0,0,0,38
1029929,697389,2018-02-06,House,"Reported With Recommendation Without Amendment",13,0,0,0,13
1029929,707573,2018-02-15,House,"House Third Reading: Given Immediate Effect Roll Call # 79",109,0,0,0,109
1029979,679970,2017-12-05,House,"Reported With Recommendation Without Amendment",11,0,0,0,11
1029979,681198,2017-12-13,House,"House Third Reading: Given Immediate Effect Roll Call # 488",110,0,0,0,110
1029979,692050,2018-01-31,Senate,"Reported Favorably Without Amendment",3,0,0,0,3
1029979,706735,2018-02-20,Senate,"Senate Third Reading: Given Immediate Effect Roll Call # 94",34,0,0,4,38
1029981,679565,2017-11-30,House,"Reported With Recommendation With Substitute H-2",15,0,0,0,15
1029981,680346,2017-12-06,House,"House Third Reading: Given Immediate Effect Roll Call # 428",96,14,0,0,110
1029981,761236,2018-06-07,Senate,"Reported Favorably With Substitute  S-1",8,1,0,0,9
1029981,780225,2018-12-05,Senate,"Senate Third Reading: Given Immediate Effect Roll Call # 686",33,4,0,1,38
1029981,780226,2018-12-06,House,"House Third Reading: Roll Call # 717",102,7,0,0,109
1029983,679568,2017-11-30,House,"Reported With Recommendation Without Amendment",15,0,0,0,15
1029983,680187,2017-12-06,House,"House Third Reading: Given Immediate Effect Roll Call # 430",97,13,0,0,110
1029983,761163,2018-06-07,Senate,"Reported Favorably With Substitute  S-1",9,0,0,0,9
1029983,780212,2018-12-05,Senate,"Senate Third Reading: Given Immediate Effect Roll Call # 688",33,4,0,1,38
1029983,780213,2018-12-06,House,"House Third Reading: Roll Call # 719",102,7,0,0,109
1029985,697111,2018-02-07,House,"Reported With Recommendation Without Amendment",10,0,0,0,10
1029985,707382,2018-02-15,House,"House Third Reading: Given Immediate Effect Roll Call # 80",88,21,0,0,109
1029985,720265,2018-03-08,Senate,"Reported Favorably Without Amendment",5,0,0,0,5
1029985,725890,2018-03-20,Senate,"Senate Third Reading: Given Immediate Effect Roll Call # 168",36,0,1,0,37
1029986,679557,2017-11-30,House,"Reported With Recommendation Without Amendment",15,0,0,0,15
1029986,680368,2017-12-06,House,"House Third Reading: Given Immediate Effect Roll Call # 429",97,13,0,0,110
1029986,761093,2018-06-07,Senate,"Reported Favorably With Substitute  S-1",8,1,0,0,9
1029986,780206,2018-12-05,Senate,"Senate Third Reading: Given Immediate Effect Roll Call # 687",33,4,0,1,38
1029986,780207,2018-12-06,House,"House Third Reading: Roll Call # 718",102,7,0,0,109
1030275,755354,2018-05-16,House,"Reported With Recommendation With Substitute  H-1",11,1,0,0,12
1030295,679967,2017-12-05,House,"Reported With Recommendation With Substitute H-1",10,0,0,0,10
1030295,681094,2017-12-13,House,"House Third Reading: Passed Roll Call # 489",104,6,0,0,110
1030295,720676,2018-03-08,Senate,"Reported Favorably With Substitute  S-2",5,0,0,0,5
1030404,683941,2017-12-28,Senate,"Reported Favorably With Substitute  S-3",5,0,0,0,5
1030404,762396,2018-06-12,Senate,"Senate Third Reading: Passed Roll Call # 530",36,0,0,1,37
1030431,679637,2017-11-30,Senate,"Reported Favorably Without Amendment",5,0,0,0,5
1030431,680190,2017-12-06,Senate,"Senate Third Reading: Passed Roll Call # 481",35,1,0,2,38
1030431,680996,2017-12-13,House,"Reported With Recommendation Without Amendment",24,4,0,0,28
1030431,680997,2017-12-13,House,"House Third Reading: Given Immediate Effect Roll Call # 500",78,32,0,0,110
1030460,680483,2017-12-07,Senate,"Reported Favorably Without Amendment",9,0,0,0,9
1030460,753969,2018-05-16,Senate,"Senate Third Reading: Passed Roll Call # 297",36,1,0,0,37
1030498,680028,2017-12-05,House,"Reported With Recommendation Without Amendment",9,1,0,0,10
1030498,719326,2018-03-07,House,"House Third Reading: Given Immediate Effect Roll Call # 132",99,9,0,0,108
1030498,740887,2018-04-18,Senate,"Reported Favorably Without Amendment",4,1,0,0,5
1030498,745600,2018-04-26,Senate,"Senate Third Reading: Given Immediate Effect Roll Call # 237",25,10,0,2,37
1030498,749102,2018-05-01,House,"House Third Reading: Roll Call # 256",99,10,0,0,109
1030505,685612,2018-01-16,House,"Reported With Recommendation With Substitute  H-1",9,2,0,0,11
1030505,707433,2018-02-15,House,"House Third Reading: Given Immediate Effect Roll Call # 78",70,39,0,0,109
1030505,750136,2018-05-03,Senate,"Reported Favorably Without Amendment",5,0,0,0,5
1030505,754172,2018-05-16,Senate,"Senate Third Reading: Given Immediate Effect Roll Call # 300",37,0,0,0,37
1030505,755438,2018-05-22,House,"House Third Reading: Roll Call # 347",70,38,0,0,108
1030511,688669,2018-01-24,House,"Reported With Recommendation With Substitute  H-4",5,3,0,0,8
1030511,723627,2018-01-24,House,"Reported With Recommendation With Substitute H-4",5,3,0,0,8
1030511,727064,2018-03-21,House,"House Third Reading: Given Immediate Effect Roll Call # 178",73,35,0,0,108
1030511,727065,2018-03-21,House,"House Third Reading: Passed Roll Call # 181",73,35,0,0,108
1030511,756854,2018-05-24,Senate,"Reported Favorably Without Amendment",7,0,0,0,7
1030511,781395,2018-12-20,Senate,"Senate Third Reading: Given Immediate Effect Roll Call # 968",38,0,0,0,38
1030511,781644,2018-12-21,House,"House Third Reading: Roll Call # 1013",71,36,0,0,107
1030518,681030,2017-12-13,House,"Reported With Recommendation With Substitute  H-1",12,0,0,0,12
1030518,685752,2018-01-16,House,"House Third Reading: Given Immediate Effect Roll Call # 6",102,5,0,0,107
1030518,713543,2018-02-28,Senate,"Reported Favorably Without Amendment",5,0,0,0,5
1030518,723325,2018-03-14,Senate,"Senate Third Reading: Given Immediate Effect Roll Call # 145",34,1,0,2,37
1030535,688686,2018-01-24,House,"Reported With Recommendation With Substitute  H-3",5,3,0,0,8
1030535,723685,2018-01-24,House,"Reported With Recommendation With Substitute H-3",5,3,0,0,8
1030535,727536,2018-03-21,House,"House Third Reading: Given Immediate Effect Roll Call # 179",71,37,0,0,108
1030535,756869,2018-05-24,Senate,"Reported Favorably Without Amendment",7,0,0,0,7
1030535,781333,2018-12-20,Senate,"Senate Third Reading: Given Immediate Effect Roll Call # 969",38,0,0,0,38
1030535,781613,2018-12-21,House,"House Third Reading: Roll Call # 1014",72,35,0,0,107
1030632,680398,2017-12-07,Senate,"Reported Favorably With Substitute  S-1",4,1,0,0,5
1030632,689035,2018-01-25,Senate,"Senate Third Reading: Passed Roll Call # 40",26,11,0,1,38
1030632,738061,2018-04-11,House,"Reported With Recommendation For Referral To Committee On Michigan Competitiveness",7,0,0,0,7
1030632,745000,2018-04-25,House,"Reported With Recommendation With Substitute  H-2",6,3,0,0,9
1030632,755449,2018-05-22,House,"House Third Reading: Given Immediate Effect Roll Call # 361",58,50,0,0,108
1030632,762485,2018-06-12,Senate,"Senate Third Reading: Roll Call # 533",25,11,0,1,37
1030634,680678,2017-12-12,Senate,"Reported Favorably Without Amendment",4,0,0,0,4
1030634,692007,2018-01-31,Senate,"Senate Third Reading: Passed Roll Call # 46",32,5,0,1,38
1030634,779632,2018-12-04,House,"Reported With Recommendation Without Amendment",4,1,0,0,5
1030634,779992,2018-12-05,House,"House Third Reading: Given Immediate Effect Roll Call # 700",79,29,0,0,108
1030636,745314,2018-04-26,Senate,"Reported Favorably With Substitute S-1",5,0,0,0,5
1030636,753438,2018-05-15,Senate,"Senate Third Reading: Passed Roll Call # 286",36,0,0,1,37
1030639,680395,2017-12-07,Senate,"Reported Favorably With Substitute  S-1",4,1,0,0,5
1030639,689099,2018-01-25,Senate,"Senate Third Reading: Passed Roll Call # 33",26,11,0,1,38
1030639,737587,2018-04-11,House,"Reported With Recommendation For Referral To Committee On Michigan Competitiveness",7,0,0,0,7
1030639,745141,2018-04-25,House,"Reported With Recommendation With Substitute  H-1",6,3,0,0,9
1030639,755487,2018-05-22,House,"House Third Reading: Given Immediate Effect Roll Call # 360",57,51,0,0,108
1030639,762517,2018-06-12,Senate,"Senate Third Reading: Roll Call # 532",25,11,0,1,37
1030646,745553,2018-04-26,Senate,"Reported Favorably With Substitute  S-1",5,0,0,0,5
1030646,753659,2018-05-15,Senate,"Senate Third Reading: Passed Roll Call # 288",36,0,0,1,37
1030648,745510,2018-04-26,Senate,"Reported Favorably With Substitute  S-1",5,0,0,0,5
1030648,753678,2018-05-15,Senate,"Senate Third Reading: Passed Roll Call # 289",36,0,0,1,37
1030653,680390,2017-12-07,Senate,"Reported Favorably With Substitute  S-1",4,1,0,0,5
1030653,688999,2018-01-25,Senate,"Senate Third Reading: Passed Roll Call # 41",26,11,0,1,38
1030653,737602,2018-04-11,House,"Reported With Recommendation For Referral To Committee On Michigan Competitiveness",7,0,0,0,7
1030653,745183,2018-04-25,House,"Reported With Recommendation With Substitute  H-1",6,3,0,0,9
1030653,755485,2018-05-22,House,"House Third Reading: Given Immediate Effect Roll Call # 362",59,49,0,0,108
1030653,762315,2018-06-12,Senate,"Senate Third Reading: Roll Call # 534",25,11,0,1,37
1030660,745453,2018-04-26,Senate,"Reported Favorably With Substitute  S-2",5,0,0,0,5
1030660,753448,2018-05-15,Senate,"Senate Third Reading: Passed Roll Call # 287",36,0,0,1,37
1030668,679973,2017-12-05,House,"Reported With Recommendation With Substitute H-1",9,1,0,0,10
1030668,719486,2018-03-07,House,"House Third Reading: Given Immediate Effect Roll Call # 133",98,10,0,0,108
1030668,755193,2018-05-17,Senate,"Reported Favorably Without Amendment",3,1,0,0,4
1030672,679979,2017-12-05,House,"Reported With Recommendation Without Amendment",8,1,0,0,9
1030672,713215,2018-02-28,House,"House Third Reading: Given Immediate Effect Roll Call # 110",107,2,0,0,109
1030686,679969,2017-12-05,House,"Reported With Recommendation Without Amendment",8,2,0,0,10
1030686,714010,2018-02-28,House,"House Third Reading: Given Immediate Effect Roll Call # 111",108,1,0,0,109
1030695,692041,2018-01-31,House,"Reported With Recommendation With Substitute  H-1",11,0,0,0,11
1030695,702180,2018-02-13,House,"House Third Reading: Given Immediate Effect Roll Call # 59",106,2,0,0,108
1030695,737486,2018-04-11,Senate,"Reported Favorably Without Amendment",4,0,0,0,4
1030695,745350,2018-04-24,Senate,"Senate Third Reading: Given Immediate Effect Roll Call # 226",36,0,0,1,37
1030704,679972,2017-12-05,House,"Reported With Recommendation With Substitute H-1",10,1,0,0,11
1030704,713685,2018-02-28,House,"House Third Reading: Given Immediate Effect Roll Call # 109",108,1,0,0,109
1030714,680369,2017-12-06,House,"Reported With Recommendation With Substitute  H-2",13,1,0,0,14
1030714,681003,2017-12-13,House,"House Third Reading: Given Immediate Effect Roll Call # 492",102,8,0,0,110
1030714,714782,2018-03-01,Senate,"Reported Favorably Without Amendment",9,0,0,0,9
1030714,720506,2018-03-08,Senate,"Senate Third Reading: Given Immediate Effect Roll Call # 143",36,0,0,1,37
1030716,755391,2018-05-22,House,"Reported With Recommendation With Substitute  H-3",9,1,0,0,10
1030716,757918,2018-05-30,House,"House Third Reading: Given Immediate Effect Roll Call # 430",103,4,0,0,107
1030716,774836,2018-09-25,Senate,"Reported Favorably Without Amendment",4,0,0,0,4
1030716,780342,2018-12-11,Senate,"Senate Third Reading: Given Immediate Effect Roll Call # 745",37,0,0,1,38
1032981,680474,2017-12-07,Senate,"Reported Favorably With Substitute  S-1",9,0,0,0,9
1032981,692453,2018-01-31,Senate,"Senate Third Reading: Passed Roll Call # 48",37,0,0,1,38
1032981,707399,2018-02-21,House,"Reported With Recommendation Without Amendment",16,0,0,0,16
1032981,725048,2018-03-15,House,"House Third Reading: Given Immediate Effect Roll Call # 168",106,0,0,0,106
1033006,747400,2018-05-01,Senate,"Reported Favorably Without Amendment",5,0,0,0,5
1033006,757424,2018-05-29,Senate,"Senate Third Reading: Passed Roll Call # 362",35,1,0,1,37
1033013,760641,2018-06-04,Senate,"Reported Favorably With Substitute  S-2",7,0,0,0,7
1033013,760642,2018-06-06,Senate,"Senate Third Reading: Passed Roll Call # 403",37,0,0,0,37
1033013,774943,2018-09-26,House,"Reported With Recommendation With Substitute H-2",8,0,0,0,8
1033013,775250,2018-09-26,House,"Reported With Recommendation With Substitute  H-2",8,0,0,0,8
1033013,778944,2018-11-27,House,"House Third Reading: Given Immediate Effect Roll Call # 637",107,2,0,0,109
1033013,779311,2018-11-28,Senate,"Senate Third Reading: Roll Call # 606",38,0,0,0,38
1033025,780501,2018-12-12,Senate,"Reported Favorably Without Amendment",4,0,0,0,4
1033025,780734,2018-12-13,Senate,"Senate Third Reading: Passed Roll Call # 832",36,1,0,1,38
1033043,679561,2017-11-29,House,"Reported With Recommendation Without Amendment",28,0,0,0,28
1033043,679562,2017-11-30,House,"House Third Reading: Roll Call # 414",108,0,0,0,108
1033043,680394,2017-12-07,Senate,"Reported Favorably Without Amendment",17,0,0,0,17
1033047,685819,2018-01-16,House,"Reported With Recommendation With Substitute  H-1",11,0,0,0,11
1033047,691138,2018-01-25,House,"House Third Reading: Given Immediate Effect Roll Call # 26",103,3,0,0,106
1033047,720574,2018-03-08,Senate,"Reported Favorably With Substitute  S-1",5,0,0,0,5
1033047,727820,2018-03-21,Senate,"Senate Third Reading: Given Immediate Effect Roll Call # 171",34,0,0,3,37
1033047,727821,2018-03-22,House,"House Third Reading: Roll Call # 192",106,3,0,0,109
1033060,685827,2018-01-16,House,"Reported With Recommendation With Substitute H-1",11,0,0,0,11
1033060,691293,2018-01-25,House,"House Third Reading: Given Immediate Effect Roll Call # 27",103,3,0,0,106
1033060,720490,2018-03-08,Senate,"Reported Favorably Without Amendment",5,0,0,0,5
1033060,728025,2018-03-21,Senate,"Senate Third Reading: Given Immediate Effect Roll Call # 172",34,0,0,3,37
1033066,697383,2018-02-07,House,"Reported With Recommendation With Substitute  H-2",12,0,0,0,12
1033066,707506,2018-02-15,House,"House Third Reading: Given Immediate Effect Roll Call # 82",106,3,0,0,109
1033066,728028,2018-03-22,Senate,"Reported Favorably Without Amendment",7,0,0,0,7
1033066,740199,2018-04-17,Senate,"Senate Third Reading: Given Immediate Effect Roll Call # 205",37,0,0,0,37
1033091,711851,2018-02-27,House,"Reported With Recommendation Without Amendment",14,0,0,0,14
1033091,719284,2018-03-07,House,"House Third Reading: Given Immediate Effect Roll Call # 138",107,1,0,0,108
1033098,707914,2018-02-21,House,"Reported With Recommendation With Substitute  H-2",16,0,0,0,16
1033098,718977,2018-03-06,House,"House Third Reading: Given Immediate Effect Roll Call # 131",105,3,0,0,108
1033098,747461,2018-05-01,Senate,"Reported Favorably Without Amendment",5,0,0,0,5
1033098,750082,2018-05-03,Senate,"Senate Third Reading: Given Immediate Effect Roll Call # 246",36,0,0,1,37
1033116,711941,2018-02-22,House,"Reported With Recommendation With Substitute  H-2",16,0,0,0,16
1033126,697574,2018-02-07,House,"Reported With Recommendation Without Amendment",8,0,0,0,8
1033126,712063,2018-02-27,House,"House Third Reading: Given Immediate Effect Roll Call # 103",108,0,0,0,108
1033126,723087,2018-03-14,Senate,"Reported Favorably Without Amendment",5,0,0,0,5
1033126,727864,2018-03-22,Senate,"Senate Third Reading: Given Immediate Effect Roll Call # 179",34,0,0,3,37
1033138,707594,2018-02-21,House,"Reported With Recommendation With Substitute  H-1",16,0,0,0,16
1033138,719584,2018-03-07,House,"House Third Reading: Passed Roll Call # 141",108,0,0,0,108
1033147,718999,2018-03-06,House,"Reported With Recommendation With Substitute  H-1",12,0,0,0,12
1033147,722466,2018-03-06,House,"Reported With Recommendation With Substitute H-1",12,0,0,0,12
1033147,725172,2018-03-15,House,"House Third Reading: Given Immediate Effect Roll Call # 169",106,0,0,0,106
1033147,755748,2018-05-23,Senate,"Reported Favorably Without Amendment",5,0,0,0,5
1033147,762415,2018-06-12,Senate,"Senate Third Reading: Given Immediate Effect Roll Call # 492",36,0,0,1,37
1033232,683937,2017-12-28,Senate,"Reported Favorably With Substitute  S-1",3,0,0,0,3
1033248,702944,2018-02-14,Senate,"Reported Favorably Without Amendment",5,0,0,0,5
1033248,707441,2018-02-21,Senate,"Senate Third Reading: Passed Roll Call # 105",36,0,0,2,38
1033248,780097,2018-12-06,House,"Reported With Recommendation With Substitute  H-2",11,0,0,0,11
1033248,781565,2018-12-21,House,"House Third Reading: Given Immediate Effect Roll Call # 1036",68,36,0,0,104
1033248,781566,2018-12-21,Senate,"Senate Third Reading: Roll Call # 1063",37,0,0,1,38
1033264,680673,2017-12-12,Senate,"Reported Favorably Without Amendment",4,0,0,0,4
1033264,685479,2018-01-16,Senate,"Senate Third Reading: Passed Roll Call # 3",34,0,0,4,38
1033264,740296,2018-04-17,House,"Reported With Recommendation Without Amendment",14,0,0,0,14
1033264,764660,2018-06-12,House,"House Third Reading: Given Immediate Effect Roll Call # 479",109,0,0,0,109
1033280,679638,2017-11-30,Senate,"Reported Favorably Without Amendment",9,0,0,0,9
1033280,680095,2017-12-06,Senate,"Senate Third Reading: Passed Roll Call # 485",36,0,0,2,38
1033280,681044,2017-12-12,House,"Reported With Recommendation With Substitute  H-1",13,0,0,0,13
1033280,681045,2017-12-13,House,"House Third Reading: Given Immediate Effect Roll Call # 494",108,2,0,0,110
1033280,681046,2017-12-13,Senate,"Senate Third Reading: Roll Call # 568",37,0,0,1,38
1033296,707793,2018-02-21,House,"Reported With Recommendation Without Amendment",11,1,0,0,12
1033296,727848,2018-03-22,House,"House Third Reading: Given Immediate Effect Roll Call # 199",66,43,0,0,109
1033296,757247,2018-05-29,Senate,"Reported Favorably Without Amendment",7,0,0,0,7
1033296,760685,2018-06-06,Senate,"Senate Third Reading: Given Immediate Effect Roll Call # 398",37,0,0,0,37
1033313,680314,2017-12-06,House,"Reported With Recommendation With Substitute  H-1",29,0,0,0,29
1033313,686381,2018-01-17,House,"House Third Reading: Given Immediate Effect Roll Call # 11",108,0,0,0,108
1033313,689008,2018-01-25,Senate,"Reported Favorably With Substitute  S-1",16,0,0,0,16
1033313,692137,2018-01-31,Senate,"Senate Third Reading: Given Immediate Effect Roll Call # 52",37,0,0,1,38
1033313,692138,2018-01-31,House,"House Third Reading: Roll Call # 43",109,0,0,0,109
1033420,680107,2017-12-06,Senate,"Reported Favorably Without Amendment",4,1,0,0,5
1033421,680078,2017-12-06,Senate,"Reported Favorably Without Amendment",4,1,0,0,5
1033423,680126,2017-12-06,Senate,"Reported Favorably Without Amendment",4,1,0,0,5
1033423,680473,2017-12-07,Senate,"Senate Third Reading: Passed Roll Call # 498",36,0,0,2,38
1033424,680104,2017-12-06,Senate,"Reported Favorably Without Amendment",4,1,0,0,5
1033424,680484,2017-12-07,Senate,"Senate Third Reading: Passed Roll Call # 499",36,0,0,2,38
1033424,681181,2017-12-12,House,"House Third Reading: Given Immediate Effect Roll Call # 464",106,3,0,0,109
1033426,680080,2017-12-06,Senate,"Reported Favorably Without Amendment",4,1,0,0,5
1033426,680412,2017-12-07,Senate,"Senate Third Reading: Passed Roll Call # 495",36,0,0,2,38
1033426,681091,2017-12-12,House,"House Third Reading: Given Immediate Effect Roll Call # 467",106,3,0,0,109
1033427,680079,2017-12-06,Senate,"Reported Favorably Without Amendment",4,1,0,0,5
1033429,680099,2017-12-06,Senate,"Reported Favorably Without Amendment",4,1,0,0,5
1033429,680386,2017-12-07,Senate,"Senate Third Reading: Passed Roll Call # 492",36,0,0,2,38
1033432,688012,2018-01-23,Senate,"Reported Favorably With Substitute  S-2",5,3,0,0,8
1033432,761085,2018-06-07,Senate,"Senate Third Reading: Passed Roll Call # 413",23,13,0,1,37
1033432,764348,2018-06-12,House,"Reported With Recommendation Without Amendment",7,2,0,0,9
1033432,764349,2018-06-12,House,"House Third Reading: Given Immediate Effect Roll Call # 482",86,23,0,0,109
1033433,760604,2018-06-06,Senate,"Reported Favorably With Substitute  S-3",8,1,0,0,9
1033433,762336,2018-06-12,Senate,"Senate Third Reading: Passed Roll Call # 520",33,3,0,1,37
1033433,780003,2018-12-05,House,"Reported With Recommendation Without Amendment",17,0,0,0,17
1033437,680083,2017-12-06,Senate,"Reported Favorably Without Amendment",4,1,0,0,5
1033437,680388,2017-12-07,Senate,"Senate Third Reading: Passed Roll Call # 494",36,0,0,2,38
1033437,680987,2017-12-12,House,"House Third Reading: Given Immediate Effect Roll Call # 465",106,3,0,0,109
1033438,680070,2017-12-06,Senate,"Reported Favorably Without Amendment",4,1,0,0,5
1033438,680389,2017-12-07,Senate,"Senate Third Reading: Passed Roll Call # 490",36,0,0,2,38
1033438,680977,2017-12-12,House,"House Third Reading: Given Immediate Effect Roll Call # 462",104,5,0,0,109
1033438,680978,2017-12-12,Senate,"Senate Third Reading: Roll Call # 518",38,0,0,0,38
1033440,680125,2017-12-06,Senate,"Reported Favorably Without Amendment",4,1,0,0,5
1033440,680392,2017-12-07,Senate,"Senate Third Reading: Passed Roll Call # 497",36,0,0,2,38
1033440,681118,2017-12-12,House,"House Third Reading: Given Immediate Effect Roll Call # 466",105,4,0,0,109
1033441,680113,2017-12-06,Senate,"Reported Favorably Without Amendment",4,1,0,0,5
1033441,680415,2017-12-07,Senate,"Senate Third Reading: Passed Roll Call # 493",36,0,0,2,38
1033447,680119,2017-12-06,Senate,"Reported Favorably Without Amendment",4,1,0,0,5
1033447,680469,2017-12-07,Senate,"Senate Third Reading: Passed Roll Call # 501",36,0,0,2,38
1033450,680103,2017-12-06,Senate,"Reported Favorably Without Amendment",4,1,0,0,5
1033450,680485,2017-12-07,Senate,"Senate Third Reading: Passed Roll Call # 502",36,0,0,2,38
1033450,681108,2017-12-12,House,"House Third Reading: Given Immediate Effect Roll Call # 468",107,2,0,0,109
1033452,680072,2017-12-06,Senate,"Reported Favorably Without Amendment",4,1,0,0,5
1033452,680397,2017-12-07,Senate,"Senate Third Reading: Passed Roll Call # 496",36,0,0,2,38
1033453,680124,2017-12-06,Senate,"Reported Favorably With Substitute  S-1",4,1,0,0,5
1033453,680387,2017-12-07,Senate,"Senate Third Reading: Passed Roll Call # 491",36,0,0,2,38
1033453,680974,2017-12-12,House,"House Third Reading: Given Immediate Effect Roll Call # 463",107,2,0,0,109
1033461,680123,2017-12-06,Senate,"Reported Favorably Without Amendment",4,1,0,0,5
1033461,680455,2017-12-07,Senate,"Senate Third Reading: Passed Roll Call # 500",36,0,0,2,38
1033462,687998,2018-01-23,Senate,"Reported Favorably With Substitute  S-1",5,3,0,0,8
1033462,761103,2018-06-07,Senate,"Senate Third Reading: Passed Roll Call # 412",23,13,0,1,37
1033462,764439,2018-06-12,House,"Reported With Recommendation Without Amendment",7,2,0,0,9
1033462,764440,2018-06-12,House,"House Third Reading: Given Immediate Effect Roll Call # 481",89,20,0,0,109
1033470,679975,2017-12-05,House,"Reported With Recommendation Without Amendment",5,4,0,0,9
1033470,680370,2017-12-07,House,"House Third Reading: Given Immediate Effect Roll Call # 448",107,3,0,0,110
1033470,680683,2017-12-12,Senate,"Senate Third Reading: Given Immediate Effect Roll Call # 508",38,0,0,0,38
1033470,681153,2017-12-12,House,"House Third Reading: Senate Amendment(s) Concurred In Roll Call # 474",106,3,0,0,109
1033471,679977,2017-12-05,House,"Reported With Recommendation With Amendment(s)",5,4,0,0,9
1033471,680367,2017-12-07,House,"House Third Reading: Given Immediate Effect Roll Call # 445",105,5,0,0,110
1033476,679968,2017-12-05,House,"Reported With Recommendation Without Amendment",5,4,0,0,9
1033476,680226,2017-12-07,House,"House Third Reading: Given Immediate Effect Roll Call # 455",107,3,0,0,110
1033476,680653,2017-12-12,Senate,"Senate Third Reading: Given Immediate Effect Roll Call # 511",38,0,0,0,38
1033476,681201,2017-12-12,House,"House Third Reading: Senate Amendment(s) Concurred In Roll Call # 477",106,3,0,0,109
1033479,679985,2017-12-05,House,"Reported With Recommendation Without Amendment",5,4,0,0,9
1033479,680308,2017-12-07,House,"House Third Reading: Given Immediate Effect Roll Call # 451",105,5,0,0,110
1033483,679958,2017-12-05,House,"Reported With Recommendation Without Amendment",5,4,0,0,9
1033483,680293,2017-12-07,House,"House Third Reading: Given Immediate Effect Roll Call # 454",107,3,0,0,110
1033483,680628,2017-12-12,Senate,"Senate Third Reading: Given Immediate Effect Roll Call # 512",38,0,0,0,38
1033483,681064,2017-12-12,House,"House Third Reading: Senate Amendment(s) Concurred In Roll Call # 473",106,3,0,0,109
1033490,679974,2017-12-05,House,"Reported With Recommendation Without Amendment",5,4,0,0,9
1033493,680023,2017-12-05,House,"Reported With Recommendation Without Amendment",5,4,0,0,9
1033493,680328,2017-12-07,House,"House Third Reading: Given Immediate Effect Roll Call # 446",107,3,0,0,110
1033493,680660,2017-12-12,Senate,"Senate Third Reading: Given Immediate Effect Roll Call # 507",38,0,0,0,38
1033493,681093,2017-12-12,House,"House Third Reading: Senate Amendment(s) Concurred In Roll Call # 472",106,3,0,0,109
1033497,679983,2017-12-05,House,"Reported With Recommendation Without Amendment",5,4,0,0,9
1033497,680371,2017-12-07,House,"House Third Reading: Given Immediate Effect Roll Call # 449",107,3,0,0,110
1033500,679946,2017-12-05,House,"Reported With Recommendation Without Amendment",5,4,0,0,9
1033500,680373,2017-12-07,House,"House Third Reading: Given Immediate Effect Roll Call # 456",107,3,0,0,110
1033503,679971,2017-12-05,House,"Reported With Recommendation With Amendment(s)",5,4,0,0,9
1033510,680032,2017-12-05,House,"Reported With Recommendation Without Amendment",5,4,0,0,9
1033510,680324,2017-12-07,House,"House Third Reading: Given Immediate Effect Roll Call # 453",107,3,0,0,110
1033516,680001,2017-12-05,House,"Reported With Recommendation Without Amendment",5,4,0,0,9
1033516,680361,2017-12-07,House,"House Third Reading: Given Immediate Effect Roll Call # 450",107,3,0,0,110
1033516,680633,2017-12-12,Senate,"Senate Third Reading: Given Immediate Effect Roll Call # 509",38,0,0,0,38
1033516,681161,2017-12-12,House,"House Third Reading: Senate Amendment(s) Concurred In Roll Call # 475",106,3,0,0,109
1033521,679988,2017-12-05,House,"Reported With Recommendation Without Amendment",5,4,0,0,9
1033521,680340,2017-12-07,House,"House Third Reading: Given Immediate Effect Roll Call # 447",107,3,0,0,110
1033524,679964,2017-12-05,House,"Reported With Recommendation Without Amendment",5,4,0,0,9
1033524,680366,2017-12-07,House,"House Third Reading: Given Immediate Effect Roll Call # 457",107,3,0,0,110
1033528,679992,2017-12-05,House,"Reported With Recommendation Without Amendment",5,4,0,0,9
1033531,679960,2017-12-05,House,"Reported With Recommendation With Substitute  H-1",6,0,0,0,6
1033537,680029,2017-12-05,House,"Reported With Recommendation Without Amendment",5,4,0,0,9
1033537,680374,2017-12-07,House,"House Third Reading: Given Immediate Effect Roll Call # 452",107,3,0,0,110
1033537,680680,2017-12-12,Senate,"Senate Third Reading: Given Immediate Effect Roll Call # 510",38,0,0,0,38
1033537,680994,2017-12-12,House,"House Third Reading: Senate Amendment(s) Concurred In Roll Call # 476",106,3,0,0,109
1033540,679981,2017-12-05,House,"Reported With Recommendation With Substitute  H-1",6,0,0,0,6
1033541,679940,2017-12-05,House,"Reported With Recommendation With Substitute  H-1",6,0,0,0,6
1034453,680745,2017-12-13,Senate,"Reported Favorably With Substitute S-3",5,0,0,0,5
1034453,680746,2017-12-13,Senate,"Senate Third Reading: Passed Roll Call # 559",26,11,0,1,38
1034453,685408,2018-01-11,House,"Reported With Recommendation Without Amendment",10,5,0,0,15
1034453,685409,2018-01-11,House,"House Third Reading: Given Immediate Effect Roll Call # 5",61,45,0,0,106
1034467,686515,2018-01-18,Senate,"Reported Favorably Without Amendment",4,0,0,0,4
1034467,775054,2018-09-26,Senate,"Senate Third Reading: Passed Roll Call # 568",29,7,0,1,37
1034467,779250,2018-11-28,House,"Reported With Recommendation Without Amendment",4,0,0,0,4
1034467,781346,2018-12-20,House,"House Third Reading: Passed Roll Call # 929",95,13,0,0,108
1034482,720765,2018-03-08,Senate,"Reported Favorably Without Amendment",3,1,0,0,4
1034496,686655,2018-01-18,Senate,"Reported Favorably Without Amendment",4,0,0,0,4
1034496,775048,2018-09-26,Senate,"Senate Third Reading: Passed Roll Call # 572",27,9,0,1,37
1034496,779241,2018-11-28,House,"Reported With Recommendation Without Amendment",4,0,0,0,4
1034496,781625,2018-12-20,House,"House Third Reading: Passed Roll Call # 933",94,14,0,0,108
1034511,686628,2018-01-18,Senate,"Reported Favorably Without Amendment",4,0,0,0,4
1034511,775042,2018-09-26,Senate,"Senate Third Reading: Passed Roll Call # 569",28,8,0,1,37
1034511,775043,2018-09-26,Senate,"Senate Third Reading: Passed Roll Call # 573",27,9,0,1,37
1034511,779255,2018-11-28,House,"Reported With Recommendation Without Amendment",4,0,0,0,4
1034511,781291,2018-12-20,House,"House Third Reading: Passed Roll Call # 930",96,12,0,0,108
1034525,745479,2018-04-24,Senate,"Reported Favorably With Substitute  S-1",9,0,0,0,9
1034525,762471,2018-06-12,Senate,"Senate Third Reading: Passed Roll Call # 512",33,3,0,1,37
1034541,686537,2018-01-18,Senate,"Reported Favorably Without Amendment",4,0,0,0,4
1034541,775099,2018-09-26,Senate,"Senate Third Reading: Passed Roll Call # 570",28,8,0,1,37
1034541,779201,2018-11-28,House,"Reported With Recommendation Without Amendment",4,0,0,0,4
1034541,781284,2018-12-20,House,"House Third Reading: Passed Roll Call # 931",95,13,0,0,108
1034554,720784,2018-03-08,Senate,"Reported Favorably Without Amendment",3,1,0,0,4
1034569,683956,2017-12-28,Senate,"Reported Favorably With Substitute  S-1",4,0,0,0,4
1034569,688495,2018-01-23,Senate,"Senate Third Reading: Passed Roll Call # 24",37,0,0,1,38
1034569,711928,2018-02-22,House,"Reported With Recommendation Without Amendment",6,0,0,0,6
1034569,727067,2018-03-21,House,"House Third Reading: Given Immediate Effect Roll Call # 186",106,2,0,0,108
1034582,720737,2018-03-08,Senate,"Reported Favorably Without Amendment",3,1,0,0,4
1034597,686490,2018-01-18,Senate,"Reported Favorably Without Amendment",4,0,0,0,4
1034597,775101,2018-09-26,Senate,"Senate Third Reading: Passed Roll Call # 571",27,9,0,1,37
1034597,779238,2018-11-28,House,"Reported With Recommendation Without Amendment",4,0,0,0,4
1034597,781286,2018-12-20,House,"House Third Reading: Passed Roll Call # 932",95,13,0,0,108
1034675,779163,2018-11-29,Senate,"Reported Favorably Without Amendment",5,0,0,0,5
1034705,727339,2018-03-21,House,"Reported With Recommendation With Substitute  H-1",8,0,0,0,8
1034705,738079,2018-03-21,House,"Reported With Recommendation With Substitute H-1",8,0,0,0,8
1034705,741848,2018-04-17,House,"House Third Reading: Given Immediate Effect Roll Call # 229",69,40,0,0,109
1034705,775347,2018-10-02,Senate,"Reported Favorably With Substitute S-1",4,1,0,0,5
1034705,780133,2018-12-06,Senate,"Senate Third Reading: Given Immediate Effect Roll Call # 699",26,10,0,2,38
1034705,780514,2018-12-13,House,"House Third Reading: Roll Call # 845",67,42,0,0,109
1034748,703977,2018-02-15,Senate,"Reported Favorably With Substitute  S-1",5,0,0,0,5
1034974,686288,2018-01-17,House,"Reported With Recommendation For Referral To Committee On Local Government",13,0,0,0,13
1034974,749224,2018-05-02,House,"Reported With Recommendation With Substitute  H-1",9,0,0,0,9
1034974,753373,2018-05-02,House,"Reported With Recommendation With Substitute H-1",9,0,0,0,9
1034974,755156,2018-05-16,House,"House Third Reading: Given Immediate Effect Roll Call # 328",76,32,0,0,108
1034974,779739,2018-12-04,Senate,"Reported Favorably Without Amendment",7,0,0,0,7
1034974,780520,2018-12-11,Senate,"Senate Third Reading: Given Immediate Effect Roll Call # 757",34,4,0,0,38
1034980,725295,2018-03-15,House,"Reported With Recommendation For Referral To Committee On Law And Justice",9,0,0,0,9
1034984,722564,2018-03-13,House,"Reported With Recommendation With Substitute  H-2",9,1,0,0,10
1034984,726150,2018-03-13,House,"Reported With Recommendation With Substitute H-2",9,1,0,0,10
1034984,728042,2018-03-22,House,"House Third Reading: Given Immediate Effect Roll Call # 203",107,2,0,0,109
1034984,753556,2018-05-15,Senate,"Reported Favorably Without Amendment",5,0,0,0,5
1034984,762368,2018-06-12,Senate,"Senate Third Reading: Given Immediate Effect Roll Call # 453",36,0,0,1,37
1036015,708748,2018-02-22,Senate,"Reported Favorably Without Amendment",4,1,0,0,5
1036015,747296,2018-05-01,Senate,"Senate Third Reading: Passed Roll Call # 240",26,10,0,1,37
1036015,781549,2018-12-21,House,"House Third Reading: Given Immediate Effect Roll Call # 1001",62,45,0,0,107
1036015,781550,2018-12-21,Senate,"Senate Third Reading: Roll Call # 1047",26,12,0,0,38
1036021,706114,2018-02-20,Senate,"Reported Favorably With Substitute  S-1",5,0,0,0,5
1036021,752321,2018-05-10,Senate,"Senate Third Reading: Passed Roll Call # 282",31,4,0,2,37
1036133,688379,2018-01-24,House,"Reported With Recommendation With Substitute  H-2",8,0,0,0,8
1036133,712396,2018-02-27,House,"House Third Reading: Passed Roll Call # 99",108,0,0,0,108
1036133,751578,2018-05-09,Senate,"Reported Favorably Without Amendment",5,0,0,0,5
1036133,757401,2018-05-29,Senate,"Senate Third Reading: Passed Roll Call # 364",36,0,0,1,37
1036133,758279,2018-05-29,Senate,"Senate Third Reading: Given Immediate Effect Roll Call # 364",36,0,0,1,37
1036133,758280,2018-05-30,House,"House Third Reading: Roll Call # 428",106,0,0,0,106
1036304,692107,2018-01-31,Senate,"Reported Favorably Without Amendment",4,0,0,0,4
1036304,702733,2018-02-14,Senate,"Senate Third Reading: Passed Roll Call # 74",36,0,0,2,38
1036304,749063,2018-05-02,House,"Reported With Recommendation With Substitute  H-1",11,0,0,0,11
1036304,755441,2018-05-22,House,"House Third Reading: Given Immediate Effect Roll Call # 354",108,0,0,0,108
1036304,757392,2018-05-29,Senate,"Senate Third Reading: Roll Call # 357",36,0,0,1,37
1036308,692095,2018-01-31,Senate,"Reported Favorably With Substitute  S-1",4,0,0,0,4
1036308,702577,2018-02-14,Senate,"Senate Third Reading: Passed Roll Call # 75",36,0,0,2,38
1036308,749403,2018-05-02,House,"Reported With Recommendation With Substitute  H-1",11,0,0,0,11
1036308,755514,2018-05-22,House,"House Third Reading: Given Immediate Effect Roll Call # 355",108,0,0,0,108
1036308,757440,2018-05-29,Senate,"Senate Third Reading: Roll Call # 358",36,0,0,1,37
1036309,692097,2018-01-31,Senate,"Reported Favorably Without Amendment",4,0,0,0,4
1036309,702756,2018-02-14,Senate,"Senate Third Reading: Passed Roll Call # 76",36,0,0,2,38
1036309,749076,2018-05-02,House,"Reported With Recommendation With Substitute  H-1",11,0,0,0,11
1036309,755430,2018-05-22,House,"House Third Reading: Given Immediate Effect Roll Call # 356",106,2,0,0,108
1036309,757334,2018-05-29,Senate,"Senate Third Reading: Roll Call # 359",36,0,0,1,37
1036310,688266,2018-01-24,Senate,"Reported Favorably With Substitute  S-1",8,0,0,0,8
1036310,751715,2018-05-08,Senate,"Senate Third Reading: Passed Roll Call # 278",36,0,0,1,37
1036310,779534,2018-12-04,House,"Reported With Recommendation With Substitute  H-1",8,0,0,0,8
1036310,781295,2018-12-20,House,"House Third Reading: Given Immediate Effect Roll Call # 917",92,17,0,0,109
1036314,692466,2018-01-31,Senate,"Reported Favorably Without Amendment",4,0,0,0,4
1036314,702287,2018-02-14,Senate,"Senate Third Reading: Passed Roll Call # 71",36,0,0,2,38
1036314,749001,2018-05-02,House,"Reported With Recommendation Without Amendment",11,0,0,0,11
1036314,755583,2018-05-22,House,"House Third Reading: Given Immediate Effect Roll Call # 351",108,0,0,0,108
1036320,688263,2018-01-24,Senate,"Reported Favorably With Substitute  S-1",4,0,0,0,4
1036320,692552,2018-01-31,Senate,"Senate Third Reading: Passed Roll Call # 51",24,13,0,1,38
1036320,711836,2018-02-22,House,"Reported With Recommendation With Substitute  H-2",15,0,0,0,15
1036320,725175,2018-02-22,House,"Reported With Recommendation With Substitute H-2",15,0,0,0,15
1036320,727002,2018-03-21,House,"House Third Reading: Given Immediate Effect Roll Call # 187",85,23,0,0,108
1036320,727849,2018-03-22,Senate,"Senate Third Reading: Roll Call # 174",24,10,0,3,37
1036321,692128,2018-01-31,Senate,"Reported Favorably Without Amendment",4,0,0,0,4
1036321,702439,2018-02-14,Senate,"Senate Third Reading: Passed Roll Call # 70",36,0,0,2,38
1036321,749107,2018-05-02,House,"Reported With Recommendation With Substitute  H-1",11,0,0,0,11
1036321,755436,2018-05-22,House,"House Third Reading: Given Immediate Effect Roll Call # 350",107,1,0,0,108
1036321,757302,2018-05-29,Senate,"Senate Third Reading: Roll Call # 355",35,0,0,2,37
1036325,692045,2018-01-31,Senate,"Reported Favorably Without Amendment",4,0,0,0,4
1036325,702939,2018-02-14,Senate,"Senate Third Reading: Passed Roll Call # 78",36,0,0,2,38
1036325,749006,2018-05-02,House,"Reported With Recommendation Without Amendment",11,0,0,0,11
1036325,755547,2018-05-22,House,"House Third Reading: Given Immediate Effect Roll Call # 358",108,0,0,0,108
1036332,747090,2018-05-01,Senate,"Reported Favorably Without Amendment",5,0,0,0,5
1036332,757469,2018-05-29,Senate,"Senate Third Reading: Passed Roll Call # 363",36,0,0,1,37
1036337,688343,2018-01-24,Senate,"Reported Favorably With Substitute  S-1",8,0,0,0,8
1036337,751667,2018-05-08,Senate,"Senate Third Reading: Passed Roll Call # 279",36,0,0,1,37
1036337,752305,2018-05-10,Senate,"Senate Third Reading: Passed Roll Call # 281",35,0,0,2,37
1036337,779580,2018-12-04,House,"Reported With Recommendation With Substitute  H-1",8,0,0,0,8
1036337,781293,2018-12-20,House,"House Third Reading: Given Immediate Effect Roll Call # 918",107,2,0,0,109
1036337,781414,2018-12-20,Senate,"Senate Third Reading: Roll Call # 1030",38,0,0,0,38
1036338,692532,2018-01-31,Senate,"Reported Favorably With Substitute  S-1",4,0,0,0,4
1036338,702390,2018-02-14,Senate,"Senate Third Reading: Passed Roll Call # 72",36,0,0,2,38
1036338,749035,2018-05-02,House,"Reported With Recommendation Without Amendment",11,0,0,0,11
1036338,755428,2018-05-22,House,"House Third Reading: Given Immediate Effect Roll Call # 352",108,0,0,0,108
1036342,692075,2018-01-31,Senate,"Reported Favorably Without Amendment",4,0,0,0,4
1036342,702683,2018-02-14,Senate,"Senate Third Reading: Passed Roll Call # 77",36,0,0,2,38
1036342,749303,2018-05-02,House,"Reported With Recommendation Without Amendment",11,0,0,0,11
1036342,755576,2018-05-22,House,"House Third Reading: Given Immediate Effect Roll Call # 357",108,0,0,0,108
1036343,692046,2018-01-31,Senate,"Reported Favorably Without Amendment",4,0,0,0,4
1036343,702494,2018-02-14,Senate,"Senate Third Reading: Passed Roll Call # 79",36,0,0,2,38
1036343,749095,2018-05-02,House,"Reported With Recommendation Without Amendment",11,0,0,0,11
1036343,755516,2018-05-22,House,"House Third Reading: Given Immediate Effect Roll Call # 359",108,0,0,0,108
1036344,692140,2018-01-31,Senate,"Reported Favorably Without Amendment",4,0,0,0,4
1036344,703050,2018-02-14,Senate,"Senate Third Reading: Passed Roll Call # 73",36,0,0,2,38
1036344,749108,2018-05-02,House,"Reported With Recommendation With Substitute  H-1",11,0,0,0,11
1036344,755431,2018-05-22,House,"House Third Reading: Given Immediate Effect Roll Call # 353",108,0,0,0,108
1036344,757378,2018-05-29,Senate,"Senate Third Reading: Roll Call # 356",36,0,0,1,37
1036558,761183,2018-06-07,House,"Reported With Recommendation For Referral To Committee On Health Policy",11,4,0,0,15
1036564,775264,2018-10-02,House,"Reported With Recommendation With Substitute  H-2",9,1,0,0,10
1036564,779249,2018-11-29,House,"House Third Reading: Given Immediate Effect Roll Call # 650",108,1,0,0,109
1036564,780550,2018-12-12,Senate,"Reported Favorably Without Amendment",4,0,0,0,4
1036564,780748,2018-12-13,Senate,"Senate Third Reading: Given Immediate Effect Roll Call # 818",37,0,0,1,38
1036568,778251,2018-11-08,House,"Reported With Recommendation For Referral To Committee On Education Reform",7,0,0,0,7
1036568,779970,2018-12-06,House,"Reported With Recommendation Without Amendment",8,7,0,0,15
1036572,719272,2018-03-06,House,"Reported With Recommendation Without Amendment",13,0,0,0,13
1036572,754991,2018-05-17,House,"House Third Reading: Given Immediate Effect Roll Call # 342",108,0,0,0,108
1036572,779587,2018-12-04,Senate,"Reported Favorably With Substitute  S-1",5,0,0,0,5
1036572,780344,2018-12-11,Senate,"Senate Third Reading: Given Immediate Effect Roll Call # 751",37,0,0,1,38
1036572,780567,2018-12-12,House,"House Third Reading: Roll Call # 811",109,0,0,0,109
1036573,778959,2018-11-27,House,"Reported With Recommendation With Substitute H-2",9,1,0,0,10
1036573,780092,2018-12-05,House,"House Third Reading: Given Immediate Effect Roll Call # 696",107,1,0,0,108
1036573,780552,2018-12-12,Senate,"Reported Favorably Without Amendment",4,0,0,0,4
1036573,781459,2018-12-19,Senate,"Senate Third Reading: Given Immediate Effect Roll Call # 924",38,0,0,0,38
1051398,755219,2018-05-15,House,"Reported With Recommendation With Substitute  H-1",14,0,0,0,14
1051398,780089,2018-12-05,House,"House Third Reading: Given Immediate Effect Roll Call # 684",108,0,0,0,108
1051398,781651,2018-12-21,Senate,"Senate Third Reading: Passed Roll Call # 1039",32,6,0,0,38
1051882,698185,2018-02-08,House,"Reported With Recommendation With Substitute  H-1",15,0,0,0,15
1051882,713801,2018-02-28,House,"House Third Reading: Given Immediate Effect Roll Call # 107",108,1,0,0,109
1051882,753916,2018-05-16,Senate,"Reported Favorably Without Amendment",4,0,0,0,4
1051882,762635,2018-06-12,Senate,"Senate Third Reading: Given Immediate Effect Roll Call # 454",35,1,0,1,37
1052049,720712,2018-03-08,Senate,"Reported Favorably Without Amendment",3,1,0,0,4
1052049,738388,2018-04-12,Senate,"Senate Third Reading: Passed Roll Call # 190",22,13,0,2,37
1052049,780073,2018-12-06,House,"Reported With Recommendation Without Amendment",8,3,0,0,11
1052100,736977,2018-04-10,House,"Reported With Recommendation With Substitute  H-1",9,0,0,0,9
1052100,758101,2018-05-30,House,"House Third Reading: Given Immediate Effect Roll Call # 435",97,10,0,0,107
1052100,774299,2018-09-05,Senate,"Reported Favorably Without Amendment",3,0,0,0,3
1052100,774487,2018-09-05,Senate,"Senate Third Reading: Given Immediate Effect Roll Call # 560",31,4,0,2,37
1052149,760500,2018-06-06,House,"Reported With Recommendation With Substitute  H-2",9,5,0,0,14
1052149,774300,2018-09-05,House,"House Third Reading: Given Immediate Effect Roll Call # 568",61,45,0,0,106
1052440,711819,2018-02-27,House,"Reported With Recommendation With Substitute  H-6",14,0,0,0,14
1052440,745145,2018-02-27,House,"Reported With Recommendation With Substitute H-6",14,0,0,0,14
1052440,749195,2018-05-01,House,"House Third Reading: Given Immediate Effect Roll Call # 260",96,13,0,0,109
1052440,757248,2018-05-29,Senate,"Reported Favorably Without Amendment",4,0,0,0,4
1052440,760899,2018-06-06,Senate,"Senate Third Reading: Given Immediate Effect Roll Call # 397",37,0,0,0,37
1053285,707627,2018-02-21,House,"Reported With Recommendation Without Amendment",5,0,0,0,5
1053412,775349,2018-10-02,Senate,"Reported Favorably With Substitute S-1",17,0,0,0,17
1053412,778947,2018-11-27,Senate,"Senate Third Reading: Passed Roll Call # 602",37,0,0,0,37
1053412,780000,2018-12-05,House,"Reported With Recommendation Without Amendment",28,0,0,0,28
1053412,780499,2018-12-13,House,"House Third Reading: Given Immediate Effect Roll Call # 831",95,14,0,0,109
1053534,685904,2018-01-17,Senate,"Reported Favorably With Substitute S-1",5,0,0,0,5
1053534,685905,2018-01-17,Senate,"Senate Third Reading: Passed Roll Call # 7",37,0,0,1,38
1053534,692101,2018-01-31,House,"Reported With Recommendation Without Amendment",12,0,0,0,12
1053534,702761,2018-02-14,House,"House Third Reading: Given Immediate Effect Roll Call # 70",107,2,0,0,109
1053534,702762,2018-02-14,Senate,"Senate Third Reading: Roll Call # 88",36,0,0,2,38
1054098,722559,2018-03-13,House,"Reported With Recommendation With Substitute  H-1",10,0,0,0,10
1054098,726516,2018-03-13,House,"Reported With Recommendation With Substitute H-1",10,0,0,0,10
1054098,727856,2018-03-22,House,"House Third Reading: Given Immediate Effect Roll Call # 205",83,26,0,0,109
1054098,753731,2018-05-15,Senate,"Reported Favorably With Substitute  S-1",5,0,0,0,5
1054098,762511,2018-06-12,Senate,"Senate Third Reading: Given Immediate Effect Roll Call # 452",36,0,0,1,37
1054098,764412,2018-06-12,House,"House Third Reading: Roll Call # 544",89,20,0,0,109
1054271,711808,2018-02-27,House,"Reported With Recommendation Without Amendment",14,0,0,0,14
1054271,722640,2018-03-13,House,"House Third Reading: Given Immediate Effect Roll Call # 156",109,0,0,0,109
1054271,740153,2018-04-17,Senate,"Reported Favorably Without Amendment",4,0,0,0,4
1054271,746627,2018-04-24,Senate,"Senate Third Reading: Given Immediate Effect Roll Call # 229",36,0,0,1,37
1054619,689102,2018-01-25,Senate,"Reported Favorably Without Amendment",4,0,0,0,4
1055139,722572,2018-03-13,House,"Reported With Recommendation With Substitute  H-2",9,0,0,0,9
1055139,726163,2018-03-13,House,"Reported With Recommendation With Substitute H-2",9,0,0,0,9
1055139,728038,2018-03-22,House,"House Third Reading: Given Immediate Effect Roll Call # 204",107,2,0,0,109
1055139,753587,2018-05-15,Senate,"Reported Favorably With Substitute  S-1",5,0,0,0,5
1055139,762475,2018-06-12,Senate,"Senate Third Reading: Given Immediate Effect Roll Call # 451",36,0,0,1,37
1055139,764423,2018-06-12,House,"House Third Reading: Roll Call # 543",106,3,0,0,109
1055661,712878,2018-02-27,House,"Reported With Recommendation With Substitute  H-3",9,1,0,0,10
1055661,722605,2018-03-08,House,"House Third Reading: Given Immediate Effect Roll Call # 150",106,1,0,0,107
1055661,748403,2018-05-02,Senate,"Reported Favorably Without Amendment",5,0,0,0,5
1055661,775070,2018-09-26,Senate,"Senate Third Reading: Given Immediate Effect Roll Call # 575",36,0,0,1,37
1056013,775265,2018-10-02,House,"Reported With Recommendation With Substitute  H-4",9,1,0,0,10
1056013,779184,2018-11-29,House,"House Third Reading: Given Immediate Effect Roll Call # 651",105,4,0,0,109
1056013,780555,2018-12-12,Senate,"Reported Favorably Without Amendment",4,0,0,0,4
1056013,780744,2018-12-13,Senate,"Senate Third Reading: Given Immediate Effect Roll Call # 819",37,0,0,1,38
1056714,712227,2018-02-27,House,"Reported With Recommendation With Substitute  H-3",9,1,0,0,10
1056714,722313,2018-03-08,House,"House Third Reading: Given Immediate Effect Roll Call # 149",105,2,0,0,107
1056714,748505,2018-05-02,Senate,"Reported Favorably Without Amendment",5,0,0,0,5
1056714,775078,2018-09-26,Senate,"Senate Third Reading: Given Immediate Effect Roll Call # 574",36,0,0,1,37
1056714,775289,2018-10-02,House,"House Third Reading: Roll Call # 587",104,2,0,0,106
1057233,702165,2018-02-13,House,"Reported With Recommendation Without Amendment",8,2,0,0,10
1057233,722398,2018-03-08,House,"House Third Reading: Given Immediate Effect Roll Call # 145",105,2,0,0,107
1057233,738425,2018-04-12,Senate,"Reported Favorably With Substitute  S-1",5,0,0,0,5
1057233,752235,2018-05-10,Senate,"Senate Third Reading: Given Immediate Effect Roll Call # 283",35,0,0,2,37
1057233,755174,2018-05-15,House,"House Third Reading: Roll Call # 281",105,3,0,0,108
1059571,685879,2018-01-17,Senate,"Reported Favorably Without Amendment",5,0,0,0,5
1059571,687649,2018-01-23,Senate,"Senate Third Reading: Passed Roll Call # 19",37,0,0,1,38
1059571,692502,2018-01-31,House,"Reported With Recommendation Without Amendment",10,1,0,0,11
1059743,686027,2018-01-17,Senate,"Reported Favorably With Substitute S-1",5,0,0,0,5
1059743,687622,2018-01-23,Senate,"Senate Third Reading: Passed Roll Call # 20",37,0,0,1,38
1059743,692485,2018-01-31,House,"Reported With Recommendation Without Amendment",12,0,0,0,12
1059743,702308,2018-02-14,House,"House Third Reading: Given Immediate Effect Roll Call # 71",109,0,0,0,109
1059743,702309,2018-02-14,Senate,"Senate Third Reading: House Amendment(s) Concurred In Roll Call # 89",36,0,0,2,38
1059840,737593,2018-04-11,House,"Reported With Recommendation Without Amendment",8,0,0,0,8
1059840,755206,2018-05-17,House,"House Third Reading: Given Immediate Effect Roll Call # 336",108,0,0,0,108
1059840,775355,2018-10-02,Senate,"Reported Favorably Without Amendment",17,0,0,0,17
1059840,781262,2018-12-18,Senate,"Senate Third Reading: Given Immediate Effect Roll Call # 839",38,0,0,0,38
1059881,688572,2018-01-24,House,"Reported With Recommendation With Substitute  H-1",10,2,0,0,12
1059881,691198,2018-01-25,House,"House Third Reading: Given Immediate Effect Roll Call # 22",100,6,0,0,106
1059881,698716,2018-02-06,Senate,"Reported Favorably Without Amendment",7,0,0,0,7
1059961,712340,2018-02-22,House,"Reported With Recommendation Without Amendment",6,0,0,0,6
1059961,718940,2018-03-07,House,"House Third Reading: Given Immediate Effect Roll Call # 144",107,1,0,0,108
1060049,707728,2018-02-20,House,"Reported With Recommendation With Substitute  H-1",9,0,0,0,9
1060049,719588,2018-03-06,House,"House Third Reading: Given Immediate Effect Roll Call # 130",99,9,0,0,108
1060049,745780,2018-04-26,Senate,"Reported Favorably Without Amendment",3,1,0,0,4
1060049,762329,2018-06-12,Senate,"Senate Third Reading: Given Immediate Effect Roll Call # 450",33,3,0,1,37
1060094,688587,2018-01-24,House,"Reported With Recommendation Without Amendment",12,0,0,0,12
1060094,691205,2018-01-25,House,"House Third Reading: Given Immediate Effect Roll Call # 21",105,1,0,0,106
1060094,698662,2018-02-06,Senate,"Reported Favorably Without Amendment",7,0,0,0,7
1060269,712307,2018-02-22,House,"Reported With Recommendation Without Amendment",6,0,0,0,6
1060269,719653,2018-03-07,House,"House Third Reading: Given Immediate Effect Roll Call # 143",106,2,0,0,108
1060311,688289,2018-01-24,House,"Reported With Recommendation With Substitute  H-4",12,0,0,0,12
1060311,691279,2018-01-25,House,"House Third Reading: Given Immediate Effect Roll Call # 20",105,1,0,0,106
1060311,698722,2018-02-06,Senate,"Reported Favorably Without Amendment",7,0,0,0,7
1061513,712044,2018-02-27,Senate,"Reported Favorably With Substitute  S-1",5,0,0,0,5
1061513,714792,2018-03-01,Senate,"Senate Third Reading: Passed Roll Call # 125",33,3,0,2,38
1061513,761112,2018-06-07,House,"Reported With Recommendation With Substitute  H-1",8,1,0,0,9
1061513,781533,2018-12-20,House,"House Third Reading: Given Immediate Effect Roll Call # 944",102,6,0,0,108
1061513,781653,2018-12-21,Senate,"Senate Third Reading: Roll Call # 1052",34,4,0,0,38
1061721,698080,2018-02-08,House,"Reported With Recommendation Without Amendment",10,5,0,0,15
1061879,727951,2018-03-22,Senate,"Reported Favorably With Substitute  S-1",8,0,0,0,8
1061879,737687,2018-04-11,Senate,"Senate Third Reading: Passed Roll Call # 189",37,0,0,0,37
1061879,774911,2018-09-26,House,"Reported With Recommendation Without Amendment",15,0,0,0,15
1061879,780036,2018-12-05,House,"House Third Reading: Given Immediate Effect Roll Call # 688",106,1,0,0,107
1062627,736520,2018-04-10,Senate,"Reported Favorably With Substitute  S-1",8,0,0,0,8
1062627,738420,2018-04-12,Senate,"Senate Third Reading: Passed Roll Call # 193",35,0,0,2,37
1062627,757884,2018-05-29,House,"Reported With Recommendation Without Amendment",11,0,0,0,11
1062627,764692,2018-06-12,House,"House Third Reading: Given Immediate Effect Roll Call # 493",101,8,0,0,109
1062711,692584,2018-01-31,House,"Reported With Recommendation With Substitute H-1",9,0,0,0,9
1062748,702814,2018-02-14,House,"Reported With Recommendation Without Amendment",5,0,0,0,5
1062789,736331,2018-04-10,Senate,"Reported Favorably With Substitute  S-1",8,0,0,0,8
1062789,738381,2018-04-12,Senate,"Senate Third Reading: Passed Roll Call # 194",35,0,0,2,37
1062789,758078,2018-05-29,House,"Reported With Recommendation Without Amendment",11,0,0,0,11
1062789,764551,2018-06-12,House,"House Third Reading: Given Immediate Effect Roll Call # 494",99,10,0,0,109
1062828,692406,2018-01-31,House,"Reported With Recommendation With Substitute H-1",9,0,0,0,9
1063112,714656,2018-03-01,House,"Reported With Recommendation With Substitute  H-2",15,0,0,0,15
1063112,723062,2018-03-14,House,"House Third Reading: Given Immediate Effect Roll Call # 163",108,0,0,0,108
1063112,756915,2018-05-24,Senate,"Reported Favorably Without Amendment",10,0,0,0,10
1063112,759979,2018-06-05,Senate,"Senate Third Reading: Given Immediate Effect Roll Call # 390",36,0,0,1,37
1063375,707638,2018-02-20,House,"Reported With Recommendation With Substitute  H-2",15,0,0,0,15
1063375,713791,2018-02-28,House,"House Third Reading: Given Immediate Effect Roll Call # 115",100,9,0,0,109
1063375,745309,2018-04-26,Senate,"Reported Favorably Without Amendment",5,0,0,0,5
1063375,760923,2018-06-06,Senate,"Senate Third Reading: Given Immediate Effect Roll Call # 394",37,0,0,0,37
1063800,707467,2018-02-20,House,"Reported With Recommendation With Substitute  H-2",15,0,0,0,15
1063800,713437,2018-02-28,House,"House Third Reading: Given Immediate Effect Roll Call # 116",96,13,0,0,109
1063800,745787,2018-04-26,Senate,"Reported Favorably With Substitute  S-1",5,0,0,0,5
1063800,760925,2018-06-06,Senate,"Senate Third Reading: Given Immediate Effect Roll Call # 393",37,0,0,0,37
1063800,764356,2018-06-12,House,"House Third Reading: Roll Call # 534",95,14,0,0,109
1068772,692933,2018-02-01,Senate,"Reported Favorably Without Amendment",13,0,0,0,13
1068772,778942,2018-11-27,Senate,"Senate Third Reading: Passed Roll Call # 596",37,0,0,0,37
1070001,738399,2018-04-12,Senate,"Reported Favorably With Substitute  S-2",4,1,0,0,5
1070001,754020,2018-05-16,Senate,"Senate Third Reading: Passed Roll Call # 294",26,11,0,0,37
1070001,781184,2018-12-19,House,"Reported With Recommendation With Substitute H-3",19,0,0,0,19
1070001,781577,2018-12-21,House,"House Third Reading: Passed Roll Call # 997",107,0,0,0,107
1070001,781578,2018-12-21,Senate,"Senate Third Reading: Roll Call # 1049",38,0,0,0,38
1070140,738395,2018-04-12,Senate,"Reported Favorably With Substitute  S-1",4,1,0,0,5
1070140,754067,2018-05-16,Senate,"Senate Third Reading: Adopted By 2/3 Vote Roll Call # 293",26,11,0,0,37
1070140,781209,2018-12-19,House,"Reported With Recommendation With Substitute H-3",19,0,0,0,19
1070140,781658,2018-12-21,House,"House Third Reading: Passed By 2/3 Vote Roll Call # 996",107,0,0,0,107
1070140,781659,2018-12-21,Senate,"Senate Third Reading: Roll Call # 1057",37,0,0,1,38
1070140,781660,2018-12-21,Senate,"Senate Third Reading: Adopted By 2/3 Vote Roll Call # 1057",37,0,0,1,38
1070393,702190,2018-02-14,House,"Reported With Recommendation With Substitute  H-1",17,0,0,0,17
1070393,713419,2018-02-28,House,"House Third Reading: Given Immediate Effect Roll Call # 112",106,3,0,0,109
1070393,748533,2018-05-02,Senate,"Reported Favorably Without Amendment",6,0,0,0,6
1070393,781318,2018-12-20,Senate,"Senate Third Reading: Given Immediate Effect Roll Call # 967",38,0,0,0,38
1070430,707974,2018-02-20,House,"Reported With Recommendation Without Amendment",11,0,0,0,11
1070430,714558,2018-03-01,House,"House Third Reading: Given Immediate Effect Roll Call # 125",108,1,0,0,109
1070430,727993,2018-03-22,Senate,"Reported Favorably Without Amendment",5,0,0,0,5
1070430,737627,2018-04-11,Senate,"Senate Third Reading: Given Immediate Effect Roll Call # 187",37,0,0,0,37
1070589,725296,2018-03-15,House,"Reported With Recommendation For Referral To Committee On Law And Justice",9,0,0,0,9
1070627,688478,2018-01-24,House,"House Third Reading: Roll Call # 17",96,11,0,0,107
1071522,709015,2018-02-22,Senate,"Reported Favorably With Substitute  S-2",5,0,0,0,5
1071522,762492,2018-06-12,Senate,"Senate Third Reading: Passed Roll Call # 507",36,0,0,1,37
1071681,761152,2018-06-07,Senate,"Reported Favorably With Substitute  S-4",5,0,0,0,5
1071681,761153,2018-06-07,Senate,"Senate Third Reading: Passed Roll Call # 433",23,13,0,1,37
1071710,709107,2018-02-22,Senate,"Reported Favorably With Substitute  S-1",5,0,0,0,5
1071710,762412,2018-06-12,Senate,"Senate Third Reading: Passed Roll Call # 508",36,0,0,1,37
1074028,706115,2018-02-20,Senate,"Reported Favorably With Substitute  S-1",5,0,0,0,5
1074028,709071,2018-02-22,Senate,"Senate Third Reading: Passed Roll Call # 109",37,0,0,1,38
1074028,779169,2018-11-29,House,"Reported With Recommendation Without Amendment",7,1,0,0,8
1074028,780589,2018-12-13,House,"House Third Reading: Given Immediate Effect Roll Call # 837",64,45,0,0,109
1074080,708857,2018-02-22,Senate,"Reported Favorably With Substitute  S-1",16,0,0,0,16
1074080,718461,2018-03-06,Senate,"Senate Third Reading: Passed Roll Call # 130",36,0,0,1,37
1074080,775394,2018-10-03,House,"Reported With Recommendation With Substitute  H-1",27,0,0,0,27
1074131,723005,2018-03-14,Senate,"Reported Favorably With Substitute  S-1",4,1,0,0,5
1074131,778952,2018-11-27,Senate,"Senate Third Reading: Given Immediate Effect Roll Call # 600",20,17,0,0,37
1074131,779962,2018-12-06,House,"Reported With Recommendation Without Amendment",8,7,0,0,15
1074186,706287,2018-02-20,Senate,"Reported Favorably With Substitute  S-1",5,0,0,0,5
1074186,709076,2018-02-22,Senate,"Senate Third Reading: Passed Roll Call # 110",37,0,0,1,38
1074186,779179,2018-11-29,House,"Reported With Recommendation Without Amendment",7,1,0,0,8
1074186,780531,2018-12-13,House,"House Third Reading: Given Immediate Effect Roll Call # 838",65,44,0,0,109
1074215,723131,2018-03-14,Senate,"Reported Favorably With Substitute  S-1",4,1,0,0,5
1074215,778930,2018-11-27,Senate,"Senate Third Reading: Given Immediate Effect Roll Call # 597",25,12,0,0,37
1074215,779957,2018-12-06,House,"Reported With Recommendation Without Amendment",8,7,0,0,15
1074391,714019,2018-02-28,House,"Reported With Recommendation Without Amendment",15,0,0,0,15
1074391,722314,2018-03-08,House,"House Third Reading: Given Immediate Effect Roll Call # 151",104,3,0,0,107
1074391,738405,2018-04-12,Senate,"Reported Favorably Without Amendment",5,0,0,0,5
1074391,745322,2018-04-24,Senate,"Senate Third Reading: Given Immediate Effect Roll Call # 227",36,0,0,1,37
1074440,714002,2018-02-28,House,"Reported With Recommendation Without Amendment",15,0,0,0,15
1074440,722310,2018-03-08,House,"House Third Reading: Given Immediate Effect Roll Call # 152",104,3,0,0,107
1074440,738443,2018-04-12,Senate,"Reported Favorably Without Amendment",5,0,0,0,5
1074440,745315,2018-04-24,Senate,"Senate Third Reading: Given Immediate Effect Roll Call # 228",36,0,0,1,37
1074452,722985,2018-03-14,House,"Reported With Recommendation Without Amendment",11,0,0,0,11
1074452,727930,2018-03-22,House,"House Third Reading: Passed Roll Call # 209",107,2,0,0,109
1074452,780455,2018-12-11,Senate,"Reported Favorably Without Amendment",4,0,0,0,4
1074452,780728,2018-12-13,Senate,"Senate Third Reading: Given Immediate Effect Roll Call # 789",37,0,0,1,38
1074463,749021,2018-05-02,House,"Reported With Recommendation With Substitute  H-1",13,0,0,0,13
1074463,755019,2018-05-17,House,"House Third Reading: Given Immediate Effect Roll Call # 338",108,0,0,0,108
1074463,779266,2018-11-28,Senate,"Reported Favorably Without Amendment",7,0,0,0,7
1074463,781460,2018-12-19,Senate,"Senate Third Reading: Given Immediate Effect Roll Call # 923",38,0,0,0,38
1074541,722969,2018-03-14,House,"Reported With Recommendation With Substitute  H-1",11,0,0,0,11
1074541,726506,2018-03-14,House,"Reported With Recommendation With Substitute H-1",11,0,0,0,11
1074541,727916,2018-03-22,House,"House Third Reading: Passed Roll Call # 207",104,5,0,0,109
1074541,780447,2018-12-11,Senate,"Reported Favorably Without Amendment",4,0,0,0,4
1074541,780678,2018-12-13,Senate,"Senate Third Reading: Given Immediate Effect Roll Call # 788",37,0,0,1,38
1074625,722959,2018-03-14,House,"Reported With Recommendation With Substitute  H-1",11,0,0,0,11
1074625,726459,2018-03-14,House,"Reported With Recommendation With Substitute H-1",11,0,0,0,11
1074625,727909,2018-03-22,House,"House Third Reading: Given Immediate Effect Roll Call # 206",108,1,0,0,109
1074625,780595,2018-12-11,Senate,"Reported Favorably Without Amendment",4,0,0,0,4
1074625,780783,2018-12-13,Senate,"Senate Third Reading: Given Immediate Effect Roll Call # 787",37,0,0,1,38
1074642,722930,2018-03-14,House,"Reported With Recommendation With Substitute  H-1",11,0,0,0,11
1074642,726365,2018-03-14,House,"Reported With Recommendation With Substitute H-1",11,0,0,0,11
1074642,727868,2018-03-22,House,"House Third Reading: Passed Roll Call # 208",102,7,0,0,109
1074652,719049,2018-03-07,House,"Reported With Recommendation With Substitute  H-1",16,0,0,0,16
1074652,726081,2018-03-07,House,"Reported With Recommendation With Substitute H-1",16,0,0,0,16
1074652,728029,2018-03-22,House,"House Third Reading: Given Immediate Effect Roll Call # 196",109,0,0,0,109
1074726,722960,2018-03-14,House,"Reported With Recommendation With Substitute  H-1",10,0,0,0,10
1074726,726501,2018-03-14,House,"Reported With Recommendation With Substitute H-1",10,0,0,0,10
1074726,727858,2018-03-22,House,"House Third Reading: Passed Roll Call # 210",106,3,0,0,109
1074737,696982,2018-02-07,House,"Reported With Recommendation Without Amendment",6,3,0,0,9
1074737,697950,2018-02-08,House,"House Third Reading: Given Immediate Effect Roll Call # 56",58,51,0,0,109
1074737,720638,2018-03-08,Senate,"Reported Favorably With Substitute  S-4",4,1,0,0,5
1074737,723729,2018-03-15,Senate,"Senate Third Reading: Given Immediate Effect Roll Call # 160",35,1,0,1,37
1074737,727366,2018-03-21,House,"House Third Reading: Roll Call # 174",83,25,0,0,108
1075523,698818,2018-02-08,Senate,"Reported Favorably Without Amendment",5,0,0,0,5
1075523,706389,2018-02-20,Senate,"Senate Third Reading: Passed Roll Call # 96",34,0,0,4,38
1075523,719345,2018-03-06,House,"Reported With Recommendation Without Amendment",12,0,0,0,12
1075523,727122,2018-03-21,House,"House Third Reading: Given Immediate Effect Roll Call # 188",102,6,0,0,108
1075852,699784,2018-02-06,Senate,"Reported Favorably Without Amendment",5,0,0,0,5
1075852,706382,2018-02-20,Senate,"Senate Third Reading: Passed Roll Call # 95",34,0,0,4,38
1075884,722382,2018-03-13,House,"Reported With Recommendation With Substitute  H-1",15,0,0,0,15
1075884,722383,2018-03-13,House,"Reported With Recommendation With Substitute H-1",15,0,0,0,15
1075884,737786,2018-04-11,House,"House Third Reading: Given Immediate Effect Roll Call # 213",108,1,0,0,109
1075884,750145,2018-05-03,Senate,"Reported Favorably Without Amendment",5,0,0,0,5
1075912,707967,2018-02-20,House,"Reported With Recommendation Without Amendment",14,0,0,0,14
1075912,749039,2018-05-01,House,"House Third Reading: Given Immediate Effect Roll Call # 259",109,0,0,0,109
1075938,722409,2018-03-13,House,"Reported With Recommendation Without Amendment",13,0,0,0,13
1075938,722410,2018-03-13,House,"Reported With Recommendation Without Amendment",13,0,0,0,13
1075938,737538,2018-04-11,House,"House Third Reading: Given Immediate Effect Roll Call # 212",108,1,0,0,109
1075938,750114,2018-05-03,Senate,"Reported Favorably With Substitute  S-1",5,0,0,0,5
1076025,778257,2018-11-08,House,"Reported With Recommendation With Substitute  H-2",10,0,0,0,10
1076025,780041,2018-12-05,House,"House Third Reading: Given Immediate Effect Roll Call # 678",106,2,0,0,108
1076025,780524,2018-12-12,Senate,"Reported Favorably With Substitute S-1",6,1,0,0,7
1076025,781406,2018-12-18,Senate,"Senate Third Reading: Given Immediate Effect Roll Call # 858",33,5,0,0,38
1076025,781529,2018-12-20,House,"House Third Reading: Roll Call # 951",106,2,0,0,108
1076144,778254,2018-11-08,House,"Reported With Recommendation With Substitute  H-3",10,0,0,0,10
1076144,779138,2018-11-08,House,"Reported With Recommendation With Substitute H-3",10,0,0,0,10
1076144,780134,2018-12-05,House,"House Third Reading: Given Immediate Effect Roll Call # 677",106,2,0,0,108
1076144,780620,2018-12-12,Senate,"Reported Favorably With Substitute  S-1",8,0,0,0,8
1076144,781305,2018-12-18,Senate,"Senate Third Reading: Given Immediate Effect Roll Call # 857",35,3,0,0,38
1076144,781640,2018-12-20,House,"House Third Reading: Roll Call # 950",106,2,0,0,108
1077466,738437,2018-04-12,Senate,"Reported Favorably Without Amendment",9,0,0,0,9
1077466,741164,2018-04-18,Senate,"Senate Third Reading: Passed Roll Call # 208",35,0,0,2,37
1077466,749086,2018-05-02,House,"Reported With Recommendation Without Amendment",15,0,0,0,15
1077466,753035,2018-05-10,House,"House Third Reading: Given Immediate Effect Roll Call # 278",103,3,0,0,106
1077558,738351,2018-04-12,Senate,"Reported Favorably Without Amendment",9,0,0,0,9
1077558,740983,2018-04-18,Senate,"Senate Third Reading: Passed Roll Call # 209",35,0,0,2,37
1077558,749083,2018-05-02,House,"Reported With Recommendation Without Amendment",15,0,0,0,15
1077558,753122,2018-05-10,House,"House Third Reading: Given Immediate Effect Roll Call # 279",99,8,0,0,107
1082449,707527,2018-02-21,House,"Reported With Recommendation Without Amendment",16,0,0,0,16
1082449,713781,2018-02-28,House,"House Third Reading: Given Immediate Effect Roll Call # 113",107,2,0,0,109
1082550,714733,2018-03-01,House,"Reported With Recommendation With Substitute  H-1",10,3,0,0,13
1082550,780554,2018-12-13,House,"House Third Reading: Passed Roll Call # 848",56,53,0,0,109
1082550,781249,2018-12-18,Senate,"Senate Third Reading: Passed Roll Call # 838",21,17,0,0,38
1083444,712119,2018-02-27,House,"Reported With Recommendation With Substitute  H-1",9,1,0,0,10
1083444,722333,2018-03-08,House,"House Third Reading: Given Immediate Effect Roll Call # 147",93,14,0,0,107
1083444,738305,2018-04-12,Senate,"Reported Favorably Without Amendment",5,0,0,0,5
1083444,745387,2018-04-26,Senate,"Senate Third Reading: Given Immediate Effect Roll Call # 234",35,0,0,2,37
1083582,712196,2018-02-27,House,"Reported With Recommendation With Substitute  H-2",11,1,0,0,12
1083582,722391,2018-03-08,House,"House Third Reading: Given Immediate Effect Roll Call # 146",106,1,0,0,107
1083582,738312,2018-04-12,Senate,"Reported Favorably With Substitute  S-1",5,0,0,0,5
1083582,745375,2018-04-26,Senate,"Senate Third Reading: Given Immediate Effect Roll Call # 233",35,0,0,2,37
1083582,745376,2018-04-26,Senate,"Senate Third Reading: Given Immediate Effect Roll Call # 233",35,0,0,2,37
1083582,745377,2018-04-26,House,"House Third Reading: Roll Call # 253",106,3,0,0,109
1084139,719134,2018-03-06,House,"Reported With Recommendation Without Amendment",12,0,0,0,12
1084139,758103,2018-05-22,Senate,"Reported Favorably Without Amendment",4,0,0,0,4
1084217,713947,2018-02-28,House,"Reported With Recommendation With Substitute H-1",15,0,0,0,15
1084356,759805,2018-06-05,House,"Reported With Recommendation Without Amendment",14,0,0,0,14
1084356,774961,2018-09-26,House,"House Third Reading: Given Immediate Effect Roll Call # 576",106,1,0,0,107
1084356,781342,2018-12-18,Senate,"Reported Favorably Without Amendment",5,0,0,0,5
1084356,781343,2018-12-18,Senate,"Senate Third Reading: Given Immediate Effect Roll Call # 871",38,0,0,0,38
1084384,756131,2018-05-23,House,"Reported With Recommendation Without Amendment",11,0,0,0,11
1084384,756132,2018-05-24,House,"House Third Reading: Given Immediate Effect Roll Call # 408",109,0,0,0,109
1084384,761208,2018-06-07,Senate,"Reported Favorably Without Amendment",4,0,0,0,4
1084384,779711,2018-12-04,Senate,"Senate Third Reading: Given Immediate Effect Roll Call # 660",36,0,0,2,38
1084398,719604,2018-03-06,House,"Reported With Recommendation With Amendment(s)",11,1,0,0,12
1084398,723057,2018-03-14,House,"House Third Reading: Given Immediate Effect Roll Call # 164",107,1,0,0,108
1084398,760931,2018-06-06,Senate,"Reported Favorably Without Amendment",4,0,0,0,4
1084398,762491,2018-06-12,Senate,"Senate Third Reading: Given Immediate Effect Roll Call # 441",36,0,0,1,37
1084398,764575,2018-06-12,House,"House Third Reading: Roll Call # 514",108,1,0,0,109
1084467,712201,2018-02-27,House,"Reported With Recommendation Without Amendment",11,1,0,0,12
1084467,722399,2018-03-08,House,"House Third Reading: Given Immediate Effect Roll Call # 148",106,1,0,0,107
1084467,738313,2018-04-12,Senate,"Reported Favorably Without Amendment",5,0,0,0,5
1084467,745308,2018-04-26,Senate,"Senate Third Reading: Given Immediate Effect Roll Call # 235",35,0,0,2,37
1084482,756143,2018-05-23,House,"Reported With Recommendation With Substitute  H-1",11,1,0,0,12
1084482,756144,2018-05-24,House,"House Third Reading: Given Immediate Effect Roll Call # 403",107,2,0,0,109
1084482,761084,2018-06-07,Senate,"Reported Favorably Without Amendment",4,0,0,0,4
1086758,722450,2018-03-13,Senate,"Reported Favorably With Substitute  S-1",5,0,0,0,5
1086758,779344,2018-11-29,Senate,"Senate Third Reading: Passed Roll Call # 620",38,0,0,0,38
1086758,780560,2018-12-11,House,"Reported With Recommendation Without Amendment",4,0,0,0,4
1086758,781101,2018-12-18,House,"House Third Reading: Given Immediate Effect Roll Call # 862",64,45,0,0,109
1086781,711962,2018-02-27,Senate,"Reported Favorably Without Amendment",5,0,0,0,5
1086781,720460,2018-03-08,Senate,"Senate Third Reading: Passed Roll Call # 138",36,0,0,1,37
1086781,727910,2018-03-22,House,"Reported With Recommendation Without Amendment",8,0,0,0,8
1086781,741885,2018-04-12,House,"House Third Reading: Given Immediate Effect Roll Call # 224",108,0,0,0,108
1086781,741886,2018-04-17,Senate,"Senate Third Reading: House Amendment(s) Concurred In Roll Call # 201",37,0,0,0,37
1086807,712039,2018-02-27,Senate,"Reported Favorably Without Amendment",5,0,0,0,5
1086807,720551,2018-03-08,Senate,"Senate Third Reading: Passed Roll Call # 136",36,0,0,1,37
1086807,727923,2018-03-22,House,"Reported With Recommendation Without Amendment",8,0,0,0,8
1086807,741853,2018-04-12,House,"House Third Reading: Given Immediate Effect Roll Call # 222",108,0,0,0,108
1086807,741854,2018-04-17,Senate,"Senate Third Reading: House Amendment(s) Concurred In Roll Call # 199",37,0,0,0,37
1086830,711709,2018-02-27,Senate,"Reported Favorably With Substitute  S-1",5,0,0,0,5
1086830,720771,2018-03-08,Senate,"Senate Third Reading: Passed Roll Call # 134",36,0,0,1,37
1086830,727920,2018-03-22,House,"Reported With Recommendation With Substitute  H-1",8,0,0,0,8
1086830,736020,2018-03-22,House,"Reported With Recommendation With Substitute H-1",8,0,0,0,8
1086830,737539,2018-04-11,House,"House Third Reading: Given Immediate Effect Roll Call # 216",107,2,0,0,109
1086830,740048,2018-04-17,Senate,"Senate Third Reading: Roll Call # 197",37,0,0,0,37
1086859,715046,2018-03-01,Senate,"Reported Favorably Without Amendment",5,0,0,0,5
1086859,723801,2018-03-15,Senate,"Senate Third Reading: Passed Roll Call # 158",35,0,0,2,37
1086859,756013,2018-05-23,House,"Reported With Recommendation Without Amendment",12,1,0,0,13
1086859,760643,2018-06-06,House,"House Third Reading: Given Immediate Effect Roll Call # 456",105,3,0,0,108
1086859,762557,2018-06-12,Senate,"Senate Third Reading: Roll Call # 536",36,0,0,1,37
1086907,711956,2018-02-27,Senate,"Reported Favorably With Substitute  S-1",5,0,0,0,5
1086907,720203,2018-03-08,Senate,"Senate Third Reading: Passed Roll Call # 137",36,0,0,1,37
1086907,727906,2018-03-22,House,"Reported With Recommendation With Substitute  H-1",8,0,0,0,8
1086907,736223,2018-03-22,House,"Reported With Recommendation With Substitute H-1",8,0,0,0,8
1086907,742110,2018-04-12,House,"House Third Reading: Given Immediate Effect Roll Call # 223",108,0,0,0,108
1086907,742111,2018-04-17,Senate,"Senate Third Reading: Roll Call # 200",37,0,0,0,37
1086933,715051,2018-03-01,Senate,"Reported Favorably Without Amendment",5,0,0,0,5
1086933,723802,2018-03-15,Senate,"Senate Third Reading: Passed Roll Call # 159",36,0,0,1,37
1086933,755999,2018-05-23,House,"Reported With Recommendation Without Amendment",12,1,0,0,13
1086933,761078,2018-06-07,House,"House Third Reading: Given Immediate Effect Roll Call # 457",104,4,0,0,108
1086985,712413,2018-02-27,Senate,"Reported Favorably Without Amendment",5,0,0,0,5
1086985,720711,2018-03-08,Senate,"Senate Third Reading: Passed Roll Call # 139",36,0,0,1,37
1086985,727907,2018-03-22,House,"Reported With Recommendation With Substitute  H-2",8,0,0,0,8
1086985,736040,2018-03-22,House,"Reported With Recommendation With Substitute H-2",8,0,0,0,8
1086985,742098,2018-04-12,House,"House Third Reading: Given Immediate Effect Roll Call # 225",108,0,0,0,108
1086985,742099,2018-04-17,Senate,"Senate Third Reading: Roll Call # 202",37,0,0,0,37
1087013,722444,2018-03-13,Senate,"Reported Favorably Without Amendment",4,0,0,0,4
1087013,726043,2018-03-20,Senate,"Senate Third Reading: Passed Roll Call # 169",37,0,0,0,37
1087013,740661,2018-04-17,House,"Reported With Recommendation Without Amendment",14,0,0,0,14
1087013,749100,2018-05-01,House,"House Third Reading: Given Immediate Effect Roll Call # 262",109,0,0,0,109
1087037,711983,2018-02-27,Senate,"Reported Favorably Without Amendment",5,0,0,0,5
1087037,720510,2018-03-08,Senate,"Senate Third Reading: Passed Roll Call # 135",36,0,0,1,37
1087037,727903,2018-03-22,House,"Reported With Recommendation With Substitute  H-1",8,0,0,0,8
1087037,735869,2018-03-22,House,"Reported With Recommendation With Substitute H-1",8,0,0,0,8
1087037,741959,2018-04-12,House,"House Third Reading: Given Immediate Effect Roll Call # 221",108,0,0,0,108
1087037,741960,2018-04-17,Senate,"Senate Third Reading: Roll Call # 198",37,0,0,0,37
1087064,753492,2018-05-15,Senate,"Reported Favorably With Substitute  S-2",5,0,0,0,5
1087064,775083,2018-09-26,Senate,"Senate Third Reading: Passed Roll Call # 563",36,0,0,1,37
1087064,780452,2018-12-11,House,"Reported With Recommendation Without Amendment",13,0,0,0,13
1087228,725091,2018-03-15,House,"Reported With Recommendation With Substitute  H-1",9,0,0,0,9
1087228,774912,2018-09-26,House,"House Third Reading: Given Immediate Effect Roll Call # 574",107,0,0,0,107
1087334,781215,2018-12-19,House,"Reported With Recommendation With Substitute  H-1",10,2,0,0,12
1087436,725141,2018-03-15,House,"Reported With Recommendation With Substitute  H-1",9,0,0,0,9
1087436,774952,2018-09-26,House,"House Third Reading: Given Immediate Effect Roll Call # 575",107,0,0,0,107
1088819,741837,2018-04-19,House,"Reported With Recommendation With Substitute  H-1",18,4,0,0,22
1088819,742984,2018-04-19,House,"Reported With Recommendation With Substitute H-1",18,4,0,0,22
1088819,745077,2018-04-24,House,"House Third Reading: Given Immediate Effect Roll Call # 244",66,41,0,0,107
1088858,752859,2018-05-09,House,"Reported With Recommendation With Substitute H-2",28,0,0,0,28
1088858,755085,2018-05-15,House,"House Third Reading: Passed Roll Call # 299",107,1,0,0,108
1088858,755504,2018-05-22,Senate,"Senate Third Reading: Passed Roll Call # 319",26,10,0,1,37
1088858,756077,2018-05-23,House,"House Third Reading: Roll Call # 366",0,109,0,0,109
1088922,741839,2018-04-19,House,"Reported With Recommendation With Substitute  H-1",19,6,0,0,25
1088922,742987,2018-04-19,House,"Reported With Recommendation With Substitute H-1",19,6,0,0,25
1088922,745255,2018-04-24,House,"House Third Reading: Given Immediate Effect Roll Call # 245",71,36,0,0,107
1088922,755543,2018-05-22,Senate,"Senate Third Reading: Passed Roll Call # 315",26,10,0,1,37
1088922,756151,2018-05-23,House,"House Third Reading: Roll Call # 371",0,109,0,0,109
1088922,764661,2018-06-12,House,"House Third Reading: Conference Report Adopted Roll Call # 483",63,46,0,0,109
1088922,764662,2018-06-12,Senate,"Senate Third Reading: Senate Adopted Conference Report With Immediate Effect Roll Call # 445",25,11,0,1,37
1088942,752838,2018-05-09,House,"Reported With Recommendation With Substitute H-2",28,0,0,0,28
1088942,755070,2018-05-15,House,"House Third Reading: Passed Roll Call # 301",107,1,0,0,108
1088942,755483,2018-05-22,Senate,"Senate Third Reading: Passed Roll Call # 321",26,10,0,1,37
1088942,756066,2018-05-23,House,"House Third Reading: Roll Call # 368",0,109,0,0,109
1088953,752858,2018-05-09,House,"Reported With Recommendation With Substitute H-2",28,0,0,0,28
1088953,755089,2018-05-15,House,"House Third Reading: Passed Roll Call # 297",107,1,0,0,108
1088953,755502,2018-05-22,Senate,"Senate Third Reading: Passed Roll Call # 317",26,10,0,1,37
1088953,756083,2018-05-23,House,"House Third Reading: Roll Call # 364",0,109,0,0,109
1088990,753045,2018-05-09,House,"Reported With Recommendation With Substitute H-2",28,0,0,0,28
1088990,755207,2018-05-15,House,"House Third Reading: Passed Roll Call # 302",107,1,0,0,108
1088990,755618,2018-05-22,Senate,"Senate Third Reading: Passed Roll Call # 322",26,10,0,1,37
1088990,756002,2018-05-23,House,"House Third Reading: Roll Call # 369",0,109,0,0,109
1089014,753109,2018-05-09,House,"Reported With Recommendation With Substitute H-2",28,0,0,0,28
1089014,755007,2018-05-15,House,"House Third Reading: Passed Roll Call # 303",107,1,0,0,108
1089014,755666,2018-05-22,Senate,"Senate Third Reading: Passed Roll Call # 323",26,10,0,1,37
1089014,756032,2018-05-23,House,"House Third Reading: Roll Call # 370",0,109,0,0,109
1089022,752958,2018-05-09,House,"Reported With Recommendation With Substitute H-2",28,0,0,0,28
1089022,755163,2018-05-15,House,"House Third Reading: Passed Roll Call # 298",107,1,0,0,108
1089022,755568,2018-05-22,Senate,"Senate Third Reading: Passed Roll Call # 318",26,10,0,1,37
1089022,756165,2018-05-23,House,"House Third Reading: Roll Call # 365",0,109,0,0,109
1089040,752861,2018-05-09,House,"Reported With Recommendation With Substitute H-2",28,0,0,0,28
1089040,755082,2018-05-15,House,"House Third Reading: Passed Roll Call # 300",105,3,0,0,108
1089040,755626,2018-05-22,Senate,"Senate Third Reading: Passed Roll Call # 320",26,10,0,1,37
1089040,756003,2018-05-23,House,"House Third Reading: Roll Call # 367",0,109,0,0,109
1089061,752857,2018-05-09,House,"Reported With Recommendation With Substitute H-2",28,0,0,0,28
1089061,755066,2018-05-15,House,"House Third Reading: Passed Roll Call # 296",106,2,0,0,108
1089061,755477,2018-05-22,Senate,"Senate Third Reading: Passed Roll Call # 316",26,10,0,1,37
1089061,756068,2018-05-23,House,"House Third Reading: Roll Call # 363",0,109,0,0,109
1089497,779306,2018-11-29,Senate,"Reported Favorably Without Amendment",9,0,0,0,9
1089525,779298,2018-11-29,Senate,"Reported Favorably Without Amendment",9,0,0,0,9
1089587,723744,2018-03-15,Senate,"Reported Favorably Without Amendment",6,1,0,0,7
1089587,755008,2018-05-17,Senate,"Senate Third Reading: Passed Roll Call # 305",24,11,0,2,37
1089619,709021,2018-02-22,Senate,"Reported Favorably With Substitute  S-1",5,0,0,0,5
1089619,762499,2018-06-12,Senate,"Senate Third Reading: Passed Roll Call # 509",36,0,0,1,37
1089899,719305,2018-03-07,House,"Reported With Recommendation With Substitute  H-1",16,0,0,0,16
1089899,722940,2018-03-14,House,"House Third Reading: Given Immediate Effect Roll Call # 165",107,1,0,0,108
1089899,752254,2018-05-10,Senate,"Reported Favorably Without Amendment",8,0,0,0,8
1089899,754184,2018-05-16,Senate,"Senate Third Reading: Given Immediate Effect Roll Call # 302",37,0,0,0,37
1093673,779157,2018-11-29,Senate,"Reported Favorably Without Amendment",5,0,0,0,5
1093678,752994,2018-05-09,House,"Reported With Recommendation With Substitute  H-3",15,0,0,0,15
1093678,758305,2018-05-29,House,"House Third Reading: Given Immediate Effect Roll Call # 421",107,0,0,0,107
1093678,780236,2018-12-06,Senate,"Reported Favorably Without Amendment",9,0,0,0,9
1093678,781248,2018-12-18,Senate,"Senate Third Reading: Given Immediate Effect Roll Call # 841",38,0,0,0,38
1093678,781580,2018-12-20,House,"House Third Reading: Roll Call # 952",106,1,0,0,107
1093683,727877,2018-03-22,House,"Reported With Recommendation With Substitute  H-2",12,1,0,0,13
1093688,714983,2018-03-01,House,"Reported With Recommendation With Substitute  H-1",15,1,0,0,16
1093688,722386,2018-03-13,House,"House Third Reading: Given Immediate Effect Roll Call # 162",107,2,0,0,109
1093688,779356,2018-11-29,Senate,"Reported Favorably Without Amendment",10,0,0,0,10
1093688,781246,2018-12-18,Senate,"Senate Third Reading: Given Immediate Effect Roll Call # 840",38,0,0,0,38
1093694,779214,2018-11-28,House,"Reported With Recommendation With Substitute  H-2",9,0,0,0,9
1093699,779220,2018-11-28,House,"Reported With Recommendation With Substitute  H-1",9,0,0,0,9
1093705,779208,2018-11-28,House,"Reported With Recommendation With Substitute  H-1",9,0,0,0,9
1093726,727891,2018-03-22,House,"Reported With Recommendation With Substitute  H-2",15,0,0,0,15
1093726,779995,2018-12-05,House,"House Third Reading: Given Immediate Effect Roll Call # 682",98,10,0,0,108
1093737,727883,2018-03-22,House,"Reported With Recommendation With Substitute  H-1",11,1,0,0,12
1093737,780098,2018-12-05,House,"House Third Reading: Given Immediate Effect Roll Call # 681",60,48,0,0,108
1093748,727882,2018-03-22,House,"Reported With Recommendation With Substitute  H-3",14,1,0,0,15
1093756,779213,2018-11-28,House,"Reported With Recommendation With Substitute  H-1",9,0,0,0,9
1093774,779219,2018-11-28,House,"Reported With Recommendation With Substitute  H-1",9,0,0,0,9
1093779,727880,2018-03-22,House,"Reported With Recommendation With Substitute  H-2",14,1,0,0,15
1093779,779996,2018-12-05,House,"House Third Reading: Given Immediate Effect Roll Call # 683",98,10,0,0,108
1093807,779192,2018-11-28,House,"Reported With Recommendation With Substitute  H-1",9,0,0,0,9
1093817,727897,2018-03-22,House,"Reported With Recommendation With Substitute  H-1",14,1,0,0,15
1093817,780123,2018-12-05,House,"House Third Reading: Given Immediate Effect Roll Call # 686",91,17,0,0,108
1093824,727900,2018-03-22,House,"Reported With Recommendation With Substitute  H-3",14,1,0,0,15
1093824,779950,2018-12-05,House,"House Third Reading: Given Immediate Effect Roll Call # 685",88,20,0,0,108
1093829,727885,2018-03-22,House,"Reported With Recommendation With Substitute  H-2",14,1,0,0,15
1094234,714904,2018-03-01,Senate,"Reported Favorably Without Amendment",5,0,0,0,5
1094234,780193,2018-12-05,Senate,"Senate Third Reading: Passed Roll Call # 682",37,0,0,1,38
1094234,780194,2018-12-05,Senate,"Senate Third Reading: Passed Roll Call # 682",37,0,0,1,38
1094234,781059,2018-12-18,House,"Reported With Recommendation With Substitute  H-3",9,0,0,0,9
1094234,781060,2018-12-18,House,"House Third Reading: Given Immediate Effect Roll Call # 871",103,6,0,0,109
1094234,781496,2018-12-19,Senate,"Senate Third Reading: Roll Call # 918",38,0,0,0,38
1094303,740177,2018-04-17,Senate,"Reported Favorably With Substitute  S-1",3,1,0,0,4
1094372,745310,2018-04-24,Senate,"Reported Favorably Without Amendment",5,0,0,0,5
1094372,755840,2018-05-23,Senate,"Senate Third Reading: Passed Roll Call # 340",26,11,0,0,37
1094372,764443,2018-06-12,House,"Reported With Recommendation Without Amendment",9,1,0,0,10
1094372,764444,2018-06-12,House,"House Third Reading: Given Immediate Effect Roll Call # 524",95,14,0,0,109
1094372,764445,2018-06-12,Senate,"Senate Third Reading: Roll Call # 551",25,11,0,1,37
1094465,722923,2018-03-14,House,"Reported With Recommendation With Substitute  H-1",13,0,0,0,13
1094465,726312,2018-03-14,House,"Reported With Recommendation With Substitute H-1",13,0,0,0,13
1094465,727862,2018-03-22,House,"House Third Reading: Given Immediate Effect Roll Call # 197",109,0,0,0,109
1094465,753725,2018-05-15,Senate,"Reported Favorably With Substitute  S-1",6,0,0,0,6
1094465,755042,2018-05-17,Senate,"Senate Third Reading: Given Immediate Effect Roll Call # 308",36,0,0,1,37
1094465,755452,2018-05-22,House,"House Third Reading: Roll Call # 348",107,1,0,0,108
1094510,722927,2018-03-14,House,"Reported With Recommendation With Substitute  H-1",13,0,0,0,13
1094510,726340,2018-03-14,House,"Reported With Recommendation With Substitute H-1",13,0,0,0,13
1094510,727867,2018-03-22,House,"House Third Reading: Given Immediate Effect Roll Call # 198",109,0,0,0,109
1094510,753606,2018-05-15,Senate,"Reported Favorably With Substitute  S-1",6,0,0,0,6
1094510,754974,2018-05-17,Senate,"Senate Third Reading: Given Immediate Effect Roll Call # 309",36,0,0,1,37
1094510,755405,2018-05-22,House,"House Third Reading: Roll Call # 349",107,1,0,0,108
1094602,719140,2018-03-06,House,"Reported With Recommendation With Substitute  H-1",15,0,0,0,15
1094602,723208,2018-03-14,House,"House Third Reading: Given Immediate Effect Roll Call # 166",80,28,0,0,108
1094623,779042,2018-11-27,House,"Reported With Recommendation Without Amendment",11,0,0,0,11
1094623,780020,2018-12-06,House,"House Third Reading: Given Immediate Effect Roll Call # 721",109,0,0,0,109
1094642,755395,2018-05-22,House,"Reported With Recommendation Without Amendment",14,0,0,0,14
1094642,757908,2018-05-30,House,"House Third Reading: Given Immediate Effect Roll Call # 431",107,0,0,0,107
1094642,781351,2018-12-18,Senate,"Reported Favorably With Substitute  S-1",5,0,0,0,5
1094642,781352,2018-12-18,Senate,"Senate Third Reading: Given Immediate Effect Roll Call # 872",38,0,0,0,38
1094642,781619,2018-12-20,House,"House Third Reading: Roll Call # 953",108,0,0,0,108
1095169,720772,2018-03-08,Senate,"Reported Favorably With Substitute  S-1",4,1,0,0,5
1095169,727944,2018-03-22,Senate,"Senate Third Reading: Passed Roll Call # 176",23,11,0,3,37
1095169,749247,2018-05-02,House,"Reported With Recommendation Without Amendment",7,2,0,0,9
1095169,755013,2018-05-15,House,"House Third Reading: Given Immediate Effect Roll Call # 285",66,42,0,0,108
1095212,720717,2018-03-08,Senate,"Reported Favorably Without Amendment",4,1,0,0,5
1095212,727928,2018-03-22,Senate,"Senate Third Reading: Passed Roll Call # 175",23,11,0,3,37
1095212,749203,2018-05-02,House,"Reported With Recommendation With Amendment(s)",7,2,0,0,9
1095212,754977,2018-05-15,House,"House Third Reading: Passed Roll Call # 304",64,44,0,0,108
1095212,754978,2018-05-15,House,"House Third Reading: Given Immediate Effect Roll Call # 305",63,45,0,0,108
1095212,754979,2018-05-16,Senate,"Senate Third Reading: House Amendment(s) Concurred In Roll Call # 304",25,12,0,0,37
1095255,714766,2018-03-01,Senate,"Reported Favorably Without Amendment",5,0,0,0,5
1095255,718921,2018-03-07,Senate,"Senate Third Reading: Passed Roll Call # 132",35,0,0,2,37
1095255,726216,2018-03-20,House,"Reported With Recommendation Without Amendment",15,0,0,0,15
1095255,742017,2018-04-17,House,"House Third Reading: Given Immediate Effect Roll Call # 228",107,1,0,0,108
1095326,752930,2018-05-09,House,"Reported With Recommendation With Substitute  H-3",6,2,0,0,8
1095326,753785,2018-05-09,House,"Reported With Recommendation With Substitute H-3",6,2,0,0,8
1095326,755057,2018-05-17,House,"House Third Reading: Given Immediate Effect Roll Call # 344",93,15,0,0,108
1095326,756886,2018-05-24,Senate,"Reported Favorably Without Amendment",4,1,0,0,5
1095326,756887,2018-05-24,Senate,"Reported Favorably Without Amendment",4,1,0,0,5
1095326,760684,2018-06-06,Senate,"Senate Third Reading: Given Immediate Effect Roll Call # 396",30,7,0,0,37
1095414,779204,2018-11-28,House,"Reported With Recommendation With Substitute  H-1",9,2,0,0,11
1095448,722570,2018-03-08,House,"Reported With Recommendation Without Amendment",9,5,0,0,14
1095448,728031,2018-03-22,House,"House Third Reading: Given Immediate Effect Roll Call # 201",56,53,0,0,109
1095480,718991,2018-03-06,House,"Reported With Recommendation With Substitute  H-1",9,2,0,0,11
1095480,737421,2018-03-06,House,"Reported With Recommendation With Substitute H-1",9,2,0,0,11
1095480,780582,2018-12-11,House,"House Third Reading: Given Immediate Effect Roll Call # 777",72,36,0,0,108
1095480,781431,2018-12-18,Senate,"Reported Favorably Without Amendment",5,0,0,0,5
1095480,781432,2018-12-18,Senate,"Senate Third Reading: Given Immediate Effect Roll Call # 891",20,18,0,0,38
1095497,752948,2018-05-09,House,"Reported With Recommendation With Substitute  H-1",12,0,0,0,12
1095497,753481,2018-05-09,House,"Reported With Recommendation With Substitute H-1",12,0,0,0,12
1095497,755161,2018-05-17,House,"House Third Reading: Given Immediate Effect Roll Call # 339",108,0,0,0,108
1096944,714709,2018-03-01,Senate,"Reported Favorably Without Amendment",4,0,0,0,4
1096944,723096,2018-03-14,Senate,"Senate Third Reading: Passed Roll Call # 157",35,0,0,2,37
1096944,756111,2018-05-23,House,"Reported With Recommendation With Substitute  H-1",10,1,0,0,11
1096944,756112,2018-05-24,House,"House Third Reading: Given Immediate Effect Roll Call # 413",108,1,0,0,109
1096952,714703,2018-03-01,Senate,"Reported Favorably Without Amendment",4,0,0,0,4
1096952,723102,2018-03-14,Senate,"Senate Third Reading: Passed Roll Call # 152",29,6,0,2,37
1096960,714702,2018-03-01,Senate,"Reported Favorably Without Amendment",4,0,0,0,4
1096960,723529,2018-03-14,Senate,"Senate Third Reading: Passed Roll Call # 153",30,5,0,2,37
1096966,747524,2018-05-01,Senate,"Reported Favorably With Substitute  S-1",12,3,0,0,15
1096966,750355,2018-05-03,Senate,"Senate Third Reading: Passed Roll Call # 275",27,9,0,1,37
1096966,755044,2018-05-15,House,"House Third Reading: Passed Roll Call # 295",106,2,0,0,108
1096966,755808,2018-05-23,Senate,"Senate Third Reading: Roll Call # 334",0,37,0,0,37
1096977,747325,2018-05-01,Senate,"Reported Favorably With Substitute  S-1",12,5,0,0,17
1096977,750151,2018-05-03,Senate,"Senate Third Reading: Passed Roll Call # 267",27,9,0,1,37
1096977,755114,2018-05-15,House,"House Third Reading: Passed Roll Call # 291",106,2,0,0,108
1096977,755862,2018-05-23,Senate,"Senate Third Reading: Roll Call # 330",0,37,0,0,37
1096982,745433,2018-04-24,Senate,"Reported Favorably With Substitute  S-1",17,0,0,0,17
1096982,750123,2018-05-03,Senate,"Senate Third Reading: Passed Roll Call # 248",36,0,0,1,37
1096982,755001,2018-05-15,House,"House Third Reading: Passed Roll Call # 288",106,2,0,0,108
1096982,755873,2018-05-23,Senate,"Senate Third Reading: Roll Call # 327",0,37,0,0,37
1096990,714725,2018-03-01,Senate,"Reported Favorably Without Amendment",4,0,0,0,4
1096990,723465,2018-03-14,Senate,"Senate Third Reading: Passed Roll Call # 154",28,7,0,2,37
1096994,747312,2018-05-01,Senate,"Reported Favorably With Substitute  S-1",17,0,0,0,17
1096994,750201,2018-05-03,Senate,"Senate Third Reading: Passed Roll Call # 263",36,0,0,1,37
1096997,745369,2018-04-24,Senate,"Reported Favorably With Substitute  S-1",17,0,0,0,17
1096997,750076,2018-05-03,Senate,"Senate Third Reading: Passed Roll Call # 249",36,0,0,1,37
1096997,755079,2018-05-15,House,"House Third Reading: Passed Roll Call # 289",107,1,0,0,108
1096997,755829,2018-05-23,Senate,"Senate Third Reading: Roll Call # 328",0,37,0,0,37
1097003,714711,2018-03-01,Senate,"Reported Favorably Without Amendment",4,0,0,0,4
1097003,723047,2018-03-14,Senate,"Senate Third Reading: Passed Roll Call # 155",35,0,0,2,37
1097010,745320,2018-04-24,Senate,"Reported Favorably With Substitute  S-1",12,5,0,0,17
1097010,750189,2018-05-03,Senate,"Senate Third Reading: Passed Roll Call # 258",24,12,0,1,37
1097010,750190,2018-05-03,Senate,"Senate Third Reading: Passed Roll Call # 259",27,9,0,1,37
1097010,755214,2018-05-15,House,"House Third Reading: Passed Roll Call # 290",106,2,0,0,108
1097010,755743,2018-05-23,Senate,"Senate Third Reading: Roll Call # 329",0,37,0,0,37
1097017,745423,2018-04-24,Senate,"Reported Favorably With Substitute  S-1",17,0,0,0,17
1097017,750107,2018-05-03,Senate,"Senate Third Reading: Passed Roll Call # 251",36,0,0,1,37
1097028,745592,2018-04-24,Senate,"Reported Favorably With Substitute  S-1",17,0,0,0,17
1097028,750134,2018-05-03,Senate,"Senate Third Reading: Passed Roll Call # 247",36,0,0,1,37
1097032,714759,2018-03-01,Senate,"Reported Favorably Without Amendment",4,0,0,0,4
1097032,723386,2018-03-14,Senate,"Senate Third Reading: Passed Roll Call # 147",35,0,0,2,37
1097032,756005,2018-05-23,House,"Reported With Recommendation With Substitute  H-2",10,2,0,0,12
1097032,756006,2018-05-24,House,"House Third Reading: Given Immediate Effect Roll Call # 391",108,1,0,0,109
1097032,757431,2018-05-29,Senate,"Senate Third Reading: Roll Call # 360",36,0,0,1,37
1097039,745399,2018-04-24,Senate,"Reported Favorably With Substitute  S-1",17,0,0,0,17
1097039,750115,2018-05-03,Senate,"Senate Third Reading: Passed Roll Call # 254",36,0,0,1,37
1097039,754973,2018-05-15,House,"House Third Reading: Passed Roll Call # 294",106,2,0,0,108
1097039,755745,2018-05-23,Senate,"Senate Third Reading: Roll Call # 333",0,37,0,0,37
1097043,738350,2018-04-12,Senate,"Reported Favorably Without Amendment",5,0,0,0,5
1097043,741192,2018-04-18,Senate,"Senate Third Reading: Passed Roll Call # 207",35,0,0,2,37
1097043,774908,2018-09-25,House,"Reported With Recommendation Without Amendment",12,0,0,0,12
1097043,781135,2018-12-18,House,"House Third Reading: Given Immediate Effect Roll Call # 860",104,5,0,0,109
1097043,781411,2018-12-19,Senate,"Senate Third Reading: Roll Call # 912",38,0,0,0,38
1097043,781531,2018-12-21,House,"House Third Reading: Passed Roll Call # 1023",104,3,0,0,107
1097043,781652,2018-12-21,Senate,"Senate Third Reading: Roll Call # 1056",37,0,0,1,38
1097056,714761,2018-03-01,Senate,"Reported Favorably Without Amendment",4,0,0,0,4
1097056,723091,2018-03-14,Senate,"Senate Third Reading: Passed Roll Call # 150",34,1,0,2,37
1097063,780116,2018-12-06,Senate,"Reported Favorably With Substitute  S-1",8,1,0,0,9
1097066,745412,2018-04-24,Senate,"Reported Favorably With Substitute  S-1",10,5,0,0,15
1097066,750090,2018-05-03,Senate,"Senate Third Reading: Passed Roll Call # 271",27,9,0,1,37
1097073,714717,2018-03-01,Senate,"Reported Favorably With Substitute S-1",4,0,0,0,4
1097073,723014,2018-03-14,Senate,"Senate Third Reading: Passed Roll Call # 151",34,1,0,2,37
1097073,756078,2018-05-23,House,"Reported With Recommendation With Substitute  H-1",10,0,0,0,10
1097073,756079,2018-05-24,House,"House Third Reading: Given Immediate Effect Roll Call # 412",107,2,0,0,109
1097083,740922,2018-04-18,Senate,"Reported Favorably Without Amendment",5,0,0,0,5
1097083,748188,2018-05-02,Senate,"Senate Third Reading: Passed Roll Call # 243",37,0,0,0,37
1097096,747307,2018-05-01,Senate,"Reported Favorably With Substitute  S-1",11,6,0,0,17
1097096,750091,2018-05-03,Senate,"Senate Third Reading: Passed Roll Call # 262",25,11,0,1,37
1097107,745307,2018-04-24,Senate,"Reported Favorably With Substitute  S-1",17,0,0,0,17
1097107,750109,2018-05-03,Senate,"Senate Third Reading: Passed Roll Call # 252",36,0,0,1,37
1097107,755127,2018-05-15,House,"House Third Reading: Passed Roll Call # 293",107,1,0,0,108
1097107,755874,2018-05-23,Senate,"Senate Third Reading: Roll Call # 332",0,37,0,0,37
1097114,745548,2018-04-24,Senate,"Reported Favorably With Substitute  S-1",17,0,0,0,17
1097114,750326,2018-05-03,Senate,"Senate Third Reading: Passed Roll Call # 255",36,0,0,1,37
1097126,745378,2018-04-24,Senate,"Reported Favorably With Substitute  S-1",12,5,0,0,17
1097126,750104,2018-05-03,Senate,"Senate Third Reading: Passed Roll Call # 269",27,9,0,1,37
1097130,714598,2018-03-01,Senate,"Reported Favorably Without Amendment",4,0,0,0,4
1097130,723423,2018-03-14,Senate,"Senate Third Reading: Passed Roll Call # 149",28,7,0,2,37
1097130,756138,2018-05-23,House,"Reported With Recommendation With Substitute  H-1",8,1,0,0,9
1097130,756139,2018-05-24,House,"House Third Reading: Given Immediate Effect Roll Call # 392",99,10,0,0,109
1097130,757387,2018-05-29,Senate,"Senate Third Reading: Roll Call # 361",34,2,0,1,37
1097136,745410,2018-04-24,Senate,"Reported Favorably With Substitute  S-1",16,0,0,0,16
1097136,750127,2018-05-03,Senate,"Senate Third Reading: Passed Roll Call # 250",36,0,0,1,37
1097136,755150,2018-05-15,House,"House Third Reading: Passed Roll Call # 292",106,2,0,0,108
1097136,755893,2018-05-23,Senate,"Senate Third Reading: Roll Call # 331",0,37,0,0,37
1097143,752202,2018-05-10,Senate,"Senate Third Reading: Passed Roll Call # 285",25,10,0,2,37
1097143,755016,2018-05-15,House,"House Third Reading: Given Immediate Effect Roll Call # 309",105,3,0,0,108
1097143,755886,2018-05-23,Senate,"Senate Third Reading: Roll Call # 326",0,37,0,0,37
1097143,762346,2018-06-12,Senate,"Senate Third Reading: Senate Adopted Conference Report With Immediate Effect Roll Call # 436",33,2,1,1,37
1097143,764411,2018-06-12,House,"House Third Reading: Conference Report Adopted Roll Call # 484",66,43,0,0,109
1097148,745502,2018-04-24,Senate,"Reported Favorably With Substitute  S-1",17,0,0,0,17
1097148,750130,2018-05-03,Senate,"Senate Third Reading: Passed Roll Call # 253",36,0,0,1,37
1097153,755788,2018-05-23,Senate,"Reported Favorably With Substitute  S-1",10,0,0,0,10
1097153,757971,2018-05-30,Senate,"Senate Third Reading: Passed Roll Call # 385",32,0,0,5,37
1097153,779160,2018-11-28,House,"Reported With Recommendation Without Amendment",15,0,0,0,15
1097153,780513,2018-12-12,House,"House Third Reading: Given Immediate Effect Roll Call # 814",106,3,0,0,109
1097159,714748,2018-03-01,Senate,"Reported Favorably Without Amendment",4,0,0,0,4
1097159,723488,2018-03-14,Senate,"Senate Third Reading: Passed Roll Call # 156",35,0,0,2,37
1097180,757917,2018-05-29,House,"Reported With Recommendation Without Amendment",14,0,0,0,14
1097180,774295,2018-09-05,House,"House Third Reading: Given Immediate Effect Roll Call # 565",105,1,0,0,106
1097180,779725,2018-12-04,Senate,"Reported Favorably With Substitute  S-1",5,0,0,0,5
1097180,780345,2018-12-11,Senate,"Senate Third Reading: Given Immediate Effect Roll Call # 754",38,0,0,0,38
1097180,780451,2018-12-12,House,"House Third Reading: Roll Call # 812",108,1,0,0,109
1097204,722446,2018-03-08,House,"Reported With Recommendation With Substitute H-1",9,0,0,0,9
1097204,724883,2018-03-15,House,"House Third Reading: Given Immediate Effect Roll Call # 170",105,1,0,0,106
1097204,740152,2018-04-17,Senate,"Reported Favorably With Substitute  S-1",5,0,0,0,5
1097204,741133,2018-04-18,Senate,"Senate Third Reading: Given Immediate Effect Roll Call # 210",35,0,0,2,37
1097204,741833,2018-04-19,House,"House Third Reading: Roll Call # 232",107,2,0,0,109
1097214,756007,2018-05-23,House,"Reported With Recommendation With Substitute  H-2",10,1,0,0,11
1097214,756008,2018-05-24,House,"House Third Reading: Given Immediate Effect Roll Call # 401",107,2,0,0,109
1097214,761131,2018-06-07,Senate,"Reported Favorably Without Amendment",4,0,0,0,4
1097214,779740,2018-12-04,Senate,"Senate Third Reading: Given Immediate Effect Roll Call # 662",35,0,1,2,38
1097223,722365,2018-03-08,House,"Reported With Recommendation With Substitute  H-1",9,0,0,0,9
1097223,722790,2018-03-08,House,"Reported With Recommendation With Substitute H-1",9,0,0,0,9
1097223,724890,2018-03-15,House,"House Third Reading: Given Immediate Effect Roll Call # 171",101,5,0,0,106
1097223,740036,2018-04-17,Senate,"Reported Favorably With Substitute  S-1",5,0,0,0,5
1097223,741004,2018-04-18,Senate,"Senate Third Reading: Given Immediate Effect Roll Call # 211",35,0,0,2,37
1097223,741836,2018-04-19,House,"House Third Reading: Roll Call # 233",107,2,0,0,109
1097242,756103,2018-05-23,House,"Reported With Recommendation With Substitute  H-2",10,1,0,0,11
1097242,756104,2018-05-24,House,"House Third Reading: Given Immediate Effect Roll Call # 402",107,2,0,0,109
1097242,761215,2018-06-07,Senate,"Reported Favorably Without Amendment",4,0,0,0,4
1097242,779770,2018-12-04,Senate,"Senate Third Reading: Given Immediate Effect Roll Call # 663",36,0,0,2,38
1097257,748997,2018-05-01,House,"Reported With Recommendation With Substitute  H-1",9,5,0,0,14
1097257,780042,2018-12-05,House,"House Third Reading: Given Immediate Effect Roll Call # 680",63,45,0,0,108
1097257,781429,2018-12-20,Senate,"Senate Third Reading: Given Immediate Effect Roll Call # 1025",27,11,0,0,38
1097257,781624,2018-12-20,House,"House Third Reading: Senate Amendment(s) Concurred In Roll Call # 972",64,43,0,0,107
1097270,757903,2018-05-29,House,"Reported With Recommendation Without Amendment",14,0,0,0,14
1097277,719303,2018-03-07,House,"Reported With Recommendation Without Amendment",9,0,0,0,9
1097277,726969,2018-03-21,House,"House Third Reading: Given Immediate Effect Roll Call # 182",107,1,0,0,108
1097277,756900,2018-05-24,Senate,"Reported Favorably Without Amendment",7,0,0,0,7
1097277,762595,2018-06-12,Senate,"Senate Third Reading: Given Immediate Effect Roll Call # 439",36,0,0,1,37
1097292,764560,2018-06-12,House,"Reported With Recommendation With Substitute  H-1",15,0,0,0,15
1097292,774794,2018-09-25,House,"House Third Reading: Given Immediate Effect Roll Call # 572",105,1,0,0,106
1097292,780429,2018-12-12,Senate,"Reported Favorably Without Amendment",9,0,0,0,9
1097292,781470,2018-12-19,Senate,"Senate Third Reading: Given Immediate Effect Roll Call # 947",38,0,0,0,38
1097303,749118,2018-05-01,House,"Reported With Recommendation Without Amendment",9,1,0,0,10
1097303,755154,2018-05-15,House,"House Third Reading: Given Immediate Effect Roll Call # 284",107,1,0,0,108
1097303,758267,2018-05-30,Senate,"Reported Favorably Without Amendment",5,0,0,0,5
1097303,762425,2018-06-12,Senate,"Senate Third Reading: Given Immediate Effect Roll Call # 459",36,0,0,1,37
1097322,757912,2018-05-29,House,"Reported With Recommendation Without Amendment",14,0,0,0,14
1097322,774293,2018-09-05,House,"House Third Reading: Given Immediate Effect Roll Call # 563",105,1,0,0,106
1097322,779620,2018-12-04,Senate,"Reported Favorably Without Amendment",5,0,0,0,5
1097322,780341,2018-12-11,Senate,"Senate Third Reading: Given Immediate Effect Roll Call # 752",38,0,0,0,38
1097335,718979,2018-03-07,House,"Reported With Recommendation With Substitute  H-1",9,0,0,0,9
1097335,723358,2018-03-07,House,"Reported With Recommendation With Substitute H-1",9,0,0,0,9
1097335,727403,2018-03-21,House,"House Third Reading: Given Immediate Effect Roll Call # 183",107,1,0,0,108
1097335,756844,2018-05-24,Senate,"Reported Favorably Without Amendment",7,0,0,0,7
1097335,762526,2018-06-12,Senate,"Senate Third Reading: Given Immediate Effect Roll Call # 440",36,0,0,1,37
1097374,757968,2018-05-29,House,"Reported With Recommendation Without Amendment",14,0,0,0,14
1097374,774294,2018-09-05,House,"House Third Reading: Given Immediate Effect Roll Call # 564",105,1,0,0,106
1097374,779726,2018-12-04,Senate,"Reported Favorably Without Amendment",5,0,0,0,5
1097374,780346,2018-12-11,Senate,"Senate Third Reading: Given Immediate Effect Roll Call # 753",37,0,1,0,38
1097380,756120,2018-05-23,House,"Reported With Recommendation With Substitute  H-1",8,1,0,0,9
1097380,756121,2018-05-24,House,"House Third Reading: Given Immediate Effect Roll Call # 405",104,5,0,0,109
1097380,761209,2018-06-07,Senate,"Reported Favorably Without Amendment",4,0,0,0,4
1097380,779773,2018-12-04,Senate,"Senate Third Reading: Given Immediate Effect Roll Call # 661",36,0,0,2,38
1097392,756115,2018-05-23,House,"Reported With Recommendation With Substitute  H-2",11,0,0,0,11
1097392,756116,2018-05-24,House,"House Third Reading: Given Immediate Effect Roll Call # 410",109,0,0,0,109
1097392,761197,2018-06-07,Senate,"Reported Favorably With Substitute  S-2",4,0,0,0,4
1097944,750180,2018-05-03,Senate,"Senate Third Reading: Passed Roll Call # 276",36,0,0,1,37
1097944,752828,2018-05-09,House,"Reported With Recommendation Without Amendment",29,0,0,0,29
1097944,755011,2018-05-16,House,"House Third Reading: Given Immediate Effect Roll Call # 330",107,1,0,0,108
1097953,720706,2018-03-08,Senate,"Reported Favorably With Substitute  S-1",4,1,0,0,5
1097953,728036,2018-03-22,Senate,"Senate Third Reading: Passed Roll Call # 177",23,11,0,3,37
1097953,749020,2018-05-02,House,"Reported With Recommendation Without Amendment",7,2,0,0,9
1097953,754992,2018-05-15,House,"House Third Reading: Given Immediate Effect Roll Call # 286",63,45,0,0,108
1097961,727962,2018-03-22,Senate,"Reported Favorably Without Amendment",4,0,0,0,4
1097961,762976,2018-06-12,Senate,"Senate Third Reading: Passed Roll Call # 555",36,0,0,1,37
1097961,780051,2018-12-06,House,"Reported With Recommendation For Referral To Committee On Appropriations",15,0,0,0,15
1097961,780467,2018-12-12,House,"Reported With Recommendation With Substitute  H-1",27,0,0,0,27
1097961,781055,2018-12-18,House,"House Third Reading: Given Immediate Effect Roll Call # 855",105,4,0,0,109
1097961,781261,2018-12-18,Senate,"Senate Third Reading: Roll Call # 833",38,0,0,0,38
1097974,719403,2018-03-06,House,"Reported With Recommendation Without Amendment",13,0,0,0,13
1097974,745096,2018-04-25,House,"House Third Reading: Given Immediate Effect Roll Call # 246",109,0,0,0,109
1097974,758023,2018-05-30,Senate,"Reported Favorably Without Amendment",4,0,0,0,4
1097974,762623,2018-06-12,Senate,"Senate Third Reading: Given Immediate Effect Roll Call # 458",36,0,0,1,37
1098104,740647,2018-04-17,House,"Reported With Recommendation Without Amendment",14,0,0,0,14
1098104,749036,2018-05-01,House,"House Third Reading: Given Immediate Effect Roll Call # 257",109,0,0,0,109
1098104,781478,2018-12-18,Senate,"Reported Favorably With Substitute  S-1",5,0,0,0,5
1098104,781479,2018-12-18,Senate,"Senate Third Reading: Given Immediate Effect Roll Call # 873",38,0,0,0,38
1098104,781590,2018-12-20,House,"House Third Reading: Roll Call # 954",108,0,0,0,108
1098191,722369,2018-03-08,House,"Reported With Recommendation With Substitute  H-1",6,3,0,0,9
1098191,722561,2018-03-08,House,"Reported With Recommendation With Substitute H-1",6,3,0,0,9
1098191,724881,2018-03-15,House,"House Third Reading: Given Immediate Effect Roll Call # 172",62,44,0,0,106
1098191,740064,2018-04-17,Senate,"Reported Favorably Without Amendment",5,0,0,0,5
1098191,740890,2018-04-18,Senate,"Senate Third Reading: Given Immediate Effect Roll Call # 213",27,8,0,2,37
1098191,741849,2018-04-19,House,"House Third Reading: Roll Call # 234",64,45,0,0,109
1098412,722669,2018-03-13,House,"Reported With Recommendation With Substitute  H-1",14,0,0,0,14
1098412,744526,2018-03-13,House,"Reported With Recommendation With Substitute H-1",14,0,0,0,14
1098412,749302,2018-05-01,House,"House Third Reading: Given Immediate Effect Roll Call # 261",103,6,0,0,109
1098412,757891,2018-05-30,Senate,"Reported Favorably Without Amendment",4,0,0,0,4
1098412,760972,2018-06-06,Senate,"Senate Third Reading: Given Immediate Effect Roll Call # 400",36,1,0,0,37
1099053,779338,2018-11-28,Senate,"Reported Favorably Without Amendment",3,2,0,0,5
1099102,749596,2018-05-01,House,"Reported With Recommendation Without Amendment",9,5,0,0,14
1099271,722638,2018-03-13,House,"Reported With Recommendation Without Amendment",8,0,0,0,8
1099271,722639,2018-03-13,House,"Reported With Recommendation Without Amendment",8,0,0,0,8
1099271,726909,2018-03-21,House,"House Third Reading: Given Immediate Effect Roll Call # 190",106,2,0,0,108
1099271,753520,2018-05-15,Senate,"Reported Favorably Without Amendment",8,0,0,0,8
1099271,757382,2018-05-29,Senate,"Senate Third Reading: Given Immediate Effect Roll Call # 366",36,0,0,1,37
1099338,722952,2018-03-14,House,"Reported With Recommendation With Substitute H-1",17,0,0,0,17
1099338,724943,2018-03-15,House,"House Third Reading: Given Immediate Effect Roll Call # 173",104,2,0,0,106
1099338,727980,2018-03-21,Senate,"Reported Favorably Without Amendment",7,0,0,0,7
1099338,727981,2018-03-22,Senate,"Senate Third Reading: Given Immediate Effect Roll Call # 180",34,0,0,3,37
1099338,727982,2018-03-22,House,"House Third Reading: Roll Call # 211",107,2,0,0,109
1099524,722533,2018-03-13,House,"Reported With Recommendation Without Amendment",14,0,0,0,14
1099524,745189,2018-04-25,House,"House Third Reading: Given Immediate Effect Roll Call # 247",109,0,0,0,109
1099524,761239,2018-06-07,Senate,"Reported Favorably Without Amendment",4,0,0,0,4
1099524,762479,2018-06-12,Senate,"Senate Third Reading: Given Immediate Effect Roll Call # 498",36,0,0,1,37
1101463,727893,2018-03-21,Senate,"Reported Favorably Without Amendment",5,0,0,0,5
1101463,755793,2018-05-23,Senate,"Senate Third Reading: Passed Roll Call # 339",37,0,0,0,37
1101463,761187,2018-06-07,House,"Reported With Recommendation Without Amendment",15,0,0,0,15
1101463,764427,2018-06-12,House,"House Third Reading: Given Immediate Effect Roll Call # 521",105,4,0,0,109
1101540,751449,2018-05-08,Senate,"Reported Favorably With Substitute  S-1",5,0,0,0,5
1101540,780224,2018-12-05,Senate,"Senate Third Reading: Passed Roll Call # 683",34,3,0,1,38
1101582,748212,2018-05-02,Senate,"Reported Favorably With Substitute  S-3",4,0,0,0,4
1101582,754017,2018-05-16,Senate,"Senate Third Reading: Passed Roll Call # 299",37,0,0,0,37
1101582,756000,2018-05-23,House,"Reported With Recommendation With Substitute  H-3",9,0,0,0,9
1101582,764513,2018-06-12,House,"House Third Reading: Given Immediate Effect Roll Call # 485",107,2,0,0,109
1101582,764514,2018-06-12,Senate,"Senate Third Reading: Roll Call # 543",36,0,0,1,37
1101701,727964,2018-03-22,Senate,"Reported Favorably With Substitute  S-3",7,0,0,0,7
1101701,741747,2018-04-19,Senate,"Senate Third Reading: Passed Roll Call # 215",37,0,0,0,37
1101701,753089,2018-05-09,House,"Reported With Recommendation Without Amendment",12,0,0,0,12
1101701,759826,2018-06-05,House,"House Third Reading: Given Immediate Effect Roll Call # 449",107,1,0,0,108
1101807,736278,2018-04-10,House,"Reported With Recommendation With Substitute  H-2",14,0,0,0,14
1101807,740538,2018-04-10,House,"Reported With Recommendation With Substitute H-2",14,0,0,0,14
1101807,742062,2018-04-19,House,"House Third Reading: Given Immediate Effect Roll Call # 235",99,10,0,0,109
1101807,753971,2018-05-16,Senate,"Reported Favorably Without Amendment",4,0,0,0,4
1101807,757383,2018-05-29,Senate,"Senate Third Reading: Given Immediate Effect Roll Call # 367",36,0,0,1,37
1101823,737052,2018-04-10,House,"Reported With Recommendation With Substitute  H-2",14,0,0,0,14
1101823,740624,2018-04-10,House,"Reported With Recommendation With Substitute H-2",14,0,0,0,14
1101823,741843,2018-04-19,House,"House Third Reading: Given Immediate Effect Roll Call # 236",96,13,0,0,109
1101823,753970,2018-05-16,Senate,"Reported Favorably Without Amendment",4,0,0,0,4
1101823,757463,2018-05-29,Senate,"Senate Third Reading: Given Immediate Effect Roll Call # 368",36,0,0,1,37
1101847,749286,2018-05-02,House,"Reported With Recommendation With Substitute  H-1",11,2,0,0,13
1101847,764762,2018-06-12,House,"House Third Reading: Given Immediate Effect Roll Call # 532",105,4,0,0,109
1101847,775116,2018-09-26,Senate,"Reported Favorably Without Amendment",7,0,0,0,7
1101847,781495,2018-12-19,Senate,"Senate Third Reading: Given Immediate Effect Roll Call # 933",38,0,0,0,38
1102211,722346,2018-03-13,Senate,"Reported Favorably Without Amendment",9,1,0,0,10
1102211,723741,2018-03-15,Senate,"Senate Third Reading: Passed Roll Call # 162",34,2,0,1,37
1102211,777211,2018-10-04,House,"Reported With Recommendation Without Amendment",15,4,0,0,19
1102211,779206,2018-11-28,House,"House Third Reading: Given Immediate Effect Roll Call # 648",77,32,0,0,109
1102242,723695,2018-03-15,Senate,"Reported Favorably Without Amendment",3,1,0,0,4
1102275,722966,2018-03-14,Senate,"Reported Favorably With Substitute  S-1",5,0,0,0,5
1102275,739955,2018-04-17,Senate,"Senate Third Reading: Passed Roll Call # 204",37,0,0,0,37
1102469,775393,2018-10-03,House,"Reported With Recommendation Without Amendment",24,0,0,0,24
1102469,778258,2018-11-08,House,"House Third Reading: Given Immediate Effect Roll Call # 629",106,2,0,0,108
1102469,779265,2018-11-29,Senate,"Reported Favorably Without Amendment",17,0,0,0,17
1102469,779750,2018-12-04,Senate,"Senate Third Reading: Given Immediate Effect Roll Call # 669",36,0,0,2,38
1102902,736541,2018-04-10,House,"Reported With Recommendation With Substitute H-1",14,0,0,0,14
1102945,727952,2018-03-22,Senate,"Reported Favorably Without Amendment",5,0,0,0,5
1102945,762428,2018-06-12,Senate,"Senate Third Reading: Passed Roll Call # 529",36,0,0,1,37
1102945,779224,2018-11-28,House,"Reported With Recommendation Without Amendment",11,0,0,0,11
1102968,760629,2018-06-06,Senate,"Reported Favorably With Substitute S-1",10,0,0,0,10
1102968,762495,2018-06-12,Senate,"Senate Third Reading: Passed Roll Call # 521",36,0,0,1,37
1102968,775363,2018-10-03,House,"Reported With Recommendation With Substitute  H-2",17,0,0,0,17
1102968,777220,2018-10-04,House,"House Third Reading: Given Immediate Effect Roll Call # 625",106,0,0,0,106
1102968,778849,2018-11-08,Senate,"Senate Third Reading: Roll Call # 588",34,0,0,3,37
1102985,777213,2018-10-04,House,"Reported With Recommendation Without Amendment",14,1,0,0,15
1102985,780635,2018-12-13,House,"House Third Reading: Given Immediate Effect Roll Call # 849",104,5,0,0,109
1103043,741448,2018-04-19,Senate,"Reported Favorably With Substitute  S-2",4,1,0,0,5
1103043,741449,2018-04-19,Senate,"Senate Third Reading: Passed Roll Call # 225",26,11,0,0,37
1103043,760487,2018-06-06,House,"Reported With Recommendation With Substitute  H-2",17,10,0,0,27
1103043,760488,2018-06-06,House,"House Third Reading: Given Immediate Effect Roll Call # 455",62,47,0,0,109
1103043,761182,2018-06-07,Senate,"Senate Third Reading: Roll Call # 411",25,11,0,1,37
1103061,779012,2018-11-27,House,"Reported With Recommendation Without Amendment",8,1,0,0,9
1103082,756853,2018-05-24,Senate,"Reported Favorably Without Amendment",10,0,0,0,10
1103082,757986,2018-05-30,Senate,"Senate Third Reading: Passed Roll Call # 386",32,0,0,5,37
1103082,779282,2018-11-29,House,"Reported With Recommendation Without Amendment",16,0,0,0,16
1103082,780527,2018-12-12,House,"House Third Reading: Passed Roll Call # 797",107,2,0,0,109
1103172,779010,2018-11-27,House,"Reported With Recommendation With Substitute H-2",9,1,0,0,10
1103194,727876,2018-03-22,Senate,"Reported Favorably Without Amendment",5,0,0,0,5
1103194,762674,2018-06-12,Senate,"Senate Third Reading: Passed Roll Call # 528",36,0,0,1,37
1103194,779316,2018-11-28,House,"Reported With Recommendation Without Amendment",11,0,0,0,11
1105133,745142,2018-04-25,House,"Reported With Recommendation Without Amendment",9,0,0,0,9
1105133,749181,2018-05-02,House,"House Third Reading: Given Immediate Effect Roll Call # 264",102,7,0,0,109
1105133,779313,2018-11-29,Senate,"Reported Favorably Without Amendment",4,1,0,0,5
1105133,780475,2018-12-12,Senate,"Senate Third Reading: Given Immediate Effect Roll Call # 761",33,5,0,0,38
1105689,780249,2018-12-06,Senate,"Reported Favorably Without Amendment",5,2,0,0,7
1105695,779041,2018-11-27,House,"Reported With Recommendation With Substitute  H-1",11,0,0,0,11
1105695,779977,2018-12-06,House,"House Third Reading: Given Immediate Effect Roll Call # 722",109,0,0,0,109
1105695,781466,2018-12-18,Senate,"Reported Favorably Without Amendment",5,0,0,0,5
1105695,781467,2018-12-18,Senate,"Senate Third Reading: Given Immediate Effect Roll Call # 883",38,0,0,0,38
1105702,753010,2018-05-09,House,"Reported With Recommendation With Substitute  H-1",15,0,0,0,15
1105702,758127,2018-05-29,House,"House Third Reading: Given Immediate Effect Roll Call # 422",103,5,0,0,108
1105702,775348,2018-10-02,Senate,"Reported Favorably Without Amendment",9,0,0,0,9
1105702,780339,2018-12-11,Senate,"Senate Third Reading: Given Immediate Effect Roll Call # 746",37,0,0,1,38
1105717,748994,2018-05-02,House,"Reported With Recommendation Without Amendment",9,0,0,0,9
1105717,755176,2018-05-16,House,"House Third Reading: Given Immediate Effect Roll Call # 329",77,31,0,0,108
1105717,779657,2018-12-04,Senate,"Reported Favorably With Substitute  S-2",7,0,0,0,7
1105717,780623,2018-12-11,Senate,"Senate Third Reading: Given Immediate Effect Roll Call # 759",34,4,0,0,38
1105717,780624,2018-12-12,House,"House Third Reading: Roll Call # 813",77,32,0,0,109
1106076,728006,2018-03-22,Senate,"Reported Favorably Without Amendment",5,2,0,0,7
1106076,762607,2018-06-12,Senate,"Senate Third Reading: Passed Roll Call # 510",26,10,0,1,37
1106076,779205,2018-11-28,House,"Reported With Recommendation Without Amendment",12,1,0,0,13
1106076,781595,2018-12-20,House,"House Third Reading: Passed Roll Call # 934",58,50,0,0,108
1106094,760698,2018-06-06,Senate,"Reported Favorably Without Amendment",4,1,0,0,5
1106094,762313,2018-06-12,Senate,"Senate Third Reading: Passed Roll Call # 517",24,12,0,1,37
1106098,760989,2018-06-06,Senate,"Reported Favorably With Substitute  S-2",4,0,0,0,4
1106098,762450,2018-06-12,Senate,"Senate Third Reading: Passed Roll Call # 516",24,12,0,1,37
1106103,751412,2018-05-09,Senate,"Reported Favorably With Substitute  S-2",5,0,0,0,5
1106103,755739,2018-05-23,Senate,"Senate Third Reading: Passed Roll Call # 341",35,2,0,0,37
1106103,761106,2018-06-07,House,"Reported With Recommendation Without Amendment",5,0,0,0,5
1106103,764422,2018-06-12,House,"House Third Reading: Given Immediate Effect Roll Call # 540",104,5,0,0,109
1106109,728003,2018-03-22,Senate,"Reported Favorably Without Amendment",5,2,0,0,7
1106109,762598,2018-06-12,Senate,"Senate Third Reading: Passed Roll Call # 511",26,10,0,1,37
1106109,779154,2018-11-28,House,"Reported With Recommendation Without Amendment",12,1,0,0,13
1106109,781594,2018-12-20,House,"House Third Reading: Passed Roll Call # 935",58,50,0,0,108
1106118,745537,2018-04-26,Senate,"Reported Favorably With Substitute  S-2",5,0,0,0,5
1106199,736422,2018-04-10,House,"Reported With Recommendation With Substitute  H-1",14,0,0,0,14
1106199,741126,2018-04-10,House,"Reported With Recommendation With Substitute H-1",14,0,0,0,14
1106199,745167,2018-04-24,House,"House Third Reading: Given Immediate Effect Roll Call # 243",90,17,0,0,107
1106199,755100,2018-05-17,Senate,"Reported Favorably With Substitute  S-1",5,0,0,0,5
1106199,755842,2018-05-23,Senate,"Senate Third Reading: Given Immediate Effect Roll Call # 349",36,0,0,1,37
1106199,758224,2018-05-29,House,"House Third Reading: Roll Call # 420",89,19,0,0,108
1106273,754995,2018-05-15,House,"Reported With Recommendation With Substitute  H-1",14,0,0,0,14
1106273,758026,2018-05-29,House,"House Third Reading: Given Immediate Effect Roll Call # 423",108,0,0,0,108
1106273,781383,2018-12-18,Senate,"Reported Favorably Without Amendment",5,0,0,0,5
1106273,781384,2018-12-18,Senate,"Senate Third Reading: Given Immediate Effect Roll Call # 874",38,0,0,0,38
1106273,781638,2018-12-21,Senate,"Senate Third Reading: Passed Roll Call # 1043",38,0,0,0,38
1106273,781639,2018-12-21,House,"House Third Reading: Roll Call # 1040",104,0,0,0,104
1106296,736414,2018-04-10,House,"Reported With Recommendation With Substitute  H-1",14,0,0,0,14
1106296,741114,2018-04-10,House,"Reported With Recommendation With Substitute H-1",14,0,0,0,14
1106296,745159,2018-04-24,House,"House Third Reading: Given Immediate Effect Roll Call # 241",86,21,0,0,107
1106296,755076,2018-05-17,Senate,"Reported Favorably Without Amendment",5,0,0,0,5
1106296,755816,2018-05-23,Senate,"Senate Third Reading: Given Immediate Effect Roll Call # 347",37,0,0,0,37
1106320,736401,2018-04-10,House,"Reported With Recommendation With Substitute  H-1",14,0,0,0,14
1106320,741097,2018-04-10,House,"Reported With Recommendation With Substitute H-1",14,0,0,0,14
1106320,745163,2018-04-24,House,"House Third Reading: Given Immediate Effect Roll Call # 240",88,19,0,0,107
1106320,755098,2018-05-17,Senate,"Reported Favorably Without Amendment",5,0,0,0,5
1106320,755845,2018-05-23,Senate,"Senate Third Reading: Given Immediate Effect Roll Call # 346",37,0,0,0,37
1106344,736429,2018-04-10,House,"Reported With Recommendation With Substitute  H-1",14,0,0,0,14
1106344,741125,2018-04-10,House,"Reported With Recommendation With Substitute H-1",14,0,0,0,14
1106344,745168,2018-04-24,House,"House Third Reading: Given Immediate Effect Roll Call # 242",96,11,0,0,107
1106344,755183,2018-05-17,Senate,"Reported Favorably Without Amendment",5,0,0,0,5
1106344,755826,2018-05-23,Senate,"Senate Third Reading: Given Immediate Effect Roll Call # 348",37,0,0,0,37
1107849,745668,2018-04-26,Senate,"Reported Favorably Without Amendment",5,0,0,0,5
1107849,748376,2018-05-02,Senate,"Senate Third Reading: Passed Roll Call # 244",34,3,0,0,37
1107849,758294,2018-05-29,House,"Reported With Recommendation Without Amendment",11,1,0,0,12
1107849,764715,2018-06-12,House,"House Third Reading: Given Immediate Effect Roll Call # 473",98,11,0,0,109
1107875,774865,2018-09-25,Senate,"Reported Favorably Without Amendment",5,0,0,0,5
1107875,775068,2018-09-26,Senate,"Senate Third Reading: Passed Roll Call # 580",36,0,0,1,37
1107883,774876,2018-09-25,Senate,"Reported Favorably Without Amendment",5,0,0,0,5
1107883,775098,2018-09-26,Senate,"Senate Third Reading: Passed Roll Call # 579",36,0,0,1,37
1107883,780001,2018-12-06,House,"Reported With Recommendation With Substitute H-2",11,0,0,0,11
1107883,780657,2018-12-13,House,"House Third Reading: Given Immediate Effect Roll Call # 842",105,4,0,0,109
1107883,780704,2018-12-13,Senate,"Senate Third Reading: Roll Call # 828",37,0,0,1,38
1107902,774864,2018-09-25,Senate,"Reported Favorably Without Amendment",5,0,0,0,5
1107902,775090,2018-09-26,Senate,"Senate Third Reading: Passed Roll Call # 581",36,0,0,1,37
1107909,774860,2018-09-25,Senate,"Reported Favorably With Substitute  S-1",5,0,0,0,5
1107909,775100,2018-09-26,Senate,"Senate Third Reading: Passed Roll Call # 583",36,0,0,1,37
1107909,780220,2018-12-06,House,"Reported With Recommendation With Substitute H-2",11,0,0,0,11
1107909,780461,2018-12-13,House,"House Third Reading: Given Immediate Effect Roll Call # 843",105,4,0,0,109
1107909,780753,2018-12-13,Senate,"Senate Third Reading: Roll Call # 829",37,0,0,1,38
1107919,774858,2018-09-25,Senate,"Reported Favorably With Substitute  S-1",5,0,0,0,5
1107919,775096,2018-09-26,Senate,"Senate Third Reading: Passed Roll Call # 582",36,0,0,1,37
1107951,747314,2018-05-01,Senate,"Reported Favorably Without Amendment",5,0,0,0,5
1107951,753943,2018-05-16,Senate,"Senate Third Reading: Passed Roll Call # 298",37,0,0,0,37
1107951,759790,2018-06-05,House,"Reported With Recommendation Without Amendment",14,0,0,0,14
1107951,764483,2018-06-12,House,"House Third Reading: Given Immediate Effect Roll Call # 518",109,0,0,0,109
1107966,752878,2018-05-10,House,"Reported With Recommendation Without Amendment",6,0,0,0,6
1107966,755097,2018-05-15,House,"House Third Reading: Given Immediate Effect Roll Call # 310",108,0,0,0,108
1107966,761159,2018-06-07,Senate,"Reported Favorably Without Amendment",5,0,0,0,5
1107966,762514,2018-06-12,Senate,"Senate Third Reading: Given Immediate Effect Roll Call # 460",36,0,0,1,37
1107979,756051,2018-05-23,House,"Reported With Recommendation Without Amendment",12,1,0,0,13
1107979,758007,2018-05-30,House,"House Third Reading: Given Immediate Effect Roll Call # 433",101,6,0,0,107
1107979,762360,2018-06-12,Senate,"Reported Favorably With Substitute  S-1",15,1,0,0,16
1107979,762361,2018-06-12,Senate,"Senate Third Reading: Given Immediate Effect Roll Call # 502",36,0,0,1,37
1107979,764535,2018-06-12,House,"House Third Reading: Roll Call # 550",103,4,0,0,107
1107989,753104,2018-05-10,House,"Reported With Recommendation Without Amendment",6,0,0,0,6
1107989,755263,2018-05-15,House,"House Third Reading: Given Immediate Effect Roll Call # 311",105,3,0,0,108
1107989,761165,2018-06-07,Senate,"Reported Favorably Without Amendment",5,0,0,0,5
1107989,762520,2018-06-12,Senate,"Senate Third Reading: Given Immediate Effect Roll Call # 461",36,0,0,1,37
1107997,756004,2018-05-23,House,"Reported With Recommendation Without Amendment",12,1,0,0,13
1107997,757935,2018-05-30,House,"House Third Reading: Given Immediate Effect Roll Call # 434",99,8,0,0,107
1107997,762356,2018-06-12,Senate,"Reported Favorably Without Amendment",15,1,0,0,16
1107997,762357,2018-06-12,Senate,"Senate Third Reading: Given Immediate Effect Roll Call # 503",36,0,0,1,37
1108398,753944,2018-05-16,Senate,"Reported Favorably With Substitute  S-1",4,1,0,0,5
1108631,753011,2018-05-10,House,"Reported With Recommendation With Substitute H-1",10,1,0,0,11
1108631,755113,2018-05-16,House,"House Third Reading: Given Immediate Effect Roll Call # 332",94,14,0,0,108
1108631,774826,2018-09-25,Senate,"Reported Favorably Without Amendment",4,0,0,0,4
1108631,781386,2018-12-18,Senate,"Senate Third Reading: Given Immediate Effect Roll Call # 888",32,6,0,0,38
1108631,781551,2018-12-20,House,"House Third Reading: Senate Amendment(s) Concurred In Roll Call # 970",98,9,0,0,107
1108652,749002,2018-05-01,House,"Reported With Recommendation Without Amendment",10,1,0,0,11
1108652,755182,2018-05-15,House,"House Third Reading: Given Immediate Effect Roll Call # 282",64,44,0,0,108
1108652,779604,2018-12-04,Senate,"Reported Favorably Without Amendment",5,0,0,0,5
1108652,780348,2018-12-11,Senate,"Senate Third Reading: Given Immediate Effect Roll Call # 755",26,12,0,0,38
1108658,779188,2018-11-28,House,"Reported With Recommendation For Referral To Committee On Local Government",8,0,0,0,8
1108665,753014,2018-05-10,House,"Reported With Recommendation Without Amendment",10,1,0,0,11
1108665,755116,2018-05-16,House,"House Third Reading: Given Immediate Effect Roll Call # 331",97,11,0,0,108
1108665,774819,2018-09-25,Senate,"Reported Favorably Without Amendment",4,0,0,0,4
1108665,781377,2018-12-18,Senate,"Senate Third Reading: Given Immediate Effect Roll Call # 887",30,8,0,0,38
1108688,779233,2018-11-28,House,"Reported With Recommendation For Referral To Committee On Local Government",8,0,0,0,8
1108688,780486,2018-12-11,House,"Reported With Recommendation With Substitute  H-3",7,3,0,0,10
1112038,753069,2018-05-10,House,"Reported With Recommendation Without Amendment",6,0,0,0,6
1112038,755220,2018-05-15,House,"House Third Reading: Given Immediate Effect Roll Call # 313",106,2,0,0,108
1112038,761246,2018-06-07,Senate,"Reported Favorably Without Amendment",5,0,0,0,5
1112038,762686,2018-06-12,Senate,"Senate Third Reading: Given Immediate Effect Roll Call # 463",36,0,0,1,37
1112048,745095,2018-04-24,House,"Reported With Recommendation For Referral To Committee On Transportation And Infrastructure",11,0,0,0,11
1112048,755202,2018-05-15,House,"Reported With Recommendation With Substitute H-1",13,0,0,0,13
1112048,779243,2018-11-28,House,"House Third Reading: Given Immediate Effect Roll Call # 642",89,20,0,0,109
1112057,745007,2018-04-25,House,"Reported With Recommendation With Substitute  H-2",13,2,0,0,15
1112057,747277,2018-04-25,House,"Reported With Recommendation With Substitute H-2",13,2,0,0,15
1112057,749048,2018-05-03,House,"House Third Reading: Given Immediate Effect Roll Call # 266",105,2,0,0,107
1112057,755053,2018-05-17,Senate,"Reported Favorably Without Amendment",9,0,0,0,9
1112057,757412,2018-05-29,Senate,"Senate Third Reading: Given Immediate Effect Roll Call # 370",36,0,0,1,37
1112092,752914,2018-05-10,House,"Reported With Recommendation Without Amendment",6,0,0,0,6
1112092,755140,2018-05-15,House,"House Third Reading: Given Immediate Effect Roll Call # 315",107,1,0,0,108
1112092,761158,2018-06-07,Senate,"Reported Favorably Without Amendment",5,0,0,0,5
1112092,762534,2018-06-12,Senate,"Senate Third Reading: Given Immediate Effect Roll Call # 465",35,1,0,1,37
1112103,753063,2018-05-10,House,"Reported With Recommendation Without Amendment",6,0,0,0,6
1112103,755234,2018-05-16,House,"House Third Reading: Given Immediate Effect Roll Call # 316",99,9,0,0,108
1112103,761233,2018-06-07,Senate,"Reported Favorably Without Amendment",5,0,0,0,5
1112103,762654,2018-06-12,Senate,"Senate Third Reading: Given Immediate Effect Roll Call # 466",36,0,0,1,37
1112112,756055,2018-05-23,House,"Reported With Recommendation With Substitute  H-3",7,4,0,0,11
1112112,764588,2018-06-12,House,"House Third Reading: Given Immediate Effect Roll Call # 472",55,54,0,0,109
1112112,780482,2018-12-12,Senate,"Reported Favorably With Substitute  S-1",4,0,0,0,4
1112112,781416,2018-12-19,Senate,"Senate Third Reading: Given Immediate Effect Roll Call # 899",24,14,0,0,38
1112112,781591,2018-12-20,House,"House Third Reading: Roll Call # 955",60,48,0,0,108
1112140,741530,2018-04-19,Senate,"Reported Favorably Without Amendment",5,0,0,0,5
1112149,780015,2018-12-05,House,"Reported With Recommendation With Substitute  H-2",13,4,0,0,17
1112149,780016,2018-12-06,House,"House Third Reading: Passed Roll Call # 767",95,14,0,0,109
1112149,781570,2018-12-21,Senate,"Senate Third Reading: Passed Roll Call # 1040",29,9,0,0,38
1112177,753101,2018-05-08,House,"Reported With Recommendation With Substitute  H-2",12,0,0,0,12
1112177,753630,2018-05-08,House,"Reported With Recommendation With Substitute H-2",12,0,0,0,12
1112177,754999,2018-05-17,House,"House Third Reading: Given Immediate Effect Roll Call # 340",107,1,0,0,108
1112177,774813,2018-09-25,Senate,"Reported Favorably With Substitute  S-4",5,0,0,0,5
1112177,775053,2018-09-26,Senate,"Senate Third Reading: Given Immediate Effect Roll Call # 585",36,0,0,1,37
1112177,775245,2018-10-02,House,"House Third Reading: Roll Call # 588",102,4,0,0,106
1112206,745011,2018-04-25,House,"Reported With Recommendation With Substitute  H-3",13,2,0,0,15
1112206,747298,2018-04-25,House,"Reported With Recommendation With Substitute H-3",13,2,0,0,15
1112206,749060,2018-05-03,House,"House Third Reading: Given Immediate Effect Roll Call # 267",103,4,0,0,107
1112206,755197,2018-05-17,Senate,"Reported Favorably Without Amendment",9,0,0,0,9
1112206,757235,2018-05-29,Senate,"Senate Third Reading: Given Immediate Effect Roll Call # 371",35,1,0,1,37
1112214,780612,2018-12-11,House,"Reported With Recommendation Without Amendment",13,0,0,0,13
1112232,753061,2018-05-10,House,"Reported With Recommendation Without Amendment",6,0,0,0,6
1112232,755213,2018-05-15,House,"House Third Reading: Given Immediate Effect Roll Call # 314",104,4,0,0,108
1112232,761145,2018-06-07,Senate,"Reported Favorably Without Amendment",5,0,0,0,5
1112232,762314,2018-06-12,Senate,"Senate Third Reading: Given Immediate Effect Roll Call # 464",36,0,0,1,37
1112240,753055,2018-05-10,House,"Reported With Recommendation Without Amendment",6,0,0,0,6
1112240,754980,2018-05-15,House,"House Third Reading: Given Immediate Effect Roll Call # 312",106,2,0,0,108
1112240,761097,2018-06-07,Senate,"Reported Favorably Without Amendment",5,0,0,0,5
1112240,762395,2018-06-12,Senate,"Senate Third Reading: Given Immediate Effect Roll Call # 462",36,0,0,1,37
1112343,760632,2018-06-06,Senate,"Reported Favorably With Substitute  S-1",10,0,0,0,10
1112343,762586,2018-06-12,Senate,"Senate Third Reading: Passed Roll Call # 522",36,0,0,1,37
1112343,779246,2018-11-28,House,"Reported With Recommendation With Substitute  H-1",16,0,0,0,16
1112343,780636,2018-12-12,House,"House Third Reading: Given Immediate Effect Roll Call # 794",109,0,0,0,109
1112343,780686,2018-12-13,Senate,"Senate Third Reading: Roll Call # 824",37,0,0,1,38
1112352,738393,2018-04-12,Senate,"Reported Favorably Without Amendment",4,1,0,0,5
1112352,754188,2018-05-16,Senate,"Senate Third Reading: Passed Roll Call # 296",26,11,0,0,37
1112352,781210,2018-12-19,House,"Reported With Recommendation With Substitute H-3",19,0,0,0,19
1112352,781614,2018-12-21,House,"House Third Reading: Passed Roll Call # 999",107,0,0,0,107
1112352,781615,2018-12-21,Senate,"Senate Third Reading: Roll Call # 1048",38,0,0,0,38
1112381,738445,2018-04-12,Senate,"Reported Favorably Without Amendment",4,1,0,0,5
1112381,754006,2018-05-16,Senate,"Senate Third Reading: Passed Roll Call # 295",26,11,0,0,37
1112381,781211,2018-12-19,House,"Reported With Recommendation With Substitute H-3",19,0,0,0,19
1112381,781642,2018-12-21,House,"House Third Reading: Passed Roll Call # 998",106,1,0,0,107
1112381,781643,2018-12-21,Senate,"Senate Third Reading: Roll Call # 1050",38,0,0,0,38
1112420,753521,2018-05-15,Senate,"Reported Favorably Without Amendment",7,0,0,0,7
1112420,755028,2018-05-17,Senate,"Senate Third Reading: Passed Roll Call # 307",35,0,0,2,37
1112558,741838,2018-04-17,House,"Reported With Recommendation With Substitute  H-1",14,0,0,0,14
1112558,742967,2018-04-17,House,"Reported With Recommendation With Substitute H-1",14,0,0,0,14
1112558,745040,2018-04-25,House,"House Third Reading: Given Immediate Effect Roll Call # 249",109,0,0,0,109
1112558,753586,2018-05-15,Senate,"Reported Favorably With Substitute  S-1",5,0,0,0,5
1112558,755047,2018-05-17,Senate,"Senate Third Reading: Given Immediate Effect Roll Call # 310",36,0,0,1,37
1112558,755048,2018-05-17,House,"House Third Reading: Roll Call # 335",108,0,0,0,108
1112694,756889,2018-05-24,Senate,"Reported Favorably Without Amendment",11,0,0,0,11
1112694,757865,2018-05-30,Senate,"Senate Third Reading: Passed Roll Call # 388",30,2,0,5,37
1112694,760666,2018-06-06,House,"Reported With Recommendation With Substitute  H-1",22,1,0,0,23
1112694,764525,2018-06-12,House,"House Third Reading: Given Immediate Effect Roll Call # 489",105,4,0,0,109
1112694,764526,2018-06-12,Senate,"Senate Third Reading: Roll Call # 547",36,0,0,1,37
1112705,756863,2018-05-24,Senate,"Reported Favorably Without Amendment",11,0,0,0,11
1112705,758309,2018-05-30,Senate,"Senate Third Reading: Passed Roll Call # 387",30,2,0,5,37
1112705,760490,2018-06-06,House,"Reported With Recommendation With Substitute  H-1",23,1,0,0,24
1112705,764396,2018-06-12,House,"House Third Reading: Given Immediate Effect Roll Call # 488",105,4,0,0,109
1112705,764397,2018-06-12,Senate,"Senate Third Reading: Roll Call # 546",34,2,0,1,37
1112714,749525,2018-05-01,House,"Reported With Recommendation Without Amendment",14,0,0,0,14
1112733,774821,2018-09-25,Senate,"Reported Favorably With Substitute  S-2",5,0,0,0,5
1112733,779341,2018-11-29,Senate,"Senate Third Reading: Passed Roll Call # 653",37,0,0,1,38
1112733,780553,2018-12-11,House,"Reported With Recommendation Without Amendment",12,0,0,0,12
1112733,781304,2018-12-20,House,"House Third Reading: Given Immediate Effect Roll Call # 912",109,0,0,0,109
1112752,778951,2018-11-27,House,"Reported With Recommendation Without Amendment",9,1,0,0,10
1112752,780109,2018-12-05,House,"House Third Reading: Given Immediate Effect Roll Call # 699",108,0,0,0,108
1112752,780494,2018-12-12,Senate,"Reported Favorably Without Amendment",4,0,0,0,4
1112752,781340,2018-12-18,Senate,"Senate Third Reading: Given Immediate Effect Roll Call # 854",38,0,0,0,38
1112757,756117,2018-05-23,House,"Reported With Recommendation With Substitute  H-1",10,2,0,0,12
1112757,756118,2018-05-24,House,"House Third Reading: Given Immediate Effect Roll Call # 415",94,15,0,0,109
1112757,761126,2018-06-07,Senate,"Reported Favorably Without Amendment",5,0,0,0,5
1112761,756107,2018-05-23,House,"Reported With Recommendation With Substitute  H-1",11,1,0,0,12
1112761,756108,2018-05-24,House,"House Third Reading: Given Immediate Effect Roll Call # 397",108,1,0,0,109
1112761,761196,2018-06-07,Senate,"Reported Favorably Without Amendment",5,0,0,0,5
1112765,756155,2018-05-23,House,"Reported With Recommendation With Substitute  H-1",12,0,0,0,12
1112765,756156,2018-05-24,House,"House Third Reading: Given Immediate Effect Roll Call # 411",109,0,0,0,109
1112765,761272,2018-06-07,Senate,"Reported Favorably Without Amendment",5,0,0,0,5
1112771,756125,2018-05-23,House,"Reported With Recommendation Without Amendment",8,2,0,0,10
1112771,756126,2018-05-24,House,"House Third Reading: Given Immediate Effect Roll Call # 409",108,1,0,0,109
1112771,761204,2018-06-07,Senate,"Reported Favorably Without Amendment",5,0,0,0,5
1112781,756098,2018-05-23,House,"Reported With Recommendation Without Amendment",11,1,0,0,12
1112781,756099,2018-05-24,House,"House Third Reading: Given Immediate Effect Roll Call # 398",108,1,0,0,109
1112781,761207,2018-06-07,Senate,"Reported Favorably With Substitute  S-1",5,0,0,0,5
1112793,756105,2018-05-23,House,"Reported With Recommendation With Substitute  H-1",10,1,0,0,11
1112793,756106,2018-05-24,House,"House Third Reading: Given Immediate Effect Roll Call # 400",106,3,0,0,109
1112793,761210,2018-06-07,Senate,"Reported Favorably Without Amendment",5,0,0,0,5
1112793,779594,2018-12-04,Senate,"Senate Third Reading: Given Immediate Effect Roll Call # 664",36,0,0,2,38
1112797,745253,2018-04-26,Senate,"Reported Favorably With Substitute S1",5,0,0,0,5
1112801,779552,2018-12-04,House,"Reported With Recommendation With Substitute  H-1",12,0,0,0,12
1112801,780625,2018-12-13,House,"House Third Reading: Given Immediate Effect Roll Call # 834",106,3,0,0,109
1112801,781538,2018-12-21,Senate,"Senate Third Reading: Passed Roll Call # 1037",38,0,0,0,38
1112807,756113,2018-05-23,House,"Reported With Recommendation With Substitute  H-1",10,1,0,0,11
1112807,756114,2018-05-24,House,"House Third Reading: Given Immediate Effect Roll Call # 395",108,1,0,0,109
1112807,761242,2018-06-07,Senate,"Reported Favorably Without Amendment",5,0,0,0,5
1112819,779006,2018-11-27,House,"Reported With Recommendation With Substitute H-2",9,1,0,0,10
1112819,780110,2018-12-05,House,"House Third Reading: Given Immediate Effect Roll Call # 697",108,0,0,0,108
1112819,780508,2018-12-12,Senate,"Reported Favorably With Substitute  S-1",4,0,0,0,4
1112819,781328,2018-12-18,Senate,"Senate Third Reading: Given Immediate Effect Roll Call # 852",38,0,0,0,38
1112819,781329,2018-12-20,House,"House Third Reading: Roll Call # 901",108,0,0,0,108
1112829,756134,2018-05-23,House,"Reported With Recommendation With Substitute  H-1",11,1,0,0,12
1112829,756135,2018-05-24,House,"House Third Reading: Given Immediate Effect Roll Call # 393",108,1,0,0,109
1112829,761252,2018-06-07,Senate,"Reported Favorably Without Amendment",5,0,0,0,5
1112833,756088,2018-05-23,House,"Reported With Recommendation With Substitute  H-2",11,1,0,0,12
1112833,756089,2018-05-24,House,"House Third Reading: Given Immediate Effect Roll Call # 407",103,6,0,0,109
1112833,761139,2018-06-07,Senate,"Reported Favorably Without Amendment",5,0,0,0,5
1112840,779018,2018-11-27,House,"Reported With Recommendation Without Amendment",9,1,0,0,10
1112840,780094,2018-12-05,House,"House Third Reading: Given Immediate Effect Roll Call # 698",108,0,0,0,108
1112840,780444,2018-12-12,Senate,"Reported Favorably Without Amendment",4,0,0,0,4
1112840,781327,2018-12-18,Senate,"Senate Third Reading: Given Immediate Effect Roll Call # 853",38,0,0,0,38
1112845,756096,2018-05-23,House,"Reported With Recommendation With Substitute  H-1",12,0,0,0,12
1112845,756097,2018-05-24,House,"House Third Reading: Given Immediate Effect Roll Call # 406",109,0,0,0,109
1112845,761175,2018-06-07,Senate,"Reported Favorably With Substitute  S-1",5,0,0,0,5
1112845,779792,2018-12-04,Senate,"Senate Third Reading: Given Immediate Effect Roll Call # 665",36,0,0,2,38
1112845,780040,2018-12-05,House,"House Third Reading: Roll Call # 676",108,0,0,0,108
1112851,749289,2018-05-02,House,"Reported With Recommendation Without Amendment",17,0,0,0,17
1112851,755147,2018-05-16,House,"House Third Reading: Given Immediate Effect Roll Call # 326",105,3,0,0,108
1112851,760825,2018-06-06,Senate,"Reported Favorably Without Amendment",8,0,0,0,8
1112851,762334,2018-06-12,Senate,"Senate Third Reading: Given Immediate Effect Roll Call # 495",36,0,0,1,37
1112855,756009,2018-05-23,House,"Reported With Recommendation With Substitute  H-1",10,2,0,0,12
1112855,756010,2018-05-24,House,"House Third Reading: Given Immediate Effect Roll Call # 416",99,10,0,0,109
1112855,761179,2018-06-07,Senate,"Reported Favorably Without Amendment",5,0,0,0,5
1112861,756140,2018-05-23,House,"Reported With Recommendation With Substitute  H-1",9,1,0,0,10
1112861,756141,2018-05-24,House,"House Third Reading: Given Immediate Effect Roll Call # 414",106,3,0,0,109
1112861,761151,2018-06-07,Senate,"Reported Favorably Without Amendment",5,0,0,0,5
1112865,756122,2018-05-23,House,"Reported With Recommendation With Substitute  H-3",10,1,0,0,11
1112865,756123,2018-05-24,House,"House Third Reading: Given Immediate Effect Roll Call # 394",108,1,0,0,109
1112865,761189,2018-06-07,Senate,"Reported Favorably Without Amendment",5,0,0,0,5
1112869,756148,2018-05-23,House,"Reported With Recommendation Without Amendment",11,1,0,0,12
1112869,756149,2018-05-24,House,"House Third Reading: Given Immediate Effect Roll Call # 399",108,1,0,0,109
1112869,761237,2018-06-07,Senate,"Reported Favorably Without Amendment",5,0,0,0,5
1112878,756037,2018-05-23,House,"Reported With Recommendation With Substitute  H-1",11,1,0,0,12
1112878,756038,2018-05-24,House,"House Third Reading: Given Immediate Effect Roll Call # 396",108,1,0,0,109
1112878,761194,2018-06-07,Senate,"Reported Favorably With Substitute  S-1",5,0,0,0,5
1112878,761195,2018-06-07,Senate,"Reported Favorably With Substitute S-1",5,0,0,0,5
1112881,756133,2018-05-23,House,"Reported With Recommendation With Substitute  H-3",12,0,0,0,12
1112881,757929,2018-05-29,House,"House Third Reading: Given Immediate Effect Roll Call # 424",98,10,0,0,108
1112881,761276,2018-06-07,Senate,"Reported Favorably Without Amendment",5,0,0,0,5
1113593,755002,2018-05-16,House,"Reported With Recommendation Without Amendment",17,0,0,0,17
1113593,757937,2018-05-30,House,"House Third Reading: Given Immediate Effect Roll Call # 437",105,2,0,0,107
1113593,780606,2018-12-12,Senate,"Reported Favorably Without Amendment",9,0,0,0,9
1113593,781423,2018-12-18,Senate,"Senate Third Reading: Given Immediate Effect Roll Call # 860",37,1,0,0,38
1113593,781424,2018-12-20,House,"House Third Reading: Roll Call # 903",107,1,0,0,108
1113594,755208,2018-05-16,House,"Reported With Recommendation Without Amendment",17,0,0,0,17
1113594,758251,2018-05-30,House,"House Third Reading: Given Immediate Effect Roll Call # 438",105,2,0,0,107
1113594,780592,2018-12-12,Senate,"Reported Favorably Without Amendment",9,0,0,0,9
1113594,781370,2018-12-18,Senate,"Senate Third Reading: Given Immediate Effect Roll Call # 861",37,1,0,0,38
1113594,781371,2018-12-20,House,"House Third Reading: Roll Call # 904",107,1,0,0,108
1113600,755209,2018-05-16,House,"Reported With Recommendation Without Amendment",17,0,0,0,17
1113600,757946,2018-05-30,House,"House Third Reading: Given Immediate Effect Roll Call # 439",107,0,0,0,107
1113600,780609,2018-12-12,Senate,"Reported Favorably Without Amendment",9,0,0,0,9
1113600,781419,2018-12-18,Senate,"Senate Third Reading: Given Immediate Effect Roll Call # 862",37,1,0,0,38
1113610,761228,2018-06-07,House,"Reported With Recommendation Without Amendment",9,1,0,0,10
1113610,780151,2018-12-06,House,"House Third Reading: Given Immediate Effect Roll Call # 764",109,0,0,0,109
1113610,781464,2018-12-18,Senate,"Reported Favorably With Substitute  S-1",5,0,0,0,5
1113610,781465,2018-12-18,Senate,"Senate Third Reading: Given Immediate Effect Roll Call # 886",38,0,0,0,38
1113610,781573,2018-12-20,House,"House Third Reading: Roll Call # 956",107,0,0,0,107
1113615,755017,2018-05-16,House,"Reported With Recommendation With Substitute  H-4",17,0,0,0,17
1113615,757876,2018-05-30,House,"House Third Reading: Given Immediate Effect Roll Call # 436",104,3,0,0,107
1113615,780510,2018-12-12,Senate,"Reported Favorably With Substitute  S-1",9,0,0,0,9
1113615,781373,2018-12-18,Senate,"Senate Third Reading: Given Immediate Effect Roll Call # 859",37,1,0,0,38
1113615,781374,2018-12-20,House,"House Third Reading: Roll Call # 902",105,3,0,0,108
1113623,747310,2018-05-01,Senate,"Reported Favorably With Substitute  S-1",7,0,0,0,7
1113623,752323,2018-05-10,Senate,"Senate Third Reading: Passed Roll Call # 284",33,2,0,2,37
1113623,758313,2018-05-29,House,"Reported With Recommendation With Substitute  H-1",8,0,0,0,8
1113623,764625,2018-06-12,House,"House Third Reading: Given Immediate Effect Roll Call # 487",100,9,0,0,109
1113623,764626,2018-06-12,Senate,"Senate Third Reading: Roll Call # 545",33,3,0,1,37
1113636,749012,2018-05-02,House,"Reported With Recommendation With Substitute  H-1",9,0,0,0,9
1113636,752981,2018-05-02,House,"Reported With Recommendation With Substitute H-1",9,0,0,0,9
1113636,755188,2018-05-16,House,"House Third Reading: Given Immediate Effect Roll Call # 327",105,3,0,0,108
1113636,760657,2018-06-06,Senate,"Reported Favorably Without Amendment",7,0,0,0,7
1113636,762408,2018-06-12,Senate,"Senate Third Reading: Given Immediate Effect Roll Call # 496",34,2,0,1,37
1113636,764375,2018-06-12,House,"House Third Reading: Senate Amendment(s) Concurred In Roll Call # 555",106,3,0,0,109
1113748,745171,2018-04-25,House,"Reported With Recommendation Without Amendment",15,0,0,0,15
1113761,749045,2018-05-02,House,"Reported With Recommendation With Substitute  H-1",5,0,0,0,5
1113785,775364,2018-10-02,Senate,"Reported Favorably Without Amendment",5,0,0,0,5
1113799,775386,2018-10-02,Senate,"Reported Favorably Without Amendment",5,0,0,0,5
1113919,760624,2018-06-06,House,"Reported With Recommendation With Substitute  H-3",9,0,0,0,9
1113919,774844,2018-09-25,House,"House Third Reading: Given Immediate Effect Roll Call # 569",106,0,0,0,106
1113919,780250,2018-12-06,Senate,"Reported Favorably Without Amendment",5,0,0,0,5
1113919,780540,2018-12-12,Senate,"Senate Third Reading: Given Immediate Effect Roll Call # 763",38,0,0,0,38
1113945,749014,2018-05-02,House,"Reported With Recommendation Without Amendment",25,1,0,0,26
1113945,753027,2018-05-08,House,"House Third Reading: Given Immediate Effect Roll Call # 269",95,14,0,0,109
1113945,753028,2018-05-08,House,"House Third Reading: Passed Roll Call # 276",97,12,0,0,109
1113945,779335,2018-11-28,Senate,"Reported Favorably With Substitute  S-2",5,0,0,0,5
1113945,781303,2018-12-18,Senate,"Senate Third Reading: Given Immediate Effect Roll Call # 843",38,0,0,0,38
1113945,781598,2018-12-20,House,"House Third Reading: Roll Call # 958",100,7,0,0,107
1113953,749022,2018-05-02,House,"Reported With Recommendation With Substitute  H-1",24,3,0,0,27
1113953,750419,2018-05-02,House,"Reported With Recommendation With Substitute H-1",24,3,0,0,27
1113953,752851,2018-05-08,House,"House Third Reading: Given Immediate Effect Roll Call # 274",98,11,0,0,109
1113953,779337,2018-11-28,Senate,"Reported Favorably With Substitute  S-2",5,0,0,0,5
1113953,781320,2018-12-18,Senate,"Senate Third Reading: Given Immediate Effect Roll Call # 844",38,0,0,0,38
1113953,781645,2018-12-20,House,"House Third Reading: Roll Call # 957",100,7,0,0,107
1113972,749027,2018-05-02,House,"Reported With Recommendation With Substitute  H-3",26,2,0,0,28
1113972,750225,2018-05-02,House,"Reported With Recommendation With Substitute H-3",26,2,0,0,28
1113972,753085,2018-05-08,House,"House Third Reading: Given Immediate Effect Roll Call # 273",95,14,0,0,109
1113972,753086,2018-05-08,House,"House Third Reading: Passed Roll Call # 275",97,12,0,0,109
1114018,755167,2018-05-15,House,"Reported With Recommendation With Substitute H-3",13,0,0,0,13
1114018,755168,2018-05-17,House,"House Third Reading: Given Immediate Effect Roll Call # 343",108,0,0,0,108
1114018,779589,2018-12-04,Senate,"Reported Favorably Without Amendment",5,0,0,0,5
1114018,780349,2018-12-11,Senate,"Senate Third Reading: Given Immediate Effect Roll Call # 756",38,0,0,0,38
1114165,745312,2018-04-26,Senate,"Reported Favorably With Substitute  S-1",5,0,0,0,5
1114165,753525,2018-05-15,Senate,"Senate Third Reading: Passed Roll Call # 291",36,0,0,1,37
1114168,755740,2018-05-23,Senate,"Reported Favorably With Substitute  S-1",5,0,0,0,5
1114168,761162,2018-06-07,Senate,"Senate Third Reading: Passed Roll Call # 417",36,0,0,1,37
1114182,755775,2018-05-23,Senate,"Reported Favorably Without Amendment",4,0,0,0,4
1114182,761115,2018-06-07,Senate,"Senate Third Reading: Passed Roll Call # 419",36,0,0,1,37
1114188,760052,2018-06-05,House,"Reported With Recommendation Without Amendment",17,1,0,0,18
1114192,749096,2018-05-02,House,"Reported With Recommendation With Substitute  H-1",5,0,0,0,5
1114196,755758,2018-05-23,Senate,"Reported Favorably With Substitute  S-1",5,0,0,0,5
1114196,761201,2018-06-07,Senate,"Senate Third Reading: Passed Roll Call # 416",35,1,0,1,37
1114206,745499,2018-04-26,Senate,"Reported Favorably With Substitute  S-1",5,0,0,0,5
1114206,753652,2018-05-15,Senate,"Senate Third Reading: Passed Roll Call # 292",36,0,0,1,37
1114209,745751,2018-04-26,Senate,"Reported Favorably With Substitute  S-1",5,0,0,0,5
1114209,753444,2018-05-15,Senate,"Senate Third Reading: Passed Roll Call # 290",36,0,0,1,37
1114254,749018,2018-05-02,House,"Reported With Recommendation With Substitute  H-3",29,0,0,0,29
1114254,750184,2018-05-02,House,"Reported With Recommendation With Substitute H-3",29,0,0,0,29
1114254,752906,2018-05-08,House,"House Third Reading: Given Immediate Effect Roll Call # 272",108,1,0,0,109
1114254,780252,2018-12-05,Senate,"Reported Favorably With Substitute  S-1",5,0,0,0,5
1114254,781311,2018-12-18,Senate,"Senate Third Reading: Given Immediate Effect Roll Call # 846",38,0,0,0,38
1114254,781637,2018-12-20,House,"House Third Reading: Roll Call # 962",106,1,0,0,107
1114265,749011,2018-05-02,House,"Reported With Recommendation With Substitute  H-5",20,5,0,0,25
1114265,750140,2018-05-02,House,"Reported With Recommendation With Substitute H-5",20,5,0,0,25
1114265,752956,2018-05-08,House,"House Third Reading: Given Immediate Effect Roll Call # 271",69,40,0,0,109
1114265,780189,2018-12-06,Senate,"Reported Favorably With Substitute  S-3",5,0,0,0,5
1114265,781299,2018-12-18,Senate,"Senate Third Reading: Given Immediate Effect Roll Call # 849",38,0,0,0,38
1114265,781562,2018-12-20,House,"House Third Reading: Roll Call # 961",73,34,0,0,107
1114292,749075,2018-05-02,House,"Reported With Recommendation Without Amendment",29,0,0,0,29
1114292,753013,2018-05-08,House,"House Third Reading: Given Immediate Effect Roll Call # 270",108,1,0,0,109
1114292,779284,2018-11-28,Senate,"Reported Favorably With Substitute  S-1",5,0,0,0,5
1114292,781315,2018-12-18,Senate,"Senate Third Reading: Given Immediate Effect Roll Call # 845",38,0,0,0,38
1114292,781601,2018-12-20,House,"House Third Reading: Roll Call # 960",106,1,0,0,107
1114302,758061,2018-05-30,House,"Reported With Recommendation Without Amendment",18,0,0,0,18
1114302,764500,2018-06-12,House,"House Third Reading: Given Immediate Effect Roll Call # 519",109,0,0,0,109
1114302,775367,2018-10-02,Senate,"Reported Favorably Without Amendment",10,0,0,0,10
1114302,781546,2018-12-21,Senate,"Senate Third Reading: Passed Roll Call # 1041",38,0,0,0,38
1114704,775040,2018-09-26,Senate,"Reported Favorably Without Amendment",7,0,0,0,7
1114704,775041,2018-09-26,Senate,"Senate Third Reading: Passed Roll Call # 584",36,0,0,1,37
1114704,778962,2018-11-27,House,"Reported With Recommendation Without Amendment",14,0,0,0,14
1114704,780053,2018-12-06,House,"House Third Reading: Given Immediate Effect Roll Call # 728",109,0,0,0,109
1114742,755753,2018-05-23,Senate,"Reported Favorably Without Amendment",10,0,0,0,10
1114742,760803,2018-06-06,Senate,"Senate Third Reading: Passed Roll Call # 395",37,0,0,0,37
1114742,775384,2018-10-03,House,"Reported With Recommendation Without Amendment",17,0,0,0,17
1114742,780417,2018-12-11,House,"House Third Reading: Given Immediate Effect Roll Call # 780",108,0,0,0,108
1114855,756064,2018-05-23,House,"Reported With Recommendation Without Amendment",8,0,0,0,8
1114855,764504,2018-06-12,House,"House Third Reading: Given Immediate Effect Roll Call # 510",64,45,0,0,109
1114855,780792,2018-12-13,Senate,"Reported Favorably Without Amendment",3,1,0,0,4
1114855,781408,2018-12-18,Senate,"Senate Third Reading: Given Immediate Effect Roll Call # 894",38,0,0,0,38
1114855,781530,2018-12-20,House,"House Third Reading: Roll Call # 963",67,40,0,0,107
1114858,756154,2018-05-23,House,"Reported With Recommendation Without Amendment",8,0,0,0,8
1114858,764399,2018-06-12,House,"House Third Reading: Given Immediate Effect Roll Call # 509",65,44,0,0,109
1114858,780702,2018-12-13,Senate,"Reported Favorably With Substitute  S-2",4,0,0,0,4
1114858,781323,2018-12-18,Senate,"Senate Third Reading: Given Immediate Effect Roll Call # 893",38,0,0,0,38
1114858,781669,2018-12-21,House,"House Third Reading: Roll Call # 1005",67,40,0,0,107
1114901,760619,2018-06-06,House,"Reported With Recommendation With Substitute  H-1",9,0,0,0,9
1114901,774281,2018-09-05,House,"House Third Reading: Given Immediate Effect Roll Call # 567",95,11,0,0,106
1114901,780168,2018-12-06,Senate,"Reported Favorably With Substitute  S-1",5,0,0,0,5
1114901,781404,2018-12-19,Senate,"Senate Third Reading: Given Immediate Effect Roll Call # 937",37,0,1,0,38
1114901,781526,2018-12-20,House,"House Third Reading: Roll Call # 964",95,12,0,0,107
1115023,757894,2018-05-30,Senate,"Reported Favorably Without Amendment",4,0,0,0,4
1115023,760745,2018-06-06,Senate,"Senate Third Reading: Passed Roll Call # 399",37,0,0,0,37
1115023,774999,2018-09-25,House,"Reported With Recommendation Without Amendment",14,0,0,0,14
1115023,778252,2018-11-08,House,"House Third Reading: Given Immediate Effect Roll Call # 628",108,0,0,0,108
1115023,779022,2018-11-27,Senate,"Senate Third Reading: House Amendment(s) Concurred In Roll Call # 595",37,0,0,0,37
1115074,753062,2018-05-10,House,"Reported With Recommendation Without Amendment",6,0,0,0,6
1115074,755115,2018-05-16,House,"House Third Reading: Given Immediate Effect Roll Call # 320",105,3,0,0,108
1115074,761173,2018-06-07,Senate,"Reported Favorably Without Amendment",5,0,0,0,5
1115074,762308,2018-06-12,Senate,"Senate Third Reading: Given Immediate Effect Roll Call # 470",36,0,0,1,37
1115081,777207,2018-10-04,House,"Reported With Recommendation With Substitute  H-3",13,2,0,0,15
1115081,779575,2018-12-04,House,"House Third Reading: Given Immediate Effect Roll Call # 661",88,18,0,0,106
1115081,781336,2018-12-20,Senate,"Senate Third Reading: Passed By 3/4 Vote Roll Call # 1017",33,5,0,0,38
1115081,781667,2018-12-21,House,"House Third Reading: Roll Call # 991",90,17,0,0,107
1115103,753039,2018-05-10,House,"Reported With Recommendation Without Amendment",6,0,0,0,6
1115103,755056,2018-05-16,House,"House Third Reading: Given Immediate Effect Roll Call # 318",106,2,0,0,108
1115103,761167,2018-06-07,Senate,"Reported Favorably Without Amendment",5,0,0,0,5
1115103,762312,2018-06-12,Senate,"Senate Third Reading: Given Immediate Effect Roll Call # 468",36,0,0,1,37
1115109,753053,2018-05-10,House,"Reported With Recommendation Without Amendment",6,0,0,0,6
1115109,754987,2018-05-16,House,"House Third Reading: Given Immediate Effect Roll Call # 319",104,4,0,0,108
1115109,761142,2018-06-07,Senate,"Reported Favorably Without Amendment",5,0,0,0,5
1115109,762309,2018-06-12,Senate,"Senate Third Reading: Given Immediate Effect Roll Call # 469",36,0,0,1,37
1115116,752944,2018-05-10,House,"Reported With Recommendation Without Amendment",6,0,0,0,6
1115116,755142,2018-05-16,House,"House Third Reading: Given Immediate Effect Roll Call # 317",105,3,0,0,108
1115116,761192,2018-06-07,Senate,"Reported Favorably Without Amendment",5,0,0,0,5
1115116,762482,2018-06-12,Senate,"Senate Third Reading: Given Immediate Effect Roll Call # 467",36,0,0,1,37
1115134,753068,2018-05-10,House,"Reported With Recommendation Without Amendment",6,0,0,0,6
1115134,754989,2018-05-16,House,"House Third Reading: Given Immediate Effect Roll Call # 321",105,3,0,0,108
1115134,761149,2018-06-07,Senate,"Reported Favorably Without Amendment",5,0,0,0,5
1115134,762310,2018-06-12,Senate,"Senate Third Reading: Given Immediate Effect Roll Call # 471",36,0,0,1,37
1115235,761380,2018-06-04,Senate,"Reported Favorably Without Amendment",4,0,0,0,4
1115235,762540,2018-06-12,Senate,"Senate Third Reading: Passed Roll Call # 515",36,0,0,1,37
1115235,779167,2018-11-28,House,"Reported With Recommendation Without Amendment",9,0,0,0,9
1115235,780434,2018-12-12,House,"House Third Reading: Given Immediate Effect Roll Call # 795",109,0,0,0,109
1115259,774872,2018-09-25,Senate,"Reported Favorably With Substitute  S-1",4,1,0,0,5
1115259,779606,2018-12-04,Senate,"Senate Third Reading: Passed Roll Call # 666",25,11,0,2,38
1115259,780410,2018-12-12,House,"Reported With Recommendation With Substitute H-1",7,6,0,0,13
1115259,781574,2018-12-20,House,"House Third Reading: Given Immediate Effect Roll Call # 973",68,39,0,0,107
1115259,781575,2018-12-21,Senate,"Senate Third Reading: Roll Call # 1053",27,10,1,0,38
1115273,780437,2018-12-12,House,"Reported With Recommendation With Substitute  H-1",18,0,0,0,18
1115273,780438,2018-12-12,House,"House Third Reading: Given Immediate Effect Roll Call # 826",60,49,0,0,109
1115275,753057,2018-05-10,House,"Reported With Recommendation Without Amendment",5,0,0,0,5
1115275,755227,2018-05-16,House,"House Third Reading: Given Immediate Effect Roll Call # 323",99,9,0,0,108
1115275,761166,2018-06-07,Senate,"Reported Favorably Without Amendment",5,0,0,0,5
1115275,762516,2018-06-12,Senate,"Senate Third Reading: Given Immediate Effect Roll Call # 473",36,0,0,1,37
1115280,753071,2018-05-10,House,"Reported With Recommendation Without Amendment",5,0,0,0,5
1115280,754986,2018-05-16,House,"House Third Reading: Given Immediate Effect Roll Call # 324",99,9,0,0,108
1115280,761181,2018-06-07,Senate,"Reported Favorably Without Amendment",5,0,0,0,5
1115280,762567,2018-06-12,Senate,"Senate Third Reading: Given Immediate Effect Roll Call # 474",36,0,0,1,37
1115288,760626,2018-06-06,House,"Reported With Recommendation With Substitute  H-1",9,0,0,0,9
1115288,764766,2018-06-12,House,"House Third Reading: Given Immediate Effect Roll Call # 526",108,1,0,0,109
1115288,778929,2018-11-27,Senate,"Reported Favorably Without Amendment",4,0,0,0,4
1115294,753058,2018-05-10,House,"Reported With Recommendation Without Amendment",5,0,0,0,5
1115294,755216,2018-05-16,House,"House Third Reading: Given Immediate Effect Roll Call # 325",98,10,0,0,108
1115294,761160,2018-06-07,Senate,"Reported Favorably Without Amendment",5,0,0,0,5
1115294,762508,2018-06-12,Senate,"Senate Third Reading: Given Immediate Effect Roll Call # 475",34,2,0,1,37
1115319,753064,2018-05-10,House,"Reported With Recommendation Without Amendment",5,0,0,0,5
1115319,755218,2018-05-16,House,"House Third Reading: Given Immediate Effect Roll Call # 322",104,4,0,0,108
1115319,761190,2018-06-07,Senate,"Reported Favorably Without Amendment",5,0,0,0,5
1115319,762572,2018-06-12,Senate,"Senate Third Reading: Given Immediate Effect Roll Call # 472",36,0,0,1,37
1115326,755046,2018-05-16,House,"Reported With Recommendation Without Amendment",8,0,0,0,8
1115326,756057,2018-05-23,House,"House Third Reading: Given Immediate Effect Roll Call # 373",109,0,0,0,109
1115753,752246,2018-05-10,Senate,"Reported Favorably With Substitute S-1",8,0,0,0,8
1115753,755061,2018-05-17,Senate,"Senate Third Reading: Passed Roll Call # 306",35,0,0,2,37
1115753,774282,2018-09-05,House,"Reported With Recommendation Without Amendment",15,1,0,0,16
1115905,755222,2018-05-15,House,"Reported With Recommendation With Substitute H-1",16,2,0,0,18
1115905,755223,2018-05-17,House,"House Third Reading: Given Immediate Effect Roll Call # 345",77,31,0,0,108
1115905,775079,2018-09-26,Senate,"Reported Favorably With Substitute  S-1",7,0,0,0,7
1115905,775080,2018-09-26,Senate,"Senate Third Reading: Given Immediate Effect Roll Call # 564",35,1,0,1,37
1115905,775244,2018-10-02,House,"House Third Reading: Roll Call # 589",78,28,0,0,106
1115910,752993,2018-05-09,House,"Reported With Recommendation With Substitute  H-1",26,1,0,0,27
1115910,755000,2018-05-15,House,"House Third Reading: Given Immediate Effect Roll Call # 307",92,16,0,0,108
1115910,756845,2018-05-24,Senate,"Reported Favorably Without Amendment",10,1,0,0,11
1115910,762496,2018-06-12,Senate,"Senate Third Reading: Passed Roll Call # 505",28,7,1,1,37
1115910,762497,2018-06-12,Senate,"Senate Third Reading: Given Immediate Effect Roll Call # 506",27,9,0,1,37
1115910,764639,2018-06-12,House,"House Third Reading: Roll Call # 554",108,1,0,0,109
1115910,764640,2018-06-12,House,"House Third Reading: Roll Call # 556",96,13,0,0,109
1115919,755172,2018-05-16,House,"Reported With Recommendation With Substitute  H-2",7,4,0,0,11
1115919,779242,2018-11-29,House,"House Third Reading: Given Immediate Effect Roll Call # 657",56,52,0,0,108
1115919,780596,2018-12-12,Senate,"Reported Favorably Without Amendment",4,1,0,0,5
1115919,780699,2018-12-13,Senate,"Senate Third Reading: Given Immediate Effect Roll Call # 801",23,14,0,1,38
1115923,774926,2018-09-26,House,"Reported With Recommendation With Substitute H-1",11,2,0,0,13
1115923,775275,2018-09-26,House,"Reported With Recommendation With Substitute  H-1",11,2,0,0,13
1115923,777214,2018-10-04,House,"House Third Reading: Given Immediate Effect Roll Call # 620",96,10,0,0,106
1115923,780479,2018-12-12,Senate,"Reported Favorably Without Amendment",7,0,0,0,7
1115923,781445,2018-12-19,Senate,"Senate Third Reading: Given Immediate Effect Roll Call # 943",38,0,0,0,38
1115923,781556,2018-12-20,House,"House Third Reading: Roll Call # 965",96,11,0,0,107
1115949,755577,2018-05-22,House,"Reported With Recommendation Without Amendment",9,0,0,0,9
1115949,757878,2018-05-30,House,"House Third Reading: Given Immediate Effect Roll Call # 441",105,2,0,0,107
1115949,775356,2018-10-02,Senate,"Reported Favorably With Substitute S-4",5,0,0,0,5
1115949,781646,2018-12-21,Senate,"Senate Third Reading: Given Immediate Effect Roll Call # 1061",26,11,0,1,38
1115949,781647,2018-12-21,House,"House Third Reading: Roll Call # 1044",58,45,0,0,103
1115958,752890,2018-05-09,House,"Reported With Recommendation Without Amendment",21,5,0,0,26
1115958,755020,2018-05-15,House,"House Third Reading: Given Immediate Effect Roll Call # 306",69,39,0,0,108
1115958,756898,2018-05-24,Senate,"Reported Favorably Without Amendment",10,2,0,0,12
1115958,762321,2018-06-12,Senate,"Senate Third Reading: Given Immediate Effect Roll Call # 443",23,13,0,1,37
1115972,755169,2018-05-16,House,"Reported With Recommendation With Substitute  H-2",7,4,0,0,11
1115972,779281,2018-11-29,House,"House Third Reading: Given Immediate Effect Roll Call # 656",57,52,0,0,109
1115972,780562,2018-12-12,Senate,"Reported Favorably Without Amendment",4,1,0,0,5
1115972,780754,2018-12-13,Senate,"Senate Third Reading: Given Immediate Effect Roll Call # 800",23,14,0,1,38
1116066,778255,2018-11-08,House,"Reported With Recommendation With Substitute  H-2",7,0,0,0,7
1116066,779638,2018-12-04,House,"House Third Reading: Given Immediate Effect Roll Call # 665",91,15,0,0,106
1116110,753096,2018-05-08,House,"Reported With Recommendation Without Amendment",14,0,0,0,14
1116110,754996,2018-05-17,House,"House Third Reading: Given Immediate Effect Roll Call # 341",108,0,0,0,108
1116110,774867,2018-09-25,Senate,"Reported Favorably Without Amendment",5,0,0,0,5
1116110,778837,2018-11-08,Senate,"Senate Third Reading: Given Immediate Effect Roll Call # 589",34,0,0,3,37
1116195,760900,2018-06-06,Senate,"Reported Favorably With Substitute  S-2",4,0,0,0,4
1116195,761094,2018-06-07,Senate,"Senate Third Reading: Passed Roll Call # 430",36,0,0,1,37
1116195,780476,2018-12-12,House,"Reported With Recommendation With Substitute  H-1",27,0,0,0,27
1116195,781010,2018-12-18,House,"House Third Reading: Given Immediate Effect Roll Call # 857",109,0,0,0,109
1116195,781247,2018-12-18,Senate,"Senate Third Reading: Roll Call # 834",38,0,0,0,38
1116207,760637,2018-06-06,Senate,"Reported Favorably Without Amendment",5,0,0,0,5
1116207,762490,2018-06-12,Senate,"Senate Third Reading: Passed Roll Call # 518",36,0,0,1,37
1116210,761270,2018-06-07,Senate,"Reported Favorably Without Amendment",4,0,0,0,4
1116210,762476,2018-06-12,Senate,"Senate Third Reading: Passed Roll Call # 524",36,0,0,1,37
1116210,779278,2018-11-28,House,"Reported With Recommendation Without Amendment",12,0,0,0,12
1116210,780436,2018-12-12,House,"House Third Reading: Given Immediate Effect Roll Call # 796",78,31,0,0,109
1116217,755126,2018-05-17,Senate,"Reported Favorably With Substitute  S-1",5,0,0,0,5
1116217,775087,2018-09-26,Senate,"Senate Third Reading: Passed Roll Call # 565",34,2,0,1,37
1116218,755757,2018-05-23,Senate,"Reported Favorably With Substitute  S-1",5,0,0,0,5
1116218,761265,2018-06-07,Senate,"Senate Third Reading: Passed Roll Call # 418",36,0,0,1,37
1116218,780460,2018-12-12,House,"Reported With Recommendation Without Amendment",27,0,0,0,27
1116218,781143,2018-12-18,House,"House Third Reading: Given Immediate Effect Roll Call # 856",107,2,0,0,109
1116223,754983,2018-05-17,Senate,"Reported Favorably Without Amendment",5,0,0,0,5
1116223,775051,2018-09-26,Senate,"Senate Third Reading: Passed Roll Call # 566",35,1,0,1,37
1116294,757975,2018-05-29,House,"Reported With Recommendation With Substitute  H-1",7,0,0,0,7
1116294,759314,2018-05-29,House,"Reported With Recommendation With Substitute H-1",7,0,0,0,7
1116294,774290,2018-09-05,House,"House Third Reading: Given Immediate Effect Roll Call # 562",106,0,0,0,106
1116294,780591,2018-12-12,Senate,"Reported Favorably Without Amendment",4,0,0,0,4
1116294,781487,2018-12-19,Senate,"Senate Third Reading: Given Immediate Effect Roll Call # 925",38,0,0,0,38
1116746,761186,2018-06-07,Senate,"Reported Favorably Without Amendment",9,0,0,0,9
1116746,779354,2018-11-29,Senate,"Senate Third Reading: Passed Roll Call # 622",38,0,0,0,38
1116746,781552,2018-12-21,House,"House Third Reading: Given Immediate Effect Roll Call # 1002",65,42,0,0,107
1116889,779165,2018-11-28,House,"Reported With Recommendation With Substitute  H-2",13,2,0,0,15
1116889,779975,2018-12-06,House,"House Third Reading: Given Immediate Effect Roll Call # 737",92,17,0,0,109
1116889,780735,2018-12-13,Senate,"Reported Favorably With Substitute  S-1",7,0,0,0,7
1116889,781505,2018-12-20,Senate,"Senate Third Reading: Given Immediate Effect Roll Call # 964",38,0,0,0,38
1116889,781618,2018-12-21,House,"House Third Reading: Roll Call # 1017",92,15,0,0,107
1116908,753050,2018-05-09,House,"Reported With Recommendation Without Amendment",29,0,0,0,29
1116908,754984,2018-05-15,House,"House Third Reading: Given Immediate Effect Roll Call # 308",107,1,0,0,108
1116908,756912,2018-05-24,Senate,"Reported Favorably Without Amendment",16,0,0,0,16
1116908,762340,2018-06-12,Senate,"Senate Third Reading: Given Immediate Effect Roll Call # 442",36,0,0,1,37
1116908,764478,2018-06-12,House,"House Third Reading: Senate Amendment(s) Concurred In Roll Call # 515",108,1,0,0,109
1116912,779038,2018-11-27,House,"Reported With Recommendation Without Amendment",13,1,0,0,14
1116912,780007,2018-12-06,House,"House Third Reading: Given Immediate Effect Roll Call # 724",106,3,0,0,109
1116912,781368,2018-12-18,Senate,"Reported Favorably Without Amendment",5,0,0,0,5
1116912,781369,2018-12-18,Senate,"Senate Third Reading: Given Immediate Effect Roll Call # 875",38,0,0,0,38
1116915,759781,2018-06-05,House,"Reported With Recommendation Without Amendment",8,1,0,0,9
1116915,764462,2018-06-12,House,"House Third Reading: Given Immediate Effect Roll Call # 511",99,10,0,0,109
1116915,780223,2018-12-05,Senate,"Reported Favorably Without Amendment",5,0,0,0,5
1116915,781515,2018-12-18,Senate,"Senate Third Reading: Given Immediate Effect Roll Call # 847",38,0,0,0,38
1116927,779158,2018-11-28,House,"Reported With Recommendation With Substitute  H-2",13,2,0,0,15
1116927,779969,2018-12-06,House,"House Third Reading: Given Immediate Effect Roll Call # 738",96,13,0,0,109
1116927,780684,2018-12-13,Senate,"Reported Favorably Without Amendment",7,0,0,0,7
1116927,781493,2018-12-20,Senate,"Senate Third Reading: Given Immediate Effect Roll Call # 965",38,0,0,0,38
1116927,781604,2018-12-21,House,"House Third Reading: Senate Amendment(s) Concurred In Roll Call # 1018",94,13,0,0,107
1116927,781605,2018-12-21,House,"House Third Reading: Senate Amendment(s) Concurred In Roll Call # 1045",93,10,0,0,103
1116939,779161,2018-11-28,House,"Reported With Recommendation With Substitute  H-2",14,1,0,0,15
1116939,780043,2018-12-06,House,"House Third Reading: Given Immediate Effect Roll Call # 739",103,6,0,0,109
1116939,780721,2018-12-13,Senate,"Reported Favorably Without Amendment",8,0,0,0,8
1116939,781507,2018-12-20,Senate,"Senate Third Reading: Given Immediate Effect Roll Call # 966",38,0,0,0,38
1116939,781620,2018-12-21,House,"House Third Reading: Senate Amendment(s) Concurred In Roll Call # 1019",101,6,0,0,107
1116944,759879,2018-06-05,House,"Reported With Recommendation Without Amendment",8,1,0,0,9
1116944,764643,2018-06-12,House,"House Third Reading: Given Immediate Effect Roll Call # 512",96,13,0,0,109
1116944,780141,2018-12-05,Senate,"Reported Favorably Without Amendment",5,0,0,0,5
1116944,781294,2018-12-18,Senate,"Senate Third Reading: Given Immediate Effect Roll Call # 848",38,0,0,0,38
1117052,758911,2018-05-29,House,"Reported With Recommendation With Substitute H-1",12,1,0,0,13
1117089,758145,2018-05-30,House,"Reported With Recommendation Without Amendment",6,5,0,0,11
1117089,764566,2018-06-12,House,"House Third Reading: Given Immediate Effect Roll Call # 461",58,50,0,0,108
1117089,779329,2018-11-29,Senate,"Reported Favorably With Substitute  S-1",4,1,0,0,5
1117089,780707,2018-12-13,Senate,"Senate Third Reading: Passed Roll Call # 774",23,11,3,1,38
1117089,780708,2018-12-13,Senate,"Senate Third Reading: Passed Roll Call # 775",25,12,0,1,38
1117089,781185,2018-12-19,House,"House Third Reading: Roll Call # 886",59,50,0,0,109
1117098,758052,2018-05-30,House,"Reported With Recommendation Without Amendment",6,5,0,0,11
1117098,764372,2018-06-12,House,"House Third Reading: Given Immediate Effect Roll Call # 470",58,51,0,0,109
1117098,779254,2018-11-29,Senate,"Reported Favorably With Substitute  S-1",4,1,0,0,5
1117098,780688,2018-12-13,Senate,"Senate Third Reading: Given Immediate Effect Roll Call # 784",25,12,0,1,38
1117098,781187,2018-12-19,House,"House Third Reading: Roll Call # 896",59,50,0,0,109
1117109,757981,2018-05-30,House,"Reported With Recommendation Without Amendment",6,5,0,0,11
1117109,764365,2018-06-12,House,"House Third Reading: Given Immediate Effect Roll Call # 466",58,50,0,0,108
1117109,779357,2018-11-29,Senate,"Reported Favorably With Substitute  S-1",4,1,0,0,5
1117109,780683,2018-12-13,Senate,"Senate Third Reading: Given Immediate Effect Roll Call # 780",25,12,0,1,38
1117109,781195,2018-12-19,House,"House Third Reading: Roll Call # 891",59,50,0,0,109
1117115,752891,2018-05-10,House,"Reported With Recommendation Without Amendment",10,1,0,0,11
1117115,755119,2018-05-16,House,"House Third Reading: Given Immediate Effect Roll Call # 334",98,10,0,0,108
1117115,774823,2018-09-25,Senate,"Reported Favorably Without Amendment",4,0,0,0,4
1117115,781387,2018-12-18,Senate,"Senate Third Reading: Given Immediate Effect Roll Call # 890",31,7,0,0,38
1117117,758030,2018-05-30,House,"Reported With Recommendation Without Amendment",6,5,0,0,11
1117117,764370,2018-06-12,House,"House Third Reading: Given Immediate Effect Roll Call # 469",58,51,0,0,109
1117117,779327,2018-11-29,Senate,"Reported Favorably With Substitute  S-1",4,1,0,0,5
1117117,780715,2018-12-13,Senate,"Senate Third Reading: Given Immediate Effect Roll Call # 783",25,12,0,1,38
1117117,781214,2018-12-19,House,"House Third Reading: Roll Call # 895",59,50,0,0,109
1117132,756152,2018-05-23,House,"Reported With Recommendation Without Amendment",6,5,0,0,11
1117132,774296,2018-09-05,House,"House Third Reading: Given Immediate Effect Roll Call # 566",59,47,0,0,106
1117136,758146,2018-05-30,House,"Reported With Recommendation Without Amendment",6,5,0,0,11
1117136,764750,2018-06-12,House,"House Third Reading: Given Immediate Effect Roll Call # 463",58,50,0,0,108
1117136,779350,2018-11-29,Senate,"Reported Favorably With Substitute  S-1",4,1,0,0,5
1117136,780761,2018-12-13,Senate,"Senate Third Reading: Given Immediate Effect Roll Call # 777",25,12,0,1,38
1117136,781186,2018-12-19,House,"House Third Reading: Roll Call # 888",59,50,0,0,109
1117150,758055,2018-05-30,House,"Reported With Recommendation Without Amendment",6,5,0,0,11
1117150,764374,2018-06-12,House,"House Third Reading: Given Immediate Effect Roll Call # 471",58,51,0,0,109
1117150,779256,2018-11-29,Senate,"Reported Favorably With Substitute  S-1",4,1,0,0,5
1117150,780698,2018-12-13,Senate,"Senate Third Reading: Given Immediate Effect Roll Call # 785",25,12,0,1,38
1117150,781205,2018-12-19,House,"House Third Reading: Roll Call # 897",59,50,0,0,109
1117153,758044,2018-05-30,House,"Reported With Recommendation Without Amendment",6,5,0,0,11
1117153,764400,2018-06-12,House,"House Third Reading: Given Immediate Effect Roll Call # 465",58,50,0,0,108
1117153,779259,2018-11-29,Senate,"Reported Favorably With Substitute  S-1",4,1,0,0,5
1117153,780691,2018-12-13,Senate,"Senate Third Reading: Given Immediate Effect Roll Call # 779",25,12,0,1,38
1117153,781200,2018-12-19,House,"House Third Reading: Roll Call # 890",59,50,0,0,109
1117158,758048,2018-05-30,House,"Reported With Recommendation Without Amendment",6,5,0,0,11
1117158,764421,2018-06-12,House,"House Third Reading: Given Immediate Effect Roll Call # 467",58,50,0,0,108
1117158,779322,2018-11-29,Senate,"Reported Favorably With Substitute  S-1",4,1,0,0,5
1117158,780680,2018-12-13,Senate,"Senate Third Reading: Given Immediate Effect Roll Call # 781",25,12,0,1,38
1117158,781177,2018-12-19,House,"House Third Reading: Roll Call # 892",59,50,0,0,109
1117163,758344,2018-05-30,House,"Reported With Recommendation Without Amendment",6,5,0,0,11
1117163,764393,2018-06-12,House,"House Third Reading: Given Immediate Effect Roll Call # 468",58,50,0,0,108
1117163,779312,2018-11-29,Senate,"Reported Favorably With Substitute  S-1",4,1,0,0,5
1117163,780711,2018-12-13,Senate,"Senate Third Reading: Given Immediate Effect Roll Call # 782",25,12,0,1,38
1117163,781206,2018-12-19,House,"House Third Reading: Roll Call # 894",59,50,0,0,109
1117166,752901,2018-05-10,House,"Reported With Recommendation Without Amendment",10,1,0,0,11
1117166,755111,2018-05-16,House,"House Third Reading: Given Immediate Effect Roll Call # 333",96,12,0,0,108
1117166,755112,2018-05-16,House,"House Third Reading: Given Immediate Effect Roll Call # 333",96,12,0,0,108
1117166,774870,2018-09-25,Senate,"Reported Favorably Without Amendment",4,0,0,0,4
1117166,781441,2018-12-18,Senate,"Senate Third Reading: Given Immediate Effect Roll Call # 889",32,6,0,0,38
1117181,758162,2018-05-30,House,"Reported With Recommendation Without Amendment",6,5,0,0,11
1117181,764760,2018-06-12,House,"House Third Reading: Given Immediate Effect Roll Call # 462",58,50,0,0,108
1117181,779318,2018-11-29,Senate,"Reported Favorably With Substitute  S-2",4,1,0,0,5
1117181,780714,2018-12-13,Senate,"Senate Third Reading: Given Immediate Effect Roll Call # 776",25,12,0,1,38
1117181,781207,2018-12-19,House,"House Third Reading: Roll Call # 887",60,49,0,0,109
1117181,781208,2018-12-19,House,"House Third Reading: Roll Call # 893",59,50,0,0,109
1117183,758132,2018-05-30,House,"Reported With Recommendation Without Amendment",6,5,0,0,11
1117183,764722,2018-06-12,House,"House Third Reading: Given Immediate Effect Roll Call # 464",58,50,0,0,108
1117183,779321,2018-11-29,Senate,"Reported Favorably With Substitute  S-1",4,1,0,0,5
1117183,780723,2018-12-13,Senate,"Senate Third Reading: Given Immediate Effect Roll Call # 778",25,12,0,1,38
1117183,781181,2018-12-19,House,"House Third Reading: Roll Call # 889",59,50,0,0,109
1117333,753983,2018-05-16,Senate,"Reported Favorably Without Amendment",4,0,0,0,4
1117333,755026,2018-05-17,Senate,"Senate Third Reading: Passed Roll Call # 312",36,0,0,1,37
1117333,756150,2018-05-23,House,"Reported With Recommendation Without Amendment",9,0,0,0,9
1117333,757958,2018-05-29,House,"House Third Reading: Given Immediate Effect Roll Call # 426",107,1,0,0,108
1117354,753978,2018-05-16,Senate,"Reported Favorably With Substitute  S-1",4,0,0,0,4
1117354,755024,2018-05-17,Senate,"Senate Third Reading: Passed Roll Call # 311",36,0,0,1,37
1117354,756146,2018-05-23,House,"Reported With Recommendation Without Amendment",9,0,0,0,9
1117354,757950,2018-05-29,House,"House Third Reading: Given Immediate Effect Roll Call # 425",107,1,0,0,108
1117367,758100,2018-05-29,House,"Reported With Recommendation Without Amendment",12,0,0,0,12
1117377,755506,2018-05-22,Senate,"Reported Favorably With Substitute  S-1",15,0,0,0,15
1117377,755876,2018-05-23,Senate,"Senate Third Reading: Passed Roll Call # 350",36,0,0,1,37
1117377,758047,2018-05-30,House,"Reported With Recommendation Without Amendment",28,0,0,0,28
1117377,764502,2018-06-12,House,"House Third Reading: Given Immediate Effect Roll Call # 459",108,0,0,0,108
1117377,764503,2018-06-12,Senate,"Senate Third Reading: Roll Call # 539",36,0,0,1,37
1117411,754156,2018-05-16,Senate,"Reported Favorably Without Amendment",4,0,0,0,4
1117411,755009,2018-05-17,Senate,"Senate Third Reading: Passed Roll Call # 314",34,2,0,1,37
1117411,756012,2018-05-23,House,"Reported With Recommendation Without Amendment",9,0,0,0,9
1117411,757913,2018-05-29,House,"House Third Reading: Given Immediate Effect Roll Call # 427",107,1,0,0,108
1117421,755747,2018-05-23,Senate,"Reported Favorably With Substitute  S-1",4,0,0,0,4
1117421,761258,2018-06-07,Senate,"Senate Third Reading: Passed Roll Call # 421",36,0,0,1,37
1117421,780466,2018-12-12,House,"Reported With Recommendation With Substitute H-1",26,0,0,0,26
1117421,781067,2018-12-18,House,"House Third Reading: Given Immediate Effect Roll Call # 859",109,0,0,0,109
1117421,781497,2018-12-19,Senate,"Senate Third Reading: Roll Call # 913",38,0,0,0,38
1117430,755751,2018-05-23,Senate,"Reported Favorably With Substitute  S-1",4,0,0,0,4
1117430,761254,2018-06-07,Senate,"Senate Third Reading: Passed Roll Call # 420",36,0,0,1,37
1117430,780468,2018-12-12,House,"Reported With Recommendation Without Amendment",26,0,0,0,26
1117430,781141,2018-12-18,House,"House Third Reading: Given Immediate Effect Roll Call # 858",107,2,0,0,109
1117430,781251,2018-12-18,Senate,"Senate Third Reading: Roll Call # 835",38,0,0,0,38
1117481,756044,2018-05-23,House,"Reported With Recommendation Without Amendment",11,1,0,0,12
1117481,756045,2018-05-24,House,"House Third Reading: Given Immediate Effect Roll Call # 404",107,2,0,0,109
1117481,761271,2018-06-07,Senate,"Reported Favorably Without Amendment",5,0,0,0,5
1118027,760849,2018-06-04,Senate,"Reported Favorably Without Amendment",7,0,0,0,7
1118027,760850,2018-06-06,Senate,"Senate Third Reading: Passed Roll Call # 406",37,0,0,0,37
1118027,774933,2018-09-26,House,"Reported With Recommendation Without Amendment",8,0,0,0,8
1118027,779090,2018-11-27,House,"House Third Reading: Given Immediate Effect Roll Call # 640",109,0,0,0,109
1118044,760747,2018-06-04,Senate,"Reported Favorably Without Amendment",7,0,0,0,7
1118044,760748,2018-06-06,Senate,"Senate Third Reading: Passed Roll Call # 407",37,0,0,0,37
1118044,774936,2018-09-26,House,"Reported With Recommendation Without Amendment",8,0,0,0,8
1118044,779049,2018-11-27,House,"House Third Reading: Given Immediate Effect Roll Call # 641",108,1,0,0,109
1118103,760754,2018-06-04,Senate,"Reported Favorably Without Amendment",7,0,0,0,7
1118103,760755,2018-06-06,Senate,"Senate Third Reading: Passed Roll Call # 405",37,0,0,0,37
1118103,774934,2018-09-26,House,"Reported With Recommendation Without Amendment",8,0,0,0,8
1118103,779091,2018-11-27,House,"House Third Reading: Given Immediate Effect Roll Call # 639",109,0,0,0,109
1118122,780214,2018-12-06,Senate,"Reported Favorably With Substitute  S-1",5,2,0,0,7
1118122,780215,2018-12-06,Senate,"Senate Third Reading: Passed Roll Call # 732",36,0,0,2,38
1118122,780411,2018-12-12,House,"Reported With Recommendation Without Amendment",14,0,0,0,14
1118122,781009,2018-12-18,House,"House Third Reading: Given Immediate Effect Roll Call # 867",109,0,0,0,109
1118141,760840,2018-06-04,Senate,"Reported Favorably With Substitute  S-1",7,0,0,0,7
1118141,760841,2018-06-06,Senate,"Senate Third Reading: Passed Roll Call # 404",37,0,0,0,37
1118141,774932,2018-09-26,House,"Reported With Recommendation Without Amendment",8,0,0,0,8
1118141,778965,2018-11-27,House,"House Third Reading: Given Immediate Effect Roll Call # 638",109,0,0,0,109
1118240,755087,2018-05-17,House,"Reported With Recommendation Without Amendment",5,0,0,0,5
1118240,756092,2018-05-23,House,"House Third Reading: Given Immediate Effect Roll Call # 389",63,46,0,0,109
1118240,780720,2018-12-13,Senate,"Reported Favorably Without Amendment",3,0,0,0,3
1118240,781540,2018-12-21,Senate,"Senate Third Reading: Passed Roll Call # 1060",31,6,0,1,38
1118242,755091,2018-05-17,House,"Reported With Recommendation Without Amendment",5,0,0,0,5
1118242,756091,2018-05-23,House,"House Third Reading: Given Immediate Effect Roll Call # 376",70,39,0,0,109
1118242,761199,2018-06-07,Senate,"Reported Favorably Without Amendment",5,0,0,0,5
1118242,762576,2018-06-12,Senate,"Senate Third Reading: Given Immediate Effect Roll Call # 478",26,10,0,1,37
1118245,755045,2018-05-17,House,"Reported With Recommendation Without Amendment",6,0,0,0,6
1118245,756015,2018-05-23,House,"House Third Reading: Given Immediate Effect Roll Call # 384",101,8,0,0,109
1118245,761170,2018-06-07,Senate,"Reported Favorably Without Amendment",5,0,0,0,5
1118245,762452,2018-06-12,Senate,"Senate Third Reading: Given Immediate Effect Roll Call # 484",35,1,0,1,37
1118248,755062,2018-05-17,House,"Reported With Recommendation Without Amendment",6,0,0,0,6
1118248,756062,2018-05-23,House,"House Third Reading: Given Immediate Effect Roll Call # 375",105,4,0,0,109
1118248,761174,2018-06-07,Senate,"Reported Favorably Without Amendment",5,0,0,0,5
1118248,762552,2018-06-12,Senate,"Senate Third Reading: Given Immediate Effect Roll Call # 477",36,0,0,1,37
1118253,755073,2018-05-17,House,"Reported With Recommendation Without Amendment",6,0,0,0,6
1118253,756072,2018-05-23,House,"House Third Reading: Passed Roll Call # 379",100,9,0,0,109
1118253,756073,2018-05-23,House,"House Third Reading: Given Immediate Effect Roll Call # 380",96,13,0,0,109
1118253,761177,2018-06-07,Senate,"Reported Favorably Without Amendment",5,0,0,0,5
1118253,761178,2018-06-07,Senate,"Reported Favorably Without Amendment",5,0,0,0,5
1118253,762546,2018-06-12,Senate,"Senate Third Reading: Given Immediate Effect Roll Call # 481",36,0,0,1,37
1118256,755060,2018-05-17,House,"Reported With Recommendation Without Amendment",5,0,0,0,5
1118256,756061,2018-05-23,House,"House Third Reading: Given Immediate Effect Roll Call # 385",99,10,0,0,109
1118256,761185,2018-06-07,Senate,"Reported Favorably Without Amendment",5,0,0,0,5
1118256,762563,2018-06-12,Senate,"Senate Third Reading: Given Immediate Effect Roll Call # 486",35,1,0,1,37
1118260,755065,2018-05-17,House,"Reported With Recommendation Without Amendment",4,0,0,0,4
1118260,756071,2018-05-23,House,"House Third Reading: Given Immediate Effect Roll Call # 381",69,40,0,0,109
1118260,761268,2018-06-07,Senate,"Reported Favorably Without Amendment",5,0,0,0,5
1118260,762398,2018-06-12,Senate,"Senate Third Reading: Given Immediate Effect Roll Call # 482",26,10,0,1,37
1118262,755077,2018-05-17,House,"Reported With Recommendation Without Amendment",6,0,0,0,6
1118262,756074,2018-05-23,House,"House Third Reading: Given Immediate Effect Roll Call # 377",100,9,0,0,109
1118262,761176,2018-06-07,Senate,"Reported Favorably Without Amendment",5,0,0,0,5
1118262,762542,2018-06-12,Senate,"Senate Third Reading: Given Immediate Effect Roll Call # 479",36,0,0,1,37
1118265,760668,2018-06-06,House,"Reported With Recommendation With Substitute  H-2",9,0,0,0,9
1118265,774806,2018-09-25,House,"House Third Reading: Given Immediate Effect Roll Call # 571",106,0,0,0,106
1118265,780154,2018-12-06,Senate,"Reported Favorably Without Amendment",5,0,0,0,5
1118265,780472,2018-12-12,Senate,"Senate Third Reading: Given Immediate Effect Roll Call # 765",38,0,0,0,38
1118268,757286,2018-05-29,Senate,"Reported Favorably Without Amendment",9,0,0,0,9
1118275,755068,2018-05-17,House,"Reported With Recommendation Without Amendment",4,0,0,0,4
1118275,756001,2018-05-23,House,"House Third Reading: Given Immediate Effect Roll Call # 378",71,38,0,0,109
1118275,761156,2018-06-07,Senate,"Reported Favorably Without Amendment",5,0,0,0,5
1118275,762510,2018-06-12,Senate,"Senate Third Reading: Given Immediate Effect Roll Call # 480",27,9,0,1,37
1118277,755133,2018-05-17,House,"Reported With Recommendation Without Amendment",5,0,0,0,5
1118277,756030,2018-05-23,House,"House Third Reading: Given Immediate Effect Roll Call # 388",62,47,0,0,109
1118277,780718,2018-12-13,Senate,"Reported Favorably Without Amendment",3,0,0,0,3
1118277,781633,2018-12-21,Senate,"Senate Third Reading: Passed Roll Call # 1059",28,8,1,1,38
1118277,781634,2018-12-21,House,"House Third Reading: Roll Call # 1043",59,43,0,0,102
1118282,755088,2018-05-17,House,"Reported With Recommendation Without Amendment",4,0,0,0,4
1118282,756100,2018-05-23,House,"House Third Reading: Given Immediate Effect Roll Call # 387",73,36,0,0,109
1118282,761180,2018-06-07,Senate,"Reported Favorably Without Amendment",5,0,0,0,5
1118282,762551,2018-06-12,Senate,"Senate Third Reading: Given Immediate Effect Roll Call # 488",27,9,0,1,37
1118284,761203,2018-06-07,House,"Reported With Recommendation With Substitute  H-3",9,0,0,0,9
1118284,774925,2018-09-26,House,"House Third Reading: Given Immediate Effect Roll Call # 581",105,2,0,0,107
1118284,779724,2018-12-04,Senate,"Reported Favorably Without Amendment",5,0,0,0,5
1118284,781385,2018-12-20,Senate,"Senate Third Reading: Given Immediate Effect Roll Call # 1003",38,0,0,0,38
1118285,755064,2018-05-17,House,"Reported With Recommendation Without Amendment",4,0,0,0,4
1118285,756080,2018-05-23,House,"House Third Reading: Given Immediate Effect Roll Call # 374",94,15,0,0,109
1118285,761172,2018-06-07,Senate,"Reported Favorably Without Amendment",5,0,0,0,5
1118285,762311,2018-06-12,Senate,"Senate Third Reading: Given Immediate Effect Roll Call # 476",26,10,0,1,37
1118291,755083,2018-05-17,House,"Reported With Recommendation Without Amendment",6,0,0,0,6
1118291,756076,2018-05-23,House,"House Third Reading: Given Immediate Effect Roll Call # 383",88,21,0,0,109
1118291,761164,2018-06-07,Senate,"Reported Favorably Without Amendment",5,0,0,0,5
1118291,762547,2018-06-12,Senate,"Senate Third Reading: Given Immediate Effect Roll Call # 485",36,0,0,1,37
1118294,755240,2018-05-17,House,"Reported With Recommendation Without Amendment",5,0,0,0,5
1118294,756160,2018-05-23,House,"House Third Reading: Given Immediate Effect Roll Call # 386",89,20,0,0,109
1118294,761281,2018-06-07,Senate,"Reported Favorably With Substitute S-1",5,0,0,0,5
1118294,762341,2018-06-12,Senate,"Senate Third Reading: Given Immediate Effect Roll Call # 487",27,9,0,1,37
1118294,764485,2018-06-12,House,"House Third Reading: Roll Call # 545",86,23,0,0,109
1118300,755049,2018-05-17,House,"Reported With Recommendation With Substitute  H-1",18,7,0,0,25
1118300,756059,2018-05-23,House,"House Third Reading: Given Immediate Effect Roll Call # 390",94,15,0,0,109
1118300,762338,2018-06-12,Senate,"Reported Favorably With Substitute  S-2",15,1,0,0,16
1118300,762339,2018-06-12,Senate,"Senate Third Reading: Given Immediate Effect Roll Call # 444",27,9,0,1,37
1118300,764486,2018-06-12,House,"House Third Reading: Roll Call # 516",97,12,0,0,109
1118301,755055,2018-05-17,House,"Reported With Recommendation Without Amendment",6,0,0,0,6
1118301,756060,2018-05-23,House,"House Third Reading: Given Immediate Effect Roll Call # 382",91,18,0,0,109
1118301,761171,2018-06-07,Senate,"Reported Favorably Without Amendment",5,0,0,0,5
1118301,762560,2018-06-12,Senate,"Senate Third Reading: Given Immediate Effect Roll Call # 483",34,2,0,1,37
1118303,760678,2018-06-06,House,"Reported With Recommendation With Substitute H-1",9,0,0,0,9
1118303,774846,2018-09-25,House,"House Third Reading: Given Immediate Effect Roll Call # 570",106,0,0,0,106
1118303,780192,2018-12-06,Senate,"Reported Favorably Without Amendment",5,0,0,0,5
1118303,780541,2018-12-12,Senate,"Senate Third Reading: Given Immediate Effect Roll Call # 764",38,0,0,0,38
1118418,755491,2018-05-22,Senate,"Reported Favorably Without Amendment",15,0,0,0,15
1118418,755822,2018-05-23,Senate,"Senate Third Reading: Passed Roll Call # 351",36,0,0,1,37
1118418,758156,2018-05-30,House,"Reported With Recommendation With Substitute  H-1",28,0,0,0,28
1118418,764401,2018-06-12,House,"House Third Reading: Given Immediate Effect Roll Call # 460",108,0,0,0,108
1118418,764402,2018-06-12,Senate,"Senate Third Reading: Roll Call # 540",36,0,0,1,37
1118423,757899,2018-05-30,Senate,"Reported Favorably With Substitute  S-1",3,0,0,0,3
1118423,761090,2018-06-07,Senate,"Senate Third Reading: Passed Roll Call # 423",36,0,0,1,37
1118423,775241,2018-10-02,House,"Reported With Recommendation With Substitute H-1",14,0,0,0,14
1118423,775324,2018-10-02,House,"Reported With Recommendation With Substitute  H-1",14,0,0,0,14
1118423,780637,2018-12-12,House,"House Third Reading: Passed Roll Call # 791",103,6,0,0,109
1118423,780682,2018-12-13,Senate,"Senate Third Reading: Roll Call # 822",37,0,0,1,38
1118429,755493,2018-05-22,Senate,"Reported Favorably Without Amendment",5,0,0,0,5
1118429,757348,2018-05-29,Senate,"Senate Third Reading: Passed Roll Call # 375",36,0,0,1,37
1118429,761120,2018-06-07,House,"Reported With Recommendation Without Amendment",5,0,0,0,5
1118429,764713,2018-06-12,House,"House Third Reading: Given Immediate Effect Roll Call # 498",100,9,0,0,109
1118436,755499,2018-05-22,Senate,"Reported Favorably Without Amendment",5,0,0,0,5
1118436,757375,2018-05-29,Senate,"Senate Third Reading: Passed Roll Call # 377",36,0,0,1,37
1118436,761132,2018-06-07,House,"Reported With Recommendation Without Amendment",5,0,0,0,5
1118436,764712,2018-06-12,House,"House Third Reading: Given Immediate Effect Roll Call # 500",95,14,0,0,109
1118441,755498,2018-05-22,Senate,"Reported Favorably Without Amendment",5,0,0,0,5
1118441,757236,2018-05-29,Senate,"Senate Third Reading: Passed Roll Call # 383",36,0,0,1,37
1118441,761122,2018-06-07,House,"Reported With Recommendation Without Amendment",5,0,0,0,5
1118441,764716,2018-06-12,House,"House Third Reading: Given Immediate Effect Roll Call # 506",100,9,0,0,109
1118448,755696,2018-05-22,Senate,"Reported Favorably Without Amendment",5,0,0,0,5
1118448,757445,2018-05-29,Senate,"Senate Third Reading: Passed Roll Call # 372",36,0,0,1,37
1118448,761117,2018-06-07,House,"Reported With Recommendation Without Amendment",5,0,0,0,5
1118448,764366,2018-06-12,House,"House Third Reading: Given Immediate Effect Roll Call # 495",100,9,0,0,109
1118454,755519,2018-05-22,Senate,"Reported Favorably Without Amendment",5,0,0,0,5
1118454,757388,2018-05-29,Senate,"Senate Third Reading: Passed Roll Call # 378",36,0,0,1,37
1118454,761114,2018-06-07,House,"Reported With Recommendation Without Amendment",5,0,0,0,5
1118454,764702,2018-06-12,House,"House Third Reading: Given Immediate Effect Roll Call # 501",100,9,0,0,109
1118461,755683,2018-05-22,Senate,"Reported Favorably Without Amendment",5,0,0,0,5
1118461,757293,2018-05-29,Senate,"Senate Third Reading: Passed Roll Call # 382",36,0,0,1,37
1118461,761125,2018-06-07,House,"Reported With Recommendation Without Amendment",5,0,0,0,5
1118461,764515,2018-06-12,House,"House Third Reading: Given Immediate Effect Roll Call # 505",97,12,0,0,109
1118467,755494,2018-05-22,Senate,"Reported Favorably Without Amendment",5,0,0,0,5
1118467,757347,2018-05-29,Senate,"Senate Third Reading: Passed Roll Call # 380",36,0,0,1,37
1118467,761123,2018-06-07,House,"Reported With Recommendation Without Amendment",5,0,0,0,5
1118467,764682,2018-06-12,House,"House Third Reading: Given Immediate Effect Roll Call # 503",100,9,0,0,109
1118475,755471,2018-05-22,Senate,"Reported Favorably Without Amendment",5,0,0,0,5
1118475,757342,2018-05-29,Senate,"Senate Third Reading: Passed Roll Call # 373",36,0,0,1,37
1118475,761124,2018-06-07,House,"Reported With Recommendation Without Amendment",5,0,0,0,5
1118475,764699,2018-06-12,House,"House Third Reading: Given Immediate Effect Roll Call # 496",105,4,0,0,109
1118481,755595,2018-05-22,Senate,"Reported Favorably Without Amendment",5,0,0,0,5
1118481,757224,2018-05-29,Senate,"Senate Third Reading: Passed Roll Call # 374",36,0,0,1,37
1118481,761133,2018-06-07,House,"Reported With Recommendation Without Amendment",5,0,0,0,5
1118481,764706,2018-06-12,House,"House Third Reading: Given Immediate Effect Roll Call # 497",98,11,0,0,109
1118487,755661,2018-05-22,Senate,"Reported Favorably Without Amendment",15,0,0,0,15
1118487,755759,2018-05-23,Senate,"Senate Third Reading: Passed Roll Call # 353",36,0,0,1,37
1118487,758205,2018-05-30,House,"Reported With Recommendation Without Amendment",8,0,0,0,8
1118487,758206,2018-05-30,House,"House Third Reading: Given Immediate Effect Roll Call # 429",107,0,0,0,107
1118493,755784,2018-05-23,Senate,"Reported Favorably With Substitute  S-1",5,0,0,0,5
1118493,755785,2018-05-23,Senate,"Senate Third Reading: Passed Roll Call # 354",36,0,0,1,37
1118493,757938,2018-05-30,House,"Reported With Recommendation Without Amendment",9,0,0,0,9
1118493,761127,2018-06-07,House,"House Third Reading: Given Immediate Effect Roll Call # 458",104,4,0,0,108
1118500,755489,2018-05-22,Senate,"Reported Favorably Without Amendment",5,0,0,0,5
1118500,757352,2018-05-29,Senate,"Senate Third Reading: Passed Roll Call # 376",36,0,0,1,37
1118500,761136,2018-06-07,House,"Reported With Recommendation Without Amendment",5,0,0,0,5
1118500,764721,2018-06-12,House,"House Third Reading: Given Immediate Effect Roll Call # 499",101,8,0,0,109
1118505,761129,2018-06-07,Senate,"Reported Favorably With Substitute  S-2",5,0,0,0,5
1118505,761130,2018-06-07,Senate,"Senate Third Reading: Passed Roll Call # 435",23,13,0,1,37
1118512,755509,2018-05-22,Senate,"Reported Favorably Without Amendment",5,0,0,0,5
1118512,757231,2018-05-29,Senate,"Senate Third Reading: Passed Roll Call # 381",36,0,0,1,37
1118512,761134,2018-06-07,House,"Reported With Recommendation Without Amendment",5,0,0,0,5
1118512,764378,2018-06-12,House,"House Third Reading: Given Immediate Effect Roll Call # 504",95,14,0,0,109
1118517,755480,2018-05-22,Senate,"Reported Favorably Without Amendment",5,0,0,0,5
1118517,757418,2018-05-29,Senate,"Senate Third Reading: Passed Roll Call # 379",36,0,0,1,37
1118517,761231,2018-06-07,House,"Reported With Recommendation Without Amendment",5,0,0,0,5
1118517,764380,2018-06-12,House,"House Third Reading: Given Immediate Effect Roll Call # 502",99,10,0,0,109
1118530,760109,2018-06-05,House,"Reported With Recommendation Without Amendment",12,1,0,0,13
1118530,764416,2018-06-12,House,"House Third Reading: Given Immediate Effect Roll Call # 530",99,10,0,0,109
1118535,760133,2018-06-05,House,"Reported With Recommendation Without Amendment",12,1,0,0,13
1118535,764407,2018-06-12,House,"House Third Reading: Given Immediate Effect Roll Call # 529",100,9,0,0,109
1118543,780157,2018-12-05,House,"Reported With Recommendation With Substitute  H-5",17,0,0,0,17
1118543,780158,2018-12-06,House,"House Third Reading: Given Immediate Effect Roll Call # 769",96,13,0,0,109
1118543,780487,2018-12-12,Senate,"Reported Favorably Without Amendment",8,0,0,0,8
1118543,781486,2018-12-19,Senate,"Senate Third Reading: Given Immediate Effect Roll Call # 952",35,3,0,0,38
1118545,760009,2018-06-05,House,"Reported With Recommendation With Substitute  H-1",12,1,0,0,13
1118545,764781,2018-06-12,House,"House Third Reading: Given Immediate Effect Roll Call # 528",98,11,0,0,109
1118552,760020,2018-06-05,House,"Reported With Recommendation Without Amendment",14,0,0,0,14
1118552,764724,2018-06-12,House,"House Third Reading: Given Immediate Effect Roll Call # 477",109,0,0,0,109
1118552,781475,2018-12-18,Senate,"Reported Favorably Without Amendment",5,0,0,0,5
1118552,781476,2018-12-18,Senate,"Senate Third Reading: Given Immediate Effect Roll Call # 878",38,0,0,0,38
1118555,780149,2018-12-05,House,"Reported With Recommendation With Substitute  H-5",17,0,0,0,17
1118555,780150,2018-12-06,House,"House Third Reading: Given Immediate Effect Roll Call # 770",96,13,0,0,109
1118555,780544,2018-12-12,Senate,"Reported Favorably Without Amendment",8,0,0,0,8
1118555,781477,2018-12-19,Senate,"Senate Third Reading: Given Immediate Effect Roll Call # 953",33,5,0,0,38
1118562,780428,2018-12-12,House,"Reported With Recommendation With Substitute  H-1",12,0,0,0,12
1118562,780656,2018-12-13,House,"House Third Reading: Given Immediate Effect Roll Call # 833",108,1,0,0,109
1118565,760040,2018-06-05,House,"Reported With Recommendation Without Amendment",14,0,0,0,14
1118565,774958,2018-09-26,House,"House Third Reading: Given Immediate Effect Roll Call # 577",105,2,0,0,107
1118565,781358,2018-12-18,Senate,"Reported Favorably Without Amendment",5,0,0,0,5
1118565,781359,2018-12-18,Senate,"Senate Third Reading: Given Immediate Effect Roll Call # 876",38,0,0,0,38
1118570,774285,2018-09-05,House,"Reported With Recommendation Without Amendment",17,0,0,0,17
1118570,775389,2018-10-03,House,"House Third Reading: Given Immediate Effect Roll Call # 596",107,0,0,0,107
1118570,780483,2018-12-12,Senate,"Reported Favorably Without Amendment",9,0,0,0,9
1118570,781511,2018-12-19,Senate,"Senate Third Reading: Given Immediate Effect Roll Call # 955",36,2,0,0,38
1118574,774283,2018-09-05,House,"Reported With Recommendation Without Amendment",17,0,0,0,17
1118574,775358,2018-10-03,House,"House Third Reading: Given Immediate Effect Roll Call # 592",107,0,0,0,107
1118574,780485,2018-12-12,Senate,"Reported Favorably Without Amendment",9,0,0,0,9
1118574,781410,2018-12-19,Senate,"Senate Third Reading: Given Immediate Effect Roll Call # 949",38,0,0,0,38
1118574,781649,2018-12-20,House,"House Third Reading: Roll Call # 967",107,0,0,0,107
1118574,781711,2018-12-20,House,"House Third Reading: Senate Amendment(s) Concurred In Roll Call # 967",107,0,0,0,107
1118576,774288,2018-09-05,House,"Reported With Recommendation Without Amendment",17,0,0,0,17
1118576,775366,2018-10-03,House,"House Third Reading: Given Immediate Effect Roll Call # 594",107,0,0,0,107
1118576,780617,2018-12-12,Senate,"Reported Favorably Without Amendment",9,0,0,0,9
1118576,781492,2018-12-19,Senate,"Senate Third Reading: Given Immediate Effect Roll Call # 951",38,0,0,0,38
1118578,774284,2018-09-05,House,"Reported With Recommendation Without Amendment",17,0,0,0,17
1118578,775382,2018-10-03,House,"House Third Reading: Given Immediate Effect Roll Call # 591",107,0,0,0,107
1118578,780641,2018-12-12,Senate,"Reported Favorably Without Amendment",9,0,0,0,9
1118578,781498,2018-12-19,Senate,"Senate Third Reading: Given Immediate Effect Roll Call # 948",38,0,0,0,38
1118580,774291,2018-09-05,House,"Reported With Recommendation With Substitute H-1",17,0,0,0,17
1118580,775266,2018-09-05,House,"Reported With Recommendation With Substitute  H-1",17,0,0,0,17
1118580,775392,2018-10-03,House,"House Third Reading: Given Immediate Effect Roll Call # 593",107,0,0,0,107
1118580,780488,2018-12-12,Senate,"Reported Favorably Without Amendment",9,0,0,0,9
1118580,781490,2018-12-19,Senate,"Senate Third Reading: Given Immediate Effect Roll Call # 950",38,0,0,0,38
1118584,774289,2018-09-05,House,"Reported With Recommendation With Substitute H-3",17,0,0,0,17
1118584,775303,2018-09-05,House,"Reported With Recommendation With Substitute  H-3",17,0,0,0,17
1118584,777175,2018-10-03,House,"House Third Reading: Given Immediate Effect Roll Call # 595",107,0,0,0,107
1118584,780604,2018-12-12,Senate,"Reported Favorably Without Amendment",9,0,0,0,9
1118584,781485,2018-12-19,Senate,"Senate Third Reading: Given Immediate Effect Roll Call # 954",38,0,0,0,38
1118584,781592,2018-12-20,House,"House Third Reading: Senate Amendment(s) Concurred In Roll Call # 968",107,0,0,0,107
1118585,760045,2018-06-05,House,"Reported With Recommendation With Substitute  H-1",14,0,0,0,14
1118585,774980,2018-09-26,House,"House Third Reading: Given Immediate Effect Roll Call # 578",105,2,0,0,107
1118585,781462,2018-12-18,Senate,"Reported Favorably With Substitute  S-1",5,0,0,0,5
1118585,781463,2018-12-18,Senate,"Senate Third Reading: Given Immediate Effect Roll Call # 877",38,0,0,0,38
1118585,781569,2018-12-20,House,"House Third Reading: Roll Call # 966",106,1,0,0,107
1118708,774820,2018-09-25,Senate,"Reported Favorably Without Amendment",3,1,0,0,4
1118708,779302,2018-11-29,Senate,"Senate Third Reading: Passed Roll Call # 625",25,13,0,0,38
1118723,774828,2018-09-25,Senate,"Reported Favorably With Substitute  S-1",3,2,0,0,5
1118751,779235,2018-11-28,House,"Reported With Recommendation With Substitute  H-1",13,0,0,0,13
1118751,780106,2018-12-06,House,"House Third Reading: Given Immediate Effect Roll Call # 753",109,0,0,0,109
1118751,780557,2018-12-12,Senate,"Reported Favorably Without Amendment",7,0,0,0,7
1118751,781469,2018-12-19,Senate,"Senate Third Reading: Given Immediate Effect Roll Call # 944",38,0,0,0,38
1118761,760649,2018-06-06,House,"Reported With Recommendation With Substitute  H-1",9,1,0,0,10
1118761,764591,2018-06-12,House,"House Third Reading: Given Immediate Effect Roll Call # 474",63,46,0,0,109
1118761,780605,2018-12-12,Senate,"Reported Favorably Without Amendment",4,0,0,0,4
1118761,781461,2018-12-18,Senate,"Senate Third Reading: Given Immediate Effect Roll Call # 897",26,12,0,0,38
1118763,756047,2018-05-23,House,"Reported With Recommendation Without Amendment",7,3,0,0,10
1118763,756048,2018-05-24,House,"House Third Reading: Given Immediate Effect Roll Call # 417",88,21,0,0,109
1118763,761138,2018-06-07,Senate,"Reported Favorably With Substitute  S-2",5,0,0,0,5
1118817,760051,2018-06-05,House,"Reported With Recommendation Without Amendment",14,0,0,0,14
1118817,764373,2018-06-12,House,"House Third Reading: Given Immediate Effect Roll Call # 513",105,4,0,0,109
1118817,780621,2018-12-11,Senate,"Reported Favorably Without Amendment",5,0,0,0,5
1118817,780622,2018-12-12,Senate,"Senate Third Reading: Given Immediate Effect Roll Call # 772",37,1,0,0,38
1119343,774868,2018-09-25,Senate,"Reported Favorably Without Amendment",5,0,0,0,5
1119343,775093,2018-09-26,Senate,"Senate Third Reading: Passed Roll Call # 576",35,1,0,1,37
1119343,779019,2018-11-27,House,"Reported With Recommendation With Substitute  H-1",13,0,0,0,13
1119343,780458,2018-12-12,House,"House Third Reading: Given Immediate Effect Roll Call # 792",96,13,0,0,109
1119343,780806,2018-12-13,Senate,"Senate Third Reading: Roll Call # 823",36,1,0,1,38
1119366,757982,2018-05-30,Senate,"Reported Favorably Without Amendment",4,1,0,0,5
1119366,778852,2018-11-08,Senate,"Senate Third Reading: Passed Roll Call # 590",22,12,0,3,37
1119437,779234,2018-11-28,House,"Reported With Recommendation With Substitute  H-3",13,0,0,0,13
1119437,780102,2018-12-06,House,"House Third Reading: Passed Roll Call # 755",106,3,0,0,109
1119437,780521,2018-12-12,Senate,"Reported Favorably Without Amendment",7,0,0,0,7
1119437,781499,2018-12-19,Senate,"Senate Third Reading: Given Immediate Effect Roll Call # 946",38,0,0,0,38
1119437,781671,2018-12-21,House,"House Third Reading: Roll Call # 1007",106,1,0,0,107
1119482,779198,2018-11-28,House,"Reported With Recommendation With Substitute  H-3",13,0,0,0,13
1119482,780056,2018-12-06,House,"House Third Reading: Passed Roll Call # 754",106,3,0,0,109
1119482,780500,2018-12-12,Senate,"Reported Favorably Without Amendment",7,0,0,0,7
1119482,781494,2018-12-19,Senate,"Senate Third Reading: Given Immediate Effect Roll Call # 945",38,0,0,0,38
1119482,781670,2018-12-21,House,"House Third Reading: Roll Call # 1006",104,3,0,0,107
1119502,760560,2018-06-06,House,"Reported With Recommendation With Substitute  H-1",8,1,0,0,9
1119502,775399,2018-10-03,House,"House Third Reading: Given Immediate Effect Roll Call # 590",104,3,0,0,107
1119502,779605,2018-12-04,Senate,"Reported Favorably Without Amendment",9,0,0,0,9
1119502,780749,2018-12-13,Senate,"Senate Third Reading: Given Immediate Effect Roll Call # 786",36,1,0,1,38
1119502,781189,2018-12-19,House,"House Third Reading: Senate Amendment(s) Concurred In Roll Call # 898",107,2,0,0,109
1119577,760994,2018-06-06,Senate,"Reported Favorably Without Amendment",5,1,0,0,6
1119577,780180,2018-12-05,Senate,"Senate Third Reading: Passed Roll Call # 685",35,2,0,1,38
1119577,780459,2018-12-12,House,"Reported With Recommendation Without Amendment",9,3,0,0,12
1119587,760583,2018-06-06,Senate,"Reported Favorably Without Amendment",5,1,0,0,6
1119587,780177,2018-12-05,Senate,"Senate Third Reading: Passed Roll Call # 684",35,2,0,1,38
1119587,780463,2018-12-12,House,"Reported With Recommendation Without Amendment",9,3,0,0,12
1119612,761155,2018-06-07,Senate,"Reported Favorably With Substitute  S-1",10,0,0,0,10
1119612,762365,2018-06-12,Senate,"Senate Third Reading: Passed Roll Call # 523",35,1,0,1,37
1119612,779291,2018-11-29,House,"Reported With Recommendation With Substitute  H-1",16,0,0,0,16
1119612,780427,2018-12-12,House,"House Third Reading: Given Immediate Effect Roll Call # 798",108,1,0,0,109
1119612,780701,2018-12-13,Senate,"Senate Third Reading: Roll Call # 825",36,1,0,1,38
1119705,777824,2018-10-17,House,"Reported With Recommendation Without Amendment",11,0,0,0,11
1119705,779543,2018-12-04,House,"House Third Reading: Given Immediate Effect Roll Call # 663",104,2,0,0,106
1119709,775295,2018-10-02,House,"Reported With Recommendation With Substitute  H-1",15,0,0,0,15
1119709,777164,2018-10-03,House,"House Third Reading: Given Immediate Effect Roll Call # 618",107,0,0,0,107
1119709,780164,2018-12-06,Senate,"Reported Favorably Without Amendment",9,0,0,0,9
1119709,780575,2018-12-12,Senate,"Senate Third Reading: Given Immediate Effect Roll Call # 771",38,0,0,0,38
1119717,760716,2018-06-06,House,"Reported With Recommendation Without Amendment",9,0,0,0,9
1119717,777221,2018-10-04,House,"House Third Reading: Given Immediate Effect Roll Call # 621",81,25,0,0,106
1119717,779798,2018-12-04,Senate,"Reported Favorably With Substitute  S-2",7,2,0,0,9
1119717,780491,2018-12-11,Senate,"Senate Third Reading: Given Immediate Effect Roll Call # 758",30,8,0,0,38
1119717,780492,2018-12-13,House,"House Third Reading: Roll Call # 847",82,27,0,0,109
1119720,775282,2018-10-02,House,"Reported With Recommendation With Substitute  H-1",15,0,0,0,15
1119720,775407,2018-10-03,House,"House Third Reading: Given Immediate Effect Roll Call # 617",107,0,0,0,107
1119720,780244,2018-12-06,Senate,"Reported Favorably Without Amendment",9,0,0,0,9
1119720,780484,2018-12-12,Senate,"Senate Third Reading: Given Immediate Effect Roll Call # 770",38,0,0,0,38
1119725,777822,2018-10-17,House,"Reported With Recommendation Without Amendment",11,0,0,0,11
1119725,779615,2018-12-04,House,"House Third Reading: Given Immediate Effect Roll Call # 664",91,15,0,0,106
1119725,780518,2018-12-12,Senate,"Reported Favorably Without Amendment",5,0,0,0,5
1119725,781452,2018-12-19,Senate,"Senate Third Reading: Given Immediate Effect Roll Call # 926",38,0,0,0,38
1119725,781666,2018-12-21,House,"House Third Reading: Roll Call # 975",95,12,0,0,107
1119733,775240,2018-10-02,House,"Reported With Recommendation With Substitute H-1",15,0,0,0,15
1119733,775322,2018-10-02,House,"Reported With Recommendation With Substitute  H-1",15,0,0,0,15
1119733,775402,2018-10-03,House,"House Third Reading: Given Immediate Effect Roll Call # 616",107,0,0,0,107
1119733,780170,2018-12-06,Senate,"Reported Favorably Without Amendment",9,0,0,0,9
1119733,780473,2018-12-12,Senate,"Senate Third Reading: Given Immediate Effect Roll Call # 769",38,0,0,0,38
1119830,758914,2018-05-29,House,"Reported With Recommendation Without Amendment",12,1,0,0,13
1119837,758910,2018-05-29,House,"Reported With Recommendation Without Amendment",12,1,0,0,13
1119863,760084,2018-05-30,House,"Reported With Recommendation Without Amendment",9,0,0,0,9
1119863,764428,2018-06-12,House,"House Third Reading: Given Immediate Effect Roll Call # 527",108,1,0,0,109
1119863,778939,2018-11-27,Senate,"Reported Favorably Without Amendment",4,0,0,0,4
1120209,774909,2018-09-26,House,"Reported With Recommendation With Substitute H-1",14,2,0,0,16
1120209,775269,2018-09-26,House,"Reported With Recommendation With Substitute  H-1",14,2,0,0,16
1120209,779949,2018-12-05,House,"House Third Reading: Given Immediate Effect Roll Call # 687",104,4,0,0,108
1120243,779029,2018-11-27,House,"Reported With Recommendation Without Amendment",14,0,0,0,14
1120243,779981,2018-12-06,House,"House Third Reading: Given Immediate Effect Roll Call # 726",109,0,0,0,109
1120243,781321,2018-12-18,Senate,"Reported Favorably Without Amendment",5,0,0,0,5
1120243,781322,2018-12-20,Senate,"Senate Third Reading: Passed Roll Call # 997",38,0,0,0,38
1120251,761473,2018-06-04,Senate,"Reported Favorably Without Amendment",3,1,0,0,4
1120251,780083,2018-12-06,Senate,"Senate Third Reading: Passed Roll Call # 700",26,10,0,2,38
1120251,780503,2018-12-12,House,"Reported With Recommendation Without Amendment",8,3,0,0,11
1120251,781347,2018-12-20,House,"House Third Reading: Given Immediate Effect Roll Call # 919",59,50,0,0,109
1120263,760817,2018-06-06,Senate,"Reported Favorably Without Amendment",4,2,0,0,6
1120268,779035,2018-11-27,House,"Reported With Recommendation With Substitute  H-1",14,0,0,0,14
1120268,780209,2018-12-06,House,"House Third Reading: Given Immediate Effect Roll Call # 725",109,0,0,0,109
1120268,781421,2018-12-18,Senate,"Reported Favorably Without Amendment",5,0,0,0,5
1120268,781422,2018-12-20,Senate,"Senate Third Reading: Passed Roll Call # 996",38,0,0,0,38
1120274,779197,2018-11-28,House,"Reported With Recommendation With Substitute  H-1",8,0,0,0,8
1120281,760630,2018-06-04,Senate,"Reported Favorably Without Amendment",8,0,0,0,8
1120281,760631,2018-06-06,Senate,"Senate Third Reading: Passed Roll Call # 408",37,0,0,0,37
1120281,761198,2018-06-07,House,"Reported With Recommendation Without Amendment",5,0,0,0,5
1120281,764414,2018-06-12,House,"House Third Reading: Given Immediate Effect Roll Call # 541",109,0,0,0,109
1120281,764415,2018-06-12,Senate,"Senate Third Reading: House Amendment(s) Concurred In Roll Call # 553",36,0,0,1,37
1120288,779231,2018-11-28,House,"Reported With Recommendation With Substitute  H-1",8,0,0,0,8
1120293,761200,2018-06-07,Senate,"Reported Favorably Without Amendment",5,0,0,0,5
1120299,779333,2018-11-28,Senate,"Reported Favorably With Substitute  S-1",5,2,0,0,7
1120299,779334,2018-11-29,Senate,"Senate Third Reading: Passed Roll Call # 630",28,9,0,1,38
1120299,780415,2018-12-11,House,"Reported With Recommendation Without Amendment",3,1,0,0,4
1120442,774827,2018-09-25,Senate,"Reported Favorably With Substitute  S-1",3,0,0,0,3
1120442,778842,2018-11-08,Senate,"Senate Third Reading: Passed Roll Call # 591",33,1,0,3,37
1120442,779237,2018-11-29,House,"Reported With Recommendation With Substitute H-1",10,0,0,0,10
1120442,781292,2018-12-20,House,"House Third Reading: Given Immediate Effect Roll Call # 906",109,0,0,0,109
1120442,781444,2018-12-20,Senate,"Senate Third Reading: Roll Call # 1012",37,1,0,0,38
1120452,774829,2018-09-25,Senate,"Reported Favorably With Substitute  S-1",3,0,0,0,3
1120452,778846,2018-11-08,Senate,"Senate Third Reading: Passed Roll Call # 593",33,1,0,3,37
1120452,778847,2018-11-08,Senate,"Senate Third Reading: Passed Roll Call # 593",33,1,0,3,37
1120452,779239,2018-11-29,House,"Reported With Recommendation With Substitute H-1",10,0,0,0,10
1120452,781354,2018-12-20,House,"House Third Reading: Given Immediate Effect Roll Call # 908",109,0,0,0,109
1120452,781355,2018-12-20,Senate,"Senate Third Reading: Roll Call # 1014",37,1,0,0,38
1120455,774825,2018-09-25,Senate,"Reported Favorably With Substitute  S-1",3,0,0,0,3
1120455,778843,2018-11-08,Senate,"Senate Third Reading: Passed Roll Call # 592",33,1,0,3,37
1120455,779211,2018-11-29,House,"Reported With Recommendation Without Amendment",10,0,0,0,10
1120455,781378,2018-12-20,House,"House Third Reading: Given Immediate Effect Roll Call # 907",109,0,0,0,109
1120455,781379,2018-12-20,Senate,"Senate Third Reading: Roll Call # 1013",37,1,0,0,38
1120463,774923,2018-09-26,House,"Reported With Recommendation Without Amendment",11,0,0,0,11
1120463,775395,2018-10-03,House,"House Third Reading: Given Immediate Effect Roll Call # 605",107,0,0,0,107
1120463,780216,2018-12-05,Senate,"Reported Favorably Without Amendment",4,0,0,0,4
1120463,781449,2018-12-19,Senate,"Senate Third Reading: Given Immediate Effect Roll Call # 935",38,0,0,0,38
1120474,780160,2018-12-06,Senate,"Reported Favorably Without Amendment",5,2,0,0,7
1120474,780161,2018-12-06,Senate,"Senate Third Reading: Passed Roll Call # 737",35,1,0,2,38
1120474,780583,2018-12-12,House,"Reported With Recommendation Without Amendment",11,1,0,0,12
1120474,781024,2018-12-18,House,"House Third Reading: Given Immediate Effect Roll Call # 868",106,3,0,0,109
1121157,775268,2018-10-02,House,"Reported With Recommendation With Substitute  H-2",14,0,0,0,14
1121157,778997,2018-11-27,House,"House Third Reading: Given Immediate Effect Roll Call # 631",108,1,0,0,109
1121179,763905,2018-06-12,Senate,"Reported Favorably With Amendment(s)",15,1,0,0,16
1121298,774286,2018-09-05,Senate,"Reported Favorably Without Amendment",3,0,0,0,3
1121298,774287,2018-09-05,Senate,"Senate Third Reading: Passed Roll Call # 560",31,4,0,2,37
1121298,774326,2018-09-05,Senate,"Senate Third Reading: Passed Roll Call # 559",35,0,0,2,37
1121298,774910,2018-09-26,House,"Reported With Recommendation With Substitute H-1",5,0,0,0,5
1121298,775270,2018-09-26,House,"Reported With Recommendation With Substitute  H-1",5,0,0,0,5
1121298,779990,2018-12-06,House,"House Third Reading: Given Immediate Effect Roll Call # 720",107,2,0,0,109
1121298,780340,2018-12-11,Senate,"Senate Third Reading: Roll Call # 744",37,0,0,1,38
1121302,780577,2018-12-12,Senate,"Reported Favorably Without Amendment",4,0,0,0,4
1121302,780727,2018-12-13,Senate,"Senate Third Reading: Passed Roll Call # 791",37,0,0,1,38
1121310,775345,2018-10-02,Senate,"Reported Favorably Without Amendment",9,0,0,0,9
1121310,778960,2018-11-27,Senate,"Senate Third Reading: Passed Roll Call # 601",37,0,0,0,37
1121310,780069,2018-12-06,House,"Reported With Recommendation Without Amendment",11,0,0,0,11
1121310,781098,2018-12-18,House,"House Third Reading: Given Immediate Effect Roll Call # 853",86,23,0,0,109
1121310,781252,2018-12-18,Senate,"Senate Third Reading: Roll Call # 836",38,0,0,0,38
1121374,779290,2018-11-29,House,"Reported With Recommendation Without Amendment",16,0,0,0,16
1121374,780086,2018-12-06,House,"House Third Reading: Given Immediate Effect Roll Call # 747",106,3,0,0,109
1121375,761243,2018-06-07,House,"Reported With Recommendation Without Amendment",6,0,0,0,6
1121375,774945,2018-09-26,House,"House Third Reading: Given Immediate Effect Roll Call # 582",94,13,0,0,107
1121375,779675,2018-12-04,Senate,"Reported Favorably Without Amendment",5,0,0,0,5
1121375,781324,2018-12-20,Senate,"Senate Third Reading: Given Immediate Effect Roll Call # 1004",38,0,0,0,38
1121375,781603,2018-12-21,House,"House Third Reading: Roll Call # 1020",95,12,0,0,107
1121376,775242,2018-10-02,House,"Reported With Recommendation Without Amendment",15,0,0,0,15
1121376,775385,2018-10-03,House,"House Third Reading: Given Immediate Effect Roll Call # 612",106,1,0,0,107
1121376,780169,2018-12-06,Senate,"Reported Favorably Without Amendment",9,0,0,0,9
1121382,775260,2018-10-02,House,"Reported With Recommendation Without Amendment",15,0,0,0,15
1121382,775342,2018-10-03,House,"House Third Reading: Given Immediate Effect Roll Call # 611",106,1,0,0,107
1121382,780196,2018-12-06,Senate,"Reported Favorably With Substitute  S-2",9,0,0,0,9
1121383,761256,2018-06-07,House,"Reported With Recommendation Without Amendment",6,0,0,0,6
1121383,774931,2018-09-26,House,"House Third Reading: Given Immediate Effect Roll Call # 583",93,14,0,0,107
1121383,779664,2018-12-04,Senate,"Reported Favorably Without Amendment",5,0,0,0,5
1121383,781453,2018-12-20,Senate,"Senate Third Reading: Given Immediate Effect Roll Call # 1005",38,0,0,0,38
1121383,781567,2018-12-21,House,"House Third Reading: Roll Call # 1021",90,17,0,0,107
1121385,775256,2018-10-02,House,"Reported With Recommendation Without Amendment",15,0,0,0,15
1121385,775354,2018-10-03,House,"House Third Reading: Given Immediate Effect Roll Call # 613",106,1,0,0,107
1121385,780163,2018-12-06,Senate,"Reported Favorably Without Amendment",9,0,0,0,9
1121386,777182,2018-10-03,House,"Reported With Recommendation With Substitute  H-1",12,0,0,0,12
1121386,779178,2018-11-28,House,"House Third Reading: Given Immediate Effect Roll Call # 649",109,0,0,0,109
1121386,780709,2018-12-13,Senate,"Reported Favorably Without Amendment",3,1,0,0,4
1121386,781484,2018-12-19,Senate,"Senate Third Reading: Given Immediate Effect Roll Call # 929",33,5,0,0,38
1121389,775351,2018-10-03,House,"Reported With Recommendation With Substitute  H-3",9,0,0,0,9
1121389,778945,2018-11-27,House,"House Third Reading: Given Immediate Effect Roll Call # 632",109,0,0,0,109
1121389,780712,2018-12-13,Senate,"Reported Favorably Without Amendment",4,0,0,0,4
1121389,781439,2018-12-20,Senate,"Senate Third Reading: Given Immediate Effect Roll Call # 959",38,0,0,0,38
1121390,775243,2018-10-02,House,"Reported With Recommendation Without Amendment",15,0,0,0,15
1121390,775387,2018-10-03,House,"House Third Reading: Given Immediate Effect Roll Call # 614",106,1,0,0,107
1121390,780090,2018-12-06,Senate,"Reported Favorably Without Amendment",9,0,0,0,9
1121469,780032,2018-12-05,House,"Reported With Recommendation Without Amendment",7,0,0,0,7
1121469,780564,2018-12-12,House,"House Third Reading: Given Immediate Effect Roll Call # 809",89,20,0,0,109
1121484,775261,2018-10-02,House,"Reported With Recommendation With Substitute  H-1",12,0,0,0,12
1121484,779153,2018-11-28,House,"House Third Reading: Given Immediate Effect Roll Call # 645",109,0,0,0,109
1121484,780480,2018-12-12,Senate,"Reported Favorably Without Amendment",4,0,0,0,4
1121484,781435,2018-12-20,Senate,"Senate Third Reading: Passed Roll Call # 962",38,0,0,0,38
1121499,775263,2018-10-02,House,"Reported With Recommendation With Substitute  H-1",12,0,0,0,12
1121499,779155,2018-11-28,House,"House Third Reading: Given Immediate Effect Roll Call # 644",109,0,0,0,109
1121499,780454,2018-12-12,Senate,"Reported Favorably Without Amendment",4,0,0,0,4
1121499,781405,2018-12-20,Senate,"Senate Third Reading: Passed Roll Call # 961",38,0,0,0,38
1121505,775258,2018-10-02,House,"Reported With Recommendation With Substitute  H-1",12,0,0,0,12
1121505,779156,2018-11-28,House,"House Third Reading: Given Immediate Effect Roll Call # 646",109,0,0,0,109
1121505,780519,2018-12-12,Senate,"Reported Favorably Without Amendment",4,0,0,0,4
1121505,781437,2018-12-20,Senate,"Senate Third Reading: Passed Roll Call # 963",38,0,0,0,38
1121510,779999,2018-12-05,House,"Reported With Recommendation Without Amendment",7,0,0,0,7
1121510,780530,2018-12-12,House,"House Third Reading: Given Immediate Effect Roll Call # 810",87,22,0,0,109
1122018,780228,2018-12-05,Senate,"Reported Favorably With Substitute  S-1",5,0,0,0,5
1122018,780229,2018-12-06,Senate,"Senate Third Reading: Passed Roll Call # 738",35,1,0,2,38
1122021,778938,2018-11-27,Senate,"Reported Favorably With Substitute S-2",4,0,0,0,4
1122021,780002,2018-12-05,House,"Reported With Recommendation Without Amendment",9,0,0,0,9
1122021,781140,2018-12-18,House,"House Third Reading: Given Immediate Effect Roll Call # 852",106,3,0,0,109
1122021,781250,2018-12-18,Senate,"Senate Third Reading: Roll Call # 837",38,0,0,0,38
1122021,781782,2018-11-28,Senate,"Senate Third Reading: Passed Roll Call # 609",38,0,0,0,38
1122028,779320,2018-11-28,House,"Reported With Recommendation Without Amendment",12,0,0,0,12
1122028,780055,2018-12-05,House,"House Third Reading: Given Immediate Effect Roll Call # 708",98,10,0,0,108
1122028,780495,2018-12-12,Senate,"Reported Favorably Without Amendment",5,0,0,0,5
1122028,781314,2018-12-20,Senate,"Senate Third Reading: Given Immediate Effect Roll Call # 982",38,0,0,0,38
1122032,779026,2018-11-27,House,"Reported With Recommendation With Substitute  H-1",14,0,0,0,14
1122032,779993,2018-12-06,House,"House Third Reading: Given Immediate Effect Roll Call # 727",109,0,0,0,109
1122032,781389,2018-12-18,Senate,"Reported Favorably Without Amendment",5,0,0,0,5
1122032,781390,2018-12-18,Senate,"Senate Third Reading: Given Immediate Effect Roll Call # 879",38,0,0,0,38
1122033,779173,2018-11-28,House,"Reported With Recommendation Without Amendment",12,0,0,0,12
1122033,780013,2018-12-05,House,"House Third Reading: Given Immediate Effect Roll Call # 706",97,11,0,0,108
1122033,780511,2018-12-12,Senate,"Reported Favorably With Substitute  S-1",5,0,0,0,5
1122033,781403,2018-12-20,Senate,"Senate Third Reading: Given Immediate Effect Roll Call # 980",38,0,0,0,38
1122033,781648,2018-12-21,House,"House Third Reading: Roll Call # 1026",95,12,0,0,107
1122041,775004,2018-09-26,House,"Reported With Recommendation Without Amendment",9,0,0,0,9
1122041,775375,2018-10-03,House,"House Third Reading: Given Immediate Effect Roll Call # 609",106,1,0,0,107
1122049,774924,2018-09-26,House,"Reported With Recommendation With Substitute H-1",9,0,0,0,9
1122049,775271,2018-09-26,House,"Reported With Recommendation With Substitute  H-1",9,0,0,0,9
1122049,775397,2018-10-03,House,"House Third Reading: Given Immediate Effect Roll Call # 607",107,0,0,0,107
1122054,774916,2018-09-26,House,"Reported With Recommendation Without Amendment",9,0,0,0,9
1122054,777181,2018-10-03,House,"House Third Reading: Given Immediate Effect Roll Call # 608",105,2,0,0,107
1122056,779280,2018-11-28,House,"Reported With Recommendation Without Amendment",12,0,0,0,12
1122056,779961,2018-12-05,House,"House Third Reading: Given Immediate Effect Roll Call # 707",95,13,0,0,108
1122056,780543,2018-12-12,Senate,"Reported Favorably Without Amendment",5,0,0,0,5
1122056,781436,2018-12-20,Senate,"Senate Third Reading: Given Immediate Effect Roll Call # 981",38,0,0,0,38
1122070,779195,2018-11-28,House,"Reported With Recommendation With Substitute  H-2",11,0,0,0,11
1122070,780057,2018-12-06,House,"House Third Reading: Given Immediate Effect Roll Call # 751",109,0,0,0,109
1122075,779159,2018-11-28,House,"Reported With Recommendation Without Amendment",12,0,0,0,12
1122075,780005,2018-12-05,House,"House Third Reading: Given Immediate Effect Roll Call # 712",99,9,0,0,108
1122075,780549,2018-12-12,Senate,"Reported Favorably With Substitute  S-1",4,0,0,0,4
1122075,781402,2018-12-20,Senate,"Senate Third Reading: Given Immediate Effect Roll Call # 986",38,0,0,0,38
1122075,781650,2018-12-21,House,"House Third Reading: Roll Call # 1029",99,7,0,0,106
1122078,779267,2018-11-28,House,"Reported With Recommendation Without Amendment",12,0,0,0,12
1122078,780175,2018-12-05,House,"House Third Reading: Given Immediate Effect Roll Call # 709",95,13,0,0,108
1122078,780551,2018-12-12,Senate,"Reported Favorably With Substitute  S-1",5,0,0,0,5
1122078,781446,2018-12-20,Senate,"Senate Third Reading: Given Immediate Effect Roll Call # 983",38,0,0,0,38
1122078,781558,2018-12-21,House,"House Third Reading: Roll Call # 1027",93,13,0,0,106
1122083,779005,2018-11-27,House,"Reported With Recommendation Without Amendment",11,0,0,0,11
1122083,780060,2018-12-05,House,"House Third Reading: Given Immediate Effect Roll Call # 690",108,0,0,0,108
1122084,779036,2018-11-27,House,"Reported With Recommendation Without Amendment",11,0,0,0,11
1122084,780147,2018-12-05,House,"House Third Reading: Given Immediate Effect Roll Call # 692",108,0,0,0,108
1122088,779268,2018-11-28,House,"Reported With Recommendation Without Amendment",12,0,0,0,12
1122088,780172,2018-12-05,House,"House Third Reading: Given Immediate Effect Roll Call # 705",94,14,0,0,108
1122088,780594,2018-12-12,Senate,"Reported Favorably With Substitute  S-1",5,0,0,0,5
1122088,781443,2018-12-20,Senate,"Senate Third Reading: Given Immediate Effect Roll Call # 978",38,0,0,0,38
1122088,781559,2018-12-21,House,"House Third Reading: Roll Call # 1025",94,13,0,0,107
1122093,778953,2018-11-27,House,"Reported With Recommendation Without Amendment",11,0,0,0,11
1122093,780135,2018-12-05,House,"House Third Reading: Given Immediate Effect Roll Call # 693",108,0,0,0,108
1122098,775368,2018-10-03,House,"Reported With Recommendation With Substitute  H-1",6,3,0,0,9
1122098,779565,2018-12-04,House,"House Third Reading: Given Immediate Effect Roll Call # 662",103,3,0,0,106
1122098,780782,2018-12-13,Senate,"Reported Favorably With Substitute  S-1",4,0,0,0,4
1122098,781392,2018-12-19,Senate,"Senate Third Reading: Given Immediate Effect Roll Call # 900",38,0,0,0,38
1122098,781676,2018-12-21,House,"House Third Reading: Roll Call # 977",92,15,0,0,107
1122106,779150,2018-11-28,House,"Reported With Recommendation Without Amendment",12,0,0,0,12
1122106,779988,2018-12-05,House,"House Third Reading: Given Immediate Effect Roll Call # 711",98,10,0,0,108
1122106,780470,2018-12-12,Senate,"Reported Favorably Without Amendment",4,0,0,0,4
1122106,781357,2018-12-20,Senate,"Senate Third Reading: Given Immediate Effect Roll Call # 985",38,0,0,0,38
1122107,779325,2018-11-28,House,"Reported With Recommendation With Substitute  H-1",12,0,0,0,12
1122107,780137,2018-12-05,House,"House Third Reading: Given Immediate Effect Roll Call # 702",94,14,0,0,108
1122107,780477,2018-12-12,Senate,"Reported Favorably With Substitute  S-3",5,0,0,0,5
1122107,781434,2018-12-20,Senate,"Senate Third Reading: Given Immediate Effect Roll Call # 975",38,0,0,0,38
1122107,781539,2018-12-21,House,"House Third Reading: Roll Call # 1022",71,36,0,0,107
1122111,779008,2018-11-27,House,"Reported With Recommendation Without Amendment",11,0,0,0,11
1122111,780010,2018-12-05,House,"House Third Reading: Given Immediate Effect Roll Call # 689",108,0,0,0,108
1122121,779181,2018-11-28,House,"Reported With Recommendation Without Amendment",9,0,0,0,9
1122121,780022,2018-12-06,House,"House Third Reading: Given Immediate Effect Roll Call # 732",109,0,0,0,109
1122121,780719,2018-12-13,Senate,"Reported Favorably Without Amendment",4,0,0,0,4
1122121,781480,2018-12-19,Senate,"Senate Third Reading: Given Immediate Effect Roll Call # 930",38,0,0,0,38
1122122,778954,2018-11-27,House,"Reported With Recommendation Without Amendment",11,0,0,0,11
1122122,780058,2018-12-05,House,"House Third Reading: Given Immediate Effect Roll Call # 694",108,0,0,0,108
1122126,779274,2018-11-28,House,"Reported With Recommendation Without Amendment",12,0,0,0,12
1122126,779960,2018-12-05,House,"House Third Reading: Given Immediate Effect Roll Call # 703",98,10,0,0,108
1122126,780542,2018-12-12,Senate,"Reported Favorably With Substitute  S-1",5,0,0,0,5
1122126,781361,2018-12-20,Senate,"Senate Third Reading: Given Immediate Effect Roll Call # 976",38,0,0,0,38
1122126,781623,2018-12-21,House,"House Third Reading: Roll Call # 1024",98,9,0,0,107
1122142,779171,2018-11-28,House,"Reported With Recommendation Without Amendment",12,0,0,0,12
1122142,780008,2018-12-05,House,"House Third Reading: Given Immediate Effect Roll Call # 710",98,10,0,0,108
1122142,780529,2018-12-12,Senate,"Reported Favorably With Substitute  S-1",5,0,0,0,5
1122142,781332,2018-12-20,Senate,"Senate Third Reading: Given Immediate Effect Roll Call # 984",38,0,0,0,38
1122142,781608,2018-12-21,House,"House Third Reading: Roll Call # 1028",98,8,0,0,106
1122158,779516,2018-12-04,House,"Reported With Recommendation For Referral To Committee On Judiciary",13,0,0,0,13
1122158,779983,2018-12-06,House,"Reported With Recommendation With Substitute H-2",9,0,0,0,9
1122158,780426,2018-12-12,House,"House Third Reading: Given Immediate Effect Roll Call # 828",104,5,0,0,109
1122158,781506,2018-12-19,Senate,"Reported Favorably With Substitute  S-1",9,0,0,0,9
1122162,779174,2018-11-28,House,"Reported With Recommendation Without Amendment",12,0,0,0,12
1122162,780006,2018-12-05,House,"House Third Reading: Given Immediate Effect Roll Call # 704",94,14,0,0,108
1122162,780581,2018-12-12,Senate,"Reported Favorably Without Amendment",5,0,0,0,5
1122162,781454,2018-12-20,Senate,"Senate Third Reading: Given Immediate Effect Roll Call # 977",38,0,0,0,38
1122163,779037,2018-11-27,House,"Reported With Recommendation Without Amendment",11,0,0,0,11
1122163,780136,2018-12-05,House,"House Third Reading: Given Immediate Effect Roll Call # 691",108,0,0,0,108
1122182,775005,2018-09-26,House,"Reported With Recommendation With Substitute H-5",8,0,0,0,8
1122182,775253,2018-09-26,House,"Reported With Recommendation With Substitute  H-5",8,0,0,0,8
1122182,775376,2018-10-03,House,"House Third Reading: Given Immediate Effect Roll Call # 606",105,2,0,0,107
1125450,775277,2018-10-02,House,"Reported With Recommendation Without Amendment",14,0,0,0,14
1125869,774982,2018-09-26,House,"Reported With Recommendation Without Amendment",27,0,0,0,27
1125869,774983,2018-09-26,House,"House Third Reading: Roll Call # 573",107,0,0,0,107
1125869,779499,2018-11-29,Senate,"Reported Favorably Without Amendment",7,0,0,0,7
1125892,777161,2018-10-02,Senate,"Reported Favorably Without Amendment",17,0,0,0,17
1125892,779332,2018-11-29,Senate,"Senate Third Reading: Passed Roll Call # 627",36,2,0,0,38
1125892,780546,2018-12-12,House,"Reported With Recommendation With Substitute  H-2",26,0,0,0,26
1125892,781297,2018-12-20,House,"House Third Reading: Given Immediate Effect Roll Call # 910",106,3,0,0,109
1125892,781471,2018-12-20,Senate,"Senate Third Reading: Roll Call # 1016",36,2,0,0,38
1125897,779279,2018-11-29,Senate,"Reported Favorably With Substitute  S-1",9,0,0,0,9
1125897,779730,2018-12-04,Senate,"Senate Third Reading: Passed Roll Call # 670",37,0,0,1,38
1125898,780084,2018-12-06,Senate,"Reported Favorably Without Amendment",4,3,0,0,7
1125903,775359,2018-10-02,Senate,"Reported Favorably With Substitute S-1",5,0,0,0,5
1125903,779352,2018-11-29,Senate,"Senate Third Reading: Passed Roll Call # 629",38,0,0,0,38
1125907,780217,2018-12-06,Senate,"Reported Favorably Without Amendment",10,0,0,0,10
1125912,775360,2018-10-02,Senate,"Reported Favorably Without Amendment",9,0,0,0,9
1125912,779342,2018-11-29,Senate,"Senate Third Reading: Passed Roll Call # 626",37,1,0,0,38
1125912,779343,2018-11-29,Senate,"Senate Third Reading: Passed Roll Call # 628",38,0,0,0,38
1125914,775357,2018-10-02,Senate,"Reported Favorably With Substitute S-1",9,0,0,0,9
1125914,779293,2018-11-28,Senate,"Senate Third Reading: Passed Roll Call # 608",38,0,0,0,38
1125914,780566,2018-12-12,House,"Reported With Recommendation Without Amendment",16,0,0,0,16
1125914,781285,2018-12-20,House,"House Third Reading: Given Immediate Effect Roll Call # 911",107,2,0,0,109
1125914,781428,2018-12-20,Senate,"Senate Third Reading: Roll Call # 1015",38,0,0,0,38
1125919,777178,2018-10-02,Senate,"Reported Favorably Without Amendment",5,0,0,0,5
1125919,779317,2018-11-28,Senate,"Senate Third Reading: Passed Roll Call # 607",38,0,0,0,38
1125924,775115,2018-09-26,Senate,"Reported Favorably Without Amendment",5,2,0,0,7
1125924,779222,2018-11-28,Senate,"Senate Third Reading: Passed Roll Call # 611",27,11,0,0,38
1125924,779561,2018-12-04,House,"Reported With Recommendation Without Amendment",12,1,0,0,13
1125924,781548,2018-12-21,House,"House Third Reading: Given Immediate Effect Roll Call # 1004",62,45,0,0,107
1125926,779360,2018-11-29,Senate,"Reported Favorably Without Amendment",16,1,0,0,17
1125926,780072,2018-12-06,Senate,"Senate Third Reading: Passed Roll Call # 710",33,3,0,2,38
1125926,780571,2018-12-12,House,"Reported With Recommendation Without Amendment",21,4,0,0,25
1125926,781582,2018-12-20,House,"House Third Reading: Given Immediate Effect Roll Call # 945",74,34,0,0,108
1125930,777159,2018-10-02,Senate,"Reported Favorably Without Amendment",17,0,0,0,17
1125930,778967,2018-11-27,Senate,"Senate Third Reading: Passed By 2/3 Vote Roll Call # 603",37,0,0,0,37
1125930,780027,2018-12-05,House,"Reported With Recommendation Without Amendment",26,0,0,0,26
1125930,781363,2018-12-20,House,"House Third Reading: Given Immediate Effect Roll Call # 909",109,0,0,0,109
1125934,779793,2018-12-04,Senate,"Reported Favorably With Substitute  S-1",5,0,0,0,5
1125934,780050,2018-12-06,Senate,"Senate Third Reading: Passed Roll Call # 701",36,0,0,2,38
1125934,781172,2018-12-19,House,"Reported With Recommendation Without Amendment",9,0,0,0,9
1125934,781635,2018-12-20,House,"House Third Reading: Given Immediate Effect Roll Call # 936",108,0,0,0,108
1125934,781636,2018-12-20,Senate,"Senate Third Reading: Roll Call # 1026",38,0,0,0,38
1125954,779226,2018-11-29,House,"Reported With Recommendation With Substitute  H-2",9,5,0,0,14
1125954,780155,2018-12-06,House,"House Third Reading: Given Immediate Effect Roll Call # 756",56,53,0,0,109
1125958,777212,2018-10-04,House,"Reported With Recommendation Without Amendment",12,2,0,0,14
1125960,778253,2018-11-08,House,"Reported With Recommendation With Substitute  H-1",13,1,0,0,14
1125960,779194,2018-11-29,House,"House Third Reading: Given Immediate Effect Roll Call # 653",106,3,0,0,109
1125965,779217,2018-11-29,House,"Reported With Recommendation With Substitute  H-2",9,5,0,0,14
1125965,779998,2018-12-06,House,"House Third Reading: Given Immediate Effect Roll Call # 757",57,52,0,0,109
1125967,778961,2018-11-27,House,"Reported With Recommendation Without Amendment",11,2,0,0,13
1125988,779166,2018-11-29,Senate,"Reported Favorably Without Amendment",5,0,0,0,5
1125989,779162,2018-11-29,Senate,"Reported Favorably Without Amendment",5,0,0,0,5
1125995,775352,2018-10-03,House,"Reported With Recommendation With Substitute  H-1",12,0,0,0,12
1125995,777218,2018-10-04,House,"House Third Reading: Given Immediate Effect Roll Call # 623",106,0,0,0,106
1125995,780085,2018-12-05,Senate,"Reported Favorably Without Amendment",4,0,0,0,4
1125995,781585,2018-12-21,Senate,"Senate Third Reading: Given Immediate Effect Roll Call # 1034",37,1,0,0,38
1126004,775350,2018-10-03,House,"Reported With Recommendation With Substitute  H-1",11,0,0,0,11
1126004,777216,2018-10-04,House,"House Third Reading: Given Immediate Effect Roll Call # 622",105,1,0,0,106
1126004,780066,2018-12-05,Senate,"Reported Favorably Without Amendment",4,0,0,0,4
1126004,781586,2018-12-21,Senate,"Senate Third Reading: Given Immediate Effect Roll Call # 1033",36,2,0,0,38
1126004,781587,2018-12-21,House,"House Third Reading: Roll Call # 1041",104,0,0,0,104
1126017,775400,2018-10-03,House,"Reported With Recommendation Without Amendment",28,1,0,0,29
1126017,777215,2018-10-04,House,"House Third Reading: Given Immediate Effect Roll Call # 626",102,4,0,0,106
1126017,780752,2018-12-13,Senate,"Reported Favorably With Substitute  S-1",17,0,0,0,17
1126017,781338,2018-12-18,Senate,"Senate Third Reading: Given Immediate Effect Roll Call # 868",38,0,0,0,38
1126017,781679,2018-12-21,House,"House Third Reading: Roll Call # 1008",106,1,0,0,107
1126020,779758,2018-12-04,House,"Reported With Recommendation With Substitute  H-2",8,2,0,0,10
1126020,780096,2018-12-05,House,"House Third Reading: Given Immediate Effect Roll Call # 715",106,2,0,0,108
1126020,780432,2018-12-12,Senate,"Reported Favorably With Substitute  S-1",4,0,0,0,4
1126020,781616,2018-12-21,Senate,"Senate Third Reading: Passed Roll Call # 1036",38,0,0,0,38
1126020,781617,2018-12-21,House,"House Third Reading: Roll Call # 1042",102,2,0,0,104
1126931,779556,2018-12-04,House,"Reported With Recommendation Without Amendment",18,0,0,0,18
1126982,780179,2018-12-06,House,"Reported With Recommendation Without Amendment",11,0,0,0,11
1127037,780046,2018-12-05,House,"Reported With Recommendation With Substitute  H-1",22,4,0,0,26
1127037,780442,2018-12-12,House,"House Third Reading: Given Immediate Effect Roll Call # 787",99,9,0,0,108
1127037,780810,2018-12-13,Senate,"Reported Favorably Without Amendment",17,0,0,0,17
1127037,781319,2018-12-18,Senate,"Senate Third Reading: Given Immediate Effect Roll Call # 870",38,0,0,0,38
1127040,775009,2018-09-26,House,"Reported With Recommendation Without Amendment",5,0,0,0,5
1127040,775379,2018-10-03,House,"House Third Reading: Given Immediate Effect Roll Call # 604",103,4,0,0,107
1127040,778856,2018-11-08,Senate,"Senate Third Reading: Given Immediate Effect Roll Call # 594",33,1,0,3,37
1127040,778857,2018-11-08,House,"House Third Reading: Roll Call # 630",106,2,0,0,108
1127042,775380,2018-10-03,House,"Reported With Recommendation With Substitute  H-1",11,0,0,0,11
1127042,779009,2018-11-27,House,"House Third Reading: Given Immediate Effect Roll Call # 636",108,1,0,0,109
1127042,780642,2018-12-12,Senate,"Reported Favorably With Substitute  S-1",4,0,0,0,4
1127042,780835,2018-12-12,Senate,"Reported Favorably With Substitute  S-2",4,0,0,0,4
1127042,781491,2018-12-19,Senate,"Senate Third Reading: Given Immediate Effect Roll Call # 942",38,0,0,0,38
1127042,781677,2018-12-21,House,"House Third Reading: Roll Call # 982",107,0,0,0,107
1127045,775378,2018-10-03,House,"Reported With Recommendation Without Amendment",11,0,0,0,11
1127045,778995,2018-11-27,House,"House Third Reading: Given Immediate Effect Roll Call # 634",109,0,0,0,109
1127045,780640,2018-12-12,Senate,"Reported Favorably With Substitute  S-2",4,0,0,0,4
1127045,781504,2018-12-19,Senate,"Senate Third Reading: Given Immediate Effect Roll Call # 940",38,0,0,0,38
1127045,781680,2018-12-21,House,"House Third Reading: Roll Call # 980",107,0,0,0,107
1127046,779227,2018-11-28,House,"Reported With Recommendation With Substitute  H-1",9,0,0,0,9
1127046,780087,2018-12-06,House,"House Third Reading: Given Immediate Effect Roll Call # 733",108,1,0,0,109
1127046,780764,2018-12-13,Senate,"Reported Favorably Without Amendment",5,0,0,0,5
1127046,781335,2018-12-18,Senate,"Senate Third Reading: Given Immediate Effect Roll Call # 892",34,4,0,0,38
1127046,781664,2018-12-21,House,"House Third Reading: Roll Call # 978",107,0,0,0,107
1127048,777168,2018-10-03,House,"Reported With Recommendation With Substitute  H-1",11,0,0,0,11
1127048,777217,2018-10-04,House,"House Third Reading: Given Immediate Effect Roll Call # 624",105,1,0,0,106
1127048,780079,2018-12-05,Senate,"Reported Favorably Without Amendment",4,0,0,0,4
1127048,781583,2018-12-21,Senate,"Senate Third Reading: Given Immediate Effect Roll Call # 1035",36,2,0,0,38
1127051,775383,2018-10-03,House,"Reported With Recommendation With Substitute  H-1",11,0,0,0,11
1127051,779007,2018-11-27,House,"House Third Reading: Given Immediate Effect Roll Call # 635",109,0,0,0,109
1127051,780633,2018-12-12,Senate,"Reported Favorably With Substitute  S-3",4,0,0,0,4
1127051,781502,2018-12-19,Senate,"Senate Third Reading: Given Immediate Effect Roll Call # 941",38,0,0,0,38
1127051,781673,2018-12-21,House,"House Third Reading: Roll Call # 981",107,0,0,0,107
1127063,775381,2018-10-03,House,"Reported With Recommendation Without Amendment",11,0,0,0,11
1127063,779004,2018-11-27,House,"House Third Reading: Given Immediate Effect Roll Call # 633",109,0,0,0,109
1127063,780639,2018-12-12,Senate,"Reported Favorably With Substitute  S-1",4,0,0,0,4
1127063,781503,2018-12-19,Senate,"Senate Third Reading: Given Immediate Effect Roll Call # 939",38,0,0,0,38
1127063,781678,2018-12-21,House,"House Third Reading: Roll Call # 979",107,0,0,0,107
1127064,780047,2018-12-05,House,"Reported With Recommendation Without Amendment",24,4,0,0,28
1127064,780416,2018-12-11,House,"House Third Reading: Given Immediate Effect Roll Call # 776",107,1,0,0,108
1127064,780697,2018-12-13,Senate,"Reported Favorably Without Amendment",17,0,0,0,17
1127064,781306,2018-12-18,Senate,"Senate Third Reading: Given Immediate Effect Roll Call # 869",38,0,0,0,38
1127066,775272,2018-10-02,House,"Reported With Recommendation Without Amendment",15,0,0,0,15
1127066,775398,2018-10-03,House,"House Third Reading: Given Immediate Effect Roll Call # 615",107,0,0,0,107
1127066,780167,2018-12-06,Senate,"Reported Favorably Without Amendment",9,0,0,0,9
1127071,778259,2018-11-08,House,"Reported With Recommendation With Substitute  H-3",6,1,0,0,7
1127071,779621,2018-12-04,House,"House Third Reading: Given Immediate Effect Roll Call # 673",63,45,0,0,108
1127071,780572,2018-12-12,Senate,"Reported Favorably With Substitute  S-1",4,0,0,0,4
1127071,780763,2018-12-13,Senate,"Senate Third Reading: Given Immediate Effect Roll Call # 813",25,12,0,1,38
1127071,781188,2018-12-19,House,"House Third Reading: Roll Call # 900",63,46,0,0,109
1127143,779631,2018-12-04,Senate,"Reported Favorably Without Amendment",5,0,0,0,5
1127143,780197,2018-12-06,Senate,"Senate Third Reading: Passed Roll Call # 702",36,0,0,2,38
1127143,781171,2018-12-19,House,"Reported With Recommendation Without Amendment",9,0,0,0,9
1127143,781641,2018-12-20,House,"House Third Reading: Given Immediate Effect Roll Call # 937",108,0,0,0,108
1127150,779797,2018-12-04,Senate,"Reported Favorably With Substitute  S-1",9,0,0,0,9
1127150,780049,2018-12-06,Senate,"Senate Third Reading: Passed Roll Call # 704",35,1,0,2,38
1127150,780453,2018-12-12,House,"Reported With Recommendation Without Amendment",12,0,0,0,12
1127150,781142,2018-12-18,House,"House Third Reading: Given Immediate Effect Roll Call # 874",100,9,0,0,109
1127154,780187,2018-12-06,Senate,"Reported Favorably With Substitute  S-1",5,2,0,0,7
1127154,780188,2018-12-06,Senate,"Senate Third Reading: Passed Roll Call # 730",36,0,0,2,38
1127154,780439,2018-12-11,House,"Reported With Recommendation Without Amendment",13,0,0,0,13
1127154,781296,2018-12-20,House,"House Third Reading: Given Immediate Effect Roll Call # 913",109,0,0,0,109
1127162,779351,2018-11-29,Senate,"Reported Favorably With Substitute  S-1",4,1,0,0,5
1127162,780070,2018-12-05,Senate,"Senate Third Reading: Passed Roll Call # 694",28,9,0,1,38
1127173,777210,2018-10-04,House,"Reported With Recommendation Without Amendment",14,1,0,0,15
1127173,780630,2018-12-13,House,"House Third Reading: Given Immediate Effect Roll Call # 850",104,5,0,0,109
1127177,779048,2018-11-27,House,"Reported With Recommendation With Substitute  H-1",11,0,0,0,11
1127177,779177,2018-11-29,House,"House Third Reading: Given Immediate Effect Roll Call # 660",109,0,0,0,109
1127177,780653,2018-12-12,Senate,"Reported Favorably Without Amendment",5,0,0,0,5
1127177,781425,2018-12-20,Senate,"Senate Third Reading: Passed Roll Call # 970",38,0,0,0,38
1127177,781535,2018-12-21,House,"House Third Reading: Senate Amendment(s) Concurred In Roll Call # 1030",105,1,0,0,106
1127180,779295,2018-11-28,House,"Reported With Recommendation Without Amendment",12,0,0,0,12
1127180,780059,2018-12-05,House,"House Third Reading: Given Immediate Effect Roll Call # 713",108,0,0,0,108
1127180,780588,2018-12-12,Senate,"Reported Favorably Without Amendment",4,0,0,0,4
1127180,781302,2018-12-20,Senate,"Senate Third Reading: Given Immediate Effect Roll Call # 987",38,0,0,0,38
1127184,775251,2018-10-02,House,"Reported With Recommendation Without Amendment",9,0,0,0,9
1127184,775373,2018-10-03,House,"House Third Reading: Given Immediate Effect Roll Call # 610",107,0,0,0,107
1127187,779203,2018-11-28,House,"Reported With Recommendation With Substitute  H-1",9,2,0,0,11
1127188,778256,2018-11-08,House,"Reported With Recommendation Without Amendment",10,0,0,0,10
1127188,780011,2018-12-05,House,"House Third Reading: Given Immediate Effect Roll Call # 679",106,2,0,0,108
1127188,780547,2018-12-12,Senate,"Reported Favorably Without Amendment",9,0,0,0,9
1127188,781290,2018-12-18,Senate,"Senate Third Reading: Given Immediate Effect Roll Call # 863",38,0,0,0,38
1127188,781557,2018-12-20,House,"House Third Reading: Senate Amendment(s) Concurred In Roll Call # 959",105,2,0,0,107
1127192,779283,2018-11-28,House,"Reported With Recommendation Without Amendment",12,0,0,0,12
1127192,779958,2018-12-05,House,"House Third Reading: Given Immediate Effect Roll Call # 714",108,0,0,0,108
1127192,780548,2018-12-12,Senate,"Reported Favorably Without Amendment",4,0,0,0,4
1127192,781362,2018-12-20,Senate,"Senate Third Reading: Given Immediate Effect Roll Call # 988",38,0,0,0,38
1127269,779186,2018-11-28,House,"Reported With Recommendation Without Amendment",7,0,0,0,7
1127269,780148,2018-12-06,House,"House Third Reading: Given Immediate Effect Roll Call # 752",103,6,0,0,109
1127269,781400,2018-12-18,Senate,"Reported Favorably With Substitute S-1",5,0,0,0,5
1127269,781401,2018-12-19,Senate,"Senate Third Reading: Given Immediate Effect Roll Call # 931",38,0,0,0,38
1127269,781672,2018-12-21,House,"House Third Reading: Roll Call # 983",103,4,0,0,107
1127270,778957,2018-11-27,House,"Reported With Recommendation With Substitute  H-1",12,0,0,0,12
1127270,779532,2018-12-04,House,"House Third Reading: Given Immediate Effect Roll Call # 667",108,0,0,0,108
1127270,780598,2018-12-11,Senate,"Reported Favorably Without Amendment",5,0,0,0,5
1127270,781509,2018-12-19,Senate,"Senate Third Reading: Given Immediate Effect Roll Call # 938",38,0,0,0,38
1127270,781510,2018-12-20,Senate,"Senate Third Reading: Given Immediate Effect Roll Call # 1007",38,0,0,0,38
1127270,781632,2018-12-21,House,"House Third Reading: Roll Call # 1031",105,0,0,0,105
1127271,779185,2018-11-28,House,"Reported With Recommendation With Substitute  H-1",6,0,0,0,6
1127271,779985,2018-12-06,House,"House Third Reading: Given Immediate Effect Roll Call # 750",103,6,0,0,109
1127271,781398,2018-12-18,Senate,"Reported Favorably With Substitute S-1",5,0,0,0,5
1127549,777209,2018-10-04,House,"Reported With Recommendation Without Amendment",14,1,0,0,15
1127549,779190,2018-11-29,House,"House Third Reading: Given Immediate Effect Roll Call # 659",85,24,0,0,109
1127549,781407,2018-12-20,Senate,"Senate Third Reading: Passed Roll Call # 1021",33,5,0,0,38
1127549,781675,2018-12-21,House,"House Third Reading: Roll Call # 992",83,23,0,0,106
1127553,777208,2018-10-04,House,"Reported With Recommendation Without Amendment",14,1,0,0,15
1127553,779152,2018-11-29,House,"House Third Reading: Given Immediate Effect Roll Call # 658",87,22,0,0,109
1127637,779232,2018-11-28,House,"Reported With Recommendation Without Amendment",10,1,0,0,11
1127637,779967,2018-12-06,House,"House Third Reading: Given Immediate Effect Roll Call # 731",106,3,0,0,109
1127637,780525,2018-12-12,Senate,"Reported Favorably Without Amendment",5,0,0,0,5
1127637,780737,2018-12-13,Senate,"Senate Third Reading: Given Immediate Effect Roll Call # 809",36,1,0,1,38
1127639,779230,2018-11-28,House,"Reported With Recommendation Without Amendment",7,4,0,0,11
1127639,780088,2018-12-06,House,"House Third Reading: Given Immediate Effect Roll Call # 730",106,3,0,0,109
1127639,780584,2018-12-12,Senate,"Reported Favorably Without Amendment",5,0,0,0,5
1127639,780739,2018-12-13,Senate,"Senate Third Reading: Given Immediate Effect Roll Call # 808",37,0,0,1,38
1127661,779289,2018-11-29,House,"Reported With Recommendation With Substitute  H-1",16,0,0,0,16
1127661,779550,2018-12-04,House,"House Third Reading: Given Immediate Effect Roll Call # 670",107,1,0,0,108
1127661,780138,2018-12-06,Senate,"Reported Favorably Without Amendment",10,0,0,0,10
1127661,780615,2018-12-12,Senate,"Senate Third Reading: Given Immediate Effect Roll Call # 768",38,0,0,0,38
1127661,781045,2018-12-18,House,"House Third Reading: Senate Amendment(s) Concurred In Roll Call # 878",105,4,0,0,109
1127679,779548,2018-12-04,House,"Reported With Recommendation Without Amendment",18,0,0,0,18
1127679,780558,2018-12-11,House,"House Third Reading: Given Immediate Effect Roll Call # 773",108,0,0,0,108
1127679,781365,2018-12-18,Senate,"Reported Favorably Without Amendment",5,0,0,0,5
1127679,781366,2018-12-18,Senate,"Senate Third Reading: Given Immediate Effect Roll Call # 880",37,1,0,0,38
1127687,779248,2018-11-28,House,"Reported With Recommendation For Referral To Committee On Regulatory Reform",9,0,0,0,9
1127687,779648,2018-12-04,House,"Reported With Recommendation Without Amendment",13,1,0,0,14
1127687,780433,2018-12-12,House,"House Third Reading: Given Immediate Effect Roll Call # 817",104,5,0,0,109
1127689,779285,2018-11-29,House,"Reported With Recommendation Without Amendment",14,0,0,0,14
1127689,779555,2018-12-04,House,"House Third Reading: Given Immediate Effect Roll Call # 672",107,1,0,0,108
1127689,780240,2018-12-06,Senate,"Reported Favorably Without Amendment",10,0,0,0,10
1127689,780626,2018-12-12,Senate,"Senate Third Reading: Given Immediate Effect Roll Call # 767",38,0,0,0,38
1127691,779544,2018-12-04,House,"Reported With Recommendation Without Amendment",18,0,0,0,18
1127691,780561,2018-12-11,House,"House Third Reading: Given Immediate Effect Roll Call # 775",108,0,0,0,108
1127691,781412,2018-12-18,Senate,"Reported Favorably Without Amendment",5,0,0,0,5
1127691,781413,2018-12-18,Senate,"Senate Third Reading: Given Immediate Effect Roll Call # 882",37,1,0,0,38
1127697,779549,2018-12-04,House,"Reported With Recommendation Without Amendment",18,0,0,0,18
1127697,780556,2018-12-11,House,"House Third Reading: Given Immediate Effect Roll Call # 774",108,0,0,0,108
1127697,781447,2018-12-18,Senate,"Reported Favorably Without Amendment",5,0,0,0,5
1127697,781448,2018-12-18,Senate,"Senate Third Reading: Given Immediate Effect Roll Call # 881",37,1,0,0,38
1127699,779553,2018-12-04,House,"Reported With Recommendation With Substitute  H-2",13,0,0,0,13
1127699,779554,2018-12-04,House,"House Third Reading: Given Immediate Effect Roll Call # 666",107,1,0,0,108
1127699,780238,2018-12-06,Senate,"Reported Favorably Without Amendment",10,0,0,0,10
1127699,780545,2018-12-12,Senate,"Senate Third Reading: Given Immediate Effect Roll Call # 766",38,0,0,0,38
1127701,779247,2018-11-28,House,"Reported With Recommendation For Referral To Committee On Regulatory Reform",9,0,0,0,9
1127701,779645,2018-12-04,House,"Reported With Recommendation With Substitute  H-1",13,1,0,0,14
1127701,780628,2018-12-12,House,"House Third Reading: Given Immediate Effect Roll Call # 818",103,6,0,0,109
1128275,778976,2018-11-27,House,"Reported With Recommendation Without Amendment",10,3,0,0,13
1128275,779994,2018-12-05,House,"House Third Reading: Given Immediate Effect Roll Call # 695",80,28,0,0,108
1128275,780770,2018-12-13,Senate,"Reported Favorably Without Amendment",3,1,0,0,4
1128275,781310,2018-12-18,Senate,"Senate Third Reading: Given Immediate Effect Roll Call # 866",29,9,0,0,38
1128808,779294,2018-11-28,House,"Reported With Recommendation Without Amendment",8,0,0,0,8
1128808,779965,2018-12-06,House,"House Third Reading: Given Immediate Effect Roll Call # 742",107,2,0,0,109
1128808,780760,2018-12-13,Senate,"Reported Favorably Without Amendment",17,0,0,0,17
1128808,781367,2018-12-20,Senate,"Senate Third Reading: Given Immediate Effect Roll Call # 991",38,0,0,0,38
1128822,779297,2018-11-28,House,"Reported With Recommendation Without Amendment",8,0,0,0,8
1128822,779984,2018-12-06,House,"House Third Reading: Given Immediate Effect Roll Call # 745",107,2,0,0,109
1128822,780765,2018-12-13,Senate,"Reported Favorably Without Amendment",17,0,0,0,17
1128822,781325,2018-12-20,Senate,"Senate Third Reading: Given Immediate Effect Roll Call # 994",38,0,0,0,38
1128849,779326,2018-11-28,House,"Reported With Recommendation Without Amendment",8,0,0,0,8
1128849,779989,2018-12-06,House,"House Third Reading: Given Immediate Effect Roll Call # 743",107,2,0,0,109
1128849,780769,2018-12-13,Senate,"Reported Favorably Without Amendment",17,0,0,0,17
1128849,781339,2018-12-20,Senate,"Senate Third Reading: Given Immediate Effect Roll Call # 992",38,0,0,0,38
1128877,779151,2018-11-28,House,"Reported With Recommendation With Substitute  H-1",9,0,0,0,9
1128877,779997,2018-12-06,House,"House Third Reading: Given Immediate Effect Roll Call # 734",107,2,0,0,109
1128877,780746,2018-12-13,Senate,"Reported Favorably Without Amendment",4,0,0,0,4
1128877,781520,2018-12-18,Senate,"Senate Third Reading: Given Immediate Effect Roll Call # 867",38,0,0,0,38
1128905,780078,2018-12-06,House,"Reported With Recommendation Without Amendment",8,7,0,0,15
1128934,779308,2018-11-28,House,"Reported With Recommendation Without Amendment",8,0,0,0,8
1128934,779986,2018-12-06,House,"House Third Reading: Given Immediate Effect Roll Call # 744",107,2,0,0,109
1128934,780762,2018-12-13,Senate,"Reported Favorably Without Amendment",17,0,0,0,17
1128934,781341,2018-12-20,Senate,"Senate Third Reading: Given Immediate Effect Roll Call # 993",38,0,0,0,38
1128990,779292,2018-11-28,House,"Reported With Recommendation With Substitute  H-2",8,0,0,0,8
1128990,779982,2018-12-06,House,"House Third Reading: Given Immediate Effect Roll Call # 740",107,2,0,0,109
1128990,780722,2018-12-13,Senate,"Reported Favorably With Substitute  S-1",17,0,0,0,17
1128990,781380,2018-12-20,Senate,"Senate Third Reading: Given Immediate Effect Roll Call # 989",38,0,0,0,38
1128990,781564,2018-12-21,House,"House Third Reading: Roll Call # 1033",104,1,0,0,105
1129018,779296,2018-11-28,House,"Reported With Recommendation Without Amendment",8,0,0,0,8
1129018,779974,2018-12-06,House,"House Third Reading: Given Immediate Effect Roll Call # 746",107,2,0,0,109
1129018,780724,2018-12-13,Senate,"Reported Favorably Without Amendment",17,0,0,0,17
1129018,781440,2018-12-20,Senate,"Senate Third Reading: Given Immediate Effect Roll Call # 995",38,0,0,0,38
1129045,779328,2018-11-28,House,"Reported With Recommendation Without Amendment",8,0,0,0,8
1129045,779991,2018-12-06,House,"House Third Reading: Given Immediate Effect Roll Call # 741",107,2,0,0,109
1129045,780777,2018-12-13,Senate,"Reported Favorably Without Amendment",17,0,0,0,17
1129045,781458,2018-12-20,Senate,"Senate Third Reading: Given Immediate Effect Roll Call # 990",38,0,0,0,38
1129048,779261,2018-11-29,Senate,"Reported Favorably Without Amendment",7,0,0,0,7
1129048,779262,2018-11-29,Senate,"Senate Third Reading: Passed Roll Call # 615",23,15,0,0,38
1129049,780190,2018-12-05,Senate,"Reported Favorably With Substitute  S-1",4,0,0,0,4
1129049,780191,2018-12-06,Senate,"Senate Third Reading: Passed Roll Call # 711",36,0,0,2,38
1129050,779371,2018-11-29,Senate,"Reported Favorably Without Amendment",7,0,0,0,7
1129050,779372,2018-11-29,Senate,"Senate Third Reading: Passed Roll Call # 644",37,0,0,1,38
1129050,779641,2018-12-04,House,"Reported With Recommendation Without Amendment",14,0,0,0,14
1129050,780570,2018-12-12,House,"House Third Reading: Given Immediate Effect Roll Call # 800",106,2,0,0,108
1129052,780245,2018-12-06,Senate,"Reported Favorably Without Amendment",5,2,0,0,7
1129052,780246,2018-12-06,Senate,"Senate Third Reading: Passed Roll Call # 727",36,0,0,2,38
1129055,779257,2018-11-29,Senate,"Reported Favorably Without Amendment",7,0,0,0,7
1129055,779258,2018-11-29,Senate,"Senate Third Reading: Passed Roll Call # 641",37,0,0,1,38
1129055,779671,2018-12-04,House,"Reported With Recommendation Without Amendment",14,0,0,0,14
1129055,780420,2018-12-11,House,"House Third Reading: Given Immediate Effect Roll Call # 785",104,2,0,0,106
1129057,779373,2018-11-29,Senate,"Reported Favorably Without Amendment",7,0,0,0,7
1129057,779374,2018-11-29,Senate,"Senate Third Reading: Passed Roll Call # 645",37,0,0,1,38
1129057,779644,2018-12-04,House,"Reported With Recommendation Without Amendment",14,0,0,0,14
1129057,780532,2018-12-12,House,"House Third Reading: Given Immediate Effect Roll Call # 801",106,2,0,0,108
1129058,779375,2018-11-29,Senate,"Reported Favorably Without Amendment",7,0,0,0,7
1129058,779376,2018-11-29,Senate,"Senate Third Reading: Passed Roll Call # 647",37,0,0,1,38
1129058,779659,2018-12-04,House,"Reported With Recommendation Without Amendment",14,0,0,0,14
1129058,780565,2018-12-12,House,"House Third Reading: Given Immediate Effect Roll Call # 803",106,2,0,0,108
1129059,778931,2018-11-27,Senate,"Reported Favorably Without Amendment",4,0,0,0,4
1129059,779271,2018-11-28,Senate,"Senate Third Reading: Passed Roll Call # 610",38,0,0,0,38
1129059,781212,2018-12-19,House,"Reported With Recommendation Without Amendment",13,0,0,0,13
1129059,781289,2018-12-20,House,"House Third Reading: Given Immediate Effect Roll Call # 923",109,0,0,0,109
1129061,779288,2018-11-28,Senate,"Reported Favorably With Substitute  S-2",3,2,0,0,5
1129061,779578,2018-12-04,House,"Reported With Recommendation Without Amendment",6,3,0,0,9
1129061,779579,2018-12-04,House,"House Third Reading: Passed Roll Call # 674",60,48,0,0,108
1129061,779699,2018-12-04,Senate,"Senate Third Reading: Roll Call # 678",26,12,0,0,38
1129061,781726,2018-11-28,Senate,"Senate Third Reading: Passed Roll Call # 604",26,12,0,0,38
1129065,779367,2018-11-29,Senate,"Reported Favorably With Substitute  S-3",7,0,0,0,7
1129065,779368,2018-11-29,Senate,"Senate Third Reading: Passed Roll Call # 652",37,0,0,1,38
1129065,779653,2018-12-04,House,"Reported With Recommendation With Substitute  H-2",14,0,0,0,14
1129065,780536,2018-12-12,House,"House Third Reading: Given Immediate Effect Roll Call # 808",103,6,0,0,109
1129065,780750,2018-12-13,Senate,"Senate Third Reading: Roll Call # 826",37,0,0,1,38
1129067,779309,2018-11-29,Senate,"Reported Favorably With Substitute  S-1",7,0,0,0,7
1129067,779310,2018-11-29,Senate,"Senate Third Reading: Passed Roll Call # 617",23,15,0,0,38
1129068,779385,2018-11-29,Senate,"Reported Favorably Without Amendment",7,0,0,0,7
1129068,779386,2018-11-29,Senate,"Senate Third Reading: Passed Roll Call # 639",37,0,0,1,38
1129068,779666,2018-12-04,House,"Reported With Recommendation Without Amendment",14,0,0,0,14
1129068,780534,2018-12-11,House,"House Third Reading: Given Immediate Effect Roll Call # 783",105,2,0,0,107
1129069,779251,2018-11-29,Senate,"Reported Favorably Without Amendment",7,0,0,0,7
1129069,779745,2018-12-04,Senate,"Senate Third Reading: Passed Roll Call # 659",36,0,0,2,38
1129071,779361,2018-11-29,Senate,"Reported Favorably Without Amendment",7,0,0,0,7
1129071,779362,2018-11-29,Senate,"Senate Third Reading: Passed Roll Call # 648",37,0,0,1,38
1129071,779634,2018-12-04,House,"Reported With Recommendation Without Amendment",14,0,0,0,14
1129071,780430,2018-12-12,House,"House Third Reading: Given Immediate Effect Roll Call # 804",106,2,0,0,108
1129073,780232,2018-12-05,Senate,"Reported Favorably With Substitute  S-1",5,0,0,0,5
1129073,780233,2018-12-05,Senate,"Senate Third Reading: Passed Roll Call # 697",36,1,0,1,38
1129073,781175,2018-12-19,House,"Reported With Recommendation Without Amendment",12,0,0,0,12
1129073,781317,2018-12-20,House,"House Third Reading: Given Immediate Effect Roll Call # 924",109,0,0,0,109
1129074,779387,2018-11-29,Senate,"Reported Favorably Without Amendment",7,0,0,0,7
1129074,779388,2018-11-29,Senate,"Senate Third Reading: Passed Roll Call # 640",37,0,0,1,38
1129074,779661,2018-12-04,House,"Reported With Recommendation Without Amendment",14,0,0,0,14
1129074,780419,2018-12-11,House,"House Third Reading: Given Immediate Effect Roll Call # 784",105,2,0,0,107
1129075,779345,2018-11-29,Senate,"Reported Favorably Without Amendment",4,0,0,0,4
1129075,780198,2018-12-05,Senate,"Senate Third Reading: Passed Roll Call # 692",37,0,0,1,38
1129077,779330,2018-11-29,Senate,"Reported Favorably Without Amendment",7,0,0,0,7
1129077,779331,2018-11-29,Senate,"Senate Third Reading: Passed Roll Call # 635",37,0,0,1,38
1129077,779568,2018-12-04,House,"Reported With Recommendation Without Amendment",9,0,0,0,9
1129077,781147,2018-12-18,House,"House Third Reading: Given Immediate Effect Roll Call # 851",108,1,0,0,109
1129078,779346,2018-11-29,Senate,"Reported Favorably Without Amendment",4,0,0,0,4
1129078,780201,2018-12-05,Senate,"Senate Third Reading: Passed Roll Call # 690",37,0,0,1,38
1129080,779347,2018-11-29,Senate,"Reported Favorably Without Amendment",7,0,0,0,7
1129080,779348,2018-11-29,Senate,"Senate Third Reading: Passed Roll Call # 634",36,1,0,1,38
1129082,779702,2018-12-04,Senate,"Reported Favorably Without Amendment",5,0,0,0,5
1129082,779703,2018-12-04,Senate,"Senate Third Reading: Passed Roll Call # 674",29,8,0,1,38
1129082,779972,2018-12-05,House,"Reported With Recommendation Without Amendment",7,2,0,0,9
1129082,780504,2018-12-12,House,"House Third Reading: Given Immediate Effect Roll Call # 815",91,18,0,0,109
1129086,779379,2018-11-29,Senate,"Reported Favorably With Substitute  S-1",7,0,0,0,7
1129086,779380,2018-11-29,Senate,"Senate Third Reading: Passed Roll Call # 642",37,0,0,1,38
1129086,779652,2018-12-04,House,"Reported With Recommendation Without Amendment",14,0,0,0,14
1129086,780509,2018-12-11,House,"House Third Reading: Given Immediate Effect Roll Call # 786",104,2,0,0,106
1129087,779353,2018-11-29,Senate,"Reported Favorably Without Amendment",4,0,0,0,4
1129087,780251,2018-12-05,Senate,"Senate Third Reading: Passed Roll Call # 691",37,0,0,1,38
1129088,780241,2018-12-06,Senate,"Reported Favorably Without Amendment",5,2,0,0,7
1129088,780242,2018-12-06,Senate,"Senate Third Reading: Passed Roll Call # 728",36,0,0,2,38
1129090,779275,2018-11-29,Senate,"Reported Favorably Without Amendment",7,0,0,0,7
1129090,779276,2018-11-29,Senate,"Senate Third Reading: Passed Roll Call # 616",24,14,0,0,38
1129091,780585,2018-12-12,Senate,"Reported Favorably With Substitute  S-1",4,0,0,0,4
1129091,780696,2018-12-13,Senate,"Senate Third Reading: Passed Roll Call # 794",26,11,0,1,38
1129092,779358,2018-11-29,Senate,"Reported Favorably With Substitute  S-1",7,0,0,0,7
1129092,779359,2018-11-29,Senate,"Senate Third Reading: Passed Roll Call # 649",37,0,0,1,38
1129092,779633,2018-12-04,House,"Reported With Recommendation Without Amendment",14,0,0,0,14
1129092,780512,2018-12-12,House,"House Third Reading: Given Immediate Effect Roll Call # 805",106,2,0,0,108
1129094,779314,2018-11-29,Senate,"Reported Favorably With Substitute  S-1",7,0,0,0,7
1129094,779315,2018-11-29,Senate,"Senate Third Reading: Passed Roll Call # 636",25,12,0,1,38
1129094,781027,2018-12-18,House,"Reported With Recommendation Without Amendment",6,3,0,0,9
1129094,781028,2018-12-18,House,"House Third Reading: Given Immediate Effect Roll Call # 869",58,51,0,0,109
1129096,779286,2018-11-29,Senate,"Reported Favorably Without Amendment",7,0,0,0,7
1129096,779287,2018-11-29,Senate,"Senate Third Reading: Passed Roll Call # 613",23,15,0,0,38
1129099,779363,2018-11-29,Senate,"Reported Favorably Without Amendment",7,0,0,0,7
1129099,779364,2018-11-29,Senate,"Senate Third Reading: Passed Roll Call # 650",37,0,0,1,38
1129099,779643,2018-12-04,House,"Reported With Recommendation Without Amendment",13,1,0,0,14
1129099,780618,2018-12-12,House,"House Third Reading: Given Immediate Effect Roll Call # 806",105,3,0,0,108
1129100,779383,2018-11-29,Senate,"Reported Favorably Without Amendment",7,0,0,0,7
1129100,779384,2018-11-29,Senate,"Senate Third Reading: Passed Roll Call # 643",37,0,0,1,38
1129100,779642,2018-12-04,House,"Reported With Recommendation Without Amendment",14,0,0,0,14
1129100,780474,2018-12-12,House,"House Third Reading: Given Immediate Effect Roll Call # 799",106,2,0,0,108
1129101,779365,2018-11-29,Senate,"Reported Favorably Without Amendment",7,0,0,0,7
1129101,779366,2018-11-29,Senate,"Senate Third Reading: Passed Roll Call # 646",37,0,0,1,38
1129101,779649,2018-12-04,House,"Reported With Recommendation Without Amendment",14,0,0,0,14
1129101,780471,2018-12-12,House,"House Third Reading: Given Immediate Effect Roll Call # 802",106,2,0,0,108
1129102,779377,2018-11-29,Senate,"Reported Favorably With Substitute  S-2",7,0,0,0,7
1129102,779378,2018-11-29,Senate,"Senate Third Reading: Passed Roll Call # 637",37,0,0,1,38
1129102,779647,2018-12-04,House,"Reported With Recommendation Without Amendment",14,0,0,0,14
1129102,780559,2018-12-11,House,"House Third Reading: Passed Roll Call # 781",105,2,0,0,107
1129103,779323,2018-11-29,Senate,"Reported Favorably With Substitute  S-1",7,0,0,0,7
1129103,779324,2018-11-29,Senate,"Senate Third Reading: Passed Roll Call # 612",23,15,0,0,38
1129106,779244,2018-11-29,Senate,"Reported Favorably Without Amendment",7,0,0,0,7
1129106,779245,2018-11-29,Senate,"Senate Third Reading: Passed Roll Call # 633",25,12,0,1,38
1129106,779551,2018-12-04,House,"Reported With Recommendation Without Amendment",9,5,0,0,14
1129106,780450,2018-12-13,House,"House Third Reading: Given Immediate Effect Roll Call # 841",62,47,0,0,109
1129107,779349,2018-11-29,Senate,"Reported Favorably Without Amendment",4,0,0,0,4
1129107,780195,2018-12-05,Senate,"Senate Third Reading: Passed Roll Call # 693",37,0,0,1,38
1129108,779624,2018-12-04,Senate,"Reported Favorably Without Amendment",5,0,0,0,5
1129108,780125,2018-12-06,Senate,"Senate Third Reading: Passed Roll Call # 703",36,0,0,2,38
1129108,780576,2018-12-11,House,"Reported With Recommendation Without Amendment",13,0,0,0,13
1129108,781309,2018-12-20,House,"House Third Reading: Given Immediate Effect Roll Call # 914",101,8,0,0,109
1129109,780044,2018-12-06,Senate,"Reported Favorably Without Amendment",5,2,0,0,7
1129109,780045,2018-12-06,Senate,"Senate Third Reading: Passed Roll Call # 707",24,12,0,2,38
1129109,781119,2018-12-18,House,"Reported With Recommendation Without Amendment",6,3,0,0,9
1129109,781120,2018-12-18,House,"House Third Reading: Given Immediate Effect Roll Call # 870",62,47,0,0,109
1129110,779303,2018-11-28,Senate,"Reported Favorably With Substitute  S-1",6,1,0,0,7
1129110,779304,2018-11-29,Senate,"Senate Third Reading: Passed Roll Call # 632",37,0,0,1,38
1129110,779669,2018-12-04,House,"Reported With Recommendation Without Amendment",13,0,0,0,13
1129110,781056,2018-12-18,House,"House Third Reading: Given Immediate Effect Roll Call # 861",64,45,0,0,109
1129110,781483,2018-12-19,Senate,"Senate Third Reading: Roll Call # 914",38,0,0,0,38
1129112,779369,2018-11-29,Senate,"Reported Favorably With Substitute  S-1",7,0,0,0,7
1129112,779370,2018-11-29,Senate,"Senate Third Reading: Passed Roll Call # 638",37,0,0,1,38
1129112,779658,2018-12-04,House,"Reported With Recommendation Without Amendment",14,0,0,0,14
1129112,780537,2018-12-11,House,"House Third Reading: Passed Roll Call # 782",105,2,0,0,107
1129113,779260,2018-11-29,Senate,"Reported Favorably Without Amendment",7,0,0,0,7
1129113,779680,2018-12-04,Senate,"Senate Third Reading: Passed Roll Call # 658",24,12,0,2,38
1129113,780413,2018-12-12,House,"Reported With Recommendation Without Amendment",10,6,0,0,16
1129113,781144,2018-12-18,House,"House Third Reading: Given Immediate Effect Roll Call # 865",61,48,0,0,109
1129114,779381,2018-11-29,Senate,"Reported Favorably Without Amendment",7,0,0,0,7
1129114,779382,2018-11-29,Senate,"Senate Third Reading: Passed Roll Call # 651",37,0,0,1,38
1129114,779650,2018-12-04,House,"Reported With Recommendation Without Amendment",14,0,0,0,14
1129114,780526,2018-12-12,House,"House Third Reading: Given Immediate Effect Roll Call # 807",106,2,0,0,108
1129115,779732,2018-12-04,Senate,"Reported Favorably With Substitute  S-1",5,0,0,0,5
1129115,779733,2018-12-04,Senate,"Senate Third Reading: Passed Roll Call # 675",29,8,0,1,38
1129115,779963,2018-12-05,House,"Reported With Recommendation Without Amendment",7,2,0,0,9
1129115,780431,2018-12-12,House,"House Third Reading: Given Immediate Effect Roll Call # 816",66,43,0,0,109
1129115,780700,2018-12-13,Senate,"Senate Third Reading: House Amendment(s) Concurred In Roll Call # 827",26,11,0,1,38
1129116,779272,2018-11-29,Senate,"Reported Favorably Without Amendment",7,0,0,0,7
1129116,779273,2018-11-29,Senate,"Senate Third Reading: Passed Roll Call # 618",23,15,0,0,38
1129117,779700,2018-12-04,Senate,"Reported Favorably With Substitute  S-1",5,0,0,0,5
1129117,779701,2018-12-04,Senate,"Senate Third Reading: Passed Roll Call # 672",36,1,0,1,38
1129117,779968,2018-12-05,House,"Reported With Recommendation With Substitute  H-1",8,0,0,0,8
1129117,781560,2018-12-21,House,"House Third Reading: Given Immediate Effect Roll Call # 1032",102,3,0,0,105
1129117,781561,2018-12-21,Senate,"Senate Third Reading: Roll Call # 1058",36,1,0,1,38
1129118,779305,2018-11-28,Senate,"Reported Favorably With Substitute  S-1",4,0,0,0,4
1129118,780185,2018-12-05,Senate,"Senate Third Reading: Passed Roll Call # 689",22,15,0,1,38
1129119,779277,2018-11-28,Senate,"Reported Favorably With Substitute  S-1",3,2,0,0,5
1129119,779392,2018-11-28,Senate,"Senate Third Reading: Passed Roll Call # 605",26,12,0,0,38
1129119,779517,2018-12-04,House,"Reported With Recommendation Without Amendment",6,3,0,0,9
1129119,779518,2018-12-04,House,"House Third Reading: Passed Roll Call # 675",60,48,0,0,108
1129119,779665,2018-12-04,Senate,"Senate Third Reading: Roll Call # 679",26,12,0,0,38
1129120,779253,2018-11-29,Senate,"Reported Favorably With Substitute  S-1",3,2,0,0,5
1129120,780048,2018-12-05,Senate,"Senate Third Reading: Passed Roll Call # 680",25,13,0,0,38
1129120,781738,2018-12-11,House,"Reported With Recommendation With Substitute  H-2",3,0,0,0,3
1129120,781739,2018-12-11,House,"House Third Reading: Given Immediate Effect Roll Call # 772",74,34,0,0,108
1129120,781740,2018-12-11,Senate,"Senate Third Reading: Roll Call # 760",25,12,1,0,38
1129121,779299,2018-11-29,Senate,"Reported Favorably Without Amendment",7,0,0,0,7
1129121,779300,2018-11-29,Senate,"Senate Third Reading: Passed Roll Call # 614",23,15,0,0,38
1129131,779301,2018-11-28,House,"Reported With Recommendation With Substitute  H-1",8,0,0,0,8
1129131,779976,2018-12-06,House,"House Third Reading: Passed Roll Call # 736",109,0,0,0,109
1129131,780745,2018-12-13,Senate,"Reported Favorably Without Amendment",5,0,0,0,5
1129131,781300,2018-12-18,Senate,"Senate Third Reading: Given Immediate Effect Roll Call # 865",38,0,0,0,38
1129133,779183,2018-11-28,House,"Reported With Recommendation With Substitute  H-1",8,0,0,0,8
1129133,780023,2018-12-06,House,"House Third Reading: Passed Roll Call # 735",109,0,0,0,109
1129133,780743,2018-12-13,Senate,"Reported Favorably Without Amendment",5,0,0,0,5
1129133,781308,2018-12-18,Senate,"Senate Third Reading: Given Immediate Effect Roll Call # 864",38,0,0,0,38
1129136,779187,2018-11-29,House,"Reported With Recommendation With Substitute  H-1",11,2,0,0,13
1129136,779971,2018-12-06,House,"House Third Reading: Passed Roll Call # 749",103,6,0,0,109
1129136,781396,2018-12-18,Senate,"Reported Favorably With Substitute S-3",5,0,0,0,5
1129136,781397,2018-12-19,Senate,"Senate Third Reading: Given Immediate Effect Roll Call # 932",38,0,0,0,38
1129136,781665,2018-12-21,House,"House Third Reading: Roll Call # 1039",98,6,0,0,104
1129137,778941,2018-11-27,House,"Reported With Recommendation Without Amendment",14,0,0,0,14
1129137,780144,2018-12-06,House,"House Third Reading: Given Immediate Effect Roll Call # 729",109,0,0,0,109
1129137,780693,2018-12-13,Senate,"Reported Favorably Without Amendment",7,0,0,0,7
1129137,781337,2018-12-20,Senate,"Senate Third Reading: Passed Roll Call # 958",38,0,0,0,38
1129138,778935,2018-11-27,House,"Reported With Recommendation Without Amendment",9,3,0,0,12
1129138,780052,2018-12-06,House,"House Third Reading: Given Immediate Effect Roll Call # 723",58,51,0,0,109
1129138,780502,2018-12-12,Senate,"Reported Favorably Without Amendment",5,2,0,0,7
1129138,781457,2018-12-20,Senate,"Senate Third Reading: Given Immediate Effect Roll Call # 1009",27,11,0,0,38
1129138,781609,2018-12-21,House,"House Third Reading: Roll Call # 1034",56,49,0,0,105
1129138,781610,2018-12-21,House,"House Third Reading: Roll Call # 1034",56,49,0,0,105
1130840,780199,2018-12-05,Senate,"Reported Favorably With Substitute  S-1",5,0,0,0,5
1130840,780200,2018-12-06,Senate,"Senate Third Reading: Passed Roll Call # 708",15,20,1,2,38
1130840,780265,2018-12-06,Senate,"Senate Third Reading: Defeated Roll Call # 708",15,20,1,2,38
1130858,779612,2018-12-04,Senate,"Reported Favorably With Substitute  S-1",5,0,0,0,5
1130858,779719,2018-12-04,Senate,"Senate Third Reading: Passed Roll Call # 676",23,14,0,1,38
1130858,781052,2018-12-18,House,"Reported With Recommendation With Substitute  H-2",6,3,0,0,9
1130858,781282,2018-12-21,House,"House Third Reading: Given Immediate Effect Roll Call # 976",61,46,0,0,107
1130858,781579,2018-12-21,Senate,"Senate Third Reading: Roll Call # 1055",25,12,0,1,38
1130864,780034,2018-12-06,Senate,"Reported Favorably Without Amendment",5,2,0,0,7
1130864,780035,2018-12-06,Senate,"Senate Third Reading: Passed Roll Call # 713",32,4,0,2,38
1130864,781182,2018-12-19,House,"Reported With Recommendation Without Amendment",10,1,0,0,11
1130864,781606,2018-12-21,House,"House Third Reading: Passed Roll Call # 985",63,44,0,0,107
1130864,781607,2018-12-21,Senate,"Senate Third Reading: Roll Call # 1064",24,13,0,1,38
1130877,780237,2018-12-06,Senate,"Reported Favorably With Substitute  S-2",9,0,0,0,9
1130914,779269,2018-11-29,Senate,"Reported Favorably With Substitute  S-1",9,0,0,0,9
1130914,779677,2018-12-04,Senate,"Senate Third Reading: Passed Roll Call # 671",33,4,0,1,38
1130914,780578,2018-12-12,House,"Reported With Recommendation With Substitute  H-1",16,0,0,0,16
1130914,781050,2018-12-18,House,"House Third Reading: Given Immediate Effect Roll Call # 864",105,4,0,0,109
1130914,781501,2018-12-19,Senate,"Senate Third Reading: Roll Call # 915",35,3,0,0,38
1130992,779678,2018-12-04,Senate,"Reported Favorably Without Amendment",5,0,0,0,5
1130992,779679,2018-12-04,Senate,"Senate Third Reading: Passed Roll Call # 673",36,1,0,1,38
1130992,780414,2018-12-12,House,"Reported With Recommendation Without Amendment",15,0,0,0,15
1130992,781049,2018-12-18,House,"House Third Reading: Given Immediate Effect Roll Call # 866",109,0,0,0,109
1131062,780076,2018-12-06,House,"Reported With Recommendation Without Amendment",10,0,0,0,10
1131085,780156,2018-12-06,House,"Reported With Recommendation With Substitute  H-1",6,5,0,0,11
1131086,780409,2018-12-12,House,"Reported With Recommendation With Substitute  H-1",15,0,0,0,15
1131086,780645,2018-12-13,House,"House Third Reading: Given Immediate Effect Roll Call # 832",107,2,0,0,109
1131086,781481,2018-12-19,Senate,"Reported Favorably Without Amendment",4,0,0,0,4
1131086,781482,2018-12-19,Senate,"Senate Third Reading: Given Immediate Effect Roll Call # 957",38,0,0,0,38
1131087,779172,2018-11-28,House,"Reported With Recommendation Without Amendment",9,2,0,0,11
1131091,779199,2018-11-29,House,"Reported With Recommendation With Substitute  H-1",16,0,0,0,16
1131091,779987,2018-12-06,House,"House Third Reading: Passed Roll Call # 748",107,2,0,0,109
1131091,780690,2018-12-13,Senate,"Reported Favorably Without Amendment",7,0,0,0,7
1131091,781472,2018-12-19,Senate,"Senate Third Reading: Given Immediate Effect Roll Call # 928",38,0,0,0,38
1131095,779168,2018-11-28,House,"Reported With Recommendation With Substitute  H-3",9,1,0,0,10
1131095,780478,2018-12-11,House,"House Third Reading: Given Immediate Effect Roll Call # 779",100,8,0,0,108
1131107,779170,2018-11-28,House,"Reported With Recommendation Without Amendment",9,2,0,0,11
1131108,780033,2018-12-05,House,"Reported With Recommendation With Substitute  H-1",6,2,0,0,8
1131108,780579,2018-12-12,House,"House Third Reading: Given Immediate Effect Roll Call # 788",77,32,0,0,109
1131119,780142,2018-12-06,House,"Reported With Recommendation Without Amendment",10,0,0,0,10
1131119,780143,2018-12-06,House,"House Third Reading: Given Immediate Effect Roll Call # 771",96,13,0,0,109
1131119,781450,2018-12-19,Senate,"Reported Favorably Without Amendment",4,0,0,0,4
1131119,781451,2018-12-19,Senate,"Senate Third Reading: Given Immediate Effect Roll Call # 956",37,1,0,0,38
1131179,779637,2018-12-04,House,"Reported With Recommendation Without Amendment",14,0,0,0,14
1131179,780159,2018-12-06,House,"House Third Reading: Given Immediate Effect Roll Call # 762",105,3,0,0,108
1131179,780736,2018-12-13,Senate,"Reported Favorably Without Amendment",8,1,0,0,9
1131180,779635,2018-12-04,House,"Reported With Recommendation With Substitute  H-2",14,0,0,0,14
1131180,780162,2018-12-06,House,"House Third Reading: Given Immediate Effect Roll Call # 763",105,3,0,0,108
1131180,780747,2018-12-13,Senate,"Reported Favorably Without Amendment",8,1,0,0,9
1131198,779563,2018-12-04,House,"Reported With Recommendation Without Amendment",9,3,0,0,12
1131198,780031,2018-12-06,House,"House Third Reading: Given Immediate Effect Roll Call # 760",58,51,0,0,109
1131198,781345,2018-12-18,Senate,"Senate Third Reading: Given Immediate Effect Roll Call # 851",38,0,0,0,38
1131205,779662,2018-12-04,House,"Reported With Recommendation Without Amendment",13,0,0,0,13
1131205,780171,2018-12-06,House,"House Third Reading: Given Immediate Effect Roll Call # 761",102,6,0,0,108
1131205,780740,2018-12-13,Senate,"Reported Favorably With Substitute S-1",6,3,0,0,9
1131209,779263,2018-11-29,House,"Reported With Recommendation With Substitute H-1",10,0,0,0,10
1131209,779558,2018-12-04,House,"House Third Reading: Given Immediate Effect Roll Call # 671",105,3,0,0,108
1131209,780580,2018-12-12,Senate,"Reported Favorably With Substitute  S-1",4,0,0,0,4
1131209,780776,2018-12-13,Senate,"Senate Third Reading: Given Immediate Effect Roll Call # 790",34,3,0,1,38
1131209,781051,2018-12-18,House,"House Third Reading: Roll Call # 881",106,3,0,0,109
1131210,779570,2018-12-04,House,"Reported With Recommendation Without Amendment",9,3,0,0,12
1131210,780037,2018-12-06,House,"House Third Reading: Given Immediate Effect Roll Call # 759",60,49,0,0,109
1131210,781348,2018-12-18,Senate,"Senate Third Reading: Given Immediate Effect Roll Call # 850",38,0,0,0,38
1131214,780024,2018-12-06,Senate,"Reported Favorably Without Amendment",5,2,0,0,7
1131214,780025,2018-12-06,Senate,"Senate Third Reading: Passed Roll Call # 716",36,0,0,2,38
1131214,781196,2018-12-19,House,"Reported With Recommendation Without Amendment",27,0,0,0,27
1131214,781360,2018-12-20,House,"House Third Reading: Given Immediate Effect Roll Call # 928",109,0,0,0,109
1131217,780038,2018-12-06,Senate,"Reported Favorably Without Amendment",5,2,0,0,7
1131217,780039,2018-12-06,Senate,"Senate Third Reading: Passed Roll Call # 714",27,9,0,2,38
1131217,781199,2018-12-19,House,"Reported With Recommendation Without Amendment",10,5,0,0,15
1131217,781330,2018-12-20,House,"House Third Reading: Given Immediate Effect Roll Call # 922",62,47,0,0,109
1131224,779616,2018-12-04,Senate,"Reported Favorably Without Amendment",9,0,0,0,9
1131224,780112,2018-12-06,Senate,"Senate Third Reading: Passed Roll Call # 706",36,0,0,2,38
1131224,780516,2018-12-12,House,"Reported With Recommendation Without Amendment",11,1,0,0,12
1131224,781344,2018-12-20,House,"House Third Reading: Given Immediate Effect Roll Call # 926",81,28,0,0,109
1131225,780029,2018-12-06,Senate,"Reported Favorably Without Amendment",5,2,0,0,7
1131225,780030,2018-12-06,Senate,"Senate Third Reading: Passed Roll Call # 715",36,0,0,2,38
1131225,781198,2018-12-19,House,"Reported With Recommendation Without Amendment",27,0,0,0,27
1131225,781364,2018-12-20,House,"House Third Reading: Given Immediate Effect Roll Call # 927",109,0,0,0,109
1131226,779610,2018-12-04,Senate,"Reported Favorably Without Amendment",9,0,0,0,9
1131226,780253,2018-12-06,Senate,"Senate Third Reading: Passed Roll Call # 705",36,0,0,2,38
1131226,781192,2018-12-19,House,"Reported With Recommendation Without Amendment",11,0,0,0,11
1131226,781349,2018-12-20,House,"House Third Reading: Given Immediate Effect Roll Call # 925",81,28,0,0,109
1131228,780644,2018-12-12,Senate,"Reported Favorably With Substitute  S-1",3,0,0,0,3
1131229,780203,2018-12-06,Senate,"Reported Favorably With Substitute  S-1",5,2,0,0,7
1131229,780204,2018-12-06,Senate,"Senate Third Reading: Passed Roll Call # 731",36,0,0,2,38
1131229,780497,2018-12-11,House,"Reported With Recommendation Without Amendment",7,2,0,0,9
1131229,780498,2018-12-13,House,"House Third Reading: Given Immediate Effect Roll Call # 844",105,4,0,0,109
1131229,780733,2018-12-13,Senate,"Senate Third Reading: Roll Call # 830",37,0,0,1,38
1131234,780247,2018-12-06,Senate,"Reported Favorably Without Amendment",5,2,0,0,7
1131234,780248,2018-12-06,Senate,"Senate Third Reading: Passed Roll Call # 712",32,4,0,2,38
1131234,780505,2018-12-11,House,"Reported With Recommendation With Substitute  H-1",5,0,0,0,5
1131234,781132,2018-12-18,House,"House Third Reading: Given Immediate Effect Roll Call # 863",107,2,0,0,109
1131234,781468,2018-12-19,Senate,"Senate Third Reading: Roll Call # 916",37,1,0,0,38
1131235,780117,2018-12-06,Senate,"Reported Favorably With Substitute  S-2",5,2,0,0,7
1131235,780118,2018-12-06,Senate,"Senate Third Reading: Passed Roll Call # 736",36,0,0,2,38
1131235,780465,2018-12-12,House,"Reported With Recommendation With Substitute  H-2",16,0,0,0,16
1131235,781543,2018-12-21,House,"House Third Reading: Given Immediate Effect Roll Call # 1037",104,0,0,0,104
1131235,781544,2018-12-21,Senate,"Senate Third Reading: Roll Call # 1062",37,0,0,1,38
1131272,779686,2018-12-04,House,"Reported With Recommendation Without Amendment",11,1,0,0,12
1131272,780186,2018-12-06,House,"House Third Reading: Given Immediate Effect Roll Call # 758",90,19,0,0,109
1131290,780130,2018-12-06,Senate,"Reported Favorably Without Amendment",5,2,0,0,7
1131290,780131,2018-12-06,Senate,"Senate Third Reading: Passed Roll Call # 720",26,10,0,2,38
1131290,781213,2018-12-19,House,"Reported With Recommendation Without Amendment",6,3,0,0,9
1131290,781553,2018-12-20,House,"House Third Reading: Given Immediate Effect Roll Call # 941",61,47,0,0,108
1131293,780128,2018-12-06,Senate,"Reported Favorably Without Amendment",5,2,0,0,7
1131293,780129,2018-12-06,Senate,"Senate Third Reading: Passed Roll Call # 723",25,11,0,2,38
1131293,780264,2018-12-06,Senate,"Reported Favorably With Substitute S-1",5,2,0,0,7
1131293,781173,2018-12-19,House,"Reported With Recommendation Without Amendment",6,3,0,0,9
1131293,781581,2018-12-20,House,"House Third Reading: Given Immediate Effect Roll Call # 943",63,45,0,0,108
1131295,780234,2018-12-06,Senate,"Reported Favorably Without Amendment",5,2,0,0,7
1131295,780235,2018-12-06,Senate,"Senate Third Reading: Passed Roll Call # 721",26,10,0,2,38
1131295,781203,2018-12-19,House,"Reported With Recommendation Without Amendment",6,3,0,0,9
1131295,781593,2018-12-20,House,"House Third Reading: Given Immediate Effect Roll Call # 942",61,47,0,0,108
1131299,780074,2018-12-06,Senate,"Reported Favorably With Substitute  S-2",5,2,0,0,7
1131299,780075,2018-12-06,Senate,"Senate Third Reading: Passed Roll Call # 717",26,10,0,2,38
1131299,781202,2018-12-19,House,"Reported With Recommendation With Substitute  H-2",6,3,0,0,9
1131299,781536,2018-12-20,House,"House Third Reading: Given Immediate Effect Roll Call # 938",57,51,0,0,108
1131299,781537,2018-12-20,Senate,"Senate Third Reading: Roll Call # 1027",26,12,0,0,38
1131300,779597,2018-12-04,Senate,"Reported Favorably Without Amendment",5,0,0,0,5
1131300,779799,2018-12-04,Senate,"Senate Third Reading: Passed Roll Call # 677",23,14,0,1,38
1131300,781043,2018-12-18,House,"Reported With Recommendation With Substitute  H-3",6,3,0,0,9
1131300,781044,2018-12-18,House,"House Third Reading: Given Immediate Effect Roll Call # 880",56,53,0,0,109
1131300,781426,2018-12-19,Senate,"Senate Third Reading: Roll Call # 921",22,16,0,0,38
1131302,780139,2018-12-05,Senate,"Reported Favorably With Substitute  S-1",5,0,0,0,5
1131302,780140,2018-12-05,Senate,"Senate Third Reading: Passed Roll Call # 695",25,12,0,1,38
1131307,780173,2018-12-06,Senate,"Reported Favorably Without Amendment",5,2,0,0,7
1131307,780174,2018-12-06,Senate,"Senate Third Reading: Passed Roll Call # 739",35,1,0,2,38
1131307,780457,2018-12-12,House,"Reported With Recommendation Without Amendment",13,3,0,0,16
1131311,780218,2018-12-06,Senate,"Reported Favorably Without Amendment",5,2,0,0,7
1131311,780219,2018-12-06,Senate,"Senate Third Reading: Passed Roll Call # 725",25,11,0,2,38
1131313,780120,2018-12-06,Senate,"Reported Favorably Without Amendment",5,2,0,0,7
1131313,780121,2018-12-06,Senate,"Senate Third Reading: Passed Roll Call # 741",35,1,0,2,38
1131313,780462,2018-12-12,House,"Reported With Recommendation Without Amendment",13,3,0,0,16
1131319,780152,2018-12-06,Senate,"Reported Favorably With Substitute  S-1",5,2,0,0,7
1131319,780153,2018-12-06,Senate,"Senate Third Reading: Passed Roll Call # 724",25,11,0,2,38
1131325,780100,2018-12-06,Senate,"Reported Favorably Without Amendment",5,2,0,0,7
1131325,780101,2018-12-06,Senate,"Senate Third Reading: Passed Roll Call # 740",35,1,0,2,38
1131325,780464,2018-12-12,House,"Reported With Recommendation Without Amendment",13,3,0,0,16
1131326,780107,2018-12-06,Senate,"Reported Favorably Without Amendment",5,2,0,0,7
1131326,780108,2018-12-06,Senate,"Senate Third Reading: Passed Roll Call # 726",25,11,0,2,38
1131330,780183,2018-12-06,Senate,"Reported Favorably With Substitute  S-1",5,2,0,0,7
1131330,780184,2018-12-06,Senate,"Senate Third Reading: Passed Roll Call # 719",26,10,0,2,38
1131330,781201,2018-12-19,House,"Reported With Recommendation Without Amendment",6,3,0,0,9
1131330,781588,2018-12-20,House,"House Third Reading: Given Immediate Effect Roll Call # 940",60,48,0,0,108
1131332,780210,2018-12-06,Senate,"Reported Favorably Without Amendment",5,2,0,0,7
1131332,780211,2018-12-06,Senate,"Senate Third Reading: Passed Roll Call # 729",36,0,0,2,38
1131332,780441,2018-12-11,House,"Reported With Recommendation Without Amendment",12,0,0,0,12
1131332,781075,2018-12-18,House,"House Third Reading: Given Immediate Effect Roll Call # 854",109,0,0,0,109
1131333,780181,2018-12-06,Senate,"Reported Favorably With Substitute  S-1",5,2,0,0,7
1131333,780182,2018-12-06,Senate,"Senate Third Reading: Passed Roll Call # 718",26,10,0,2,38
1131333,781167,2018-12-19,House,"Reported With Recommendation With Substitute  H-1",6,3,0,0,9
1131333,781554,2018-12-20,House,"House Third Reading: Given Immediate Effect Roll Call # 939",60,48,0,0,108
1131333,781555,2018-12-20,Senate,"Senate Third Reading: Roll Call # 1028",26,12,0,0,38
1131335,780126,2018-12-06,Senate,"Reported Favorably Without Amendment",5,2,0,0,7
1131335,780127,2018-12-06,Senate,"Senate Third Reading: Passed Roll Call # 722",25,11,0,2,38
1131342,779574,2018-12-04,House,"Reported With Recommendation Without Amendment",3,2,0,0,5
1131342,779953,2018-12-05,House,"House Third Reading: Passed Roll Call # 701",58,50,0,0,108
1131342,780481,2018-12-12,Senate,"Reported Favorably With Substitute  S-1",3,2,0,0,5
1131342,781356,2018-12-20,Senate,"Senate Third Reading: Given Immediate Effect Roll Call # 974",26,12,0,0,38
1131342,781622,2018-12-21,House,"House Third Reading: Roll Call # 1015",60,47,0,0,107
1131346,779538,2018-12-04,House,"Reported With Recommendation Without Amendment",11,1,0,0,12
1132089,780705,2018-12-13,Senate,"Reported Favorably Without Amendment",3,0,0,0,3
1132089,780706,2018-12-13,Senate,"Senate Third Reading: Passed Roll Call # 821",29,8,0,1,38
1132094,780202,2018-12-05,Senate,"Reported Favorably With Substitute  S-2",5,0,0,0,5
1132115,780205,2018-12-05,Senate,"Reported Favorably With Substitute  S-2",5,0,0,0,5
1132125,780758,2018-12-13,Senate,"Reported Favorably Without Amendment",3,0,0,0,3
1132125,780759,2018-12-13,Senate,"Senate Third Reading: Passed Roll Call # 820",28,9,0,1,38
1132164,780221,2018-12-06,Senate,"Reported Favorably Without Amendment",4,1,0,0,5
1132221,779966,2018-12-06,House,"Reported With Recommendation Without Amendment",9,0,0,0,9
1132221,780443,2018-12-12,House,"House Third Reading: Given Immediate Effect Roll Call # 789",109,0,0,0,109
1132221,781375,2018-12-18,Senate,"Reported Favorably Without Amendment",5,0,0,0,5
1132221,781376,2018-12-18,Senate,"Senate Third Reading: Given Immediate Effect Roll Call # 884",38,0,0,0,38
1132243,780573,2018-12-12,House,"Reported With Recommendation With Substitute  H-1",6,0,0,0,6
1132243,780574,2018-12-12,House,"House Third Reading: Given Immediate Effect Roll Call # 821",99,10,0,0,109
1132243,781455,2018-12-20,Senate,"Reported Favorably With Substitute  S-2",5,0,0,0,5
1132243,781456,2018-12-20,Senate,"Senate Third Reading: Given Immediate Effect Roll Call # 1006",38,0,0,0,38
1132243,781568,2018-12-21,House,"House Third Reading: Roll Call # 1016",97,10,0,0,107
1132246,779973,2018-12-06,House,"Reported With Recommendation Without Amendment",9,0,0,0,9
1132246,780425,2018-12-12,House,"House Third Reading: Given Immediate Effect Roll Call # 790",109,0,0,0,109
1132246,781381,2018-12-18,Senate,"Reported Favorably Without Amendment",5,0,0,0,5
1132246,781382,2018-12-18,Senate,"Senate Third Reading: Given Immediate Effect Roll Call # 885",38,0,0,0,38
1132288,780239,2018-12-06,Senate,"Reported Favorably Without Amendment",5,0,0,0,5
1132288,780703,2018-12-13,Senate,"Senate Third Reading: Passed Roll Call # 797",33,4,0,1,38
1132288,781298,2018-12-20,House,"House Third Reading: Given Immediate Effect Roll Call # 921",73,36,0,0,109
1132416,780646,2018-12-12,Senate,"Reported Favorably With Substitute  S-1",5,0,0,0,5
1132416,780689,2018-12-13,Senate,"Senate Third Reading: Passed Roll Call # 807",37,0,0,1,38
1132416,781584,2018-12-21,House,"House Third Reading: Given Immediate Effect Roll Call # 995",104,3,0,0,107
1132420,780638,2018-12-12,Senate,"Reported Favorably With Substitute  S-1",3,0,0,0,3
1132420,780687,2018-12-13,Senate,"Senate Third Reading: Passed Roll Call # 805",30,7,0,1,38
1132420,781571,2018-12-21,House,"House Third Reading: Given Immediate Effect Roll Call # 993",96,11,0,0,107
1132420,781572,2018-12-21,Senate,"Senate Third Reading: Roll Call # 1051",34,4,0,0,38
1132423,780445,2018-12-12,House,"Reported With Recommendation Without Amendment",6,3,0,0,9
1132423,780446,2018-12-12,House,"House Third Reading: Given Immediate Effect Roll Call # 819",60,49,0,0,109
1132423,781391,2018-12-20,Senate,"Reported Favorably With Substitute  S-1",5,0,0,0,5
1132423,781596,2018-12-21,Senate,"Senate Third Reading: Given Immediate Effect Roll Call # 1046",26,12,0,0,38
1132423,781597,2018-12-21,House,"House Third Reading: Roll Call # 1038",57,47,0,0,104
1132434,780523,2018-12-12,Senate,"Reported Favorably Without Amendment",5,0,0,0,5
1132434,780742,2018-12-13,Senate,"Senate Third Reading: Passed Roll Call # 806",35,2,0,1,38
1132434,781576,2018-12-21,House,"House Third Reading: Given Immediate Effect Roll Call # 994",102,5,0,0,107
